bac_id,chrNo,cyto,bac_start,bac_end,bac_size,is_CNV_targetting,is_chr20_targetting
BAC246_L01,1,1p36.33,665398,742831,77433,-,-
BAC181_E22,1,1p36.33,711634,789889,78255,-,-
BAC127_E01,1,1p36.33,727410,821316,93906,-,-
BAC115_K03,1,1p36.33,762629,865959,103330,-,-
BAC54_B22,1,1p36.33,763939,837961,74022,-,-
BAC142_A22,1,1p36.33,778566,865959,87393,-,-
BAC37_N14,1,1p36.33,805555,893509,87954,-,-
BAC31_J22,1,1p36.33,838028,933541,95513,-,-
BAC69_G22,1,1p36.33,865968,964268,98300,-,-
BAC230_P11,1,1p36.33,1575434,1670693,95259,-,-
BAC56_B04,1,1p36.33,1725694,1820328,94634,-,-
BAC90_F04,1,1p36.33,1744728,1877123,132395,-,-
BAC199_B19,1,1p36.33,1849948,1981352,131404,-,-
BAC142_C15,1,1p36.33,1912205,1994524,82319,-,-
BAC183_I23,1,1p36.33,1917621,1994524,76903,-,-
BAC195_G03,1,1p36.33,1945814,2065352,119538,-,-
BAC145_F02,1,1p36.33,1968377,2065352,96975,-,-
BAC196_M17,1,1p36.33,2032232,2113710,81478,-,-
BAC176_F17,1,1p36.33,2085982,2192431,106449,-,-
BAC169_D13,1,1p36.33,2137149,2223509,86360,-,-
BAC38_N15,1,1p36.33,2192427,2278103,85676,-,-
BAC185_K01,1,1p36.33-1p36.32,2223564,2323053,99489,-,-
BAC205_M15,1,1p36.32,2341887,2435682,93795,-,-
BAC34_L22,1,1p36.32,2436026,2562198,126172,-,-
BAC100_M01,1,1p36.32,2448292,2559232,110940,-,-
BAC66_E08,1,1p36.32,2725104,2845778,120674,-,-
BAC41_E20,1,1p36.32,2736150,2852398,116248,-,-
BAC90_D18,1,1p36.32,2795614,2880870,85256,-,-
BAC185_M13,1,1p36.32,2987391,3150855,163464,-,-
BAC12_N07,1,1p36.32,3000997,3154925,153928,-,-
BAC109_P05,1,1p36.32,3000997,3086239,85242,-,-
BAC176_L05,1,1p36.32,3050312,3154925,104613,-,-
BAC27_I22,1,1p36.32,3050312,3168429,118117,-,-
BAC221_A09,1,1p36.32,3056266,3204889,148623,-,-
BAC170_P01,1,1p36.32,3056266,3168429,112163,-,-
BAC50_D17,1,1p36.32,3086239,3187553,101314,-,-
BAC248_M02,1,1p36.32,3167567,3290677,123110,-,-
BAC144_F04,1,1p36.32,3187550,3290678,103128,-,-
BAC148_K02,1,1p36.32,3195349,3360342,164993,-,-
BAC237_L15,1,1p36.32,3290729,3380425,89696,-,-
BAC58_E04,1,1p36.32,3336792,3460513,123721,-,-
BAC89_O17,1,1p36.32,3489433,3580644,91211,-,-
BAC242_E17,1,1p36.32,3512790,3680189,167399,-,-
BAC168_E18,1,1p36.32,3536337,3650185,113848,-,-
BAC163_A07,1,1p36.32,3536399,3655707,119308,-,-
BAC141_N19,1,1p36.32,3549885,3650185,100300,-,-
BAC46_N07,1,1p36.32,3549931,3650182,100251,-,-
BAC176_G17,1,1p36.32,3627922,3730262,102340,-,-
BAC184_J17,1,1p36.32,3647312,3735731,88419,-,-
BAC127_N23,1,1p36.32,3655702,3797375,141673,-,-
BAC225_F14,1,1p36.32,3680186,3793213,113027,-,-
BAC152_F16,1,1p36.32,3689984,3793213,103229,-,-
BAC141_C05,1,1p36.32,3730264,3811493,81229,-,-
BAC151_P12,1,1p36.32,3730264,3828330,98066,-,-
BAC53_H02,1,1p36.32,3899060,4000365,101305,-,-
BAC50_A12,1,1p36.32,3995785,4153099,157314,-,-
BAC234_C06,1,1p36.32,4018429,4130236,111807,-,-
BAC242_N11,1,1p36.32,4062618,4195855,133237,-,-
BAC236_I14,1,1p36.32,4066745,4167947,101202,-,-
BAC248_C19,1,1p36.32,4071574,4171020,99446,-,-
BAC78_N22,1,1p36.32,4106083,4193546,87463,-,-
BAC30_F12,1,1p36.32,4216288,4327381,111093,-,-
BAC26_B13,1,1p36.32,4232038,4371750,139712,-,-
BAC22_B20,1,1p36.32,4239211,4360593,121382,-,-
BAC22_D04,1,1p36.32,4239277,4388683,149406,-,-
BAC74_H04,1,1p36.32,4251925,4377471,125546,-,-
BAC169_C16,1,1p36.32,4253508,4377210,123702,-,-
BAC235_P13,1,1p36.32,4285041,4358266,73225,-,-
BAC37_P03,1,1p36.32,4336528,4449067,112539,-,-
BAC194_L23,1,1p36.32,4394377,4483986,89609,-,-
BAC5_I01,1,1p36.32,4397979,4572490,174511,-,-
BAC51_O19,1,1p36.32,4397987,4547559,149572,-,-
BAC180_I08,1,1p36.32,4408183,4485458,77275,-,-
BAC191_P10,1,1p36.32,4449097,4547559,98462,-,-
BAC68_E14,1,1p36.32,4487314,4574213,86899,-,-
BAC244_G17,1,1p36.32,4531228,4617532,86304,-,-
BAC170_E07,1,1p36.32,4547807,4639728,91921,-,-
BAC76_E01,1,1p36.32,4550089,4639728,89639,-,-
BAC1_H18,1,1p36.32,4551318,4639728,88410,-,-
BAC48_E17,1,1p36.32,4551350,4671266,119916,-,-
BAC83_A03,1,1p36.32,4639967,4716716,76749,-,-
BAC171_P09,1,1p36.32,4749037,4832802,83765,-,-
BAC148_O02,1,1p36.32,4749040,4825702,76662,-,-
BAC52_H04,1,1p36.32,4779512,4893228,113716,-,-
BAC167_N11,1,1p36.32,4944144,5023766,79622,-,-
BAC33_A06,1,1p36.32,5008152,5088354,80202,-,-
BAC161_H02,1,1p36.32-1p36.31,5225867,5318450,92583,-,-
BAC127_O11,1,1p36.31,5410334,5580096,169762,-,-
BAC61_O19,1,1p36.31,5419187,5516446,97259,-,-
BAC227_G17,1,1p36.31,5426906,5507451,80545,-,-
BAC104_P05,1,1p36.31,5471167,5629937,158770,-,-
BAC48_G06,1,1p36.31,5580221,5673504,93283,-,-
BAC31_N15,1,1p36.31,5640011,5754499,114488,-,-
BAC128_D11,1,1p36.31,5656992,5780029,123037,-,-
BAC12_N05,1,1p36.31,5659835,5754365,94530,-,-
BAC200_L08,1,1p36.31,5698864,5780029,81165,-,-
BAC240_I21,1,1p36.31,5829605,5930188,100583,-,-
BAC174_C08,1,1p36.31,5836718,5929053,92335,-,-
BAC102_E19,1,1p36.31,5859523,5959337,99814,-,-
BAC217_J14,1,1p36.31,5929047,6053229,124182,-,-
BAC224_J01,1,1p36.31,5950584,6053232,102648,-,-
BAC69_A04,1,1p36.31,5972249,6064482,92233,-,-
BAC64_H05,1,1p36.31,6058854,6180605,121751,-,-
BAC81_D16,1,1p36.31,6064489,6208823,144334,-,-
BAC63_J20,1,1p36.31,6064489,6245805,181316,-,-
BAC169_K24,1,1p36.31,6143403,6256544,113141,-,-
BAC46_L04,1,1p36.31,6180603,6296133,115530,-,-
BAC82_C24,1,1p36.31,6180608,6276656,96048,-,-
BAC33_L12,1,1p36.31,6198474,6276651,78177,-,-
BAC189_I08,1,1p36.31,6206563,6298400,91837,-,-
BAC55_D19,1,1p36.31,6208847,6296133,87286,-,-
BAC41_B20,1,1p36.31,6209161,6317250,108089,-,-
BAC71_H07,1,1p36.31,6264779,6395841,131062,-,-
BAC114_A01,1,1p36.31,6350972,6453833,102861,-,-
BAC143_J22,1,1p36.31,6414078,6518992,104914,-,-
BAC159_B08,1,1p36.31,6439847,6591983,152136,-,-
BAC247_P16,1,1p36.31,6473930,6557885,83955,-,-
BAC32_B12,1,1p36.31,6476310,6588197,111887,-,-
BAC20_E04,1,1p36.31,6504288,6606023,101735,-,-
BAC59_J23,1,1p36.31,6516266,6606143,89877,-,-
BAC195_O24,1,1p36.31,6588296,6685979,97683,-,-
BAC195_L24,1,1p36.31,6588296,6685972,97676,-,-
BAC170_J23,1,1p36.31,6611799,6699878,88079,-,-
BAC63_P20,1,1p36.31,6655055,6783540,128485,-,-
BAC182_L03,1,1p36.31,6699041,6787649,88608,-,-
BAC84_P03,1,1p36.31,6705724,6794350,88626,-,-
BAC141_E06,1,1p36.31,6763421,6903859,140438,-,-
BAC125_B21,1,1p36.31,6785360,6903859,118499,-,-
BAC191_I15,1,1p36.31,6825735,6907880,82145,-,-
BAC250_C07,1,1p36.31,6874359,6966238,91879,-,-
BAC102_O08,1,1p36.31,6895530,7075347,179817,-,-
BAC198_E05,1,1p36.31,6903849,6992848,88999,-,-
BAC119_E07,1,1p36.31,6903849,6992848,88999,-,-
BAC242_H15,1,1p36.31,6921360,7001473,80113,-,-
BAC197_I23,1,1p36.31,6936803,7024579,87776,-,-
BAC57_C18,1,1p36.31,6978352,7075329,96977,-,-
BAC167_C08,1,1p36.31-1p36.23,7076821,7193950,117129,-,-
BAC195_B17,1,1p36.31-1p36.23,7080361,7175501,95140,-,-
BAC120_P02,1,1p36.31-1p36.23,7087207,7204385,117178,-,-
BAC42_I15,1,1p36.23,7120287,7193950,73663,-,-
BAC159_E02,1,1p36.23,7163183,7285824,122641,-,-
BAC161_M16,1,1p36.23,7174468,7298664,124196,-,-
BAC161_D03,1,1p36.23,7193963,7289979,96016,-,-
BAC193_K23,1,1p36.23,7291556,7382799,91243,-,-
BAC86_L19,1,1p36.23,7296027,7425849,129822,-,-
BAC108_P15,1,1p36.23,7298656,7396742,98086,-,-
BAC96_F09,1,1p36.23,7298657,7382799,84142,-,-
BAC80_F08,1,1p36.23,7298657,7398639,99982,-,-
BAC209_L16,1,1p36.23,7298727,7388330,89603,-,-
BAC48_C03,1,1p36.23,7312085,7393196,81111,-,-
BAC195_O09,1,1p36.23,7312111,7423491,111380,-,-
BAC64_O16,1,1p36.23,7315926,7423524,107598,-,-
BAC185_C17,1,1p36.23,7447331,7538217,90886,-,-
BAC243_A07,1,1p36.23,7547306,7658831,111525,-,-
BAC183_D10,1,1p36.23,7547306,7659225,111919,-,-
BAC162_L03,1,1p36.23,7555447,7683290,127843,-,-
BAC57_D03,1,1p36.23,7575330,7659809,84479,-,-
BAC45_C11,1,1p36.23,7594264,7658463,64199,-,-
BAC116_C20,1,1p36.23,7668252,7739891,71639,-,-
BAC34_E20,1,1p36.23,7729712,7815328,85616,-,-
BAC140_N09,1,1p36.23,7731927,7828073,96146,-,-
BAC45_C05,1,1p36.23,7755933,7882413,126480,-,-
BAC165_A08,1,1p36.23,7832635,7919980,87345,-,-
BAC223_I07,1,1p36.23,7886594,7995607,109013,-,-
BAC35_C11,1,1p36.23,7891224,8002461,111237,-,-
BAC109_P09,1,1p36.23,7891472,7983529,92057,-,-
BAC1_O02,1,1p36.23,7892707,7983670,90963,-,-
BAC88_J18,1,1p36.23,7915500,8000641,85141,-,-
BAC187_D10,1,1p36.23,7996644,8080379,83735,-,-
BAC228_G23,1,1p36.23,8059802,8150008,90206,-,-
BAC69_O01,1,1p36.23,8161468,8297057,135589,-,-
BAC105_H04,1,1p36.23,8162346,8243757,81411,-,-
BAC233_F11,1,1p36.23,8165182,8233451,68269,-,-
BAC246_N16,1,1p36.23,8297052,8387510,90458,-,-
BAC128_J02,1,1p36.23,8344242,8444060,99818,-,-
BAC30_J05,1,1p36.23,8363335,8466997,103662,-,-
BAC233_O07,1,1p36.23,8400942,8494006,93064,-,-
BAC37_N19,1,1p36.23,8410307,8513653,103346,-,-
BAC190_M14,1,1p36.23,8410315,8508188,97873,-,-
BAC125_E11,1,1p36.23,8438633,8532018,93385,-,-
BAC230_P19,1,1p36.23,8444055,8573648,129593,-,-
BAC86_J18,1,1p36.23,8472052,8553679,81627,-,-
BAC76_J09,1,1p36.23,8475470,8643533,168063,-,-
BAC45_M07,1,1p36.23,8502758,8625216,122458,-,-
BAC31_D02,1,1p36.23,8525888,8608670,82782,-,-
BAC125_O07,1,1p36.23,8537658,8625220,87562,-,-
BAC26_B06,1,1p36.23,8578937,8665670,86733,-,-
BAC10_I07,1,1p36.23,8643531,8731169,87638,-,-
BAC95_C02,1,1p36.23,8657015,8774576,117561,-,-
BAC162_C01,1,1p36.23,8665735,8750250,84515,-,-
BAC37_B23,1,1p36.23,8671796,8839965,168169,-,-
BAC135_K24,1,1p36.23,8758432,8860199,101767,-,-
BAC198_B17,1,1p36.23,8840065,8959193,119128,-,-
BAC184_H16,1,1p36.23,8843132,8935254,92122,-,-
BAC63_O24,1,1p36.23,8843140,8936528,93388,-,-
BAC78_C20,1,1p36.23,8845627,8972351,126724,-,-
BAC82_P18,1,1p36.23,8863298,8959400,96102,-,-
BAC239_I05,1,1p36.23,8867858,8944883,77025,-,-
BAC78_L17,1,1p36.23,8936524,9068161,131637,-,-
BAC209_I15,1,1p36.23,8966402,9070488,104086,-,-
BAC240_M24,1,1p36.23,8972346,9070490,98144,-,-
BAC146_P13,1,1p36.23,8987816,9070795,82979,-,-
BAC233_H01,1,1p36.23,8987837,9070795,82958,-,-
BAC2_E09,1,1p36.23,9014303,9101127,86824,-,-
BAC55_O11,1,1p36.23,9014377,9101133,86756,-,-
BAC129_N18,1,1p36.23,9070786,9187091,116305,-,-
BAC84_O08,1,1p36.23,9070786,9195749,124963,-,-
BAC83_G16,1,1p36.23,9073605,9187091,113486,-,-
BAC190_E13,1,1p36.23,9085788,9170094,84306,-,-
BAC151_J19,1,1p36.23,9101128,9185120,83992,-,-
BAC145_L13,1,1p36.23,9101145,9187091,85946,-,-
BAC27_B16,1,1p36.23-1p36.22,9172279,9279816,107537,-,-
BAC132_L11,1,1p36.22,9208290,9352825,144535,-,-
BAC63_M18,1,1p36.22,9236082,9334144,98062,-,-
BAC248_B08,1,1p36.22,9259584,9348086,88502,-,-
BAC27_E07,1,1p36.22,9287189,9392043,104854,-,-
BAC33_K20,1,1p36.22,9345560,9435007,89447,-,-
BAC109_N18,1,1p36.22,9642317,9779641,137324,-,-
BAC106_B19,1,1p36.22,9667644,9760293,92649,-,-
BAC91_O21,1,1p36.22,9667644,9763814,96170,-,-
BAC48_E02,1,1p36.22,9667644,9779586,111942,-,-
BAC78_L05,1,1p36.22,9667646,9762226,94580,-,-
BAC26_M23,1,1p36.22,9667648,9763814,96166,-,-
BAC20_B10,1,1p36.22,9667650,9759300,91650,-,-
BAC162_M21,1,1p36.22,9668022,9763814,95792,-,-
BAC152_N21,1,1p36.22,9685596,9770031,84435,-,-
BAC130_O03,1,1p36.22,9802379,9889579,87200,-,-
BAC60_M04,1,1p36.22,9886785,10030125,143340,-,-
BAC188_I15,1,1p36.22,9984869,10056896,72027,-,-
BAC73_N08,1,1p36.22,10082111,10163722,81611,-,-
BAC34_N10,1,1p36.22,10086903,10197749,110846,-,-
BAC120_E02,1,1p36.22,10196634,10304092,107458,-,-
BAC135_H08,1,1p36.22,10201416,10276462,75046,-,-
BAC36_A12,1,1p36.22,10221606,10393890,172284,-,-
BAC83_P20,1,1p36.22,10221612,10309556,87944,-,-
BAC229_M09,1,1p36.22,10236822,10306486,69664,-,-
BAC219_L12,1,1p36.22,10253848,10340656,86808,-,-
BAC191_L15,1,1p36.22,10260491,10349737,89246,-,-
BAC158_O15,1,1p36.22,10261858,10367961,106103,-,-
BAC34_K03,1,1p36.22,10322415,10412065,89650,-,-
BAC176_O15,1,1p36.22,10328426,10442177,113751,-,-
BAC76_L10,1,1p36.22,10383626,10472825,89199,-,-
BAC92_P07,1,1p36.22,10393883,10506846,112963,-,-
BAC119_G02,1,1p36.22,10440518,10564292,123774,-,-
BAC169_B14,1,1p36.22,10442171,10519305,77134,-,-
BAC58_N24,1,1p36.22,10506898,10627404,120506,-,-
BAC166_C09,1,1p36.22,10564443,10700025,135582,-,-
BAC187_J05,1,1p36.22,10586230,10700025,113795,-,-
BAC24_J17,1,1p36.22,10586387,10731172,144785,-,-
BAC229_N15,1,1p36.22,10597273,10703802,106529,-,-
BAC167_I17,1,1p36.22,10627398,10734650,107252,-,-
BAC26_I04,1,1p36.22,10673667,10814182,140515,-,-
BAC161_H09,1,1p36.22,10782505,10891932,109427,-,-
BAC140_G07,1,1p36.22,10811249,10888966,77717,-,-
BAC167_J04,1,1p36.22,10826727,10952381,125654,-,-
BAC217_O06,1,1p36.22,10969464,11062657,93193,-,-
BAC32_G12,1,1p36.22,11063257,11141608,78351,-,-
BAC36_H16,1,1p36.22,11068638,11203014,134376,-,-
BAC170_D02,1,1p36.22,11104460,11201256,96796,-,-
BAC132_G11,1,1p36.22,11114879,11207823,92944,-,-
BAC90_A08,1,1p36.22,11114879,11263174,148295,-,-
BAC37_L12,1,1p36.22,11135077,11244313,109236,-,-
BAC171_L15,1,1p36.22,11141602,11261296,119694,-,-
BAC4_D14,1,1p36.22,11147547,11245291,97744,-,-
BAC82_D15,1,1p36.22,11151290,11266512,115222,-,-
BAC40_L11,1,1p36.22,11210555,11340390,129835,-,-
BAC100_A15,1,1p36.22,11250787,11342606,91819,-,-
BAC39_F19,1,1p36.22,11277332,11437474,160142,-,-
BAC66_D06,1,1p36.22,11277349,11423348,145999,-,-
BAC193_F05,1,1p36.22,11309500,11406941,97441,-,-
BAC247_L06,1,1p36.22,11340437,11437474,97037,-,-
BAC36_L20,1,1p36.22,11358876,11462224,103348,-,-
BAC127_O05,1,1p36.22,11462216,11555060,92844,-,-
BAC188_P01,1,1p36.22,11503390,11600677,97287,-,-
BAC193_N19,1,1p36.22,11545826,11696672,150846,-,-
BAC52_J22,1,1p36.22,11555057,11719879,164822,-,-
BAC77_E10,1,1p36.22,11555069,11719889,164820,-,-
BAC149_C20,1,1p36.22,11644319,11778527,134208,-,-
BAC63_C10,1,1p36.22,11693808,11801660,107852,-,-
BAC180_C01,1,1p36.22,11696949,11801660,104711,-,-
BAC219_K08,1,1p36.22,11706249,11801658,95409,-,-
BAC226_J01,1,1p36.22,11719884,11801660,81776,-,-
BAC26_D16,1,1p36.22,11801716,11966731,165015,-,-
BAC165_I22,1,1p36.22,11840110,11956665,116555,-,-
BAC167_A22,1,1p36.22,11843637,11956665,113028,-,-
BAC173_J09,1,1p36.22,11844787,11966728,121941,-,-
BAC44_G09,1,1p36.22,11844904,11967247,122343,-,-
BAC81_I11,1,1p36.22,11896777,12080549,183772,-,-
BAC21_F06,1,1p36.22,11966725,12101160,134435,-,-
BAC117_P17,1,1p36.22,11975747,12085109,109362,-,-
BAC182_B03,1,1p36.22,12002982,12079068,76086,-,-
BAC140_N13,1,1p36.22,12014894,12091671,76777,-,-
BAC167_K08,1,1p36.22,12122605,12217579,94974,-,-
BAC28_J24,1,1p36.22,12322436,12417406,94970,-,-
BAC149_A02,1,1p36.22,12345454,12443239,97785,-,-
BAC218_I01,1,1p36.22,12355548,12477520,121972,-,-
BAC57_N24,1,1p36.22,12379147,12462717,83570,-,-
BAC193_D12,1,1p36.22,12379147,12477523,98376,-,-
BAC26_N24,1,1p36.22,12385219,12485989,100770,-,-
BAC226_O08,1,1p36.22,12407431,12485972,78541,-,-
BAC92_L07,1,1p36.22,12462603,12549503,86900,-,-
BAC49_K01,1,1p36.22-1p36.21,12549848,12660441,110593,-,-
BAC25_D06,1,1p36.22-1p36.21,12549888,12639046,89158,-,-
BAC231_C13,1,1p36.22-1p36.21,12570376,12671985,101609,-,-
BAC103_G18,1,1p36.21,12639038,12745919,106881,-,-
BAC159_E07,1,1p36.21,12749224,12866210,116986,-,-
BAC82_E19,1,1p36.21,12755094,12886275,131181,-,-
BAC57_I03,1,1p36.21,12782385,12886079,103694,-,-
BAC147_I23,1,1p36.21,12798101,12880736,82635,-,-
BAC219_P22,1,1p36.21,12886367,13092500,206133,-,-
BAC230_A05,1,1p36.21,13092494,13268691,176197,-,-
BAC127_N04,1,1p36.21,13107937,13272966,165029,-,-
BAC70_I04,1,1p36.21,13119967,13276004,156037,-,-
BAC79_E19,1,1p36.21,13279563,13584929,305366,-,-
BAC189_J08,1,1p36.21,13280679,13418320,137641,-,-
BAC246_L04,1,1p36.21,13292754,13380944,88190,-,-
BAC198_A04,1,1p36.21,13293004,13405338,112334,-,-
BAC165_K12,1,1p36.21,13296675,13380946,84271,-,-
BAC168_I01,1,1p36.21,13588987,13706263,117276,-,-
BAC40_B04,1,1p36.21,13681896,13807568,125672,-,-
BAC46_L14,1,1p36.21,13714343,13807512,93169,-,-
BAC43_P01,1,1p36.21,13715595,13836513,120918,-,-
BAC190_M04,1,1p36.21,13883759,13958962,75203,-,-
BAC251_M11,1,1p36.21,13966616,13992781,26165,-,-
BAC106_N10,1,1p36.21,13972273,14068428,96155,-,-
BAC169_I09,1,1p36.21,13972273,14087482,115209,-,-
BAC234_B12,1,1p36.21,13985735,14083245,97510,-,-
BAC172_I12,1,1p36.21,13995308,14080752,85444,-,-
BAC117_K06,1,1p36.21,13997802,14095974,98172,-,-
BAC221_M11,1,1p36.21,14126782,14218579,91797,-,-
BAC154_M06,1,1p36.21,14173122,14254568,81446,-,-
BAC150_A19,1,1p36.21,14173122,14259087,85965,-,-
BAC247_O14,1,1p36.21,14227239,14313865,86626,-,-
BAC149_K17,1,1p36.21,14239209,14350832,111623,-,-
BAC80_M10,1,1p36.21,14320608,14426955,106347,-,-
BAC142_I08,1,1p36.21,14366129,14525725,159596,-,-
BAC234_K21,1,1p36.21,14373284,14500049,126765,-,-
BAC180_D15,1,1p36.21,14384753,14500049,115296,-,-
BAC175_F24,1,1p36.21,14384889,14495195,110306,-,-
BAC217_G02,1,1p36.21,14401527,14503566,102039,-,-
BAC238_F17,1,1p36.21,14414041,14498586,84545,-,-
BAC59_P18,1,1p36.21,14512486,14648546,136060,-,-
BAC246_P17,1,1p36.21,14576364,14654037,77673,-,-
BAC126_N05,1,1p36.21,14603388,14675979,72591,-,-
BAC11_A02,1,1p36.21,14712538,14799678,87140,-,-
BAC46_O02,1,1p36.21,14770594,14872993,102399,-,-
BAC28_H08,1,1p36.21,14785314,14968094,182780,-,-
BAC229_F11,1,1p36.21,14799772,14873667,73895,-,-
BAC79_C21,1,1p36.21,14815569,14941458,125889,-,-
BAC246_O05,1,1p36.21,14816772,14938822,122050,-,-
BAC246_J17,1,1p36.21,14837683,14912313,74630,-,-
BAC160_J07,1,1p36.21,14972247,15088216,115969,-,-
BAC91_A07,1,1p36.21,14972982,15068854,95872,-,-
BAC178_M20,1,1p36.21,14984143,15046252,62109,-,-
BAC27_L06,1,1p36.21,14984159,15090619,106460,-,-
BAC185_M08,1,1p36.21,15003152,15088216,85064,-,-
BAC221_E23,1,1p36.21,15088218,15168615,80397,-,-
BAC37_E08,1,1p36.21,15090613,15195996,105383,-,-
BAC97_F03,1,1p36.21,15202556,15256077,53521,-,-
BAC194_C04,1,1p36.21,15295388,15437916,142528,-,-
BAC192_C14,1,1p36.21,15295388,15381244,85856,-,-
BAC37_A04,1,1p36.21,15317752,15418687,100935,-,-
BAC246_H10,1,1p36.21,15346462,15429291,82829,-,-
BAC136_O17,1,1p36.21,15346713,15429299,82586,-,-
BAC36_I11,1,1p36.21,15358957,15453918,94961,-,-
BAC160_N19,1,1p36.21,15435533,15538516,102983,-,-
BAC118_G04,1,1p36.21,15460440,15555019,94579,-,-
BAC33_O05,1,1p36.21,15482450,15594802,112352,-,-
BAC126_M09,1,1p36.21,15507620,15589813,82193,-,-
BAC239_O03,1,1p36.21,15507620,15636402,128782,-,-
BAC135_K06,1,1p36.21,15507823,15591795,83972,-,-
BAC226_M08,1,1p36.21,15508772,15591799,83027,-,-
BAC137_H14,1,1p36.21,15522587,15593920,71333,-,-
BAC193_B08,1,1p36.21,15540530,15642526,101996,-,-
BAC52_K07,1,1p36.21,15594795,15695308,100513,-,-
BAC230_F05,1,1p36.21,15618567,15695303,76736,-,-
BAC217_F15,1,1p36.21,15618580,15698943,80363,-,-
BAC236_J03,1,1p36.21,15680622,15797536,116914,-,-
BAC175_P19,1,1p36.21,15689359,15778494,89135,-,-
BAC51_J08,1,1p36.21,15699268,15803043,103775,-,-
BAC38_B08,1,1p36.21,15793443,15896165,102722,-,-
BAC203_E15,1,1p36.21,15842817,15936651,93834,-,-
BAC151_A22,1,1p36.21,15844290,15932361,88071,-,-
BAC96_I03,1,1p36.21,15880647,15986484,105837,-,-
BAC170_C20,1,1p36.21,15915030,16011327,96297,-,-
BAC130_H02,1,1p36.21,15954357,16043377,89020,-,-
BAC126_J14,1,1p36.21-1p36.13,15986548,16134204,147656,-,-
BAC126_B13,1,1p36.21-1p36.13,15986548,16134204,147656,-,-
BAC200_E04,1,1p36.21-1p36.13,16043373,16134204,90831,-,-
BAC80_C03,1,1p36.21-1p36.13,16078771,16263753,184982,-,-
BAC45_C16,1,1p36.13,16152860,16265755,112895,-,-
BAC144_I01,1,1p36.13,16162571,16245110,82539,-,-
BAC67_H20,1,1p36.13,16168203,16263753,95550,-,-
BAC175_H20,1,1p36.13,16231438,16322751,91313,-,-
BAC67_F15,1,1p36.13,16280915,16308312,27397,-,-
BAC173_K16,1,1p36.13,16324638,16410862,86224,-,-
BAC43_C23,1,1p36.13,16324687,16488490,163803,-,-
BAC97_A11,1,1p36.13,16336799,16427594,90795,-,-
BAC67_G22,1,1p36.13,16518756,16632155,113399,-,-
BAC161_N05,1,1p36.13,16572330,16661652,89322,-,-
BAC142_P14,1,1p36.13,16591701,16684665,92964,-,-
BAC46_J05,1,1p36.13,16625359,16722455,97096,-,-
BAC81_B05,1,1p36.13,16661647,16789011,127364,-,-
BAC125_F22,1,1p36.13,16699492,16769398,69906,-,-
BAC149_K10,1,1p36.13,16723318,16776436,53118,-,-
BAC5_L06,1,1p36.13,16727476,16815983,88507,yes,-
BAC209_B08,1,1p36.13,16729560,16782379,52819,-,-
BAC22_M16,1,1p36.13,16730977,16782713,51736,-,-
BAC46_C04,1,1p36.13,16731037,16782694,51657,-,-
BAC41_G07,1,1p36.13,16754819,16847296,92477,yes,-
BAC194_H07,1,1p36.13,16782707,16868799,86092,-,-
BAC27_A14,1,1p36.13,16854896,17070429,215533,-,-
BAC181_C06,1,1p36.13,16922055,17136811,214756,-,-
BAC45_I11,1,1p36.13,17081249,17264898,183649,yes,-
BAC247_I23,1,1p36.13,17086112,17169276,83164,-,-
BAC27_K22,1,1p36.13,17088525,17222563,134038,-,-
BAC152_A20,1,1p36.13,17106690,17188780,82090,-,-
BAC129_E19,1,1p36.13,17222557,17329004,106447,yes,-
BAC41_O15,1,1p36.13,17271986,17381089,109103,-,-
BAC39_H06,1,1p36.13,17271990,17381094,109104,-,-
BAC123_C12,1,1p36.13,17458564,17583315,124751,yes,-
BAC149_H02,1,1p36.13,17472875,17586540,113665,yes,-
BAC165_D06,1,1p36.13,17489962,17583315,93353,yes,-
BAC58_P20,1,1p36.13,17494578,17574174,79596,yes,-
BAC95_C15,1,1p36.13,17494594,17570143,75549,yes,-
BAC183_I02,1,1p36.13,17652326,17747208,94882,-,-
BAC180_I22,1,1p36.13,17754885,17907040,152155,-,-
BAC154_F08,1,1p36.13,17783346,17886662,103316,-,-
BAC68_G11,1,1p36.13,17786187,17884125,97938,-,-
BAC240_K05,1,1p36.13,17829396,17906700,77304,-,-
BAC45_K03,1,1p36.13,17829402,17910571,81169,-,-
BAC224_F15,1,1p36.13,17891114,17998197,107083,-,-
BAC250_B02,1,1p36.13,17911632,17995850,84218,-,-
BAC145_B18,1,1p36.13,17924962,18021969,97007,-,-
BAC61_C03,1,1p36.13,17945071,18129651,184580,-,-
BAC37_N24,1,1p36.13,17978994,18076994,98000,-,-
BAC180_E13,1,1p36.13,17998190,18083434,85244,-,-
BAC123_H23,1,1p36.13,18027993,18129652,101659,-,-
BAC145_D21,1,1p36.13,18095296,18204714,109418,-,-
BAC242_O07,1,1p36.13,18104019,18187114,83095,-,-
BAC153_J06,1,1p36.13,18104019,18190686,86667,-,-
BAC165_C08,1,1p36.13,18119169,18250425,131256,-,-
BAC193_H01,1,1p36.13,18373447,18461880,88433,-,-
BAC218_H23,1,1p36.13,18377192,18461880,84688,-,-
BAC63_F16,1,1p36.13,18377192,18464535,87343,-,-
BAC37_L16,1,1p36.13,18466668,18678704,212036,-,-
BAC196_G15,1,1p36.13,18528040,18621353,93313,-,-
BAC46_G09,1,1p36.13,18528093,18638534,110441,-,-
BAC1_N04,1,1p36.13,18585771,18678736,92965,-,-
BAC175_E19,1,1p36.13,18598387,18736334,137947,-,-
BAC142_F02,1,1p36.13,18621348,18738391,117043,-,-
BAC249_A11,1,1p36.13,18621367,18713202,91835,-,-
BAC25_K24,1,1p36.13,18624118,18724823,100705,-,-
BAC150_P17,1,1p36.13,18642457,18738390,95933,-,-
BAC50_L15,1,1p36.13,18736346,18823323,86977,-,-
BAC48_C10,1,1p36.13,18736440,18863620,127180,-,-
BAC123_P09,1,1p36.13,18738383,18814530,76147,-,-
BAC240_N09,1,1p36.13,18752129,18850481,98352,-,-
BAC84_C21,1,1p36.13,18783156,18868803,85647,-,-
BAC41_O07,1,1p36.13,18814521,18922245,107724,-,-
BAC40_A19,1,1p36.13,18833016,19013854,180838,-,-
BAC75_L08,1,1p36.13,18838595,18966504,127909,-,-
BAC234_A24,1,1p36.13,18868840,18968802,99962,-,-
BAC157_I08,1,1p36.13,18885105,18974565,89460,-,-
BAC144_M10,1,1p36.13,18959539,19037714,78175,-,-
BAC217_D23,1,1p36.13,19062397,19185060,122663,-,-
BAC232_F22,1,1p36.13,19072224,19185129,112905,-,-
BAC81_M21,1,1p36.13,19104802,19189411,84609,-,-
BAC240_H03,1,1p36.13,19245708,19327554,81846,-,-
BAC27_N16,1,1p36.13,19285054,19395702,110648,-,-
BAC180_M11,1,1p36.13,19312173,19399349,87176,-,-
BAC73_K13,1,1p36.13,19373501,19457166,83665,-,-
BAC218_P06,1,1p36.13,19373501,19457166,83665,-,-
BAC158_G13,1,1p36.13,19399752,19495672,95920,-,-
BAC53_L09,1,1p36.13,19399752,19495774,96022,-,-
BAC240_H11,1,1p36.13,19401295,19495759,94464,-,-
BAC192_I12,1,1p36.13,19457299,19543420,86121,-,-
BAC219_F01,1,1p36.13,19462224,19543420,81196,-,-
BAC146_L22,1,1p36.13,19463089,19543420,80331,-,-
BAC201_B08,1,1p36.13,19463093,19544626,81533,-,-
BAC90_B03,1,1p36.13,19466076,19618465,152389,-,-
BAC119_C22,1,1p36.13,19478895,19597517,118622,-,-
BAC76_N10,1,1p36.13,19597511,19706727,109216,-,-
BAC250_O19,1,1p36.13,19597511,19680427,82916,-,-
BAC34_G16,1,1p36.13,19608687,19743972,135285,-,-
BAC42_O11,1,1p36.13,19632793,19743985,111192,-,-
BAC161_B12,1,1p36.13,19642725,19784193,141468,-,-
BAC83_A11,1,1p36.13,19680580,19778619,98039,-,-
BAC186_L13,1,1p36.13,19680938,19778619,97681,-,-
BAC66_A04,1,1p36.13,19686013,19775368,89355,-,-
BAC238_H21,1,1p36.13,19784234,19867099,82865,-,-
BAC100_J11,1,1p36.13,19798413,19904530,106117,-,-
BAC16_P22,1,1p36.13,19826320,19916707,90387,-,-
BAC84_M17,1,1p36.13,19867577,19956822,89245,-,-
BAC140_M10,1,1p36.13,19906944,20012592,105648,-,-
BAC127_A11,1,1p36.13,19916968,20014529,97561,-,-
BAC71_P10,1,1p36.13,19936411,20031025,94614,-,-
BAC66_C19,1,1p36.13,19937172,20095450,158278,-,-
BAC154_N22,1,1p36.13,19938261,20014545,76284,-,-
BAC151_G15,1,1p36.13,19938261,20014545,76284,-,-
BAC194_G15,1,1p36.13,19957117,20012569,55452,-,-
BAC69_A17,1,1p36.13,20060910,20144537,83627,-,-
BAC60_P13,1,1p36.13,20060910,20169981,109071,-,-
BAC249_P19,1,1p36.13,20060985,20169981,108996,-,-
BAC46_H21,1,1p36.13,20112191,20226348,114157,-,-
BAC103_A23,1,1p36.13,20141255,20226359,85104,-,-
BAC217_I12,1,1p36.13,20145326,20242841,97515,-,-
BAC41_E12,1,1p36.13,20170050,20256380,86330,-,-
BAC197_C18,1,1p36.13,20174305,20281198,106893,-,-
BAC130_N16,1,1p36.13-1p36.12,20208545,20317119,108574,yes,-
BAC135_H03,1,1p36.13-1p36.12,20226434,20310072,83638,yes,-
BAC85_G19,1,1p36.13-1p36.12,20249908,20350965,101057,yes,-
BAC200_G17,1,1p36.13-1p36.12,20281193,20358885,77692,yes,-
BAC89_E01,1,1p36.13-1p36.12,20281196,20382389,101193,-,-
BAC150_A13,1,1p36.12,20358207,20457220,99013,-,-
BAC178_F09,1,1p36.12,20391131,20493235,102104,-,-
BAC236_P03,1,1p36.12,20407868,20554702,146834,-,-
BAC110_E15,1,1p36.12,20412325,20493235,80910,-,-
BAC158_N20,1,1p36.12,20415067,20493212,78145,-,-
BAC195_C14,1,1p36.12,20416939,20508707,91768,-,-
BAC156_H14,1,1p36.12,20437248,20517216,79968,-,-
BAC83_I12,1,1p36.12,20439154,20587594,148440,-,-
BAC176_A11,1,1p36.12,20641884,20738647,96763,-,-
BAC242_I05,1,1p36.12,20789132,20866251,77119,-,-
BAC221_G07,1,1p36.12,20849349,20964247,114898,-,-
BAC160_P24,1,1p36.12,20883213,20968097,84884,-,-
BAC226_L05,1,1p36.12,20978915,21071179,92264,-,-
BAC133_A08,1,1p36.12,21103053,21181546,78493,-,-
BAC131_O13,1,1p36.12,21381934,21537074,155140,-,-
BAC154_K11,1,1p36.12,21381934,21471115,89181,-,-
BAC162_G23,1,1p36.12,21387380,21471115,83735,-,-
BAC122_L01,1,1p36.12,21387380,21471967,84587,-,-
BAC242_L04,1,1p36.12,21442497,21525353,82856,-,-
BAC80_K09,1,1p36.12,21442497,21565486,122989,-,-
BAC242_H21,1,1p36.12,21447027,21531520,84493,-,-
BAC154_A23,1,1p36.12,21471107,21531506,60399,-,-
BAC152_A03,1,1p36.12,21471119,21563272,92153,-,-
BAC79_O09,1,1p36.12,21615564,21729834,114270,-,-
BAC43_H03,1,1p36.12,21615564,21749759,134195,-,-
BAC151_B22,1,1p36.12,21616915,21729853,112938,-,-
BAC68_M07,1,1p36.12,21749894,21793431,43537,-,-
BAC46_N04,1,1p36.12,21815560,21927181,111621,-,-
BAC133_M03,1,1p36.12,21848734,21948243,99509,-,-
BAC151_A07,1,1p36.12,21886198,21988502,102304,-,-
BAC72_O04,1,1p36.12,21952445,22085398,132953,-,-
BAC84_O21,1,1p36.12,22009653,22150201,140548,-,-
BAC220_F14,1,1p36.12,22052412,22150201,97789,-,-
BAC144_O20,1,1p36.12,22120873,22214050,93177,-,-
BAC243_I08,1,1p36.12,22135719,22223993,88274,-,-
BAC144_G11,1,1p36.12,22155097,22244138,89041,-,-
BAC122_D18,1,1p36.12,22155311,22265553,110242,-,-
BAC66_G24,1,1p36.12,22155311,22249098,93787,-,-
BAC194_L11,1,1p36.12,22155311,22265811,110500,-,-
BAC154_A05,1,1p36.12,22164259,22265817,101558,-,-
BAC196_F20,1,1p36.12,22190856,22312432,121576,-,-
BAC184_D24,1,1p36.12,22250502,22361403,110901,-,-
BAC13_F18,1,1p36.12,22252859,22339324,86465,-,-
BAC56_E08,1,1p36.12,22313378,22396947,83569,-,-
BAC141_K11,1,1p36.12,22336236,22474939,138703,-,-
BAC248_K14,1,1p36.12,22396554,22497909,101355,-,-
BAC221_N03,1,1p36.12,22474932,22576975,102043,-,-
BAC236_N09,1,1p36.12,22517148,22607963,90815,-,-
BAC249_L24,1,1p36.12,22518362,22642558,124196,-,-
BAC40_O12,1,1p36.12,22518362,22689634,171272,-,-
BAC27_N20,1,1p36.12,22574929,22680482,105553,-,-
BAC83_M05,1,1p36.12,22576992,22680474,103482,-,-
BAC39_I09,1,1p36.12,22584221,22680482,96261,-,-
BAC122_N01,1,1p36.12,22593813,22709724,115911,-,-
BAC196_E15,1,1p36.12,22707619,22818890,111271,-,-
BAC183_G06,1,1p36.12,22729493,22876900,147407,-,-
BAC199_M24,1,1p36.12,22729493,22845594,116101,-,-
BAC50_J16,1,1p36.12,22729493,22901793,172300,-,-
BAC35_J16,1,1p36.12,22741681,22831433,89752,-,-
BAC39_M16,1,1p36.12,22778646,22934780,156134,-,-
BAC1_L16,1,1p36.12,22778717,22880755,102038,-,-
BAC78_F13,1,1p36.12,22802707,22908223,105516,-,-
BAC56_I12,1,1p36.12,22876895,22977861,100966,-,-
BAC52_D08,1,1p36.12,22917100,23013395,96295,-,-
BAC221_B23,1,1p36.12,23013417,23097576,84159,-,-
BAC69_L12,1,1p36.12,23013417,23140416,126999,-,-
BAC191_N17,1,1p36.12,23014584,23127473,112889,-,-
BAC69_P10,1,1p36.12,23020370,23127456,107086,-,-
BAC130_P12,1,1p36.12,23022841,23142398,119557,-,-
BAC175_M10,1,1p36.12,23049612,23192218,142606,-,-
BAC178_J21,1,1p36.12,23049646,23142402,92756,-,-
BAC134_B12,1,1p36.12,23076604,23180914,104310,-,-
BAC100_G17,1,1p36.12,23097583,23180914,83331,-,-
BAC126_N09,1,1p36.12,23127467,23229578,102111,-,-
BAC69_F19,1,1p36.12,23140433,23242679,102246,-,-
BAC151_I20,1,1p36.12,23140443,23223643,83200,-,-
BAC199_N14,1,1p36.12,23142397,23229578,87181,-,-
BAC155_B07,1,1p36.12,23180908,23276044,95136,-,-
BAC246_B09,1,1p36.12,23268265,23351929,83664,-,-
BAC200_M09,1,1p36.12,23276214,23361983,85769,-,-
BAC169_H18,1,1p36.12,23276214,23359868,83654,-,-
BAC30_P13,1,1p36.12,23284772,23385065,100293,-,-
BAC246_G01,1,1p36.12,23284774,23429273,144499,-,-
BAC84_J07,1,1p36.12,23351928,23446430,94502,-,-
BAC8_G07,1,1p36.12,23359711,23461363,101652,-,-
BAC42_C24,1,1p36.12,23394538,23482651,88113,-,-
BAC163_P14,1,1p36.12,23459267,23561691,102424,-,-
BAC46_B04,1,1p36.12,23461379,23541527,80148,-,-
BAC51_H15,1,1p36.12,23586277,23641807,55530,-,-
BAC187_K09,1,1p36.12,23592534,23711897,119363,-,-
BAC221_C09,1,1p36.12,23622072,23698254,76182,-,-
BAC22_M05,1,1p36.12,23644339,23756762,112423,-,-
BAC151_H23,1,1p36.11,23803095,23909598,106503,-,-
BAC24_D05,1,1p36.11,23965034,24161294,196260,-,-
BAC193_N09,1,1p36.11,24039934,24130524,90590,-,-
BAC141_G18,1,1p36.11,24059085,24160453,101368,-,-
BAC251_P10,1,1p36.11,24150878,24252757,101879,-,-
BAC53_P11,1,1p36.11,24160466,24252758,92292,-,-
BAC56_L04,1,1p36.11,24165373,24267095,101722,-,-
BAC61_I21,1,1p36.11,24181276,24280902,99626,-,-
BAC244_B03,1,1p36.11,24181276,24279366,98090,-,-
BAC60_M20,1,1p36.11,24252860,24377699,124839,-,-
BAC203_D02,1,1p36.11,24252863,24377655,124792,-,-
BAC142_G19,1,1p36.11,24279359,24366763,87404,-,-
BAC226_D10,1,1p36.11,24279383,24377640,98257,-,-
BAC118_I06,1,1p36.11,24280928,24377699,96771,-,-
BAC137_C16,1,1p36.11,24283731,24456628,172897,-,-
BAC148_B09,1,1p36.11,24367049,24473209,106160,-,-
BAC2_P04,1,1p36.11,24367049,24457109,90060,-,-
BAC144_K10,1,1p36.11,24367250,24457109,89859,-,-
BAC24_M02,1,1p36.11,24373971,24529842,155871,-,-
BAC96_H17,1,1p36.11,24398492,24503320,104828,-,-
BAC194_L03,1,1p36.11,24477406,24604061,126655,-,-
BAC20_D03,1,1p36.11,24477406,24578775,101369,-,-
BAC165_P05,1,1p36.11,24493965,24583851,89886,-,-
BAC149_E05,1,1p36.11,24495111,24630060,134949,-,-
BAC124_I13,1,1p36.11,24495416,24615453,120037,-,-
BAC22_P02,1,1p36.11,24504374,24607230,102856,-,-
BAC158_J14,1,1p36.11,24512583,24658862,146279,-,-
BAC197_F23,1,1p36.11,24516448,24597015,80567,-,-
BAC226_K21,1,1p36.11,24529847,24624310,94463,-,-
BAC69_O19,1,1p36.11,24590916,24698660,107744,-,-
BAC149_N10,1,1p36.11,24614220,24709354,95134,-,-
BAC169_K04,1,1p36.11,24614721,24691550,76829,-,-
BAC43_O03,1,1p36.11,24618145,24717238,99093,-,-
BAC183_H18,1,1p36.11,24635319,24757280,121961,-,-
BAC242_G01,1,1p36.11,24719055,24802737,83682,-,-
BAC160_C23,1,1p36.11,24727746,24829488,101742,-,-
BAC90_I04,1,1p36.11,24735108,24829496,94388,-,-
BAC241_N12,1,1p36.11,24737669,24836153,98484,-,-
BAC193_B13,1,1p36.11,24737669,24802735,65066,-,-
BAC49_F15,1,1p36.11,24740052,24830970,90918,-,-
BAC65_B05,1,1p36.11,24829500,24951745,122245,-,-
BAC150_P06,1,1p36.11,24872305,24971049,98744,-,-
BAC235_J11,1,1p36.11,24881999,24967692,85693,-,-
BAC55_C13,1,1p36.11,24882066,24966100,84034,-,-
BAC10_L11,1,1p36.11,24951740,25078669,126929,-,-
BAC214_I11,1,1p36.11,24951756,25025946,74190,-,-
BAC71_N15,1,1p36.11,24971112,25108154,137042,-,-
BAC79_N20,1,1p36.11,25051487,25132595,81108,-,-
BAC247_O04,1,1p36.11,25082335,25185958,103623,-,-
BAC168_N24,1,1p36.11,25109010,25223277,114267,-,-
BAC110_D17,1,1p36.11,25109028,25231019,121991,-,-
BAC145_B23,1,1p36.11,25121288,25231019,109731,-,-
BAC240_J24,1,1p36.11,25187466,25291908,104442,-,-
BAC60_C09,1,1p36.11,25240048,25343807,103759,-,-
BAC159_E11,1,1p36.11,25294096,25396967,102871,-,-
BAC162_H11,1,1p36.11,25303132,25413188,110056,-,-
BAC171_E14,1,1p36.11,25310434,25409806,99372,-,-
BAC44_G14,1,1p36.11,25313073,25409767,96694,-,-
BAC170_B01,1,1p36.11,25343801,25413188,69387,-,-
BAC204_N22,1,1p36.11,25343804,25422042,78238,-,-
BAC69_J12,1,1p36.11,25378282,25511189,132907,yes,-
BAC168_P22,1,1p36.11,25413509,25508738,95229,yes,-
BAC141_N12,1,1p36.11,25477055,25572229,95174,yes,-
BAC180_F01,1,1p36.11,25477055,25548943,71888,yes,-
BAC34_N11,1,1p36.11,25477059,25618894,141835,yes,-
BAC224_L06,1,1p36.11,25540959,25634229,93270,yes,-
BAC32_D04,1,1p36.11,25558709,25685044,126335,yes,-
BAC176_F15,1,1p36.11,25579407,25685044,105637,yes,-
BAC214_F08,1,1p36.11,25618608,25719620,101012,-,-
BAC79_B23,1,1p36.11,25783752,25905182,121430,-,-
BAC240_F02,1,1p36.11,25808901,25905196,96295,-,-
BAC33_I04,1,1p36.11,25808912,25915639,106727,-,-
BAC243_I05,1,1p36.11,25811471,25913247,101776,-,-
BAC153_G09,1,1p36.11,25848224,25951147,102923,-,-
BAC244_G05,1,1p36.11,25850131,25925716,75585,-,-
BAC107_A06,1,1p36.11,25913630,26029034,115404,-,-
BAC179_N24,1,1p36.11,25915633,26002343,86710,-,-
BAC198_I08,1,1p36.11,25922068,26049478,127410,-,-
BAC175_E12,1,1p36.11,25925747,26007404,81657,-,-
BAC180_C12,1,1p36.11,25925989,26038691,112702,-,-
BAC8_A11,1,1p36.11,25925989,26029025,103036,-,-
BAC236_J05,1,1p36.11,26067866,26154504,86638,-,-
BAC122_G24,1,1p36.11,26096845,26193051,96206,-,-
BAC141_M11,1,1p36.11,26097414,26175089,77675,-,-
BAC60_M05,1,1p36.11,26175240,26364141,188901,-,-
BAC238_D17,1,1p36.11,26198681,26277342,78661,-,-
BAC160_A20,1,1p36.11,26198682,26301226,102544,-,-
BAC168_L06,1,1p36.11,26198702,26338050,139348,-,-
BAC146_G07,1,1p36.11,26241256,26338050,96794,-,-
BAC86_H20,1,1p36.11,26308985,26435472,126487,-,-
BAC242_E19,1,1p36.11,26328143,26424674,96531,-,-
BAC189_A08,1,1p36.11,26338044,26424674,86630,-,-
BAC29_C02,1,1p36.11,26338104,26461814,123710,-,-
BAC202_A05,1,1p36.11,26364226,26478723,114497,-,-
BAC27_O05,1,1p36.11,26367784,26458077,90293,-,-
BAC150_F24,1,1p36.11,26483118,26563217,80099,-,-
BAC149_M16,1,1p36.11,26493648,26576975,83327,-,-
BAC95_N24,1,1p36.11,26493651,26576958,83307,-,-
BAC169_D07,1,1p36.11,26578935,26686187,107252,-,-
BAC148_P17,1,1p36.11,26594838,26689352,94514,-,-
BAC239_M11,1,1p36.11,26637733,26750564,112831,-,-
BAC82_N02,1,1p36.11,26661654,26793475,131821,-,-
BAC86_K16,1,1p36.11,26661668,26782189,120521,-,-
BAC52_G01,1,1p36.11,26686343,26777870,91527,-,-
BAC21_M17,1,1p36.11,26813651,26900289,86638,-,-
BAC132_A07,1,1p36.11,26854535,26943750,89215,-,-
BAC243_C13,1,1p36.11,26944565,27031620,87055,-,-
BAC244_H07,1,1p36.11,26963532,27066857,103325,-,-
BAC8_K15,1,1p36.11,26978470,27137257,158787,-,-
BAC67_K21,1,1p36.11,27078115,27225790,147675,-,-
BAC195_M14,1,1p36.11,27095014,27184655,89641,-,-
BAC101_D03,1,1p36.11,27233535,27327208,93673,-,-
BAC107_G13,1,1p36.11,27234368,27324676,90308,-,-
BAC151_G18,1,1p36.11,27243890,27327207,83317,-,-
BAC196_J13,1,1p36.11,27292139,27383859,91720,-,-
BAC37_P10,1,1p36.11,27384024,27479560,95536,-,-
BAC135_A20,1,1p36.11,27385015,27525013,139998,-,-
BAC248_J23,1,1p36.11,27533858,27612832,78974,-,-
BAC182_D11,1,1p36.11,27553585,27654793,101208,-,-
BAC34_E09,1,1p36.11,27617251,27712764,95513,-,-
BAC1_E18,1,1p36.11,27617251,27744244,126993,-,-
BAC131_N22,1,1p36.11,27694598,27782760,88162,-,-
BAC200_K19,1,1p36.11-1p35.3,27794217,27904395,110178,-,-
BAC37_K05,1,1p35.3,27804259,27999950,195691,-,-
BAC137_D10,1,1p35.3,27818307,27882145,63838,-,-
BAC150_H03,1,1p35.3,27851250,27938212,86962,-,-
BAC181_J17,1,1p35.3,27884726,27980804,96078,-,-
BAC240_F15,1,1p35.3,27938218,28031830,93612,-,-
BAC107_I09,1,1p35.3,27999948,28110807,110859,-,-
BAC153_K18,1,1p35.3,28057268,28137275,80007,-,-
BAC22_H16,1,1p35.3,28228708,28361583,132875,-,-
BAC46_E05,1,1p35.3,28247810,28333608,85798,-,-
BAC120_F15,1,1p35.3,28257255,28333608,76353,-,-
BAC111_L17,1,1p35.3,28361576,28468231,106655,-,-
BAC231_J15,1,1p35.3,28384386,28468355,83969,-,-
BAC43_D08,1,1p35.3,28465388,28583134,117746,-,-
BAC106_G08,1,1p35.3,28492396,28586061,93665,-,-
BAC141_H04,1,1p35.3,28496594,28576503,79909,-,-
BAC124_D19,1,1p35.3,28496594,28596582,99988,-,-
BAC181_J18,1,1p35.3,28570413,28660722,90309,-,-
BAC53_D24,1,1p35.3,28598083,28694363,96280,-,-
BAC101_F12,1,1p35.3,28650502,28752494,101992,-,-
BAC173_L09,1,1p35.3,28660965,28747955,86990,-,-
BAC194_P06,1,1p35.3,28667820,28778475,110655,-,-
BAC241_H10,1,1p35.3,28803995,28897475,93480,-,-
BAC171_M07,1,1p35.3,28805688,28886657,80969,-,-
BAC51_I17,1,1p35.3,28923507,29041745,118238,-,-
BAC95_B04,1,1p35.3,28923507,29018032,94525,-,-
BAC128_P20,1,1p35.3,28942635,29083209,140574,-,-
BAC25_I21,1,1p35.3,29036411,29196787,160376,-,-
BAC117_O21,1,1p35.3,29044763,29157060,112297,-,-
BAC191_M14,1,1p35.3,29080506,29157060,76554,-,-
BAC66_D13,1,1p35.3,29083498,29187450,103952,-,-
BAC25_I04,1,1p35.3,29083498,29187444,103946,-,-
BAC148_H05,1,1p35.3,29083498,29202169,118671,-,-
BAC128_F23,1,1p35.3,29104623,29196787,92164,-,-
BAC244_B04,1,1p35.3,29104935,29202136,97201,-,-
BAC38_G19,1,1p35.3,29131099,29253353,122254,-,-
BAC25_P11,1,1p35.3,29131240,29222786,91546,-,-
BAC136_A08,1,1p35.3,29257910,29348786,90876,-,-
BAC70_O12,1,1p35.3,29301705,29395213,93508,-,-
BAC71_H13,1,1p35.3,29308582,29407606,99024,-,-
BAC26_A23,1,1p35.3,29308582,29413882,105300,-,-
BAC129_J03,1,1p35.3,29427789,29527179,99390,-,-
BAC244_G20,1,1p35.3,29446253,29550364,104111,-,-
BAC244_K21,1,1p35.3,29452861,29550364,97503,-,-
BAC234_L06,1,1p35.3,29452904,29550364,97460,-,-
BAC135_H02,1,1p35.3,29453362,29549731,96369,-,-
BAC127_K21,1,1p35.3,29453362,29550364,97002,-,-
BAC238_C06,1,1p35.3,29549728,29631168,81440,-,-
BAC224_N05,1,1p35.3,29550606,29646519,95913,-,-
BAC228_D07,1,1p35.3,29550608,29631168,80560,-,-
BAC108_L12,1,1p35.3,29598024,29676287,78263,-,-
BAC96_O09,1,1p35.3,29598024,29711854,113830,-,-
BAC148_M04,1,1p35.3,29598038,29663622,65584,-,-
BAC52_L07,1,1p35.3,29601516,29719366,117850,-,-
BAC236_L18,1,1p35.3,29607472,29717389,109917,-,-
BAC70_O15,1,1p35.3,29607552,29729221,121669,-,-
BAC232_N14,1,1p35.3,29810833,29911070,100237,-,-
BAC195_L10,1,1p35.3,29858642,29962010,103368,-,-
BAC43_B19,1,1p35.3,29896337,29999003,102666,-,-
BAC180_K14,1,1p35.3,29896344,29983396,87052,-,-
BAC158_J03,1,1p35.2,30040117,30125288,85171,-,-
BAC8_A09,1,1p35.2,30042587,30161455,118868,-,-
BAC156_G06,1,1p35.2,30045414,30128564,83150,-,-
BAC53_B05,1,1p35.2,30045414,30059402,13988,-,-
BAC73_N22,1,1p35.2,30051205,30162036,110831,-,-
BAC63_I09,1,1p35.2,30057125,30146459,89334,-,-
BAC145_N21,1,1p35.2,30112073,30238328,126255,-,-
BAC26_P23,1,1p35.2,30125294,30231141,105847,-,-
BAC122_A05,1,1p35.2,30162092,30307003,144911,-,-
BAC198_E13,1,1p35.2,30180163,30276870,96707,-,-
BAC162_F12,1,1p35.2,30325090,30451604,126514,-,-
BAC113_F13,1,1p35.2,30343904,30451675,107771,-,-
BAC178_E15,1,1p35.2,30374193,30451674,77481,-,-
BAC39_L19,1,1p35.2,30425727,30569653,143926,-,-
BAC37_B22,1,1p35.2,30432999,30524641,91642,-,-
BAC167_G04,1,1p35.2,30451670,30537934,86264,-,-
BAC184_B23,1,1p35.2,30484673,30601038,116365,-,-
BAC179_B08,1,1p35.2,30494851,30551653,56802,-,-
BAC18_C07,1,1p35.2,30556702,30643484,86782,-,-
BAC145_O15,1,1p35.2,30561470,30645111,83641,-,-
BAC158_F09,1,1p35.2,30716785,30794715,77930,-,-
BAC158_I09,1,1p35.2,30716785,30794715,77930,-,-
BAC105_O11,1,1p35.2,30716785,30808314,91529,-,-
BAC35_J10,1,1p35.2,30745445,30842826,97381,-,-
BAC237_A06,1,1p35.2,30769229,30854105,84876,-,-
BAC65_B16,1,1p35.2,30879334,31069020,189686,-,-
BAC150_P05,1,1p35.2,30997776,31084283,86507,-,-
BAC111_A08,1,1p35.2,31016163,31027746,11583,-,-
BAC192_D16,1,1p35.2,31111889,31198108,86219,-,-
BAC167_B16,1,1p35.2,31112321,31211848,99527,-,-
BAC65_I13,1,1p35.2,31159397,31249714,90317,-,-
BAC75_A03,1,1p35.2,31159411,31245523,86112,-,-
BAC142_I18,1,1p35.2,31174512,31245538,71026,-,-
BAC173_M03,1,1p35.2,31307383,31443524,136141,-,-
BAC90_B01,1,1p35.2,31329382,31443281,113899,-,-
BAC221_G13,1,1p35.2,31396376,31489412,93036,-,-
BAC34_M11,1,1p35.2,31503562,31654510,150948,-,-
BAC53_O02,1,1p35.2,31524775,31664781,140006,-,-
BAC108_H03,1,1p35.2,31527361,31627128,99767,-,-
BAC196_E06,1,1p35.2,31551959,31648227,96268,-,-
BAC154_G12,1,1p35.2,31556713,31648227,91514,-,-
BAC121_N01,1,1p35.2,31654615,31746335,91720,-,-
BAC100_G22,1,1p35.2,31657123,31736574,79451,-,-
BAC146_G09,1,1p35.2,31873029,31955779,82750,-,-
BAC185_K19,1,1p35.2,32056137,32140016,83879,-,-
BAC134_P14,1,1p35.2,32060462,32140008,79546,-,-
BAC117_O19,1,1p35.2,32081871,32194127,112256,-,-
BAC161_F17,1,1p35.2,32081873,32169734,87861,-,-
BAC65_M20,1,1p35.2-1p35.1,32150887,32241635,90748,-,-
BAC84_P19,1,1p35.2-1p35.1,32162371,32290422,128051,-,-
BAC41_L20,1,1p35.2-1p35.1,32177641,32271943,94302,-,-
BAC181_A13,1,1p35.1,32282301,32394921,112620,-,-
BAC137_C18,1,1p35.1,32298037,32418403,120366,-,-
BAC85_E17,1,1p35.1,32316273,32394887,78614,-,-
BAC180_H20,1,1p35.1,32366180,32474184,108004,-,-
BAC124_B01,1,1p35.1,32392585,32501010,108425,-,-
BAC55_J09,1,1p35.1,32517595,32631309,113714,-,-
BAC39_A15,1,1p35.1,32519953,32632860,112907,-,-
BAC215_D24,1,1p35.1,32536785,32632718,95933,-,-
BAC152_M04,1,1p35.1,32545048,32659197,114149,-,-
BAC198_L14,1,1p35.1,32609152,32718328,109176,-,-
BAC193_C16,1,1p35.1,32623217,32729351,106134,-,-
BAC171_L03,1,1p35.1,32654165,32729333,75168,-,-
BAC236_H09,1,1p35.1,32736057,32818418,82361,-,-
BAC230_E18,1,1p35.1,32778891,32874683,95792,-,-
BAC88_L02,1,1p35.1,32790408,32908689,118281,-,-
BAC143_I11,1,1p35.1,32790411,32883629,93218,-,-
BAC165_O14,1,1p35.1,32823835,32908689,84854,-,-
BAC92_B24,1,1p35.1,32847987,32929742,81755,-,-
BAC117_A08,1,1p35.1,32944938,33037306,92368,-,-
BAC218_J16,1,1p35.1,33021225,33099900,78675,-,-
BAC252_P15,1,1p35.1,33022955,33104544,81589,-,-
BAC166_M02,1,1p35.1,33179968,33282223,102255,-,-
BAC241_J17,1,1p35.1,33181495,33266692,85197,-,-
BAC250_P21,1,1p35.1,33191455,33282224,90769,-,-
BAC40_G21,1,1p35.1,33206876,33414107,207231,-,-
BAC66_F11,1,1p35.1,33214158,33353551,139393,-,-
BAC143_J20,1,1p35.1,33230270,33311793,81523,-,-
BAC52_M02,1,1p35.1,33240465,33385514,145049,-,-
BAC42_E06,1,1p35.1,33243357,33360138,116781,-,-
BAC7_O17,1,1p35.1,33259465,33374219,114754,-,-
BAC16_K14,1,1p35.1,33259482,33353487,94005,-,-
BAC193_D02,1,1p35.1,33282220,33360186,77966,-,-
BAC132_L12,1,1p35.1,33285485,33379742,94257,-,-
BAC73_A21,1,1p35.1,33311787,33414144,102357,-,-
BAC15_E05,1,1p35.1,33335107,33425633,90526,-,-
BAC8_G03,1,1p35.1,33335107,33425984,90877,-,-
BAC233_J11,1,1p35.1,33385553,33510467,124914,-,-
BAC79_I08,1,1p35.1,33418201,33510395,92194,-,-
BAC87_F19,1,1p35.1,33425979,33502754,76775,-,-
BAC225_D03,1,1p35.1,33450426,33534844,84418,-,-
BAC177_J15,1,1p35.1,33450463,33534808,84345,-,-
BAC110_G06,1,1p35.1,33510464,33636572,126108,-,-
BAC41_D11,1,1p35.1,33510504,33660544,150040,-,-
BAC243_M05,1,1p35.1,33514915,33619547,104632,-,-
BAC112_M02,1,1p35.1,33514919,33623082,108163,-,-
BAC82_D24,1,1p35.1,33539422,33572932,33510,-,-
BAC176_P23,1,1p35.1,33544010,33639748,95738,-,-
BAC32_M12,1,1p35.1,33559287,33660527,101240,-,-
BAC237_I09,1,1p35.1,33651008,33733266,82258,-,-
BAC119_F20,1,1p35.1,33710986,33885909,174923,-,-
BAC213_K18,1,1p35.1,33796607,33891513,94906,-,-
BAC190_K10,1,1p35.1,33830608,33911553,80945,-,-
BAC252_F09,1,1p35.1,33913934,34046461,132527,-,-
BAC123_G20,1,1p35.1,33916553,34059488,142935,-,-
BAC128_A22,1,1p35.1,33934601,34096655,162054,-,-
BAC142_B14,1,1p35.1,33991827,34077636,85809,-,-
BAC66_G20,1,1p35.1,34000653,34090558,89905,-,-
BAC159_N02,1,1p35.1,34038824,34139900,101076,-,-
BAC109_A15,1,1p35.1,34046469,34136917,90448,-,-
BAC70_L02,1,1p35.1,34118474,34209859,91385,-,-
BAC65_K15,1,1p35.1,34224398,34362343,137945,-,-
BAC191_J16,1,1p35.1-1p34.3,34295538,34401082,105544,-,-
BAC243_N19,1,1p35.1,34295538,34378286,82748,-,-
BAC72_L15,1,1p35.1,34299252,34376501,77249,-,-
BAC238_M05,1,1p35.1-1p34.3,34332346,34421283,88937,-,-
BAC21_G08,1,1p35.1-1p34.3,34350356,34475590,125234,-,-
BAC191_O17,1,1p35.1-1p34.3,34376511,34463906,87395,-,-
BAC20_I15,1,1p34.3,34426997,34556651,129654,-,-
BAC176_L03,1,1p34.3,34505400,34631529,126129,-,-
BAC73_A11,1,1p34.3,34517062,34631516,114454,-,-
BAC31_F24,1,1p34.3,34637216,34731942,94726,-,-
BAC192_M03,1,1p34.3,34680993,34769690,88697,-,-
BAC227_D16,1,1p34.3,34769788,34859605,89817,-,-
BAC143_C14,1,1p34.3,34833644,34940412,106768,-,-
BAC49_M01,1,1p34.3,34871785,34984407,112622,-,-
BAC217_M21,1,1p34.3,34989061,35085076,96015,-,-
BAC125_E10,1,1p34.3,34991812,35091748,99936,-,-
BAC81_C23,1,1p34.3,35106234,35198469,92235,-,-
BAC130_F20,1,1p34.3,35210671,35297053,86382,-,-
BAC63_B18,1,1p34.3,35210677,35320211,109534,-,-
BAC221_N09,1,1p34.3,35232645,35320167,87522,-,-
BAC106_O06,1,1p34.3,35241942,35343791,101849,-,-
BAC36_L04,1,1p34.3,35344296,35429530,85234,-,-
BAC226_J13,1,1p34.3,35424784,35501626,76842,-,-
BAC31_D10,1,1p34.3,35446082,35593208,147126,-,-
BAC134_O05,1,1p34.3,35505875,35601383,95508,-,-
BAC154_D02,1,1p34.3,35571163,35694997,123834,-,-
BAC197_B19,1,1p34.3,35593416,35694997,101581,-,-
BAC101_P17,1,1p34.3,35625859,35743334,117475,-,-
BAC193_P14,1,1p34.3,35680678,35771381,90703,-,-
BAC54_J06,1,1p34.3,35685777,35801224,115447,-,-
BAC96_E21,1,1p34.3,35695151,35801251,106100,-,-
BAC33_C20,1,1p34.3,35695151,35801220,106069,-,-
BAC162_P03,1,1p34.3,35743328,35805542,62214,-,-
BAC86_C15,1,1p34.3,35779079,35883836,104757,-,-
BAC46_I10,1,1p34.3,35806357,35952719,146362,-,-
BAC43_N02,1,1p34.3,35862380,35956191,93811,-,-
BAC42_M09,1,1p34.3,35880546,35985146,104600,-,-
BAC119_K03,1,1p34.3,35880564,36024744,144180,-,-
BAC45_J17,1,1p34.3,35891056,35972865,81809,-,-
BAC1_H24,1,1p34.3,35964874,36068785,103911,-,-
BAC234_I12,1,1p34.3,35985140,36091436,106296,-,-
BAC167_D14,1,1p34.3,35986436,36057590,71154,-,-
BAC167_C16,1,1p34.3,35986436,36057588,71152,-,-
BAC20_K05,1,1p34.3,36050486,36155158,104672,-,-
BAC248_L15,1,1p34.3,36057585,36160565,102980,-,-
BAC108_E10,1,1p34.3,36086057,36197255,111198,-,-
BAC165_H19,1,1p34.3,36091672,36160705,69033,-,-
BAC104_H07,1,1p34.3,36099010,36197262,98252,-,-
BAC188_L11,1,1p34.3,36113585,36217065,103480,-,-
BAC36_M02,1,1p34.3,36119840,36259763,139923,-,-
BAC97_P24,1,1p34.3,36160961,36244599,83638,-,-
BAC67_C03,1,1p34.3,36175916,36260200,84284,-,-
BAC78_K16,1,1p34.3,36176187,36274798,98611,-,-
BAC165_K07,1,1p34.3,36214154,36343326,129172,-,-
BAC237_F18,1,1p34.3,36274903,36353992,79089,-,-
BAC156_N21,1,1p34.3,36304243,36408697,104454,-,-
BAC214_I03,1,1p34.3,36354894,36481064,126170,-,-
BAC40_O08,1,1p34.3,36361119,36449782,88663,-,-
BAC205_C08,1,1p34.3,36376696,36461961,85265,-,-
BAC106_A11,1,1p34.3,36447502,36534628,87126,-,-
BAC235_I15,1,1p34.3,36449799,36534640,84841,-,-
BAC186_N23,1,1p34.3,36491159,36598692,107533,-,-
BAC137_N07,1,1p34.3,36532778,36636494,103716,-,-
BAC217_N13,1,1p34.3,36598934,36681676,82742,-,-
BAC92_N23,1,1p34.3,36625057,36733462,108405,-,-
BAC135_F08,1,1p34.3,36636487,36721165,84678,-,-
BAC49_P07,1,1p34.3,36648060,36793203,145143,-,-
BAC210_B20,1,1p34.3,36680793,36757721,76928,-,-
BAC1_G02,1,1p34.3,36733455,36865946,132491,-,-
BAC178_B08,1,1p34.3,36803881,36901078,97197,-,-
BAC84_P09,1,1p34.3,36812890,36916489,103599,-,-
BAC105_L14,1,1p34.3,36839874,36946350,106476,-,-
BAC178_C21,1,1p34.3,36901071,37015662,114591,-,-
BAC79_M19,1,1p34.3,36901100,36998213,97113,-,-
BAC231_A03,1,1p34.3,36925040,37003120,78080,-,-
BAC88_J02,1,1p34.3,36934257,37082258,148001,-,-
BAC126_J22,1,1p34.3,37003535,37204590,201055,-,-
BAC126_D17,1,1p34.3,37003535,37204540,201005,-,-
BAC224_M22,1,1p34.3,37015834,37118082,102248,-,-
BAC1_I08,1,1p34.3,37099976,37328437,228461,-,-
BAC154_G02,1,1p34.3,37103249,37189353,86104,-,-
BAC170_L06,1,1p34.3,37112546,37229663,117117,-,-
BAC175_C04,1,1p34.3,37118214,37280724,162510,-,-
BAC46_F05,1,1p34.3,37162178,37300933,138755,-,-
BAC236_H03,1,1p34.3,37168132,37266999,98867,-,-
BAC25_C19,1,1p34.3,37170820,37285410,114590,-,-
BAC232_J03,1,1p34.3,37206455,37302665,96210,-,-
BAC244_N16,1,1p34.3,37206702,37302850,96148,-,-
BAC76_A13,1,1p34.3,37206702,37321966,115264,-,-
BAC199_K20,1,1p34.3,37206702,37287905,81203,-,-
BAC112_D01,1,1p34.3,37213783,37300938,87155,-,-
BAC69_C15,1,1p34.3,37255666,37361309,105643,-,-
BAC129_H04,1,1p34.3,37280883,37371653,90770,-,-
BAC177_L12,1,1p34.3,37312120,37407318,95198,-,-
BAC224_I03,1,1p34.3,37321961,37411074,89113,-,-
BAC118_L10,1,1p34.3,37321961,37394886,72925,-,-
BAC86_P16,1,1p34.3,37345259,37453265,108006,-,-
BAC115_M24,1,1p34.3,37345478,37453071,107593,-,-
BAC27_F14,1,1p34.3,37354507,37454466,99959,-,-
BAC162_O23,1,1p34.3,37385582,37488283,102701,-,-
BAC51_O02,1,1p34.3,37409550,37514499,104949,-,-
BAC230_L07,1,1p34.3,37409654,37524801,115147,-,-
BAC189_I07,1,1p34.3,37411092,37514495,103403,-,-
BAC153_K20,1,1p34.3,37422363,37510790,88427,-,-
BAC61_C02,1,1p34.3,37457248,37641823,184575,-,-
BAC97_O18,1,1p34.3,37519243,37620099,100856,-,-
BAC153_K08,1,1p34.3,37568510,37677505,108995,-,-
BAC30_J13,1,1p34.3,37595755,37678265,82510,-,-
BAC176_I13,1,1p34.3,37601556,37677505,75949,-,-
BAC43_P15,1,1p34.3,37601556,37697081,95525,-,-
BAC168_B03,1,1p34.3,37606154,37697081,90927,-,-
BAC185_I15,1,1p34.3,37775439,37856582,81143,-,-
BAC52_K06,1,1p34.3,37784487,37893546,109059,-,-
BAC196_A02,1,1p34.3,37806941,37959328,152387,-,-
BAC36_M19,1,1p34.3,37836509,37959329,122820,-,-
BAC140_C07,1,1p34.3,37838163,37939916,101753,-,-
BAC66_G08,1,1p34.3,37846571,37979231,132660,-,-
BAC75_I21,1,1p34.3,37850806,37939916,89110,-,-
BAC20_K23,1,1p34.3,37851748,37966085,114337,-,-
BAC204_H13,1,1p34.3,37856579,37964342,107763,-,-
BAC156_O03,1,1p34.3,37863101,37959326,96225,-,-
BAC10_I13,1,1p34.3,37972109,38051016,78907,-,-
BAC228_N10,1,1p34.3,38037421,38126020,88599,-,-
BAC223_C13,1,1p34.3,38037421,38125678,88257,-,-
BAC68_B08,1,1p34.3,38037421,38125260,87839,-,-
BAC16_I16,1,1p34.3,38039097,38114104,75007,-,-
BAC38_D15,1,1p34.3,38067035,38187716,120681,-,-
BAC64_G17,1,1p34.3,38186532,38308726,122194,-,-
BAC69_L04,1,1p34.3,38203084,38281031,77947,-,-
BAC165_O16,1,1p34.3,38232676,38339934,107258,-,-
BAC74_E11,1,1p34.3,38232676,38339907,107231,-,-
BAC108_N07,1,1p34.3,38255589,38352862,97273,-,-
BAC171_H03,1,1p34.3,38279802,38363389,83587,-,-
BAC33_L19,1,1p34.3,38315341,38425004,109663,-,-
BAC162_F05,1,1p34.3,38351079,38480182,129103,-,-
BAC42_N10,1,1p34.3,38404043,38550951,146908,-,-
BAC184_A22,1,1p34.3,38411889,38546329,134440,-,-
BAC51_C09,1,1p34.3,38430106,38590595,160489,-,-
BAC211_L23,1,1p34.3,38452508,38550840,98332,-,-
BAC142_P12,1,1p34.3,38475326,38549748,74422,-,-
BAC18_H08,1,1p34.3,38484240,38581563,97323,-,-
BAC165_M16,1,1p34.3,38498884,38628323,129439,-,-
BAC135_I22,1,1p34.3,38529643,38603293,73650,-,-
BAC40_M21,1,1p34.3,38576757,38682955,106198,-,-
BAC136_O05,1,1p34.3,38610814,38694581,83767,-,-
BAC1_I14,1,1p34.3,38657544,38747668,90124,-,-
BAC160_J22,1,1p34.3,38729068,38808901,79833,-,-
BAC61_L06,1,1p34.3,38747663,38863749,116086,-,-
BAC97_P03,1,1p34.3,38808921,38899519,90598,-,-
BAC166_I02,1,1p34.3,38835359,38936387,101028,-,-
BAC175_C08,1,1p34.3,38872349,38937789,65440,-,-
BAC172_F22,1,1p34.3,38872349,38954863,82514,-,-
BAC35_B01,1,1p34.3,38872862,38954762,81900,-,-
BAC8_H12,1,1p34.3,38893503,38985378,91875,-,-
BAC42_H02,1,1p34.3,38936391,39047085,110694,-,-
BAC57_C16,1,1p34.3,38995394,39095436,100042,-,-
BAC55_K06,1,1p34.3,39100958,39192312,91354,-,-
BAC124_N02,1,1p34.3,39103778,39220040,116262,-,-
BAC247_D03,1,1p34.3,39195312,39274973,79661,-,-
BAC175_A02,1,1p34.3,39377256,39467758,90502,-,-
BAC200_L16,1,1p34.3,39409500,39513750,104250,-,-
BAC236_N11,1,1p34.3,39415412,39519749,104337,-,-
BAC60_P20,1,1p34.3,39415412,39516285,100873,-,-
BAC66_F20,1,1p34.3,39441413,39566627,125214,-,-
BAC83_B03,1,1p34.3,39453869,39566627,112758,-,-
BAC141_F23,1,1p34.3,39453869,39531959,78090,-,-
BAC144_H10,1,1p34.3-1p34.2,39501242,39648975,147733,-,-
BAC57_P12,1,1p34.3-1p34.2,39503264,39632498,129234,-,-
BAC218_H09,1,1p34.3-1p34.2,39525838,39632498,106660,-,-
BAC62_E23,1,1p34.3-1p34.2,39525988,39630289,104301,-,-
BAC186_K11,1,1p34.2,39605829,39686444,80615,-,-
BAC26_H08,1,1p34.2,39706090,39811174,105084,-,-
BAC188_A14,1,1p34.2,39811441,39913052,101611,-,-
BAC1_C19,1,1p34.2,39852158,39954714,102556,-,-
BAC219_O09,1,1p34.2,39864503,39954714,90211,-,-
BAC90_B05,1,1p34.2,39885322,39983937,98615,-,-
BAC148_J05,1,1p34.2,39896889,40009852,112963,-,-
BAC162_J22,1,1p34.2,39954709,40038367,83658,-,-
BAC148_F08,1,1p34.2,39984213,40080722,96509,-,-
BAC97_A06,1,1p34.2,40006712,40135113,128401,-,-
BAC247_K10,1,1p34.2,40038362,40135129,96767,-,-
BAC151_F14,1,1p34.2,40074350,40177482,103132,-,-
BAC102_M02,1,1p34.2,40132636,40230413,97777,-,-
BAC82_D18,1,1p34.2,40132636,40217139,84503,-,-
BAC215_J18,1,1p34.2,40135122,40256321,121199,-,-
BAC62_O09,1,1p34.2,40135212,40262698,127486,-,-
BAC195_F03,1,1p34.2,40213825,40287979,74154,-,-
BAC67_O15,1,1p34.2,40213825,40287979,74154,-,-
BAC222_C13,1,1p34.2,40284292,40401638,117346,yes,-
BAC25_N22,1,1p34.2,40287858,40390333,102475,yes,-
BAC31_B17,1,1p34.2,40326072,40468465,142393,-,-
BAC89_I13,1,1p34.2,40410421,40520758,110337,-,-
BAC213_K15,1,1p34.2,40468495,40590257,121762,-,-
BAC64_N05,1,1p34.2,40479862,40578078,98216,-,-
BAC65_K12,1,1p34.2,40479869,40615600,135731,-,-
BAC148_F21,1,1p34.2,40520444,40623444,103000,-,-
BAC20_F17,1,1p34.2,40532680,40624288,91608,-,-
BAC188_D11,1,1p34.2,40601168,40623443,22275,-,-
BAC220_H06,1,1p34.2,40651188,40748270,97082,-,-
BAC218_C15,1,1p34.2,40657170,40748270,91100,-,-
BAC165_P19,1,1p34.2,40657193,40752982,95789,-,-
BAC147_A17,1,1p34.2,40690044,40765764,75720,-,-
BAC100_N10,1,1p34.2,40691724,40836328,144604,-,-
BAC143_P18,1,1p34.2,40707124,40826200,119076,-,-
BAC89_N15,1,1p34.2,40707160,40853093,145933,-,-
BAC219_N07,1,1p34.2,40748275,40832533,84258,-,-
BAC10_N05,1,1p34.2,40768863,40887859,118996,-,-
BAC208_K09,1,1p34.2,40790640,40909590,118950,-,-
BAC68_F16,1,1p34.2,40794629,40957833,163204,-,-
BAC139_A07,1,1p34.2,40857011,40960877,103866,-,-
BAC140_P09,1,1p34.2,40890978,40971067,80089,-,-
BAC20_F03,1,1p34.2,40922804,41018326,95522,-,-
BAC88_E15,1,1p34.2,40960467,41061334,100867,-,-
BAC234_J19,1,1p34.2,41014302,41094292,79990,-,-
BAC111_P17,1,1p34.2,41018420,41153818,135398,-,-
BAC243_N14,1,1p34.2,41036207,41134140,97933,-,-
BAC120_G10,1,1p34.2,41061327,41142371,81044,-,-
BAC65_P23,1,1p34.2,41070772,41193141,122369,-,-
BAC132_B16,1,1p34.2,41145827,41332433,186606,-,-
BAC41_G03,1,1p34.2,41153918,41264157,110239,-,-
BAC63_O14,1,1p34.2,41207998,41309595,101597,-,-
BAC92_B07,1,1p34.2,41222658,41310795,88137,-,-
BAC73_M24,1,1p34.2,41223481,41310795,87314,-,-
BAC32_J20,1,1p34.2,41239352,41377120,137768,-,-
BAC30_L06,1,1p34.2,41278232,41332121,53889,-,-
BAC56_G20,1,1p34.2,41341055,41437476,96421,-,-
BAC252_A18,1,1p34.2,41346803,41473203,126400,-,-
BAC186_M04,1,1p34.2,41351107,41444666,93559,-,-
BAC7_E23,1,1p34.2,41416397,41532900,116503,-,-
BAC200_G13,1,1p34.2,41437470,41524542,87072,-,-
BAC61_A11,1,1p34.2,41521949,41683747,161798,-,-
BAC214_F11,1,1p34.2,41523939,41622714,98775,-,-
BAC140_N12,1,1p34.2,41616902,41741065,124163,-,-
BAC189_M10,1,1p34.2,41644396,41731995,87599,-,-
BAC101_O17,1,1p34.2,41705128,41731999,26871,-,-
BAC65_H13,1,1p34.2,41718799,41811278,92479,-,-
BAC230_C02,1,1p34.2,41789504,41875217,85713,-,-
BAC63_O12,1,1p34.2,41806627,41911930,105303,-,-
BAC113_B03,1,1p34.2,41858784,41942378,83594,-,-
BAC191_D07,1,1p34.2,41861641,42006745,145104,-,-
BAC61_M14,1,1p34.2,41866265,42054431,188166,-,-
BAC52_A20,1,1p34.2,41873930,41991067,117137,-,-
BAC61_E11,1,1p34.2,41883302,41996772,113470,-,-
BAC91_O03,1,1p34.2,41919380,42006745,87365,-,-
BAC16_J22,1,1p34.2,41931346,42035139,103793,-,-
BAC183_O22,1,1p34.2,41936824,42030671,93847,-,-
BAC221_L21,1,1p34.2,41938461,42048487,110026,-,-
BAC177_F07,1,1p34.2,41942380,42046801,104421,-,-
BAC27_G13,1,1p34.2,41942380,42043453,101073,-,-
BAC181_L18,1,1p34.2,42005518,42095035,89517,-,-
BAC95_M14,1,1p34.2,42099998,42213352,113354,-,-
BAC139_C12,1,1p34.2,42105345,42185909,80564,-,-
BAC165_P11,1,1p34.2,42105538,42193150,87612,-,-
BAC16_M16,1,1p34.2,42141088,42245311,104223,-,-
BAC163_N01,1,1p34.2,42193237,42301261,108024,-,-
BAC222_E16,1,1p34.2,42200413,42290511,90098,-,-
BAC187_J07,1,1p34.2,42219293,42300883,81590,-,-
BAC141_E16,1,1p34.2,42242126,42324825,82699,-,-
BAC42_B16,1,1p34.2,42346918,42426214,79296,-,-
BAC55_P03,1,1p34.2,42380739,42503196,122457,-,-
BAC201_C20,1,1p34.2,42440373,42543174,102801,-,-
BAC194_L08,1,1p34.2,42516670,42659079,142409,-,-
BAC234_N23,1,1p34.2,42534572,42622247,87675,-,-
BAC55_F05,1,1p34.2,42550170,42682104,131934,-,-
BAC26_A04,1,1p34.2,42803475,42909685,106210,-,-
BAC200_H07,1,1p34.2,42845993,42952798,106805,-,-
BAC108_H23,1,1p34.2,42877931,42977320,99389,-,-
BAC77_P12,1,1p34.2,42939309,43051253,111944,-,-
BAC14_K05,1,1p34.2,42970539,43153667,183128,-,-
BAC41_H18,1,1p34.2,43012099,43118441,106342,-,-
BAC127_P13,1,1p34.2,43041595,43142351,100756,-,-
BAC169_E19,1,1p34.2,43097664,43214379,116715,-,-
BAC180_M12,1,1p34.2,43112077,43221591,109514,-,-
BAC204_F20,1,1p34.2,43151941,43271770,119829,-,-
BAC118_H12,1,1p34.2,43189951,43293506,103555,-,-
BAC154_C02,1,1p34.2,43198891,43310261,111370,-,-
BAC90_I17,1,1p34.2,43214374,43384136,169762,-,-
BAC219_N17,1,1p34.2,43221740,43310261,88521,-,-
BAC226_H11,1,1p34.2,43240572,43319521,78949,-,-
BAC20_A15,1,1p34.2,43262134,43384137,122003,-,-
BAC223_B13,1,1p34.2,43271903,43362677,90774,-,-
BAC52_M14,1,1p34.2,43380748,43459060,78312,-,-
BAC242_G16,1,1p34.2,43384129,43506120,121991,-,-
BAC173_P15,1,1p34.2,43391384,43496734,105350,-,-
BAC25_L18,1,1p34.2,43422018,43596503,174485,-,-
BAC127_N15,1,1p34.2,43481977,43627984,146007,-,-
BAC152_K14,1,1p34.2,43484852,43596503,111651,-,-
BAC152_I24,1,1p34.2,43496734,43596421,99687,-,-
BAC108_F03,1,1p34.2,43542373,43627977,85604,-,-
BAC12_F08,1,1p34.2,43680820,43794813,113993,-,-
BAC40_L03,1,1p34.2,43693785,43794864,101079,-,-
BAC223_I01,1,1p34.2,43732277,43858889,126612,-,-
BAC42_H10,1,1p34.2,43732277,43822083,89806,-,-
BAC66_K13,1,1p34.2,43772544,43858924,86380,-,-
BAC53_D23,1,1p34.2-1p34.1,43849653,43945341,95688,-,-
BAC241_M06,1,1p34.2-1p34.1,43858937,43949047,90110,-,-
BAC127_B21,1,1p34.2-1p34.1,43862978,44003597,140619,-,-
BAC69_M10,1,1p34.1,43902070,44003255,101185,-,-
BAC130_J02,1,1p34.1,44052194,44130867,78673,-,-
BAC68_H09,1,1p34.1,44088076,44197614,109538,-,-
BAC2_K22,1,1p34.1,44092198,44210124,117926,-,-
BAC162_A01,1,1p34.1,44131015,44210143,79128,-,-
BAC140_E04,1,1p34.1,44148693,44265277,116584,-,-
BAC170_B05,1,1p34.1,44192012,44285285,93273,-,-
BAC95_D04,1,1p34.1,44197656,44290951,93295,-,-
BAC157_M05,1,1p34.1,44197698,44287128,89430,-,-
BAC186_H12,1,1p34.1,44230792,44327538,96746,-,-
BAC237_L07,1,1p34.1,44231095,44327540,96445,-,-
BAC127_P16,1,1p34.1,44323640,44417583,93943,-,-
BAC86_M18,1,1p34.1,44323657,44417583,93926,-,-
BAC41_O10,1,1p34.1,44341367,44451251,109884,-,-
BAC41_H20,1,1p34.1,44349742,44508090,158348,-,-
BAC150_J06,1,1p34.1,44417711,44552796,135085,-,-
BAC142_B11,1,1p34.1,44456895,44552212,95317,-,-
BAC91_J03,1,1p34.1,44544894,44586411,41517,-,-
BAC123_I10,1,1p34.1,44552423,44651854,99431,-,-
BAC67_C12,1,1p34.1,44552423,44636161,83738,-,-
BAC37_L08,1,1p34.1,44552423,44636156,83733,-,-
BAC192_N11,1,1p34.1,44552791,44638733,85942,-,-
BAC227_M17,1,1p34.1,44556374,44635791,79417,-,-
BAC223_O09,1,1p34.1,44616554,44734275,117721,-,-
BAC193_L11,1,1p34.1,44643158,44774655,131497,-,-
BAC20_C19,1,1p34.1,44658493,44774655,116162,-,-
BAC179_J03,1,1p34.1,44687142,44771457,84315,-,-
BAC48_I05,1,1p34.1,44688682,44792258,103576,-,-
BAC199_G04,1,1p34.1,44717818,44742002,24184,-,-
BAC166_E09,1,1p34.1,44805349,44886031,80682,-,-
BAC1_H04,1,1p34.1,44828620,44920820,92200,-,-
BAC61_G16,1,1p34.1,44845233,44920820,75587,-,-
BAC10_A06,1,1p34.1,44857170,45014270,157100,-,-
BAC55_D20,1,1p34.1,44890321,45000077,109756,-,-
BAC209_N20,1,1p34.1,44908969,45000082,91113,-,-
BAC182_M23,1,1p34.1,44922418,45014257,91839,-,-
BAC187_L15,1,1p34.1,44922418,45004868,82450,-,-
BAC237_L18,1,1p34.1,44929212,45016384,87172,-,-
BAC148_J06,1,1p34.1,45105541,45188681,83140,-,-
BAC189_P08,1,1p34.1,45141263,45219587,78324,-,-
BAC140_M21,1,1p34.1,45144318,45255257,110939,-,-
BAC2_P06,1,1p34.1,45148334,45249370,101036,-,-
BAC124_D10,1,1p34.1,45255251,45359090,103839,-,-
BAC220_F03,1,1p34.1,45258680,45355394,96714,-,-
BAC220_J08,1,1p34.1,45258686,45351184,92498,-,-
BAC173_B19,1,1p34.1,45308089,45392136,84047,-,-
BAC156_O13,1,1p34.1,45402026,45438225,36199,-,-
BAC204_P21,1,1p34.1,45474694,45545301,70607,-,-
BAC2_B06,1,1p34.1,45478242,45578645,100403,-,-
BAC169_P08,1,1p34.1,45502755,45579926,77171,-,-
BAC219_O24,1,1p34.1,45513287,45578655,65368,-,-
BAC214_I12,1,1p34.1,45594989,45669878,74889,-,-
BAC24_M12,1,1p34.1,45619305,45711876,92571,-,-
BAC156_N08,1,1p34.1,45670166,45759746,89580,-,-
BAC221_D03,1,1p34.1,45670357,45774581,104224,-,-
BAC99_M06,1,1p34.1,45684979,45768096,83117,-,-
BAC82_E08,1,1p34.1,45739809,45883944,144135,-,-
BAC41_F05,1,1p34.1,45746142,45838152,92010,-,-
BAC140_I12,1,1p34.1,45750902,45895444,144542,-,-
BAC39_L04,1,1p34.1,45750902,45868080,117178,-,-
BAC146_E16,1,1p34.1,45785331,45875755,90424,-,-
BAC173_K07,1,1p34.1,45933605,46038556,104951,-,-
BAC186_K20,1,1p34.1,45937735,46012590,74855,-,-
BAC186_B13,1,1p34.1,45951352,46035944,84592,-,-
BAC70_L01,1,1p34.1,45985393,46086808,101415,-,-
BAC114_B11,1,1p34.1,46095404,46188332,92928,-,-
BAC176_K08,1,1p34.1,46107372,46186284,78912,-,-
BAC117_C01,1,1p34.1,46166270,46270210,103940,-,-
BAC70_P15,1,1p34.1,46166270,46297674,131404,-,-
BAC243_G10,1,1p34.1,46196143,46282256,86113,-,-
BAC149_D15,1,1p34.1,46235368,46323092,87724,-,-
BAC43_C08,1,1p34.1,46235368,46369596,134228,-,-
BAC247_O17,1,1p34.1,46270207,46359863,89656,-,-
BAC51_I03,1,1p34.1,46282356,46369360,87004,-,-
BAC76_D04,1,1p34.1,46323087,46440955,117868,-,-
BAC162_G16,1,1p34.1,46419672,46497093,77421,-,-
BAC46_F19,1,1p34.1-1p33,46448551,46566673,118122,-,-
BAC137_K12,1,1p34.1-1p33,46498348,46585695,87347,-,-
BAC25_M07,1,1p33,46504475,46607384,102909,-,-
BAC42_M21,1,1p33,46504497,46633691,129194,-,-
BAC96_M17,1,1p33,46536257,46640198,103941,-,-
BAC15_O05,1,1p33,46633685,46745479,111794,-,-
BAC247_O10,1,1p33,46640192,46734512,94320,-,-
BAC240_P16,1,1p33,46656320,46734046,77726,-,-
BAC173_E17,1,1p33,46741394,46835559,94165,-,-
BAC106_E21,1,1p33,46741394,46853784,112390,-,-
BAC191_M13,1,1p33,46751133,46840254,89121,-,-
BAC208_O17,1,1p33,46768140,46920896,152756,-,-
BAC97_E13,1,1p33,46812553,46907020,94467,-,-
BAC40_N22,1,1p33,46812553,46955853,143300,-,-
BAC42_K20,1,1p33,46814193,46919922,105729,-,-
BAC8_L17,1,1p33,46814229,46919922,105693,-,-
BAC123_C17,1,1p33,46948993,47115107,166114,-,-
BAC151_F07,1,1p33,46987752,47079312,91560,-,-
BAC26_K12,1,1p33,46987752,47137597,149845,-,-
BAC14_M06,1,1p33,47023390,47141793,118403,-,-
BAC144_D22,1,1p33,47166881,47271322,104441,-,-
BAC127_I14,1,1p33,47261956,47351479,89523,-,-
BAC120_E01,1,1p33,47280131,47414644,134513,-,-
BAC68_K22,1,1p33,47282010,47376786,94776,-,-
BAC30_L14,1,1p33,47290301,47376781,86480,-,-
BAC45_C17,1,1p33,47388539,47485930,97391,-,-
BAC64_G01,1,1p33,47401707,47522486,120779,-,-
BAC141_O03,1,1p33,47419224,47522486,103262,-,-
BAC176_A08,1,1p33,47491084,47588632,97548,-,-
BAC226_O12,1,1p33,47491084,47563037,71953,-,-
BAC148_K18,1,1p33,47491084,47587053,95969,-,-
BAC83_I17,1,1p33,47491084,47587072,95988,-,-
BAC24_E20,1,1p33,47491084,47601105,110021,-,-
BAC136_G06,1,1p33,47491084,47587071,95987,-,-
BAC102_O23,1,1p33,47491084,47588632,97548,-,-
BAC172_M19,1,1p33,47577323,47588632,11309,-,-
BAC193_B07,1,1p33,47601153,47673809,72656,-,-
BAC248_D09,1,1p33,47643920,47739232,95312,-,-
BAC238_C04,1,1p33,47739569,47828776,89207,-,-
BAC72_I14,1,1p33,47772816,47890622,117806,-,-
BAC241_B08,1,1p33,47789439,47877691,88252,-,-
BAC129_C10,1,1p33,47833553,47911213,77660,-,-
BAC65_E24,1,1p33,47877690,48039081,161391,-,-
BAC182_G10,1,1p33,47906738,47992243,85505,-,-
BAC76_K17,1,1p33,47911423,48002826,91403,-,-
BAC14_O01,1,1p33,47917876,48005933,88057,-,-
BAC28_D02,1,1p33,47924152,48022458,98306,-,-
BAC236_A16,1,1p33,47934110,48025497,91387,-,-
BAC131_P18,1,1p33,47934404,48078200,143796,-,-
BAC151_C13,1,1p33,47937569,48022458,84889,-,-
BAC84_B06,1,1p33,47993966,48078200,84234,-,-
BAC51_C03,1,1p33,48015944,48166232,150288,-,-
BAC16_H12,1,1p33,48050712,48145122,94410,-,-
BAC224_K12,1,1p33,48058751,48166719,107968,-,-
BAC219_K22,1,1p33,48072446,48166208,93762,-,-
BAC148_E03,1,1p33,48072863,48178326,105463,-,-
BAC123_E05,1,1p33,48072863,48160658,87795,-,-
BAC83_G03,1,1p33,48078193,48185194,107001,-,-
BAC244_E19,1,1p33,48115249,48224853,109604,-,-
BAC141_H16,1,1p33,48228650,48324131,95481,-,-
BAC252_A21,1,1p33,48228650,48380306,151656,-,-
BAC151_D20,1,1p33,48257586,48382946,125360,-,-
BAC116_C06,1,1p33,48527975,48611628,83653,-,-
BAC32_K11,1,1p33,48610672,48764623,153951,-,-
BAC19_J17,1,1p33,48639602,48736491,96889,-,-
BAC53_M14,1,1p33,48802000,48922516,120516,-,-
BAC199_J14,1,1p33,48802084,48915540,113456,-,-
BAC61_D01,1,1p33,48860161,48968068,107907,-,-
BAC58_P06,1,1p33,48860760,48935433,74673,-,-
BAC184_H15,1,1p33,48999671,49076970,77299,-,-
BAC202_K17,1,1p33,49020258,49090167,69909,-,-
BAC153_L18,1,1p33,49030944,49120502,89558,-,-
BAC153_O18,1,1p33,49030944,49120502,89558,-,-
BAC1_F19,1,1p33,49069462,49093875,24413,-,-
BAC8_H15,1,1p33,49078774,49190522,111748,-,-
BAC18_E24,1,1p33,49196974,49315016,118042,-,-
BAC10_N02,1,1p33,49421875,49508556,86681,-,-
BAC180_P05,1,1p33,49508142,49576387,68245,-,-
BAC61_C13,1,1p33,49534546,49632021,97475,-,-
BAC137_F16,1,1p33,49584829,49663754,78925,-,-
BAC106_D10,1,1p33,49631551,49710700,79149,-,-
BAC132_L17,1,1p33,49653751,49770987,117236,-,-
BAC72_N06,1,1p33,49729149,49819395,90246,-,-
BAC121_D23,1,1p33,49819397,49921904,102507,-,-
BAC163_P10,1,1p33,50001188,50115792,114604,-,-
BAC222_C19,1,1p33,50055677,50154686,99009,-,-
BAC110_A18,1,1p33,50066251,50194879,128628,-,-
BAC128_J22,1,1p33,50116023,50281659,165636,-,-
BAC75_I20,1,1p33,50166526,50299879,133353,-,-
BAC219_L19,1,1p33,50233918,50326217,92299,-,-
BAC52_H21,1,1p33,50326212,50496348,170136,-,-
BAC127_K12,1,1p33,50400666,50481127,80461,-,-
BAC92_K02,1,1p33,50434143,50534576,100433,-,-
BAC188_H24,1,1p33,50452840,50560997,108157,-,-
BAC154_C09,1,1p33,50452840,50534577,81737,-,-
BAC37_G12,1,1p33,50452840,50537697,84857,-,-
BAC120_I04,1,1p33,50611791,50719265,107474,-,-
BAC133_E10,1,1p33,50711847,50731999,20152,-,-
BAC178_B23,1,1p33,50753423,50848011,94588,-,-
BAC148_G14,1,1p33,50841974,50938223,96249,-,-
BAC183_H16,1,1p33,50848067,50935128,87061,-,-
BAC169_F03,1,1p33,50848067,50935128,87061,-,-
BAC143_P03,1,1p33,50906358,51014386,108028,-,-
BAC123_J04,1,1p33,50955142,51039641,84499,-,-
BAC194_E17,1,1p33,51073303,51131799,58496,-,-
BAC134_M19,1,1p33,51173295,51276712,103417,-,-
BAC61_D05,1,1p33,51173295,51245390,72095,-,-
BAC95_N07,1,1p33-1p32.3,51242636,51338613,95977,-,-
BAC224_B18,1,1p32.3,51310634,51410000,99366,-,-
BAC96_E04,1,1p32.3,51310634,51373402,62768,-,-
BAC176_P02,1,1p32.3,51347661,51456924,109263,-,-
BAC222_O14,1,1p32.3,51391420,51474210,82790,-,-
BAC109_J09,1,1p32.3,51510846,51657617,146771,-,-
BAC224_H02,1,1p32.3,51560877,51636155,75278,-,-
BAC85_K15,1,1p32.3,51585725,51717520,131795,-,-
BAC228_G18,1,1p32.3,51625487,51705767,80280,-,-
BAC153_N04,1,1p32.3,51717516,51782783,65267,-,-
BAC103_M24,1,1p32.3,51728052,51817790,89738,-,-
BAC167_N19,1,1p32.3,51788306,51913163,124857,-,-
BAC155_J15,1,1p32.3,51849105,51936390,87285,-,-
BAC220_E24,1,1p32.3,51863116,51943293,80177,-,-
BAC110_D07,1,1p32.3,51913278,52021943,108665,-,-
BAC59_M22,1,1p32.3,51927071,51984974,57903,-,-
BAC4_B22,1,1p32.3,51957408,52077262,119854,-,-
BAC102_P10,1,1p32.3,52015650,52093303,77653,-,-
BAC224_C11,1,1p32.3,52077952,52172601,94649,-,-
BAC62_H09,1,1p32.3,52091572,52172600,81028,-,-
BAC169_J05,1,1p32.3,52154499,52227001,72502,-,-
BAC200_C13,1,1p32.3,52187706,52294139,106433,-,-
BAC154_F19,1,1p32.3,52187706,52290993,103287,-,-
BAC76_I20,1,1p32.3,52187724,52311009,123285,-,-
BAC66_H18,1,1p32.3,52252198,52386376,134178,-,-
BAC191_B02,1,1p32.3,52252198,52326334,74136,-,-
BAC230_I21,1,1p32.3,52297308,52399902,102594,-,-
BAC194_J18,1,1p32.3,52303142,52381043,77901,-,-
BAC162_C03,1,1p32.3,52303142,52399903,96761,-,-
BAC30_G11,1,1p32.3,52422133,52560316,138183,-,-
BAC126_M08,1,1p32.3,52422253,52530542,108289,-,-
BAC40_C09,1,1p32.3,52428597,52542843,114246,-,-
BAC244_I17,1,1p32.3,52457772,52551981,94209,-,-
BAC113_D02,1,1p32.3,52471505,52552062,80557,-,-
BAC46_D07,1,1p32.3,52511596,52669527,157931,-,-
BAC39_G18,1,1p32.3,52527565,52621621,94056,-,-
BAC8_J08,1,1p32.3,52560399,52734003,173604,-,-
BAC16_M08,1,1p32.3,52571722,52653129,81407,-,-
BAC157_O14,1,1p32.3,52599884,52613613,13729,-,-
BAC158_M24,1,1p32.3,52719211,52806452,87241,-,-
BAC114_H11,1,1p32.3,52719211,52805902,86691,-,-
BAC56_E18,1,1p32.3,52728843,52858039,129196,-,-
BAC43_H04,1,1p32.3,52742075,52858048,115973,-,-
BAC127_G16,1,1p32.3,52747162,52858048,110886,-,-
BAC174_O08,1,1p32.3,52808806,52914757,105951,-,-
BAC78_O20,1,1p32.3,52853818,52993759,139941,-,-
BAC170_L03,1,1p32.3,52853828,52961732,107904,-,-
BAC100_C05,1,1p32.3,52858154,52962635,104481,-,-
BAC67_G24,1,1p32.3,52858507,52964521,106014,-,-
BAC222_K14,1,1p32.3,52876262,52965833,89571,-,-
BAC124_D15,1,1p32.3,52876787,52994400,117613,-,-
BAC190_I07,1,1p32.3,52877014,52993756,116742,-,-
BAC123_D15,1,1p32.3,52894604,52994400,99796,-,-
BAC197_B13,1,1p32.3,52990598,53076419,85821,-,-
BAC92_N02,1,1p32.3,53121154,53238916,117762,-,-
BAC238_M20,1,1p32.3,53148043,53243393,95350,-,-
BAC125_C11,1,1p32.3,53201320,53283166,81846,-,-
BAC161_N10,1,1p32.3,53240010,53362510,122500,-,-
BAC24_M23,1,1p32.3,53296215,53393907,97692,-,-
BAC166_F05,1,1p32.3,53320800,53433042,112242,-,-
BAC179_H09,1,1p32.3,53395171,53490800,95629,-,-
BAC153_J18,1,1p32.3,53442301,53528084,85783,-,-
BAC188_B07,1,1p32.3,53445740,53529414,83674,-,-
BAC239_L10,1,1p32.3,53445740,53531176,85436,-,-
BAC157_P16,1,1p32.3,53477668,53562855,85187,-,-
BAC10_N19,1,1p32.3,53490979,53600974,109995,-,-
BAC91_K15,1,1p32.3,53496388,53579076,82688,-,-
BAC176_O22,1,1p32.3,53531187,53638546,107359,-,-
BAC182_G06,1,1p32.3,53541996,53638546,96550,-,-
BAC29_J22,1,1p32.3,53544298,53650173,105875,-,-
BAC240_E24,1,1p32.3,53562879,53650347,87468,-,-
BAC114_I15,1,1p32.3,53586755,53688540,101785,-,-
BAC235_B20,1,1p32.3,53662192,53744062,81870,-,-
BAC99_C09,1,1p32.3,53701776,53791993,90217,-,-
BAC168_D18,1,1p32.3,53716655,53809244,92589,-,-
BAC31_D20,1,1p32.3,53788188,53885875,97687,-,-
BAC238_I02,1,1p32.3,53791688,53885889,94201,-,-
BAC45_I14,1,1p32.3,53841216,53930375,89159,-,-
BAC236_P10,1,1p32.3,53851856,53974150,122294,-,-
BAC27_E23,1,1p32.3,53880037,53991594,111557,-,-
BAC156_D24,1,1p32.3,53963451,54058515,95064,-,-
BAC197_D10,1,1p32.3,53963451,54047852,84401,-,-
BAC190_L10,1,1p32.3,53973444,54073554,100110,-,-
BAC196_I06,1,1p32.3,54155717,54250536,94819,-,-
BAC104_D19,1,1p32.3,54247632,54363820,116188,-,-
BAC230_B23,1,1p32.3,54250529,54363802,113273,-,-
BAC115_L07,1,1p32.3,54312746,54404881,92135,-,-
BAC25_O13,1,1p32.3,54315078,54409098,94020,-,-
BAC73_C06,1,1p32.3,54337405,54439420,102015,-,-
BAC162_A04,1,1p32.3,54376697,54459218,82521,-,-
BAC51_I04,1,1p32.3,54410760,54498905,88145,-,-
BAC242_M07,1,1p32.3,54411256,54507926,96670,-,-
BAC244_K06,1,1p32.3,54475200,54564760,89560,-,-
BAC235_I22,1,1p32.3,54479369,54594258,114889,-,-
BAC153_I07,1,1p32.3,54534001,54652201,118200,-,-
BAC49_N20,1,1p32.3,54564779,54652214,87435,-,-
BAC66_D08,1,1p32.3,54566618,54718175,151557,-,-
BAC250_G01,1,1p32.3,54724982,54835695,110713,-,-
BAC135_O07,1,1p32.3,54769512,54869786,100274,-,-
BAC197_F03,1,1p32.3,54769523,54824618,55095,-,-
BAC78_D22,1,1p32.3,54798568,54912916,114348,-,-
BAC141_O10,1,1p32.3,54805558,54912916,107358,-,-
BAC131_K07,1,1p32.3,54830139,54944035,113896,-,-
BAC55_H09,1,1p32.3,54859936,54994820,134884,-,-
BAC153_N03,1,1p32.3,54904714,54991083,86369,-,-
BAC177_L07,1,1p32.3,54964743,55080587,115844,-,-
BAC26_A14,1,1p32.3,54989048,55090435,101387,-,-
BAC39_A18,1,1p32.3,54989057,55090435,101378,-,-
BAC116_O09,1,1p32.3,54991139,55085486,94347,-,-
BAC95_F15,1,1p32.3,54993833,55091027,97194,-,-
BAC218_M19,1,1p32.3,54994812,55104460,109648,-,-
BAC51_D10,1,1p32.3,54994834,55104460,109626,-,-
BAC24_D24,1,1p32.3,54995740,55085486,89746,-,-
BAC213_H14,1,1p32.3,54998944,55080434,81490,-,-
BAC140_F08,1,1p32.3,55080593,55240853,160260,-,-
BAC217_F05,1,1p32.3,55081270,55167888,86618,-,-
BAC217_C18,1,1p32.3,55143661,55230674,87013,-,-
BAC111_C02,1,1p32.3,55228951,55336322,107371,-,-
BAC189_D11,1,1p32.3,55264224,55368638,104414,-,-
BAC152_O16,1,1p32.3,55372788,55461616,88828,-,-
BAC48_I04,1,1p32.3,55386549,55518697,132148,-,-
BAC223_G02,1,1p32.3,55412133,55490006,77873,-,-
BAC156_N01,1,1p32.3,55440982,55569836,128854,-,-
BAC248_P16,1,1p32.3,55521306,55606255,84949,-,-
BAC192_D06,1,1p32.3,55575967,55670735,94768,-,-
BAC11_L08,1,1p32.3,55595271,55706710,111439,-,-
BAC222_K04,1,1p32.3,55635057,55724881,89824,-,-
BAC55_O17,1,1p32.3,55651379,55734683,83304,-,-
BAC193_I19,1,1p32.3,55659435,55751444,92009,-,-
BAC161_N13,1,1p32.3,55665084,55765552,100468,-,-
BAC219_H22,1,1p32.3,55672730,55751575,78845,-,-
BAC145_J10,1,1p32.3,55682469,55788522,106053,-,-
BAC142_G14,1,1p32.3,55727205,55827258,100053,-,-
BAC88_H03,1,1p32.3,55751442,55849190,97748,-,-
BAC179_G17,1,1p32.3,55765538,55849190,83652,-,-
BAC107_N10,1,1p32.3,55769147,55907607,138460,-,-
BAC58_P08,1,1p32.3,55782571,55885601,103030,-,-
BAC58_H23,1,1p32.3,55789719,55896698,106979,-,-
BAC79_P19,1,1p32.3,55842845,55943338,100493,-,-
BAC241_F03,1,1p32.3,55921006,56007912,86906,-,-
BAC218_M14,1,1p32.3,55975582,56127243,151661,-,-
BAC151_C05,1,1p32.3,56007907,56093175,85268,-,-
BAC76_F01,1,1p32.3,56014240,56105109,90869,-,-
BAC115_M20,1,1p32.3-1p32.2,56109167,56208503,99336,-,-
BAC96_O07,1,1p32.3-1p32.2,56182198,56272999,90801,-,-
BAC56_G02,1,1p32.2,56439569,56533001,93432,-,-
BAC15_I18,1,1p32.2,56611546,56738075,126529,-,-
BAC173_E03,1,1p32.2,56614132,56699945,85813,-,-
BAC109_G11,1,1p32.2,56672326,56769838,97512,-,-
BAC129_J05,1,1p32.2,56709839,56796796,86957,-,-
BAC152_P18,1,1p32.2,56710237,56801453,91216,-,-
BAC56_E10,1,1p32.2,56710237,56796796,86559,-,-
BAC193_L08,1,1p32.2,56710239,56804822,94583,-,-
BAC118_O17,1,1p32.2,56716104,56834520,118416,-,-
BAC239_E20,1,1p32.2,56716115,56796796,80681,-,-
BAC76_O17,1,1p32.2,56718017,56801453,83436,-,-
BAC173_F16,1,1p32.2,56719061,56804819,85758,-,-
BAC219_E12,1,1p32.2,56913276,56993698,80422,-,-
BAC120_H04,1,1p32.2,57035971,57138383,102412,-,-
BAC21_N04,1,1p32.2,57080113,57232678,152565,-,-
BAC84_J05,1,1p32.2,57144493,57238301,93808,-,-
BAC61_O20,1,1p32.2,57198268,57308863,110595,-,-
BAC22_P12,1,1p32.2,57302900,57385084,82184,-,-
BAC218_C04,1,1p32.2,57454121,57549683,95562,-,-
BAC177_F22,1,1p32.2,57458273,57566088,107815,-,-
BAC95_E17,1,1p32.2,57504188,57536227,32039,-,-
BAC195_J05,1,1p32.2,57531311,57628090,96779,-,-
BAC21_C18,1,1p32.2,57566124,57671176,105052,-,-
BAC184_D18,1,1p32.2,57630102,57701815,71713,-,-
BAC184_G21,1,1p32.2,57655597,57754746,99149,-,-
BAC61_L02,1,1p32.2,57682665,57770978,88313,-,-
BAC197_P21,1,1p32.2,57707340,57817982,110642,-,-
BAC59_P15,1,1p32.2,57781311,57869621,88310,-,-
BAC8_F10,1,1p32.2,57796250,57883540,87290,-,-
BAC2_E08,1,1p32.2,57871789,57990721,118932,-,-
BAC114_E15,1,1p32.2,57878842,57990093,111251,-,-
BAC23_C03,1,1p32.2,57960743,58084379,123636,-,-
BAC159_P06,1,1p32.2,57990832,58091455,100623,-,-
BAC20_L07,1,1p32.2,58012399,58153960,141561,-,-
BAC76_L12,1,1p32.2,58013997,58118941,104944,-,-
BAC117_L14,1,1p32.2,58200246,58313372,113126,-,-
BAC78_E08,1,1p32.2,58218436,58303469,85033,-,-
BAC195_K22,1,1p32.2,58444858,58564458,119600,-,-
BAC234_I09,1,1p32.2,58481514,58594343,112829,-,-
BAC126_K01,1,1p32.2-1p32.1,58632301,58731320,99019,-,-
BAC83_I24,1,1p32.2-1p32.1,58673172,58780985,107813,-,-
BAC161_M14,1,1p32.1,58734786,58805870,71084,-,-
BAC53_M04,1,1p32.1,58780980,58870149,89169,-,-
BAC230_D01,1,1p32.1,58795852,58870146,74294,-,-
BAC209_G10,1,1p32.1,58810929,58898982,88053,-,-
BAC51_N21,1,1p32.1,58810943,58899250,88307,-,-
BAC43_B24,1,1p32.1,58844518,58930820,86302,-,-
BAC234_H22,1,1p32.1,58909059,59044901,135842,-,-
BAC57_C10,1,1p32.1,58919483,59058380,138897,-,-
BAC165_C16,1,1p32.1,58930815,59044901,114086,-,-
BAC165_N17,1,1p32.1,58958809,59044901,86092,-,-
BAC180_D08,1,1p32.1,58970391,59044901,74510,-,-
BAC30_K17,1,1p32.1,59002032,59116839,114807,-,-
BAC196_O15,1,1p32.1,59017977,59132076,114099,-,-
BAC11_N04,1,1p32.1,59059871,59160035,100164,-,-
BAC27_J14,1,1p32.1,59178885,59342810,163925,-,-
BAC170_H22,1,1p32.1,59188327,59275675,87348,-,-
BAC161_E16,1,1p32.1,59188365,59298979,110614,-,-
BAC118_N09,1,1p32.1,59203672,59303189,99517,-,-
BAC71_J20,1,1p32.1,59321145,59425165,104020,-,-
BAC168_N08,1,1p32.1,59390358,59475049,84691,-,-
BAC76_M13,1,1p32.1,59425156,59559024,133868,-,-
BAC6_B21,1,1p32.1,59436521,59547827,111306,-,-
BAC150_B09,1,1p32.1,59461920,59566702,104782,-,-
BAC178_I17,1,1p32.1,59547826,59658876,111050,-,-
BAC239_O05,1,1p32.1,59566951,59686866,119915,-,-
BAC162_M15,1,1p32.1,59659142,59778049,118907,-,-
BAC101_B06,1,1p32.1,59698967,59813494,114527,-,-
BAC36_I07,1,1p32.1,59702230,59822573,120343,-,-
BAC175_M07,1,1p32.1,59872713,59959248,86535,-,-
BAC188_L13,1,1p32.1,59909710,60000244,90534,-,-
BAC219_G02,1,1p32.1,59914638,60024786,110148,-,-
BAC46_H01,1,1p32.1,60022646,60058648,36002,-,-
BAC73_K06,1,1p32.1,60310366,60395884,85518,-,-
BAC141_M04,1,1p32.1,60744896,60871044,126148,-,-
BAC247_H09,1,1p31.3,60932276,61010284,78008,-,-
BAC243_F18,1,1p31.3,60942468,61031450,88982,-,-
BAC121_K13,1,1p31.3,60950881,61053607,102726,-,-
BAC96_G04,1,1p31.3,61290688,61381382,90694,-,-
BAC190_O10,1,1p31.3,61349038,61436238,87200,-,-
BAC116_B22,1,1p31.3,61409513,61498664,89151,-,-
BAC128_F06,1,1p31.3,61788416,61884942,96526,-,-
BAC161_E21,1,1p31.3,61822810,61907205,84395,-,-
BAC27_O20,1,1p31.3,61899967,61997389,97422,-,-
BAC25_P22,1,1p31.3,61907899,62033718,125819,-,-
BAC236_H10,1,1p31.3,61913148,61992780,79632,-,-
BAC59_F06,1,1p31.3,61920568,62071547,150979,-,-
BAC60_A09,1,1p31.3,61997476,62121515,124039,-,-
BAC169_C12,1,1p31.3,62048512,62174245,125733,-,-
BAC70_H16,1,1p31.3,62085542,62172870,87328,-,-
BAC34_F04,1,1p31.3,62196087,62320831,124744,-,-
BAC116_A16,1,1p31.3,62226948,62315946,88998,-,-
BAC92_J04,1,1p31.3,62242296,62334100,91804,-,-
BAC167_H19,1,1p31.3,62388080,62494240,106160,-,-
BAC222_J19,1,1p31.3,62421821,62500030,78209,-,-
BAC215_J06,1,1p31.3,62424528,62515598,91070,-,-
BAC153_E04,1,1p31.3,62436909,62521459,84550,-,-
BAC43_B06,1,1p31.3,62469756,62564341,94585,-,-
BAC62_F02,1,1p31.3,62489411,62605013,115602,-,-
BAC161_A05,1,1p31.3,62527357,62611927,84570,-,-
BAC165_O02,1,1p31.3,62589869,62679900,90031,-,-
BAC236_C16,1,1p31.3,62694846,62788187,93341,-,-
BAC187_J03,1,1p31.3,62694846,62784149,89303,-,-
BAC1_P08,1,1p31.3,62711232,62850020,138788,-,-
BAC30_L17,1,1p31.3,62711269,62815354,104085,-,-
BAC153_J05,1,1p31.3,62713271,62784427,71156,-,-
BAC228_L23,1,1p31.3,62743448,62837146,93698,-,-
BAC236_D09,1,1p31.3,62784627,62868960,84333,-,-
BAC120_M18,1,1p31.3,62812052,62967870,155818,-,-
BAC12_P13,1,1p31.3,62821110,62967870,146760,-,-
BAC38_E12,1,1p31.3,62869147,62974077,104930,-,-
BAC112_H03,1,1p31.3,62892515,63038531,146016,-,-
BAC173_P05,1,1p31.3,62911094,62994719,83625,-,-
BAC247_B14,1,1p31.3,63117354,63206097,88743,-,-
BAC165_O13,1,1p31.3,63219248,63304372,85124,-,-
BAC110_E02,1,1p31.3,63237348,63338313,100965,-,-
BAC17_L21,1,1p31.3,63237536,63348369,110833,-,-
BAC234_P02,1,1p31.3,63281168,63380659,99491,-,-
BAC143_F22,1,1p31.3,63321349,63414698,93349,-,-
BAC144_C19,1,1p31.3,63500534,63589634,89100,-,-
BAC58_L02,1,1p31.3,63500700,63599380,98680,-,-
BAC196_A15,1,1p31.3,63592166,63640424,48258,-,-
BAC156_E21,1,1p31.3,63681575,63768998,87423,-,-
BAC230_D16,1,1p31.3,63768830,63863617,94787,-,-
BAC106_G16,1,1p31.3,63786966,63869942,82976,-,-
BAC118_H02,1,1p31.3,63793550,63902767,109217,-,-
BAC198_F14,1,1p31.3,63796236,63885515,89279,-,-
BAC67_F20,1,1p31.3,63883091,64009388,126297,-,-
BAC191_N08,1,1p31.3,63919592,64017178,97586,-,-
BAC81_F02,1,1p31.3,64153580,64278194,124614,-,-
BAC104_C15,1,1p31.3,64187647,64279125,91478,-,-
BAC177_L19,1,1p31.3,64193532,64287691,94159,-,-
BAC58_J02,1,1p31.3,64286963,64382116,95153,-,-
BAC22_P16,1,1p31.3,64296867,64379603,82736,-,-
BAC233_M01,1,1p31.3,64393796,64533686,139890,-,-
BAC81_D15,1,1p31.3,64536653,64647066,110413,-,-
BAC131_K11,1,1p31.3,64543066,64652207,109141,-,-
BAC171_P14,1,1p31.3,64546697,64631036,84339,-,-
BAC17_G23,1,1p31.3,64546808,64674778,127970,-,-
BAC34_P11,1,1p31.3,64731162,64902476,171314,-,-
BAC125_A18,1,1p31.3,64735170,64824560,89390,-,-
BAC15_M17,1,1p31.3,64735170,64831791,96621,-,-
BAC179_D09,1,1p31.3,64811819,64908624,96805,-,-
BAC57_B18,1,1p31.3,64831796,64948809,117013,-,-
BAC116_M22,1,1p31.3,64912970,65010888,97918,-,-
BAC137_O24,1,1p31.3,64991252,65079730,88478,-,-
BAC44_G18,1,1p31.3,65010710,65120128,109418,-,-
BAC220_G20,1,1p31.3,65045448,65120154,74706,-,-
BAC190_F01,1,1p31.3,65075217,65164200,88983,-,-
BAC175_O03,1,1p31.3,65095127,65206712,111585,-,-
BAC97_K08,1,1p31.3,65147029,65289455,142426,-,-
BAC70_D08,1,1p31.3,65186773,65294028,107255,-,-
BAC35_D08,1,1p31.3,65186826,65289660,102834,-,-
BAC100_F23,1,1p31.3,65231312,65318936,87624,-,-
BAC222_I12,1,1p31.3,65340315,65439788,99473,-,-
BAC252_A10,1,1p31.3,65350934,65457726,106792,-,-
BAC230_O08,1,1p31.3,65350967,65452871,101904,-,-
BAC55_C07,1,1p31.3,65432503,65515515,83012,-,-
BAC118_O11,1,1p31.3,65500457,65617978,117521,-,-
BAC84_P06,1,1p31.3,65712901,65792848,79947,-,-
BAC28_P05,1,1p31.3,65712931,65891010,178079,-,-
BAC115_L11,1,1p31.3,65947531,66040608,93077,-,-
BAC108_D12,1,1p31.3,65974460,66071465,97005,-,-
BAC84_N01,1,1p31.3,65987466,66068589,81123,-,-
BAC131_P01,1,1p31.3,66100689,66181257,80568,-,-
BAC101_P22,1,1p31.3,66149491,66237139,87648,-,-
BAC146_N21,1,1p31.3,66276161,66352678,76517,-,-
BAC158_H14,1,1p31.3,66380974,66468093,87119,-,-
BAC158_G14,1,1p31.3,66380974,66468093,87119,-,-
BAC232_K18,1,1p31.3,66441377,66536319,94942,-,-
BAC89_J12,1,1p31.3,66447480,66537891,90411,-,-
BAC124_B03,1,1p31.3,66447481,66542123,94642,-,-
BAC137_A09,1,1p31.3,66611149,66688842,77693,-,-
BAC102_P23,1,1p31.3,66674672,66763718,89046,-,-
BAC59_E04,1,1p31.3,66697244,66822427,125183,-,-
BAC182_A19,1,1p31.3,66797822,66881998,84176,-,-
BAC217_C19,1,1p31.3,66822471,66925991,103520,-,-
BAC91_J17,1,1p31.3,67034700,67172143,137443,-,-
BAC34_D05,1,1p31.3,67080161,67181586,101425,-,-
BAC89_J07,1,1p31.3,67113979,67263677,149698,-,-
BAC176_C15,1,1p31.3,67162345,67266627,104282,-,-
BAC83_H20,1,1p31.3,67267540,67391093,123553,-,-
BAC237_H24,1,1p31.3,67268295,67362260,93965,-,-
BAC40_N02,1,1p31.3,67306000,67407092,101092,-,-
BAC201_G20,1,1p31.3,67362255,67452096,89841,-,-
BAC46_F02,1,1p31.3,67460914,67549639,88725,-,-
BAC12_C22,1,1p31.3,67586219,67673735,87516,-,-
BAC107_K17,1,1p31.3,67614136,67739023,124887,-,-
BAC184_P23,1,1p31.3,67645086,67724843,79757,-,-
BAC192_N18,1,1p31.3,67666063,67748663,82600,-,-
BAC60_A24,1,1p31.3,67667883,67774015,106132,-,-
BAC76_O03,1,1p31.3,67724838,67841354,116516,-,-
BAC129_L06,1,1p31.3,67729829,67833943,104114,-,-
BAC55_K16,1,1p31.3,67740236,67870978,130742,-,-
BAC204_N24,1,1p31.3,67774134,67896405,122271,-,-
BAC196_N17,1,1p31.3,67809528,67927369,117841,-,-
BAC108_E16,1,1p31.3,67822588,67929786,107198,-,-
BAC27_G04,1,1p31.3,67965258,68069029,103771,-,-
BAC185_E07,1,1p31.3,67980731,68065155,84424,-,-
BAC82_O06,1,1p31.3,68016080,68112439,96359,-,-
BAC46_G17,1,1p31.3,68033194,68183559,150365,-,-
BAC192_C07,1,1p31.3,68065146,68138082,72936,-,-
BAC110_G09,1,1p31.3,68065148,68173202,108054,-,-
BAC110_G05,1,1p31.3,68065148,68173202,108054,-,-
BAC124_G02,1,1p31.3,68135476,68224169,88693,-,-
BAC232_A21,1,1p31.3,68191208,68277908,86700,-,-
BAC179_B05,1,1p31.3,68221978,68300148,78170,-,-
BAC103_B10,1,1p31.3,68458917,68586831,127914,-,-
BAC250_A24,1,1p31.3,68461422,68557660,96238,-,-
BAC62_E09,1,1p31.3,68463192,68581301,118109,-,-
BAC64_M08,1,1p31.3,68469070,68581299,112229,-,-
BAC82_J18,1,1p31.3,68493578,68612410,118832,-,-
BAC58_O02,1,1p31.3-1p31.2,68637124,68761016,123892,-,-
BAC180_I20,1,1p31.3-1p31.2,68645845,68722812,76967,-,-
BAC48_J07,1,1p31.3-1p31.2,68656165,68752447,96282,-,-
BAC101_M15,1,1p31.3-1p31.2,68684136,68776061,91925,-,-
BAC247_N14,1,1p31.2,68769132,68864792,95660,-,-
BAC139_P15,1,1p31.2,69059500,69142038,82538,-,-
BAC134_I12,1,1p31.2,69085534,69179209,93675,-,-
BAC119_I17,1,1p31.2,69211422,69288497,77075,-,-
BAC119_I15,1,1p31.2,69211422,69288504,77082,-,-
BAC248_M22,1,1p31.2,69278932,69379107,100175,-,-
BAC242_K19,1,1p31.2,69320006,69399368,79362,-,-
BAC34_J16,1,1p31.1,69502747,69632404,129657,-,-
BAC55_E07,1,1p31.1,69502747,69612191,109444,-,-
BAC238_C10,1,1p31.1,69507237,69595956,88719,-,-
BAC61_O09,1,1p31.1,69518070,69609510,91440,-,-
BAC237_H19,1,1p31.1,69680646,69793159,112513,-,-
BAC46_G11,1,1p31.1,69762611,69873586,110975,-,-
BAC21_E02,1,1p31.1,69793754,69911720,117966,-,-
BAC252_H05,1,1p31.1,69820765,69914047,93282,-,-
BAC166_O22,1,1p31.1,70000572,70088443,87871,-,-
BAC218_J13,1,1p31.1,70129454,70228090,98636,-,-
BAC159_H02,1,1p31.1,70499147,70583005,83858,-,-
BAC189_G13,1,1p31.1,70509176,70605890,96714,-,-
BAC192_K14,1,1p31.1,70528332,70607619,79287,-,-
BAC18_F07,1,1p31.1,70590167,70740045,149878,-,-
BAC44_B06,1,1p31.1,70606124,70697297,91173,-,-
BAC118_G24,1,1p31.1,70614632,70740045,125413,-,-
BAC227_H12,1,1p31.1,70648340,70737872,89532,-,-
BAC92_F17,1,1p31.1,70697425,70790530,93105,-,-
BAC28_B16,1,1p31.1,70766322,70858347,92025,-,-
BAC97_J17,1,1p31.1,70790532,70897327,106795,-,-
BAC73_G16,1,1p31.1,70876567,71060241,183674,-,-
BAC157_D21,1,1p31.1,70913428,71003445,90017,-,-
BAC186_I13,1,1p31.1,71011567,71126365,114798,-,-
BAC33_I03,1,1p31.1,71018934,71106811,87877,-,-
BAC72_N09,1,1p31.1,71024569,71110391,85822,-,-
BAC124_F06,1,1p31.1,71029991,71139980,109989,-,-
BAC53_J23,1,1p31.1,71069819,71229968,160149,-,-
BAC17_P17,1,1p31.1,71087397,71213428,126031,-,-
BAC91_I17,1,1p31.1,71249423,71360200,110777,-,-
BAC59_L04,1,1p31.1,71254593,71360175,105582,-,-
BAC106_J09,1,1p31.1,71346977,71441442,94465,-,-
BAC91_C04,1,1p31.1,71373793,71490320,116527,-,-
BAC228_P14,1,1p31.1,71573009,71652264,79255,-,-
BAC15_A12,1,1p31.1,71613569,71744599,131030,-,-
BAC206_C19,1,1p31.1,71693673,71788055,94382,-,-
BAC132_G01,1,1p31.1,71799067,71906017,106950,-,-
BAC107_D09,1,1p31.1,71948157,72047111,98954,-,-
BAC55_L19,1,1p31.1,72175486,72273741,98255,-,-
BAC226_K10,1,1p31.1,72358196,72460864,102668,-,-
BAC232_M08,1,1p31.1,72465887,72596540,130653,-,-
BAC224_J13,1,1p31.1,72749537,72838880,89343,-,-
BAC50_K18,1,1p31.1,72820310,72906508,86198,-,-
BAC39_K10,1,1p31.1,72842653,72923522,80869,-,-
BAC71_P18,1,1p31.1,72985371,73082954,97583,-,-
BAC46_F10,1,1p31.1,73055287,73147063,91776,-,-
BAC114_B18,1,1p31.1,73117643,73221306,103663,-,-
BAC196_G13,1,1p31.1,73255792,73352776,96984,-,-
BAC178_I13,1,1p31.1,73284299,73407187,122888,-,-
BAC100_D15,1,1p31.1,73311327,73431908,120581,-,-
BAC122_F19,1,1p31.1,73559496,73678888,119392,-,-
BAC30_N09,1,1p31.1,73585476,73719658,134182,-,-
BAC44_I01,1,1p31.1,73822262,73833589,11327,-,-
BAC41_G12,1,1p31.1,73845649,73934889,89240,-,-
BAC125_K04,1,1p31.1,73876453,74040170,163717,-,-
BAC126_B08,1,1p31.1,74094317,74219824,125507,-,-
BAC101_I09,1,1p31.1,74174289,74266089,91800,-,-
BAC181_N16,1,1p31.1,74407257,74525389,118132,-,-
BAC106_F22,1,1p31.1,74727550,74845053,117503,-,-
BAC4_O01,1,1p31.1,74889584,74996439,106855,-,-
BAC161_B09,1,1p31.1,75497096,75572460,75364,-,-
BAC104_J20,1,1p31.1,75648969,75745555,96586,-,-
BAC127_M17,1,1p31.1,75820673,75907278,86605,-,-
BAC97_O03,1,1p31.1,75865135,75959559,94424,-,-
BAC102_F16,1,1p31.1,76068529,76152727,84198,-,-
BAC178_F06,1,1p31.1,76096908,76210060,113152,-,-
BAC134_H19,1,1p31.1,76165173,76280830,115657,-,-
BAC52_G24,1,1p31.1,76330197,76428999,98802,-,-
BAC169_G06,1,1p31.1,76354645,76447300,92655,-,-
BAC159_M03,1,1p31.1,76379833,76462862,83029,-,-
BAC171_N07,1,1p31.1,76397951,76498912,100961,-,-
BAC171_E12,1,1p31.1,76424802,76498912,74110,-,-
BAC29_B08,1,1p31.1,76545656,76643640,97984,-,-
BAC235_N13,1,1p31.1,76631561,76728156,96595,-,-
BAC53_B09,1,1p31.1,76659409,76687085,27676,-,-
BAC167_B07,1,1p31.1,76859579,76989920,130341,-,-
BAC84_B09,1,1p31.1,76878497,76965716,87219,-,-
BAC176_H07,1,1p31.1,76986542,77098592,112050,-,-
BAC88_D14,1,1p31.1,77007329,77112699,105370,-,-
BAC103_J03,1,1p31.1,77108646,77212476,103830,-,-
BAC6_H19,1,1p31.1,77337629,77421163,83534,-,-
BAC1_E06,1,1p31.1,77563187,77676565,113378,-,-
BAC77_K04,1,1p31.1,77650032,77815030,164998,-,-
BAC200_D02,1,1p31.1,77673533,77770622,97089,-,-
BAC60_J19,1,1p31.1,77678299,77815030,136731,-,-
BAC234_B04,1,1p31.1,77723918,77830196,106278,-,-
BAC29_K09,1,1p31.1,77723918,77826320,102402,-,-
BAC187_N13,1,1p31.1,77747691,77824705,77014,-,-
BAC151_M11,1,1p31.1,77945590,78041449,95859,-,-
BAC132_H19,1,1p31.1,77945590,78075069,129479,-,-
BAC41_B22,1,1p31.1,77989388,78096617,107229,-,-
BAC173_H11,1,1p31.1,78048755,78176462,127707,-,-
BAC181_E18,1,1p31.1,78055017,78137907,82890,-,-
BAC14_D19,1,1p31.1,78083322,78172817,89495,-,-
BAC59_F03,1,1p31.1,78084238,78176442,92204,-,-
BAC120_H05,1,1p31.1,78186066,78297924,111858,-,-
BAC5_N06,1,1p31.1,78268024,78385314,117290,-,-
BAC40_J04,1,1p31.1,78296280,78382593,86313,-,-
BAC133_O12,1,1p31.1,78300566,78385334,84768,-,-
BAC182_K07,1,1p31.1,78330688,78428496,97808,-,-
BAC175_D06,1,1p31.1,78397739,78493137,95398,-,-
BAC31_I18,1,1p31.1,78443147,78535357,92210,-,-
BAC123_D13,1,1p31.1,78493155,78583053,89898,-,-
BAC102_L05,1,1p31.1,78494200,78571903,77703,-,-
BAC8_L04,1,1p31.1,78571905,78640420,68515,-,-
BAC221_L18,1,1p31.1,78579590,78668724,89134,-,-
BAC65_J05,1,1p31.1,78670775,78769441,98666,-,-
BAC61_H20,1,1p31.1,78724031,78819134,95103,-,-
BAC167_A21,1,1p31.1,78821864,78931704,109840,-,-
BAC82_D05,1,1p31.1,78945974,79068589,122615,-,-
BAC122_B12,1,1p31.1,78956092,79062335,106243,-,-
BAC148_F11,1,1p31.1,79151082,79266138,115056,-,-
BAC167_P23,1,1p31.1,79266703,79345843,79140,-,-
BAC29_A05,1,1p31.1,79384608,79479947,95339,-,-
BAC59_L14,1,1p31.1,79498605,79517877,19272,-,-
BAC66_J17,1,1p31.1,79532711,79653648,120937,-,-
BAC232_J02,1,1p31.1,79544672,79643225,98553,-,-
BAC236_F23,1,1p31.1,79544948,79639063,94115,-,-
BAC110_C08,1,1p31.1,79593996,79712436,118440,-,-
BAC151_P19,1,1p31.1,79598044,79685836,87792,-,-
BAC35_P05,1,1p31.1,79733007,79834409,101402,-,-
BAC83_E04,1,1p31.1,79834668,79957025,122357,-,-
BAC26_J23,1,1p31.1,79934332,80088249,153917,-,-
BAC192_E06,1,1p31.1,80018059,80108444,90385,-,-
BAC193_P03,1,1p31.1,80030937,80129206,98269,-,-
BAC10_C05,1,1p31.1,80038322,80129191,90869,-,-
BAC161_L04,1,1p31.1,80226432,80330034,103602,-,-
BAC90_N05,1,1p31.1,80241451,80257911,16460,-,-
BAC221_I14,1,1p31.1,80294675,80384960,90285,-,-
BAC57_M04,1,1p31.1,80357885,80480114,122229,-,-
BAC19_M03,1,1p31.1,80380560,80518251,137691,-,-
BAC90_M23,1,1p31.1,80523929,80634995,111066,-,-
BAC117_L03,1,1p31.1,80552863,80640797,87934,-,-
BAC49_K05,1,1p31.1,80588127,80719065,130938,-,-
BAC54_D16,1,1p31.1,80672342,80787327,114985,-,-
BAC59_C03,1,1p31.1,80673345,80768375,95030,-,-
BAC179_M17,1,1p31.1,80709142,80796613,87471,-,-
BAC237_I20,1,1p31.1,80796870,80876753,79883,-,-
BAC196_N11,1,1p31.1,80799617,80928568,128951,-,-
BAC223_G01,1,1p31.1,80818463,80905661,87198,-,-
BAC31_D14,1,1p31.1,81179879,81199012,19133,-,-
BAC151_G09,1,1p31.1,81193300,81329036,135736,-,-
BAC116_P03,1,1p31.1,81329293,81429722,100429,-,-
BAC133_L17,1,1p31.1,81352649,81462304,109655,-,-
BAC220_D02,1,1p31.1,81487914,81566469,78555,-,-
BAC200_M21,1,1p31.1,81653345,81737390,84045,-,-
BAC217_K10,1,1p31.1,81662140,81743383,81243,-,-
BAC158_I19,1,1p31.1,81699584,81737376,37792,-,-
BAC158_F19,1,1p31.1,81699611,81737376,37765,-,-
BAC150_L03,1,1p31.1,81829617,81909660,80043,-,-
BAC102_B05,1,1p31.1,81909805,82045836,136031,-,-
BAC59_C04,1,1p31.1,81936493,82072583,136090,-,-
BAC59_D13,1,1p31.1,82036545,82127504,90959,-,-
BAC162_L04,1,1p31.1,82361349,82420414,59065,-,-
BAC96_H09,1,1p31.1,82457189,82541238,84049,-,-
BAC97_A07,1,1p31.1,82589859,82702891,113032,-,-
BAC90_M20,1,1p31.1,82732813,82849707,116894,-,-
BAC145_P04,1,1p31.1,82797709,82868432,70723,-,-
BAC150_N08,1,1p31.1,82828867,82945133,116266,-,-
BAC36_F08,1,1p31.1,83049569,83140076,90507,-,-
BAC189_F17,1,1p31.1,83051746,83128957,77211,-,-
BAC129_P07,1,1p31.1,83065935,83151916,85981,-,-
BAC231_K15,1,1p31.1,83118604,83196276,77672,-,-
BAC76_I04,1,1p31.1,83281967,83384949,102982,-,-
BAC178_A21,1,1p31.1,83430122,83525554,95432,-,-
BAC103_O02,1,1p31.1,83564043,83652469,88426,-,-
BAC75_C24,1,1p31.1,83747358,83867128,119770,-,-
BAC119_O12,1,1p31.1,83780561,83868371,87810,-,-
BAC83_D11,1,1p31.1,83797809,83906368,108559,-,-
BAC182_H23,1,1p31.1,83823388,83903261,79873,-,-
BAC234_O08,1,1p31.1,83935049,84020260,85211,-,-
BAC199_B14,1,1p31.1,83965365,84069685,104320,-,-
BAC27_M12,1,1p31.1,83975652,84055961,80309,-,-
BAC36_L07,1,1p31.1,84052757,84216340,163583,-,-
BAC160_N02,1,1p31.1,84162582,84244633,82051,-,-
BAC18_K02,1,1p31.1,84165878,84312309,146431,-,-
BAC101_N08,1,1p31.1,84424049,84541452,117403,-,-
BAC61_H07,1,1p31.1,84481768,84575721,93953,-,-
BAC233_E08,1,1p22.3,84914667,84994063,79396,-,-
BAC142_J09,1,1p22.3,84936957,85031219,94262,-,-
BAC179_C19,1,1p22.3,84994056,85079763,85707,-,-
BAC19_B13,1,1p22.3,85104361,85276584,172223,-,-
BAC42_E02,1,1p22.3,85181998,85291023,109025,-,-
BAC217_L14,1,1p22.3,85196498,85275455,78957,-,-
BAC18_B19,1,1p22.3,85291291,85392034,100743,-,-
BAC222_P15,1,1p22.3,85294312,85379546,85234,-,-
BAC91_K12,1,1p22.3,85347340,85432233,84893,-,-
BAC139_G05,1,1p22.3,85372375,85475181,102806,-,-
BAC71_O19,1,1p22.3,85407155,85491299,84144,-,-
BAC188_J14,1,1p22.3,85411889,85491299,79410,-,-
BAC78_B10,1,1p22.3,85434534,85554414,119880,-,-
BAC226_J10,1,1p22.3,85462618,85555871,93253,-,-
BAC104_E19,1,1p22.3,85468228,85558904,90676,-,-
BAC246_K04,1,1p22.3,85593222,85671926,78704,-,-
BAC192_H22,1,1p22.3,85625076,85701528,76452,-,-
BAC33_L18,1,1p22.3,85628811,85736337,107526,-,-
BAC135_F09,1,1p22.3,85701522,85786674,85152,-,-
BAC162_N16,1,1p22.3,85705126,85786674,81548,-,-
BAC74_F02,1,1p22.3,85733882,85842585,108703,-,-
BAC222_F03,1,1p22.3,85750439,85851181,100742,-,-
BAC161_E15,1,1p22.3,85802131,85914607,112476,-,-
BAC248_L16,1,1p22.3,85833428,85926312,92884,-,-
BAC55_G07,1,1p22.3,85842644,85947075,104431,-,-
BAC123_K22,1,1p22.3,85855505,85974173,118668,-,-
BAC155_E18,1,1p22.3,85868068,85969774,101706,-,-
BAC54_L04,1,1p22.3,85883909,85990449,106540,-,-
BAC51_H21,1,1p22.3,85969768,86109761,139993,-,-
BAC249_A20,1,1p22.3,86133365,86215880,82515,-,-
BAC193_B14,1,1p22.3,86268104,86290294,22190,-,-
BAC118_I08,1,1p22.3,86268104,86361233,93129,-,-
BAC55_A22,1,1p22.3,86281255,86381519,100264,-,-
BAC61_H06,1,1p22.3,86320563,86421284,100721,-,-
BAC53_A11,1,1p22.3,86405411,86558691,153280,-,-
BAC125_G21,1,1p22.3,86441265,86557184,115919,-,-
BAC38_J14,1,1p22.3,86608865,86740984,132119,-,-
BAC33_M05,1,1p22.3,86618500,86716701,98201,-,-
BAC150_O09,1,1p22.3,86656183,86759842,103659,-,-
BAC81_P03,1,1p22.3,86656186,86740984,84798,-,-
BAC186_D07,1,1p22.3,86711540,86803275,91735,-,-
BAC235_F17,1,1p22.3,86756246,86860455,104209,-,-
BAC252_J10,1,1p22.3,86777166,86882976,105810,-,-
BAC43_K06,1,1p22.3,86816508,86897077,80569,-,-
BAC104_D02,1,1p22.3,86852074,86932752,80678,-,-
BAC199_A04,1,1p22.3,86988061,87085099,97038,-,-
BAC143_F14,1,1p22.3,87016407,87094079,77672,-,-
BAC58_F21,1,1p22.3,87030799,87131711,100912,-,-
BAC131_A09,1,1p22.3,87045449,87140650,95201,-,-
BAC27_D10,1,1p22.3,87106394,87229918,123524,-,-
BAC213_N06,1,1p22.3,87153723,87237036,83313,-,-
BAC59_B17,1,1p22.3,87455129,87548653,93524,-,-
BAC59_G14,1,1p22.3,87554393,87666387,111994,-,-
BAC38_H23,1,1p22.3,87554592,87687034,132442,-,-
BAC105_I17,1,1p22.3,87563610,87666740,103130,-,-
BAC48_O17,1,1p22.3,87605232,87724241,119009,-,-
BAC42_O20,1,1p22.3,87641512,87733702,92190,-,-
BAC36_D14,1,1p22.3,87666765,87797464,130699,-,-
BAC252_I10,1,1p22.3,87690959,87818090,127131,-,-
BAC60_B11,1,1p22.3,87818085,87919494,101409,-,-
BAC162_J16,1,1p22.3,87852333,87946655,94322,-,-
BAC189_B08,1,1p22.3,87853916,87946655,92739,-,-
BAC144_A24,1,1p22.3,87901092,87987164,86072,-,-
BAC103_E12,1,1p22.3,87924165,88022079,97914,-,-
BAC148_A14,1,1p22.3,87987840,88071836,83996,-,-
BAC8_L01,1,1p22.3-1p22.2,88010107,88105074,94967,-,-
BAC17_N17,1,1p22.2,88156655,88256545,99890,-,-
BAC54_I02,1,1p22.2,88351055,88477939,126884,-,-
BAC88_M04,1,1p22.2,88444731,88538748,94017,-,-
BAC179_N19,1,1p22.2,88538951,88614471,75520,-,-
BAC147_B21,1,1p22.2,88714057,88824720,110663,-,-
BAC34_H08,1,1p22.2,88717909,88812669,94760,-,-
BAC129_P01,1,1p22.2,88789494,88886611,97117,-,-
BAC9_C05,1,1p22.2,88812665,88914521,101856,-,-
BAC133_O04,1,1p22.2,88816093,88925118,109025,-,-
BAC230_J08,1,1p22.2,88906965,88982601,75636,-,-
BAC184_O19,1,1p22.2,88925113,89025905,100792,-,-
BAC58_B15,1,1p22.2,88933725,89025916,92191,-,-
BAC29_K21,1,1p22.2,88933725,89042046,108321,-,-
BAC141_P12,1,1p22.2,88973078,89055464,82386,-,-
BAC140_F19,1,1p22.2,89055459,89136252,80793,-,-
BAC28_N23,1,1p22.2,89102834,89195269,92435,-,-
BAC29_O19,1,1p22.2,89115101,89209234,94133,-,-
BAC123_O23,1,1p22.2,89212002,89341197,129195,-,-
BAC44_E12,1,1p22.2,89247800,89387541,139741,-,-
BAC12_B19,1,1p22.2,89295598,89418155,122557,-,-
BAC63_M17,1,1p22.2,89555686,89666073,110387,-,-
BAC48_K04,1,1p22.2,89599922,89704632,104710,-,-
BAC109_J06,1,1p22.2,89723257,89869536,146279,-,-
BAC124_H06,1,1p22.2,89785065,89909985,124920,-,-
BAC51_A10,1,1p22.2,89865156,89981862,116706,-,-
BAC246_L12,1,1p22.2,89900341,90022758,122417,-,-
BAC32_E01,1,1p22.2,89900345,90022924,122579,-,-
BAC134_K22,1,1p22.2,90004951,90090243,85292,-,-
BAC25_A16,1,1p22.2,90203832,90297807,93975,-,-
BAC31_B08,1,1p22.2,90255100,90360103,105003,-,-
BAC228_P11,1,1p22.2,90329013,90423270,94257,-,-
BAC169_K10,1,1p22.2,90360176,90455245,95069,-,-
BAC124_J07,1,1p22.2,90486636,90683420,196784,-,-
BAC81_A04,1,1p22.2,90527239,90546768,19529,-,-
BAC132_I04,1,1p22.2,90608473,90688497,80024,-,-
BAC140_D08,1,1p22.2,90646050,90721308,75258,-,-
BAC12_P16,1,1p22.2,90756271,90864805,108534,-,-
BAC102_A09,1,1p22.2,90864799,91034888,170089,-,-
BAC36_P05,1,1p22.2,90915626,91006831,91205,-,-
BAC226_K07,1,1p22.2,90987057,91053131,66074,-,-
BAC53_A01,1,1p22.2,90998484,91079408,80924,-,-
BAC31_K04,1,1p22.2,91318753,91439112,120359,-,-
BAC90_P02,1,1p22.2,91324319,91472211,147892,-,-
BAC239_O04,1,1p22.2,91329292,91429877,100585,-,-
BAC247_F03,1,1p22.2,91329294,91435565,106271,-,-
BAC78_O07,1,1p22.2,91354296,91435565,81269,-,-
BAC63_M20,1,1p22.2,91417403,91511092,93689,-,-
BAC60_D08,1,1p22.2,91426639,91538723,112084,-,-
BAC61_D15,1,1p22.2,91535439,91679287,143848,-,-
BAC39_P07,1,1p22.2,91545616,91665943,120327,-,-
BAC240_F05,1,1p22.2,91590609,91662893,72284,-,-
BAC101_N21,1,1p22.2,91595666,91677508,81842,-,-
BAC80_P23,1,1p22.2,91787563,91874351,86788,-,-
BAC90_P17,1,1p22.2,91874441,91985428,110987,-,-
BAC146_H14,1,1p22.2,91878709,91973487,94778,-,-
BAC109_A24,1,1p22.1,92039414,92151954,112540,-,-
BAC186_J04,1,1p22.1,92051411,92154211,102800,-,-
BAC66_C06,1,1p22.1,92070306,92238742,168436,-,-
BAC61_C24,1,1p22.1,92089794,92204384,114590,-,-
BAC187_E17,1,1p22.1,92154427,92228730,74303,-,-
BAC132_E09,1,1p22.1,92228723,92318046,89323,-,-
BAC250_B17,1,1p22.1,92229638,92325870,96232,-,-
BAC157_E07,1,1p22.1,92229639,92331707,102068,-,-
BAC70_F18,1,1p22.1,92325634,92399942,74308,-,-
BAC150_J04,1,1p22.1,92333055,92456690,123635,-,-
BAC177_J20,1,1p22.1,92401792,92490265,88473,-,-
BAC116_L21,1,1p22.1,92409659,92518975,109316,-,-
BAC127_M19,1,1p22.1,92414270,92524728,110458,-,-
BAC135_B03,1,1p22.1,92414970,92492393,77423,-,-
BAC127_C22,1,1p22.1,92444459,92549658,105199,-,-
BAC25_O20,1,1p22.1,92518969,92673607,154638,-,-
BAC153_G13,1,1p22.1,92529246,92627902,98656,-,-
BAC105_M10,1,1p22.1,92529246,92655958,126712,-,-
BAC96_H06,1,1p22.1,92542699,92645155,102456,-,-
BAC82_G01,1,1p22.1,92567318,92655958,88640,-,-
BAC38_B17,1,1p22.1,92589131,92693246,104115,-,-
BAC93_L18,1,1p22.1,92593890,92693256,99366,-,-
BAC53_D06,1,1p22.1,92655971,92756800,100829,-,-
BAC127_I23,1,1p22.1,92736891,92817840,80949,-,-
BAC60_O02,1,1p22.1,92792082,92914889,122807,-,-
BAC230_D14,1,1p22.1,92802598,92929696,127098,-,-
BAC188_M01,1,1p22.1,92802598,92904062,101464,-,-
BAC124_B20,1,1p22.1,92818521,92940044,121523,-,-
BAC61_B06,1,1p22.1,92819358,92984219,164861,-,-
BAC150_A08,1,1p22.1,92858652,92940044,81392,-,-
BAC180_M21,1,1p22.1,92892983,92981976,88993,-,-
BAC116_H08,1,1p22.1,92939868,93081720,141852,-,-
BAC232_M15,1,1p22.1,92952709,93056511,103802,-,-
BAC145_K02,1,1p22.1,93086580,93179005,92425,-,-
BAC22_A24,1,1p22.1,93137692,93219213,81521,-,-
BAC217_P14,1,1p22.1,93137697,93281242,143545,-,-
BAC102_I03,1,1p22.1,93137722,93239112,101390,-,-
BAC213_D16,1,1p22.1,93179276,93276586,97310,-,-
BAC230_O19,1,1p22.1,93193893,93303167,109274,-,-
BAC243_J01,1,1p22.1,93243175,93330854,87679,-,-
BAC69_N09,1,1p22.1,93281436,93411595,130159,-,-
BAC13_I06,1,1p22.1,93289261,93380411,91150,-,-
BAC124_G03,1,1p22.1,93289263,93402649,113386,-,-
BAC153_B07,1,1p22.1,93304295,93380423,76128,-,-
BAC219_G22,1,1p22.1,93325157,93402716,77559,-,-
BAC38_L15,1,1p22.1,93404900,93527001,122101,-,-
BAC29_J07,1,1p22.1,93433035,93562108,129073,-,-
BAC171_P16,1,1p22.1,93608236,93713352,105116,-,-
BAC244_D03,1,1p22.1,93646825,93734160,87335,-,-
BAC67_I09,1,1p22.1,93652719,93740613,87894,-,-
BAC86_P05,1,1p22.1,93653242,93848623,195381,-,-
BAC224_I19,1,1p22.1,93667241,93738593,71352,-,-
BAC24_M06,1,1p22.1,93754570,93864124,109554,-,-
BAC153_K06,1,1p22.1,93901006,94004966,103960,-,-
BAC29_E13,1,1p22.1,93924658,94037187,112529,-,-
BAC46_B18,1,1p22.1,93924658,94025357,100699,-,-
BAC135_I13,1,1p22.1,93976595,94075179,98584,-,-
BAC63_N24,1,1p22.1,94024701,94139158,114457,-,-
BAC51_I24,1,1p22.1,94053088,94155018,101930,-,-
BAC67_N05,1,1p22.1,94053088,94163568,110480,-,-
BAC75_F20,1,1p22.1,94122168,94142980,20812,-,-
BAC198_F10,1,1p22.1,94135675,94218487,82812,-,-
BAC31_K20,1,1p22.1,94135675,94231809,96134,-,-
BAC194_N07,1,1p22.1,94163577,94237811,74234,-,-
BAC85_J09,1,1p22.1,94245045,94360332,115287,-,-
BAC244_E10,1,1p22.1,94248276,94324411,76135,-,-
BAC132_A15,1,1p22.1,94272474,94360337,87863,-,-
BAC197_J13,1,1p21.3,94593495,94681598,88103,-,-
BAC169_K06,1,1p21.3,94643765,94751645,107880,-,-
BAC57_G14,1,1p21.3,94705964,94806378,100414,-,-
BAC177_P02,1,1p21.3,94879790,94980078,100288,-,-
BAC32_I09,1,1p21.3,94890839,95014805,123966,-,-
BAC69_L17,1,1p21.3,94920924,95014856,93932,-,-
BAC239_G18,1,1p21.3,94920961,95048334,127373,-,-
BAC49_G06,1,1p21.3,94944682,95109907,165225,-,-
BAC237_K05,1,1p21.3,95045614,95147838,102224,-,-
BAC178_H15,1,1p21.3,95100515,95210086,109571,-,-
BAC71_I08,1,1p21.3,95263636,95358720,95084,-,-
BAC41_E14,1,1p21.3,95391559,95522710,131151,-,-
BAC159_J12,1,1p21.3,95425768,95509417,83649,-,-
BAC193_N08,1,1p21.3,95683333,95772890,89557,-,-
BAC60_E19,1,1p21.3,95683880,95806085,122205,-,-
BAC209_O20,1,1p21.3,95703605,95797552,93947,-,-
BAC126_C13,1,1p21.3,95848869,95953939,105070,-,-
BAC247_D01,1,1p21.3,95928419,96027939,99520,-,-
BAC90_E23,1,1p21.3,95999342,96103401,104059,-,-
BAC60_N07,1,1p21.3,96191796,96293984,102188,-,-
BAC114_K14,1,1p21.3,96258154,96391137,132983,-,-
BAC162_C20,1,1p21.3,96494500,96578427,83927,-,-
BAC64_I04,1,1p21.3,96494508,96597823,103315,-,-
BAC240_N08,1,1p21.3,96654665,96758197,103532,-,-
BAC199_F15,1,1p21.3,96676464,96908122,231658,-,-
BAC74_O04,1,1p21.3,96716559,96809922,93363,-,-
BAC105_M09,1,1p21.3,96917620,97016843,99223,-,-
BAC102_O05,1,1p21.3,96919551,97034901,115350,-,-
BAC65_D17,1,1p21.3,96954876,97045525,90649,-,-
BAC244_L14,1,1p21.3,97032091,97139399,107308,-,-
BAC12_O19,1,1p21.3,97061121,97142314,81193,-,-
BAC128_G02,1,1p21.3,97093722,97207309,113587,-,-
BAC220_N21,1,1p21.3,97117722,97208787,91065,-,-
BAC54_A13,1,1p21.3,97257405,97354490,97085,-,-
BAC119_F07,1,1p21.3,97469343,97613173,143830,-,-
BAC229_B17,1,1p21.3,97655306,97736555,81249,-,-
BAC10_A08,1,1p21.3,97660892,97779769,118877,-,-
BAC65_M16,1,1p21.3,97688012,97766811,78799,-,-
BAC113_J05,1,1p21.3,97791451,97876595,85144,-,-
BAC62_M01,1,1p21.3,97864022,97965553,101531,-,-
BAC142_A19,1,1p21.3,97889574,97996962,107388,-,-
BAC71_L08,1,1p21.3,97893509,97996961,103452,-,-
BAC234_P01,1,1p21.3,97932724,98030405,97681,-,-
BAC163_C09,1,1p21.3,98212449,98304737,92288,-,-
BAC117_E09,1,1p21.3,98545080,98627011,81931,-,-
BAC149_H20,1,1p21.3,98737139,98826382,89243,-,-
BAC179_H05,1,1p21.3,98741961,98822780,80819,-,-
BAC139_N15,1,1p21.3,98838226,98932025,93799,-,-
BAC163_N15,1,1p21.3,98847393,98940236,92843,-,-
BAC60_E09,1,1p21.3,99031712,99167200,135488,-,-
BAC232_F17,1,1p21.3,99053726,99178795,125069,-,-
BAC85_N03,1,1p21.3,99134696,99222737,88041,-,-
BAC100_N09,1,1p21.3,99186747,99320479,133732,-,-
BAC239_O02,1,1p21.2,99434740,99499489,64749,-,-
BAC125_O20,1,1p21.2,99516288,99630792,114504,-,-
BAC56_K16,1,1p21.2,99527362,99674720,147358,-,-
BAC110_D13,1,1p21.2,99677614,99811028,133414,-,-
BAC63_E24,1,1p21.2,99789216,99925705,136489,-,-
BAC58_G02,1,1p21.2,99870404,100037282,166878,-,-
BAC161_N22,1,1p21.2,99956229,100040519,84290,-,-
BAC91_P13,1,1p21.2,100137358,100255721,118363,-,-
BAC58_O12,1,1p21.2,100156919,100255745,98826,-,-
BAC235_A04,1,1p21.2,100171649,100255148,83499,-,-
BAC186_P17,1,1p21.2,100189065,100286315,97250,-,-
BAC109_P02,1,1p21.2,100202555,100319350,116795,-,-
BAC20_G18,1,1p21.2,100203543,100319318,115775,-,-
BAC163_J09,1,1p21.2,100367923,100456339,88416,-,-
BAC60_C13,1,1p21.2,100398785,100495335,96550,-,-
BAC60_O01,1,1p21.2,100723827,100853365,129538,-,-
BAC86_N20,1,1p21.2,100767331,100850911,83580,-,-
BAC131_B24,1,1p21.2,100861674,100945060,83386,-,-
BAC233_I15,1,1p21.2,100895067,101028637,133570,-,-
BAC171_K02,1,1p21.2,101021577,101109037,87460,-,-
BAC209_I11,1,1p21.2,101218579,101282506,63927,-,-
BAC114_F11,1,1p21.2,101250434,101350833,100399,-,-
BAC232_O05,1,1p21.2,101258094,101350610,92516,-,-
BAC60_N09,1,1p21.2,101325034,101426298,101264,-,-
BAC196_J03,1,1p21.2,101401081,101484314,83233,-,-
BAC83_C17,1,1p21.2,101401081,101491257,90176,-,-
BAC186_F19,1,1p21.2,101691201,101794611,103410,-,-
BAC172_E05,1,1p21.2,101834348,101898344,63996,-,-
BAC137_K05,1,1p21.2,101851203,101953395,102192,-,-
BAC97_P07,1,1p21.1,102352719,102479273,126554,-,-
BAC78_P20,1,1p21.1,102661273,102740742,79469,-,-
BAC199_D19,1,1p21.1,102683997,102795115,111118,-,-
BAC226_L09,1,1p21.1,102747309,102834259,86950,-,-
BAC85_D09,1,1p21.1,102795134,102886147,91013,-,-
BAC107_L16,1,1p21.1,102795158,102879569,84411,-,-
BAC171_O11,1,1p21.1,103066090,103159298,93208,-,-
BAC250_M16,1,1p21.1,103145851,103223164,77313,-,-
BAC62_M23,1,1p21.1,103231085,103326299,95214,-,-
BAC58_N23,1,1p21.1,103299979,103428351,128372,-,-
BAC200_J05,1,1p21.1,103783395,103895035,111640,yes,-
BAC115_O07,1,1p21.1,103823033,103993024,169991,yes,-
BAC45_N10,1,1p21.1,103949081,103991778,42697,yes,-
BAC22_M23,1,1p21.1,103961840,103992000,30160,-,-
BAC243_P20,1,1p21.1,104137831,104226708,88877,yes,-
BAC23_P04,1,1p21.1,104184767,104321248,136481,yes,-
BAC187_I02,1,1p21.1,104424978,104508288,83310,-,-
BAC39_F24,1,1p21.1,104469065,104589643,120578,-,-
BAC106_E12,1,1p21.1,104480202,104580448,100246,-,-
BAC85_I21,1,1p21.1,104488294,104619801,131507,-,-
BAC19_D19,1,1p21.1,104590073,104681179,91106,-,-
BAC177_B12,1,1p21.1,104885789,104960577,74788,-,-
BAC67_P02,1,1p21.1,104898761,105014828,116067,-,-
BAC122_N06,1,1p21.1,104938151,105031620,93469,-,-
BAC38_B11,1,1p21.1,105041051,105126049,84998,-,-
BAC150_H19,1,1p21.1,105255123,105349074,93951,-,-
BAC238_E02,1,1p21.1,105255123,105333312,78189,-,-
BAC171_J17,1,1p21.1,105411684,105491245,79561,-,-
BAC66_K23,1,1p21.1,105423276,105527045,103769,-,-
BAC57_J10,1,1p21.1,105586940,105686427,99487,-,-
BAC70_D17,1,1p21.1,105901259,106002043,100784,-,-
BAC223_F20,1,1p21.1,105917020,105999788,82768,-,-
BAC150_E14,1,1p21.1,105921207,105999788,78581,-,-
BAC19_D09,1,1p21.1,105940552,106048901,108349,-,-
BAC120_D03,1,1p21.1,106054699,106133174,78475,-,-
BAC149_G05,1,1p21.1,106106997,106251562,144565,-,-
BAC249_C15,1,1p21.1,106168684,106269308,100624,-,-
BAC40_E02,1,1p21.1,106354823,106458326,103503,-,-
BAC46_F24,1,1p21.1,106451448,106543850,92402,-,-
BAC163_E16,1,1p21.1,106593862,106674902,81040,-,-
BAC73_C19,1,1p21.1,106727878,106847363,119485,-,-
BAC21_O02,1,1p21.1,106787342,106884629,97287,-,-
BAC100_D16,1,1p21.1,106889242,106980869,91627,-,-
BAC122_G12,1,1p13.3,107036365,107143598,107233,-,-
BAC228_F02,1,1p13.3,107104585,107195776,91191,-,-
BAC69_C12,1,1p13.3,107153433,107265784,112351,-,-
BAC100_H08,1,1p13.3,107279955,107359426,79471,-,-
BAC188_A10,1,1p13.3,107317377,107453106,135729,-,-
BAC166_K24,1,1p13.3,107354945,107447326,92381,-,-
BAC218_I09,1,1p13.3,107359846,107466458,106612,-,-
BAC55_P09,1,1p13.3,107629797,107734166,104369,-,-
BAC26_E23,1,1p13.3,107696118,107781561,85443,-,-
BAC120_M16,1,1p13.3,107731563,107882754,151191,-,-
BAC236_C07,1,1p13.3,107835256,107928716,93460,-,-
BAC75_L23,1,1p13.3,107918789,108006614,87825,-,-
BAC163_F08,1,1p13.3,108102915,108201456,98541,-,-
BAC194_H15,1,1p13.3,108163218,108254038,90820,-,-
BAC26_F23,1,1p13.3,108192525,108287885,95360,-,-
BAC39_I02,1,1p13.3,108244344,108403432,159088,-,-
BAC228_I23,1,1p13.3,108247408,108381244,133836,-,-
BAC197_O04,1,1p13.3,108284700,108388530,103830,-,-
BAC217_M24,1,1p13.3,108293475,108403432,109957,-,-
BAC236_L22,1,1p13.3,108319665,108410374,90709,-,-
BAC142_K10,1,1p13.3,108384628,108469391,84763,-,-
BAC107_H02,1,1p13.3,108536542,108630445,93903,yes,-
BAC224_C19,1,1p13.3,108536543,108632568,96025,yes,-
BAC118_G12,1,1p13.3,108536545,108698618,162073,yes,-
BAC149_C17,1,1p13.3,108542779,108630438,87659,yes,-
BAC155_B21,1,1p13.3,108877221,108987790,110569,-,-
BAC18_G06,1,1p13.3,109010887,109120065,109178,-,-
BAC103_M13,1,1p13.3,109097590,109209183,111593,-,-
BAC72_G08,1,1p13.3,109135319,109237160,101841,-,-
BAC88_G23,1,1p13.3,109137961,109230626,92665,-,-
BAC156_L06,1,1p13.3,109195137,109315933,120796,-,-
BAC221_B20,1,1p13.3,109249103,109315933,66830,-,-
BAC191_J23,1,1p13.3,109249135,109350919,101784,-,-
BAC210_B08,1,1p13.3,109254136,109276103,21967,-,-
BAC85_F11,1,1p13.3,109276126,109358035,81909,-,-
BAC131_D18,1,1p13.3,109351817,109362501,10684,-,-
BAC250_C05,1,1p13.3,109368958,109503030,134072,-,-
BAC33_O11,1,1p13.3,109369160,109491217,122057,-,-
BAC140_G12,1,1p13.3,109402115,109564147,162032,-,-
BAC79_M22,1,1p13.3,109407170,109475257,68087,-,-
BAC240_K07,1,1p13.3,109407170,109510826,103656,-,-
BAC37_A08,1,1p13.3,109426620,109538681,112061,-,-
BAC123_F17,1,1p13.3,109432160,109648875,216715,-,-
BAC67_F02,1,1p13.3,109460366,109574415,114049,-,-
BAC157_N03,1,1p13.3,109478654,109564136,85482,-,-
BAC146_G03,1,1p13.3,109509908,109623763,113855,-,-
BAC131_J12,1,1p13.3,109545572,109615808,70236,-,-
BAC163_M21,1,1p13.3,109662619,109747967,85348,-,-
BAC43_G03,1,1p13.3,109678729,109801782,123053,-,-
BAC45_O10,1,1p13.3,109691785,109765149,73364,-,-
BAC118_A05,1,1p13.3,109699501,109801782,102281,-,-
BAC113_J15,1,1p13.3,109700902,109820170,119268,-,-
BAC124_P16,1,1p13.3,109709146,109812901,103755,-,-
BAC60_L01,1,1p13.3,109723566,109801779,78213,-,-
BAC190_N09,1,1p13.3,109748012,109847521,99509,-,-
BAC220_A24,1,1p13.3,109864565,109950860,86295,-,-
BAC31_C03,1,1p13.3,109884971,109985741,100770,yes,-
BAC51_G07,1,1p13.3,109930111,110049573,119462,yes,-
BAC177_P12,1,1p13.3,109931323,110094170,162847,yes,-
BAC105_E13,1,1p13.3,110005034,110109723,104689,yes,-
BAC149_B02,1,1p13.3,110052517,110153753,101236,yes,-
BAC131_F18,1,1p13.3,110052517,110130003,77486,yes,-
BAC115_O08,1,1p13.3,110052523,110152739,100216,yes,-
BAC179_G19,1,1p13.3,110089292,110195979,106687,-,-
BAC136_M22,1,1p13.3,110094226,110202370,108144,-,-
BAC228_P10,1,1p13.3,110094229,110178314,84085,-,-
BAC127_H20,1,1p13.3,110260230,110354387,94157,-,-
BAC60_B24,1,1p13.3,110310374,110389620,79246,-,-
BAC234_L04,1,1p13.3,110364369,110445382,81013,-,-
BAC86_D22,1,1p13.3,110411386,110487358,75972,-,-
BAC211_C17,1,1p13.3,110452955,110573006,120051,-,-
BAC218_G03,1,1p13.3,110490903,110607934,117031,-,-
BAC54_H18,1,1p13.3,110518302,110629524,111222,-,-
BAC249_B21,1,1p13.3,110629894,110737731,107837,-,-
BAC232_D15,1,1p13.3,110707836,110834741,126905,-,-
BAC91_J05,1,1p13.3,110774521,110886421,111900,-,-
BAC249_B08,1,1p13.3,110777693,110868195,90502,-,-
BAC25_C12,1,1p13.3,110784612,110880203,95591,-,-
BAC1_G14,1,1p13.3,110795892,110900182,104290,-,-
BAC89_H12,1,1p13.3,110844303,110918160,73857,-,-
BAC129_E15,1,1p13.3,110859149,110945922,86773,-,-
BAC199_M02,1,1p13.3,110900177,111035445,135268,-,-
BAC95_G13,1,1p13.3,110918153,111028206,110053,-,-
BAC223_F15,1,1p13.3,110946010,111028252,82242,-,-
BAC11_H14,1,1p13.3,110946119,111030948,84829,-,-
BAC88_A19,1,1p13.3,110997930,111103269,105339,-,-
BAC89_D04,1,1p13.3,111016437,111132707,116270,-,-
BAC141_C09,1,1p13.3,111079457,111164319,84862,-,-
BAC132_I13,1,1p13.3,111193820,111299055,105235,-,-
BAC231_A17,1,1p13.3,111205806,111320651,114845,-,-
BAC94_M10,1,1p13.3,111205919,111294969,89050,-,-
BAC53_K13,1,1p13.3,111284152,111372104,87952,-,-
BAC45_H16,1,1p13.3,111287591,111299055,11464,-,-
BAC157_L03,1,1p13.3,111337860,111416706,78846,-,-
BAC112_H06,1,1p13.3-1p13.2,111532940,111637222,104282,-,-
BAC213_I15,1,1p13.3-1p13.2,111579985,111677451,97466,-,-
BAC217_F19,1,1p13.3-1p13.2,111580813,111725200,144387,-,-
BAC162_F17,1,1p13.2,111655251,111759875,104624,-,-
BAC157_J21,1,1p13.2,111664303,111765582,101279,-,-
BAC88_F24,1,1p13.2,111730067,111842739,112672,-,-
BAC184_D20,1,1p13.2,111748164,111843508,95344,-,-
BAC83_B19,1,1p13.2,111797565,111893364,95799,-,-
BAC72_O14,1,1p13.2,111837884,111931676,93792,-,-
BAC128_P01,1,1p13.2,111956294,112063729,107435,-,-
BAC118_G19,1,1p13.2,111956296,112046305,90009,-,-
BAC151_G05,1,1p13.2,111960378,112046317,85939,-,-
BAC90_H05,1,1p13.2,111960378,112038459,78081,-,-
BAC158_K03,1,1p13.2,111968724,112058232,89508,-,-
BAC115_E21,1,1p13.2,112058306,112146648,88342,-,-
BAC120_C01,1,1p13.2,112147001,112239893,92892,-,-
BAC4_N11,1,1p13.2,112152073,112229597,77524,-,-
BAC218_C08,1,1p13.2,112267629,112353343,85714,-,-
BAC69_J06,1,1p13.2,112268664,112371867,103203,-,-
BAC115_E18,1,1p13.2,112442090,112557129,115039,-,-
BAC105_H12,1,1p13.2,112476455,112576483,100028,-,-
BAC55_G14,1,1p13.2,112538764,112621511,82747,-,-
BAC163_G14,1,1p13.2,112557223,112675753,118530,-,-
BAC64_F22,1,1p13.2,112569207,112686945,117738,-,-
BAC1_E13,1,1p13.2,112701574,112811863,110289,-,-
BAC234_N06,1,1p13.2,112713823,112807009,93186,-,-
BAC217_G18,1,1p13.2,112725609,112807009,81400,-,-
BAC226_D03,1,1p13.2,112752741,112833927,81186,-,-
BAC126_B16,1,1p13.2,112822445,112935838,113393,-,-
BAC227_N14,1,1p13.2,112834153,112923980,89827,-,-
BAC76_N16,1,1p13.2,112891179,112975148,83969,-,-
BAC166_G04,1,1p13.2,112891356,112993804,102448,-,-
BAC40_M08,1,1p13.2,112955359,113076345,120986,-,-
BAC36_L14,1,1p13.2,112973818,113063675,89857,-,-
BAC123_O13,1,1p13.2,113038136,113124133,85997,-,-
BAC51_I16,1,1p13.2,113043003,113226546,183543,-,-
BAC217_E03,1,1p13.2,113073802,113156087,82285,-,-
BAC236_K17,1,1p13.2,113126924,113232932,106008,-,-
BAC176_C22,1,1p13.2,113371207,113465542,94335,-,-
BAC223_D03,1,1p13.2,113371798,113455783,83985,-,-
BAC186_N01,1,1p13.2,113374825,113462517,87692,-,-
BAC115_D22,1,1p13.2,113384465,113470773,86308,-,-
BAC78_K04,1,1p13.2,113384467,113479761,95294,-,-
BAC194_D03,1,1p13.2,113438172,113564340,126168,-,-
BAC188_J18,1,1p13.2,113442138,113538359,96221,-,-
BAC160_H12,1,1p13.2,113500323,113597399,97076,-,-
BAC162_G13,1,1p13.2,113504995,113620196,115201,-,-
BAC176_O14,1,1p13.2,113564334,113666058,101724,-,-
BAC208_O18,1,1p13.2,113574040,113664653,90613,-,-
BAC234_B23,1,1p13.2,113615842,113697203,81361,-,-
BAC162_F19,1,1p13.2,113620530,113726442,105912,-,-
BAC41_P04,1,1p13.2,113631466,113710705,79239,-,-
BAC110_O05,1,1p13.2,113746873,113852918,106045,-,-
BAC170_D10,1,1p13.2,113823054,113912793,89739,-,-
BAC102_A14,1,1p13.2,113825891,113925373,99482,-,-
BAC74_B10,1,1p13.2,113852690,113944006,91316,-,-
BAC15_O11,1,1p13.2,113925366,114029188,103822,-,-
BAC33_P19,1,1p13.2,114037406,114149610,112204,-,-
BAC49_J03,1,1p13.2,114051311,114149614,98303,-,-
BAC86_F24,1,1p13.2,114115285,114223584,108299,-,-
BAC44_C10,1,1p13.2,114137280,114254411,117131,-,-
BAC116_C12,1,1p13.2,114167608,114291093,123485,-,-
BAC200_B07,1,1p13.2,114178074,114261612,83538,-,-
BAC233_G12,1,1p13.2,114231065,114330835,99770,-,-
BAC134_L04,1,1p13.2,114231065,114353382,122317,-,-
BAC79_K19,1,1p13.2,114260038,114347965,87927,-,-
BAC21_L16,1,1p13.2,114261607,114367430,105823,-,-
BAC180_M02,1,1p13.2,114261637,114382010,120373,-,-
BAC242_J08,1,1p13.2,114275383,114385460,110077,-,-
BAC160_D16,1,1p13.2,114275395,114380933,105538,-,-
BAC116_B07,1,1p13.2,114321642,114404235,82593,-,-
BAC175_G16,1,1p13.2,114330955,114405811,74856,-,-
BAC198_H15,1,1p13.2,114367465,114457494,90029,-,-
BAC6_F03,1,1p13.2,114382001,114485278,103277,-,-
BAC118_A17,1,1p13.2,114393340,114509443,116103,-,-
BAC102_H19,1,1p13.2,114417125,114519198,102073,-,-
BAC1_C21,1,1p13.2,114455389,114550484,95095,-,-
BAC142_A20,1,1p13.2,114458727,114550484,91757,-,-
BAC74_B04,1,1p13.2,114485312,114571205,85893,-,-
BAC46_I09,1,1p13.2,114493669,114589708,96039,-,-
BAC234_F09,1,1p13.2,114519237,114594314,75077,-,-
BAC59_B21,1,1p13.2,114534146,114643089,108943,-,-
BAC91_G15,1,1p13.2,114550476,114663917,113441,-,-
BAC147_M22,1,1p13.2,114581892,114663917,82025,-,-
BAC133_B16,1,1p13.2,114584509,114650023,65514,-,-
BAC38_D12,1,1p13.2,114716307,114814276,97969,-,-
BAC230_A04,1,1p13.2,114730899,114814212,83313,-,-
BAC88_H13,1,1p13.2,114772870,114911790,138920,-,-
BAC65_M08,1,1p13.2,114815125,114908446,93321,-,-
BAC29_M17,1,1p13.2,114832591,114908487,75896,-,-
BAC113_H08,1,1p13.2,114880426,114954013,73587,-,-
BAC48_O13,1,1p13.2,114882746,114971381,88635,-,-
BAC27_N22,1,1p13.2,114945427,115075534,130107,-,-
BAC31_H20,1,1p13.2,115011844,115095836,83992,-,-
BAC37_N20,1,1p13.2,115130355,115218459,88104,-,-
BAC102_H11,1,1p13.2,115436156,115521367,85211,-,-
BAC92_E18,1,1p13.2,115595503,115707946,112443,-,-
BAC147_J13,1,1p13.2,115622249,115702902,80653,-,-
BAC151_B17,1,1p13.2-1p13.1,115818696,115930058,111362,-,-
BAC160_K19,1,1p13.2-1p13.1,115848623,115937406,88783,-,-
BAC105_N09,1,1p13.2-1p13.1,115889939,115974196,84257,-,-
BAC228_D17,1,1p13.1,115935795,116041229,105434,-,-
BAC56_P04,1,1p13.1,115948689,116048055,99366,-,-
BAC133_C20,1,1p13.1,116036526,116138365,101839,-,-
BAC64_J03,1,1p13.1,116048108,116169572,121464,-,-
BAC199_B15,1,1p13.1,116050072,116138365,88293,-,-
BAC2_N06,1,1p13.1,116056542,116132520,75978,-,-
BAC249_N14,1,1p13.1,116073563,116154477,80914,-,-
BAC167_G05,1,1p13.1,116088984,116209322,120338,-,-
BAC63_P22,1,1p13.1,116132117,116245431,113314,-,-
BAC62_H20,1,1p13.1,116134727,116263074,128347,-,-
BAC33_O20,1,1p13.1,116142583,116280877,138294,-,-
BAC178_G17,1,1p13.1,116217696,116323512,105816,-,-
BAC115_L13,1,1p13.1,116233216,116330693,97477,-,-
BAC68_G15,1,1p13.1,116314656,116417073,102417,-,-
BAC115_E11,1,1p13.1,116323655,116412067,88412,-,-
BAC96_E13,1,1p13.1,116385802,116536176,150374,-,-
BAC114_O22,1,1p13.1,116417110,116518671,101561,-,-
BAC76_F12,1,1p13.1,116427998,116525726,97728,-,-
BAC166_H06,1,1p13.1,116434151,116518671,84520,-,-
BAC149_C03,1,1p13.1,116435480,116519889,84409,-,-
BAC19_P06,1,1p13.1,116461337,116575700,114363,-,-
BAC32_I06,1,1p13.1,116549827,116720806,170979,-,-
BAC42_H07,1,1p13.1,116573105,116714659,141554,-,-
BAC64_J20,1,1p13.1,116602181,116704154,101973,-,-
BAC171_E21,1,1p13.1,116614556,116728838,114282,-,-
BAC248_B16,1,1p13.1,116625361,116714659,89298,-,-
BAC77_A12,1,1p13.1,116714668,116840754,126086,-,-
BAC202_J08,1,1p13.1,116714700,116790503,75803,-,-
BAC97_M23,1,1p13.1,116724174,116905926,181752,-,-
BAC244_B02,1,1p13.1,116745939,116880437,134498,-,-
BAC22_C21,1,1p13.1,116799669,116981260,181591,-,-
BAC29_D19,1,1p13.1,116799676,116905138,105462,-,-
BAC200_J02,1,1p13.1,116803161,116897963,94802,-,-
BAC242_A14,1,1p13.1,116840748,117003583,162835,-,-
BAC165_J16,1,1p13.1,116861229,116940325,79096,-,-
BAC73_D23,1,1p13.1,116905144,116991810,86666,-,-
BAC183_N19,1,1p13.1,116910923,117022381,111458,-,-
BAC179_P03,1,1p13.1,116983767,117112458,128691,-,-
BAC102_F17,1,1p13.1,117020645,117111006,90361,yes,-
BAC39_I04,1,1p13.1,117041346,117133338,91992,yes,-
BAC60_F24,1,1p13.1,117041626,117150515,108889,yes,-
BAC102_J12,1,1p13.1,117074411,117211373,136962,-,-
BAC246_K15,1,1p13.1,117101156,117199703,98547,-,-
BAC163_H19,1,1p13.1,117111152,117199703,88551,-,-
BAC144_K03,1,1p13.1,117118660,117211343,92683,-,-
BAC117_D19,1,1p13.1,117122084,117222255,100171,-,-
BAC192_A08,1,1p13.1,117158373,117232008,73635,-,-
BAC81_E23,1,1p13.1,117173286,117291885,118599,-,-
BAC235_L06,1,1p13.1,117217125,117320230,103105,-,-
BAC34_H16,1,1p13.1,117275102,117417744,142642,-,-
BAC157_D20,1,1p13.1,117408996,117518525,109529,-,-
BAC158_K15,1,1p13.1,117429927,117518544,88617,-,-
BAC240_A14,1,1p13.1,117442997,117546157,103160,-,-
BAC115_F16,1,1p13.1,117460559,117545953,85394,-,-
BAC6_F07,1,1p13.1,117467792,117556440,88648,-,-
BAC158_F14,1,1p13.1,117479284,117574283,94999,-,-
BAC8_I03,1,1p13.1-1p12,117563651,117661347,97696,-,-
BAC37_P21,1,1p13.1-1p12,117577063,117706087,129024,-,-
BAC126_J02,1,1p13.1-1p12,117582166,117671112,88946,-,-
BAC237_J03,1,1p13.1-1p12,117587139,117671843,84704,-,-
BAC218_A22,1,1p12,117806779,117889328,82549,-,-
BAC165_F05,1,1p12,117816878,117934557,117679,-,-
BAC183_I12,1,1p12,117884854,117985413,100559,-,-
BAC198_I03,1,1p12,117888086,117985413,97327,-,-
BAC220_N18,1,1p12,117893756,117985413,91657,-,-
BAC152_F22,1,1p12,117910281,118017185,106904,-,-
BAC41_B16,1,1p12,117944613,118046582,101969,-,-
BAC222_I22,1,1p12,117952240,118042889,90649,-,-
BAC200_O09,1,1p12,118017215,118105521,88306,-,-
BAC169_A20,1,1p12,118042913,118121895,78982,-,-
BAC197_I19,1,1p12,118138779,118218465,79686,-,-
BAC36_E13,1,1p12,118303833,118449059,145226,-,-
BAC252_M21,1,1p12,118491301,118584699,93398,-,-
BAC249_H11,1,1p12,118694261,118779434,85173,-,-
BAC249_M16,1,1p12,118707663,118789760,82097,-,-
BAC189_I24,1,1p12,118881243,118970091,88848,-,-
BAC244_H02,1,1p12,118881243,118981741,100498,-,-
BAC229_G07,1,1p12,118932456,119013875,81419,-,-
BAC150_K18,1,1p12,119069720,119186301,116581,-,-
BAC116_M20,1,1p12,119142434,119264820,122386,-,-
BAC100_M12,1,1p12,119390201,119470177,79976,-,-
BAC46_K10,1,1p12,119430649,119507476,76827,-,-
BAC144_J19,1,1p12,119470171,119555617,85446,-,-
BAC72_J02,1,1p12,119529929,119646944,117015,-,-
BAC153_G12,1,1p12,119586547,119690386,103839,-,-
BAC19_N24,1,1p12,119681943,119720891,38948,-,-
BAC187_F23,1,1p12,119722204,119790425,68221,-,-
BAC69_D14,1,1p12,119724901,119850594,125693,-,-
BAC31_G04,1,1p12,119745842,119832346,86504,-,-
BAC172_P07,1,1p12,119771379,119882364,110985,-,-
BAC175_M21,1,1p12,119840785,119941124,100339,-,-
BAC56_M06,1,1p12,119854070,119981087,127017,-,-
BAC119_O15,1,1p12,119854070,119974407,120337,-,-
BAC232_A09,1,1p12,119854082,119948066,93984,-,-
BAC113_N18,1,1p12,119858147,119952748,94601,-,-
BAC135_H22,1,1p12,119913756,120018662,104906,-,-
BAC29_M19,1,1p12,119974438,120059738,85300,-,-
BAC130_L12,1,1p12,120153313,120249738,96425,yes,-
BAC222_D08,1,1p12,120174239,120264960,90721,yes,-
BAC108_N01,1,1p12,120214296,120390096,175800,-,-
BAC144_L20,1,1p12,120220770,120297106,76336,-,-
BAC67_L15,1,1p12,120569044,120675969,106925,-,-
BAC125_N15,1,1p11.2,120806558,120921777,115219,-,-
BAC198_H20,1,1q12,141487629,141576075,88446,-,-
BAC54_A07,1,1q12,141505063,141644681,139618,-,-
BAC221_K16,1,1q12,141511368,141585615,74247,-,-
BAC147_F13,1,1q12,141539057,141616405,77348,-,-
BAC176_M21,1,1q12,141663128,141839399,176271,-,-
BAC233_D17,1,1q12,141670416,141866223,195807,-,-
BAC90_B16,1,1q12,141773191,141834701,61510,-,-
BAC107_G04,1,1q12,141777852,141891999,114147,-,-
BAC247_C17,1,1q12,141780587,142316149,535562,-,-
BAC90_M09,1,1q12,142201600,142311326,109726,-,-
BAC167_D23,1,1q12,142280742,142364526,83784,-,-
BAC36_M06,1,1q12,142306604,142368738,62134,-,-
BAC115_B10,1,1q21.1,142470401,142555262,84861,-,-
BAC119_L16,1,1q21.1,142475540,142555262,79722,-,-
BAC91_H22,1,1q21.1,142548439,143259337,710898,-,-
BAC248_A07,1,1q21.1,142560307,143251446,691139,-,-
BAC40_G08,1,1q21.1,142560312,143297274,736962,-,-
BAC39_C20,1,1q21.1,142666402,142777343,110941,-,-
BAC100_C08,1,1q21.1,143217448,144018913,801465,-,-
BAC195_H23,1,1q21.1,143251440,143568082,316642,-,-
BAC226_I10,1,1q21.1,143253121,143530243,277122,-,-
BAC105_I14,1,1q21.1,143265281,143573189,307908,-,-
BAC42_H16,1,1q21.1,143297283,143564683,267400,-,-
BAC222_H23,1,1q21.1,143297343,143567287,269944,-,-
BAC160_H24,1,1q21.1,143386631,143774117,387486,-,-
BAC238_J09,1,1q21.1,143386782,143732651,345869,-,-
BAC237_B08,1,1q21.1,143390939,143785660,394721,-,-
BAC88_F01,1,1q21.1,143402834,143774157,371323,-,-
BAC106_G15,1,1q21.1,143413186,143901497,488311,-,-
BAC115_P07,1,1q21.1,143550547,143629697,79150,-,-
BAC14_H15,1,1q21.1,143567722,143676521,108799,-,-
BAC132_O01,1,1q21.1,143585205,143675331,90126,-,-
BAC39_C22,1,1q21.1,143618148,143784011,165863,-,-
BAC33_L16,1,1q21.1,143632285,143762934,130649,-,-
BAC183_I20,1,1q21.1,143675325,143774157,98832,-,-
BAC191_M08,1,1q21.1,143676521,143784006,107485,-,-
BAC228_A07,1,1q21.1,143734695,143818547,83852,-,-
BAC91_H17,1,1q21.1,143749970,143845146,95176,-,-
BAC203_P09,1,1q21.1,143752033,143834085,82052,-,-
BAC165_A06,1,1q21.1,143808766,143893236,84470,-,-
BAC151_C14,1,1q21.1,143818739,143900705,81966,-,-
BAC148_C09,1,1q21.1,144018217,144103432,85215,-,-
BAC236_A20,1,1q21.1,144020182,144085887,65705,-,-
BAC181_O05,1,1q21.1,144020185,144087193,67008,-,-
BAC148_C24,1,1q21.1,144020201,144095234,75033,-,-
BAC123_I23,1,1q21.1,144087188,144182589,95401,yes,-
BAC184_L09,1,1q21.1,144088531,144112532,24001,-,-
BAC41_H12,1,1q21.1,144123265,144262598,139333,yes,-
BAC139_I09,1,1q21.1,144152446,144239452,87006,yes,-
BAC217_E01,1,1q21.1,144152446,144231866,79420,yes,-
BAC117_D10,1,1q21.1,144153109,144249916,96807,yes,-
BAC112_L01,1,1q21.1,144162828,144267155,104327,yes,-
BAC142_O16,1,1q21.1,144181885,144267161,85276,yes,-
BAC217_O15,1,1q21.1,144181933,144281119,99186,yes,-
BAC96_P20,1,1q21.1,144182584,144281119,98535,-,-
BAC172_J17,1,1q21.1,144230006,144317549,87543,-,-
BAC50_E22,1,1q21.1,144308243,144411203,102960,-,-
BAC235_E21,1,1q21.1,144362991,144436620,73629,-,-
BAC167_M17,1,1q21.1,144365444,144468301,102857,-,-
BAC189_I03,1,1q21.1,144411338,144509195,97857,-,-
BAC39_A06,1,1q21.1,144639479,144731725,92246,-,-
BAC184_M24,1,1q21.1,144664175,144731729,67554,-,-
BAC6_H01,1,1q21.1,144669137,146068558,1399421,-,-
BAC60_A05,1,1q21.1,144797336,146212559,1415223,-,-
BAC184_A11,1,1q21.1,144967331,145045913,78582,-,-
BAC22_N06,1,1q21.1,145149961,145252484,102523,-,-
BAC198_L17,1,1q21.1,145367993,145448771,80778,-,-
BAC30_B09,1,1q21.1,145367993,145448765,80772,-,-
BAC34_P03,1,1q21.1,145406431,145498341,91910,-,-
BAC69_B19,1,1q21.1,145534465,145649603,115138,-,-
BAC42_A03,1,1q21.1,145550490,145688358,137868,-,-
BAC196_P02,1,1q21.1,145572965,145649603,76638,-,-
BAC134_F13,1,1q21.1,145574842,145688363,113521,-,-
BAC21_M11,1,1q21.1,145587236,145677242,90006,-,-
BAC31_D07,1,1q21.1,145705400,145841291,135891,-,-
BAC78_H12,1,1q21.1,145731891,145831694,99803,-,-
BAC17_L20,1,1q21.1,145751282,145878152,126870,-,-
BAC106_O02,1,1q21.1,146173372,146917192,743820,-,-
BAC130_P08,1,1q21.1,146229768,146322357,92589,-,-
BAC60_L05,1,1q21.1,146575616,146793016,217400,yes,-
BAC135_D03,1,1q21.1,146930247,147165017,234770,yes,-
BAC171_O08,1,1q21.1,147500849,147606949,106100,-,-
BAC219_I08,1,1q21.1-1q21.2,147528950,148001169,472219,-,-
BAC153_D11,1,1q21.1,147540013,147563997,23984,-,-
BAC169_N13,1,1q21.1-1q21.2,147557735,148045268,487533,-,-
BAC177_D20,1,1q21.1-1q21.2,147583337,148047009,463672,-,-
BAC223_L13,1,1q21.1,147586366,147674271,87905,yes,-
BAC78_P10,1,1q21.1,147818766,147908670,89904,-,-
BAC224_H10,1,1q21.2,148052523,148144662,92139,yes,-
BAC161_C18,1,1q21.2,148132272,148218950,86678,yes,-
BAC239_K17,1,1q21.2,148133869,148228784,94915,yes,-
BAC159_I07,1,1q21.2,148195371,148273136,77765,-,-
BAC1_N07,1,1q21.2,148275865,148370732,94867,-,-
BAC162_I23,1,1q21.2,148281853,148379174,97321,-,-
BAC188_F06,1,1q21.2,148307115,148412095,104980,-,-
BAC110_G04,1,1q21.2,148312267,148459130,146863,-,-
BAC84_H13,1,1q21.2,148312267,148412189,99922,-,-
BAC187_F01,1,1q21.2,148325603,148412184,86581,-,-
BAC73_E18,1,1q21.2,148367095,148464195,97100,-,-
BAC110_H14,1,1q21.2,148397088,148504240,107152,-,-
BAC182_B11,1,1q21.2,148505391,148580042,74651,-,-
BAC150_L22,1,1q21.2,148601823,148702524,100701,-,-
BAC179_E10,1,1q21.2,148655011,148724659,69648,-,-
BAC41_J17,1,1q21.2,148738484,148884335,145851,-,-
BAC75_G02,1,1q21.2,148863687,148952635,88948,-,-
BAC149_D21,1,1q21.2,148863687,148958660,94973,-,-
BAC100_K05,1,1q21.2,148926733,149076367,149634,-,-
BAC193_G02,1,1q21.2,148930302,149027191,96889,-,-
BAC125_G10,1,1q21.2,148958682,149070493,111811,-,-
BAC252_N15,1,1q21.2,148987697,149070494,82797,-,-
BAC116_I15,1,1q21.2,148995290,149105465,110175,-,-
BAC252_M16,1,1q21.2,149008303,149174616,166313,-,-
BAC1_O10,1,1q21.2,149025331,149137600,112269,-,-
BAC173_C12,1,1q21.2,149049351,149129966,80615,-,-
BAC131_H08,1,1q21.2,149055773,149137600,81827,-,-
BAC82_M19,1,1q21.2,149105493,149201837,96344,-,-
BAC133_E23,1,1q21.2,149141924,149238859,96935,-,-
BAC36_F15,1,1q21.2,149306217,149420876,114659,-,-
BAC248_M01,1,1q21.2,149336416,149420847,84431,-,-
BAC250_G03,1,1q21.2,149394475,149486039,91564,-,-
BAC235_D07,1,1q21.2,149395759,149481919,86160,-,-
BAC242_J18,1,1q21.2,149420874,149549705,128831,-,-
BAC20_B04,1,1q21.2,149485505,149567555,82050,-,-
BAC185_F03,1,1q21.2-1q21.3,149521045,149634829,113784,-,-
BAC83_C22,1,1q21.3,149649029,149808812,159783,-,-
BAC74_M08,1,1q21.3,149649029,149749820,100791,-,-
BAC100_I16,1,1q21.3,149803665,149938468,134803,-,-
BAC165_L16,1,1q21.3,149820027,149909878,89851,-,-
BAC228_H13,1,1q21.3,149830467,149938472,108005,-,-
BAC83_L10,1,1q21.3,149876983,149991657,114674,-,-
BAC103_F08,1,1q21.3,149938463,150029873,91410,-,-
BAC122_P03,1,1q21.3,149938474,150046718,108244,-,-
BAC26_A19,1,1q21.3,149960272,150078610,118338,-,-
BAC63_N21,1,1q21.3,149968257,150059922,91665,-,-
BAC172_E23,1,1q21.3,150015574,150107704,92130,-,-
BAC44_B09,1,1q21.3,150015692,150160544,144852,-,-
BAC191_O03,1,1q21.3,150026948,150128421,101473,-,-
BAC126_O02,1,1q21.3,150037303,150150863,113560,-,-
BAC91_D09,1,1q21.3,150046713,150144389,97676,-,-
BAC128_F07,1,1q21.3,150049021,150128421,79400,-,-
BAC53_I11,1,1q21.3,150076814,150175982,99168,-,-
BAC75_P17,1,1q21.3,150128463,150231401,102938,-,-
BAC109_C02,1,1q21.3,150128482,150237156,108674,-,-
BAC29_I11,1,1q21.3,150134441,150292969,158528,-,-
BAC66_N13,1,1q21.3,150221424,150311668,90244,-,-
BAC139_C15,1,1q21.3,150227430,150307471,80041,-,-
BAC19_A20,1,1q21.3,150293019,150382578,89559,-,-
BAC103_F02,1,1q21.3,150312990,150412243,99253,-,-
BAC185_B13,1,1q21.3,150413501,150510795,97294,-,-
BAC148_I16,1,1q21.3,150413501,150500721,87220,-,-
BAC39_L03,1,1q21.3,150563680,150687893,124213,-,-
BAC129_C05,1,1q21.3,150609013,150737877,128864,-,-
BAC226_I21,1,1q21.3,150644352,150737885,93533,-,-
BAC148_A16,1,1q21.3,150669482,150749889,80407,-,-
BAC131_N14,1,1q21.3,150676201,150781735,105534,yes,-
BAC19_M22,1,1q21.3,150676207,150758716,82509,yes,-
BAC84_O13,1,1q21.3,150697635,150781735,84100,yes,-
BAC82_N11,1,1q21.3,150755089,150870723,115634,yes,-
BAC205_H14,1,1q21.3,150819365,150901858,82493,yes,-
BAC27_F05,1,1q21.3,150853431,150950348,96917,yes,-
BAC230_C23,1,1q21.3,150892910,150968578,75668,yes,-
BAC157_P18,1,1q21.3,151017426,151127605,110179,-,-
BAC133_H18,1,1q21.3,151037323,151128743,91420,yes,-
BAC6_N17,1,1q21.3,151043638,151181537,137899,yes,-
BAC238_O05,1,1q21.3,151079663,151165462,85799,yes,-
BAC64_F14,1,1q21.3,151104190,151224169,119979,-,-
BAC64_J21,1,1q21.3,151128738,151210535,81797,-,-
BAC208_D15,1,1q21.3,151159509,151238612,79103,-,-
BAC196_M11,1,1q21.3,151220309,151309615,89306,-,-
BAC133_F06,1,1q21.3,151295913,151397498,101585,-,-
BAC27_L13,1,1q21.3,151295913,151468040,172127,-,-
BAC153_K07,1,1q21.3,151309631,151424179,114548,-,-
BAC145_D10,1,1q21.3,151351911,151450687,98776,-,-
BAC10_J11,1,1q21.3,151367910,151484415,116505,-,-
BAC33_B21,1,1q21.3,151542385,151647394,105009,-,-
BAC159_O06,1,1q21.3,151568782,151647416,78634,-,-
BAC57_I18,1,1q21.3,151581903,151706932,125029,-,-
BAC82_G22,1,1q21.3,151592406,151708364,115958,-,-
BAC108_H17,1,1q21.3,151604372,151691084,86712,-,-
BAC82_F21,1,1q21.3,151609009,151851747,242738,-,-
BAC247_E19,1,1q21.3,151645039,151733136,88097,-,-
BAC80_P03,1,1q21.3,151694644,151803197,108553,-,-
BAC151_J06,1,1q21.3,151704246,151796461,92215,-,-
BAC226_G24,1,1q21.3,151726855,151843194,116339,-,-
BAC179_C14,1,1q21.3,151741850,151843195,101345,-,-
BAC38_N03,1,1q21.3,151877392,151988232,110840,-,-
BAC165_K15,1,1q21.3,151877392,151975861,98469,-,-
BAC60_I19,1,1q21.3,151878910,152056132,177222,-,-
BAC233_E20,1,1q21.3,151880064,151970203,90139,-,-
BAC158_J05,1,1q21.3,151880064,151983003,102939,-,-
BAC189_L21,1,1q21.3,151927842,152045192,117350,-,-
BAC97_C07,1,1q21.3,151976048,152056133,80085,-,-
BAC69_G12,1,1q21.3,152020493,152128856,108363,-,-
BAC161_A21,1,1q21.3,152050367,152179055,128688,-,-
BAC80_P13,1,1q21.3,152105479,152242004,136525,-,-
BAC86_M06,1,1q21.3,152122850,152242004,119154,-,-
BAC106_F21,1,1q21.3,152133180,152247367,114187,-,-
BAC101_P04,1,1q21.3,152179048,152285496,106448,-,-
BAC43_H24,1,1q21.3,152201930,152305650,103720,-,-
BAC176_M16,1,1q21.3,152217000,152302470,85470,-,-
BAC77_I02,1,1q21.3,152247529,152341676,94147,-,-
BAC233_D16,1,1q21.3,152266557,152376019,109462,-,-
BAC132_G15,1,1q21.3,152386112,152468194,82082,-,-
BAC223_I23,1,1q21.3,152434211,152513736,79525,-,-
BAC151_K05,1,1q21.3,152434211,152513736,79525,-,-
BAC90_M14,1,1q21.3,152497875,152577058,79183,-,-
BAC175_A14,1,1q21.3,152569105,152678322,109217,-,-
BAC122_G05,1,1q21.3,152571779,152740090,168311,-,-
BAC146_G01,1,1q21.3,152576328,152693415,117087,-,-
BAC150_L04,1,1q21.3,152577060,152677303,100243,-,-
BAC32_N24,1,1q21.3,152651066,152762439,111373,-,-
BAC8_N16,1,1q21.3,152651066,152740055,88989,-,-
BAC41_J06,1,1q21.3,152651066,152733283,82217,-,-
BAC128_G22,1,1q21.3,152678433,152812224,133791,-,-
BAC89_G12,1,1q21.3,152678433,152772393,93960,-,-
BAC217_K13,1,1q21.3,152681239,152762443,81204,-,-
BAC8_M16,1,1q21.3,152762494,152879512,117018,-,-
BAC78_N06,1,1q21.3,152974147,153084451,110304,-,-
BAC232_F16,1,1q21.3,152981333,153067444,86111,-,-
BAC26_B15,1,1q21.3,152984630,153090472,105842,-,-
BAC122_H09,1,1q21.3,153019320,153130729,111409,-,-
BAC133_P22,1,1q21.3,153118643,153229380,110737,-,-
BAC186_C08,1,1q21.3,153156253,153249570,93317,-,-
BAC39_H15,1,1q21.3,153156258,153249570,93312,-,-
BAC236_I15,1,1q21.3,153156309,153249570,93261,-,-
BAC36_B10,1,1q22,153361988,153454544,92556,-,-
BAC33_H01,1,1q22,153368096,153485492,117396,yes,-
BAC189_J11,1,1q22,153368128,153513001,144873,yes,-
BAC49_B06,1,1q22,153368226,153546689,178463,yes,-
BAC34_D17,1,1q22,153377600,153509382,131782,yes,-
BAC235_F12,1,1q22,153405851,153476470,70619,-,-
BAC196_K10,1,1q22,153421201,153580038,158837,yes,-
BAC130_M01,1,1q22,153421230,153506368,85138,yes,-
BAC171_D03,1,1q22,153446480,153556668,110188,yes,-
BAC124_L11,1,1q22,153523565,153663167,139602,yes,-
BAC182_F12,1,1q22,153557189,153669688,112499,yes,-
BAC151_P24,1,1q22,153608384,153703264,94880,-,-
BAC154_D11,1,1q22,153608384,153703298,94914,-,-
BAC31_P13,1,1q22,153619492,153723705,104213,-,-
BAC77_K14,1,1q22,153630641,153739796,109155,-,-
BAC131_F23,1,1q22,153663568,153773458,109890,-,-
BAC168_L08,1,1q22,153663740,153744123,80383,-,-
BAC44_O10,1,1q22,153714528,153807534,93006,-,-
BAC151_J01,1,1q22,153723983,153807572,83589,-,-
BAC28_D09,1,1q22,153739905,153847334,107429,-,-
BAC177_N06,1,1q22,153746871,153844351,97480,-,-
BAC24_C07,1,1q22,153773665,153876114,102449,-,-
BAC91_A20,1,1q22,153807618,153893830,86212,-,-
BAC139_F14,1,1q22,153844356,153959023,114667,-,-
BAC39_F16,1,1q22,153876801,153961735,84934,-,-
BAC20_K09,1,1q22,153893870,154002646,108776,yes,-
BAC113_N17,1,1q22,153895082,153977326,82244,-,-
BAC64_D03,1,1q22,153895083,153977326,82243,yes,-
BAC162_L17,1,1q22,153950664,154051719,101055,-,-
BAC124_M24,1,1q22,153982908,154097200,114292,-,-
BAC110_F07,1,1q22,153998616,154077450,78834,-,-
BAC223_F09,1,1q22,154002640,154078139,75499,-,-
BAC159_G11,1,1q22,154002660,154085898,83238,-,-
BAC242_K15,1,1q22,154085979,154211827,125848,yes,-
BAC57_C19,1,1q22,154100430,154192660,92230,yes,-
BAC243_L17,1,1q22,154162072,154277813,115741,yes,-
BAC107_K05,1,1q22,154170298,154277781,107483,yes,-
BAC107_J06,1,1q22,154182464,154350933,168469,yes,-
BAC73_F06,1,1q22,154192654,154300270,107616,-,-
BAC109_N10,1,1q22,154237703,154341545,103842,-,-
BAC219_F24,1,1q22,154247068,154350890,103822,-,-
BAC38_G10,1,1q22,154366219,154460331,94112,-,-
BAC213_A19,1,1q22,154369012,154460085,91073,-,-
BAC39_C14,1,1q22,154374604,154459878,85274,-,-
BAC228_F19,1,1q22,154374606,154460085,85479,-,-
BAC85_N11,1,1q22,154374676,154470196,95520,-,-
BAC41_K17,1,1q22,154387939,154470196,82257,-,-
BAC178_E18,1,1q22,154397126,154520040,122914,-,-
BAC34_E01,1,1q22,154397136,154529889,132753,-,-
BAC191_A17,1,1q22,154434884,154519464,84580,-,-
BAC54_E09,1,1q22,154434884,154518767,83883,-,-
BAC116_A20,1,1q22,154436126,154531500,95374,-,-
BAC169_I21,1,1q22,154436156,154570120,133964,-,-
BAC233_J09,1,1q22,154470369,154570120,99751,-,-
BAC49_L08,1,1q22,154482965,154638781,155816,-,-
BAC227_B18,1,1q22,154518761,154603446,84685,-,-
BAC100_P13,1,1q22,154520338,154608220,87882,-,-
BAC39_N08,1,1q22,154570114,154670242,100128,-,-
BAC149_L06,1,1q22,154583789,154660350,76561,-,-
BAC91_G22,1,1q22,154583789,154667801,84012,-,-
BAC36_I16,1,1q22,154638024,154757662,119638,-,-
BAC240_D04,1,1q22,154646851,154731848,84997,-,-
BAC62_K05,1,1q22,154660565,154772039,111474,-,-
BAC171_H20,1,1q22,154668815,154781654,112839,-,-
BAC102_E08,1,1q22-1q23.1,154720231,154841171,120940,-,-
BAC33_K19,1,1q23.1,154818190,154989736,171546,-,-
BAC20_J23,1,1q23.1,154841353,154972842,131489,-,-
BAC73_O13,1,1q23.1,154856412,154952268,95856,-,-
BAC97_J02,1,1q23.1,154951848,155057806,105958,-,-
BAC185_M02,1,1q23.1,154952359,155029346,76987,-,-
BAC215_N06,1,1q23.1,154989850,155076531,86681,-,-
BAC125_K03,1,1q23.1,155045029,155148345,103316,-,-
BAC45_K06,1,1q23.1,155063061,155208797,145736,-,-
BAC65_B20,1,1q23.1,155076688,155208814,132126,-,-
BAC43_H23,1,1q23.1,155094739,155194905,100166,-,-
BAC68_N15,1,1q23.1,155117702,155228437,110735,-,-
BAC113_G12,1,1q23.1,155118101,155244816,126715,-,-
BAC176_G13,1,1q23.1,155124809,155208814,84005,-,-
BAC82_D10,1,1q23.1,155209016,155324332,115316,-,-
BAC90_G21,1,1q23.1,155307308,155397475,90167,-,-
BAC168_I19,1,1q23.1,155341510,155448400,106890,-,-
BAC120_N11,1,1q23.1,155375445,155487408,111963,-,-
BAC88_F17,1,1q23.1,155375445,155487408,111963,-,-
BAC163_I20,1,1q23.1,155454337,155584059,129722,-,-
BAC23_J17,1,1q23.1,155565178,155700838,135660,-,-
BAC36_G21,1,1q23.1,155575936,155662572,86636,-,-
BAC175_O02,1,1q23.1,155579074,155670483,91409,-,-
BAC95_O10,1,1q23.1,155587480,155700838,113358,-,-
BAC181_H23,1,1q23.1,155644104,155736226,92122,-,-
BAC8_A02,1,1q23.1,155675281,155834470,159189,-,-
BAC168_K17,1,1q23.1,155739307,155863766,124459,-,-
BAC44_G07,1,1q23.1,155758301,155851398,93097,-,-
BAC163_F11,1,1q23.1,155886346,155969391,83045,-,-
BAC72_I16,1,1q23.1,155886388,155977528,91140,-,-
BAC192_A11,1,1q23.1,155897884,155986134,88250,-,-
BAC189_E11,1,1q23.1,155916612,156011684,95072,-,-
BAC106_B24,1,1q23.1,155943261,156073634,130373,-,-
BAC33_L06,1,1q23.1,155964806,156057427,92621,-,-
BAC232_F10,1,1q23.1,156067869,156167392,99523,-,-
BAC41_L01,1,1q23.1,156147166,156231874,84708,-,-
BAC56_J07,1,1q23.1,156206839,156300512,93673,-,-
BAC232_H02,1,1q23.1,156206841,156289285,82444,-,-
BAC56_M24,1,1q23.1,156216083,156316859,100776,-,-
BAC220_G08,1,1q23.1,156244876,156341261,96385,-,-
BAC151_H11,1,1q23.1,156258487,156341278,82791,-,-
BAC107_N04,1,1q23.1,156270838,156361591,90753,-,-
BAC145_D06,1,1q23.1,156294904,156383250,88346,-,-
BAC51_K23,1,1q23.1,156311930,156449582,137652,-,-
BAC78_F03,1,1q23.1,156341271,156469986,128715,-,-
BAC230_D06,1,1q23.1,156364489,156456897,92408,-,-
BAC199_O06,1,1q23.1,156390615,156464113,73498,-,-
BAC67_E06,1,1q23.1,156457012,156566137,109125,-,-
BAC50_B04,1,1q23.1,156566134,156657596,91462,-,-
BAC39_G17,1,1q23.1,156644878,156734231,89353,-,-
BAC108_B03,1,1q23.1,156655691,156758354,102663,-,-
BAC193_I12,1,1q23.1,156657616,156734235,76619,-,-
BAC183_I21,1,1q23.1,156785016,156881145,96129,-,-
BAC40_B02,1,1q23.1,156788189,156862731,74542,-,-
BAC57_E09,1,1q23.1,156857372,156961724,104352,-,-
BAC235_H19,1,1q23.1,156895176,156974593,79417,-,-
BAC86_E05,1,1q23.1,156925546,157019039,93493,-,-
BAC68_D16,1,1q23.1,157129522,157207533,78011,-,-
BAC102_M19,1,1q23.1,157154855,157270985,116130,-,-
BAC76_C10,1,1q23.1,157172920,157265668,92748,-,-
BAC12_J06,1,1q23.1,157183861,157267245,83384,-,-
BAC103_N09,1,1q23.1-1q23.2,157196502,157311375,114873,yes,-
BAC123_G21,1,1q23.1-1q23.2,157207526,157312305,104779,yes,-
BAC235_K22,1,1q23.1-1q23.2,157272936,157366428,93492,-,-
BAC89_A02,1,1q23.2,157363082,157483431,120349,-,-
BAC196_N10,1,1q23.2,157570494,157673567,103073,-,-
BAC178_N10,1,1q23.2,157570494,157673567,103073,-,-
BAC182_K01,1,1q23.2,157680643,157760887,80244,-,-
BAC70_M19,1,1q23.2,158009031,158122462,113431,-,-
BAC220_N09,1,1q23.2,158022258,158109306,87048,-,-
BAC70_C03,1,1q23.2,158029802,158123676,93874,-,-
BAC191_M01,1,1q23.2,158089409,158171382,81973,-,-
BAC160_F17,1,1q23.2,158144573,158278749,134176,-,-
BAC50_I07,1,1q23.2,158182951,158299543,116592,-,-
BAC243_P05,1,1q23.2,158189295,158266191,76896,-,-
BAC178_D07,1,1q23.2,158189296,158321489,132193,-,-
BAC183_F06,1,1q23.2,158215024,158291352,76328,-,-
BAC135_M17,1,1q23.2,158216088,158331778,115690,-,-
BAC84_M08,1,1q23.2,158225661,158309491,83830,-,-
BAC148_B04,1,1q23.2,158331772,158435240,103468,-,-
BAC38_B19,1,1q23.2,158395633,158513375,117742,-,-
BAC34_G22,1,1q23.2,158435274,158571725,136451,-,-
BAC57_I10,1,1q23.2,158455289,158561682,106393,-,-
BAC210_C09,1,1q23.2,158462841,158555974,93133,-,-
BAC165_J02,1,1q23.2,158571719,158673433,101714,-,-
BAC32_I05,1,1q23.2,158588562,158678213,89651,-,-
BAC236_B13,1,1q23.2,158597055,158693641,96586,-,-
BAC149_O16,1,1q23.2,158613840,158695949,82109,-,-
BAC190_L06,1,1q23.2,158678206,158775546,97340,-,-
BAC34_E21,1,1q23.2-1q23.3,158757587,158862839,105252,-,-
BAC192_H21,1,1q23.2-1q23.3,158797739,158879456,81717,-,-
BAC218_E18,1,1q23.3,158824203,158914992,90789,-,-
BAC117_A04,1,1q23.3,158960441,159054654,94213,-,-
BAC103_H09,1,1q23.3,159001333,159099333,98000,-,-
BAC108_G08,1,1q23.3,159021364,159124392,103028,-,-
BAC162_L22,1,1q23.3,159031084,159134317,103233,-,-
BAC45_M13,1,1q23.3,159134331,159275892,141561,-,-
BAC200_K08,1,1q23.3,159176527,159282944,106417,-,-
BAC48_O01,1,1q23.3,159177988,159255446,77458,-,-
BAC6_P19,1,1q23.3,159188116,159276698,88582,-,-
BAC83_C12,1,1q23.3,159324813,159445810,120997,-,-
BAC53_D19,1,1q23.3,159372713,159496087,123374,-,-
BAC180_D09,1,1q23.3,159402590,159488576,85986,-,-
BAC1_P22,1,1q23.3,159445140,159545875,100735,-,-
BAC38_F18,1,1q23.3,159456373,159550061,93688,-,-
BAC31_P20,1,1q23.3,159593600,159798591,204991,yes,-
BAC131_D11,1,1q23.3,159672579,159710970,38391,-,-
BAC228_J08,1,1q23.3,159769192,159884475,115283,yes,-
BAC44_D07,1,1q23.3,159783786,159879937,96151,yes,-
BAC126_P23,1,1q23.3,159803105,159954879,151774,yes,-
BAC234_O20,1,1q23.3,159899599,159979595,79996,yes,-
BAC84_L17,1,1q23.3,159955219,160084280,129061,-,-
BAC109_O08,1,1q23.3,160110819,160262832,152013,yes,-
BAC29_L02,1,1q23.3,160198918,160300640,101722,yes,-
BAC122_F01,1,1q23.3,160214462,160299668,85206,yes,-
BAC247_F04,1,1q23.3,160214466,160326544,112078,yes,-
BAC252_P07,1,1q23.3,160224097,160326564,102467,-,-
BAC128_I08,1,1q23.3,160249095,160326544,77449,-,-
BAC238_P19,1,1q23.3,160545460,160625772,80312,-,-
BAC60_F10,1,1q23.3,160551832,160686476,134644,-,-
BAC38_P07,1,1q23.3,160566284,160673290,107006,-,-
BAC140_L23,1,1q23.3,160596113,160677252,81139,-,-
BAC185_E14,1,1q23.3,160619324,160735301,115977,-,-
BAC128_O08,1,1q23.3,160630336,160762689,132353,-,-
BAC59_J17,1,1q23.3,160634002,160752447,118445,-,-
BAC122_O02,1,1q23.3,160704401,160828921,124520,-,-
BAC155_M01,1,1q23.3,160718040,160805955,87915,-,-
BAC139_A15,1,1q23.3,160762962,160844563,81601,-,-
BAC233_P02,1,1q23.3,160829523,160931243,101720,-,-
BAC15_J16,1,1q23.3,160878383,160971804,93421,-,-
BAC110_I14,1,1q23.3,160903972,160991998,88026,-,-
BAC24_L14,1,1q23.3,160928959,161026365,97406,-,-
BAC146_H03,1,1q23.3,160971795,161072487,100692,-,-
BAC33_K04,1,1q23.3,160983809,161110346,126537,-,-
BAC142_J20,1,1q23.3,160991990,161069494,77504,-,-
BAC20_L17,1,1q23.3,161051203,161138197,86994,-,-
BAC73_C13,1,1q23.3,161098659,161190330,91671,-,-
BAC96_I22,1,1q23.3,161125095,161222357,97262,-,-
BAC132_B07,1,1q23.3,161162760,161253416,90656,-,-
BAC153_L09,1,1q23.3,161224391,161307067,82676,-,-
BAC42_G02,1,1q23.3,161224490,161342680,118190,-,-
BAC143_N12,1,1q23.3,161260474,161342680,82206,-,-
BAC241_B03,1,1q23.3,161278342,161360963,82621,-,-
BAC169_K23,1,1q23.3,161300457,161394838,94381,-,-
BAC244_L17,1,1q23.3,161322751,161411563,88812,-,-
BAC14_M19,1,1q23.3,161454464,161560182,105718,-,-
BAC163_K20,1,1q23.3,161585653,161705837,120184,-,-
BAC175_A13,1,1q23.3,161608747,161697558,88811,-,-
BAC161_I14,1,1q23.3,161733760,161867230,133470,-,-
BAC194_L20,1,1q23.3,161771613,161851875,80262,-,-
BAC55_J05,1,1q23.3,161900679,161994808,94129,-,-
BAC72_G11,1,1q23.3,161937322,162019332,82010,-,-
BAC171_E03,1,1q23.3,162046975,162166164,119189,-,-
BAC178_L13,1,1q23.3,162079932,162177591,97659,-,-
BAC120_L03,1,1q23.3,162079932,162176606,96674,-,-
BAC168_M12,1,1q23.3,162079932,162188501,108569,-,-
BAC114_C21,1,1q23.3,162105757,162196710,90953,-,-
BAC58_E02,1,1q23.3,162198778,162286064,87286,-,-
BAC187_A12,1,1q23.3,162232473,162323056,90583,-,-
BAC11_A18,1,1q23.3,162426472,162533946,107474,-,-
BAC250_M04,1,1q23.3,162742407,162809996,67589,-,-
BAC152_M12,1,1q23.3,162795593,162900837,105244,-,-
BAC113_O02,1,1q23.3,162800727,162878959,78232,-,-
BAC145_L11,1,1q23.3,162863145,162984456,121311,-,-
BAC151_D21,1,1q23.3,162873720,162973063,99343,-,-
BAC32_M11,1,1q23.3,162882246,162973049,90803,-,-
BAC157_C20,1,1q23.3,162960574,163038188,77614,-,-
BAC28_B13,1,1q23.3,162961958,163073254,111296,-,-
BAC142_L11,1,1q23.3,162973362,163041951,68589,-,-
BAC146_D04,1,1q23.3,162981567,163087304,105737,-,-
BAC161_P20,1,1q23.3,163005057,163095751,90694,-,-
BAC106_A17,1,1q23.3,163005084,163125679,120595,-,-
BAC118_P22,1,1q23.3,163034780,163162385,127605,-,-
BAC110_K18,1,1q23.3,163034780,163197324,162544,-,-
BAC218_P14,1,1q23.3,163073598,163161989,88391,-,-
BAC146_H07,1,1q23.3,163075992,163150694,74702,-,-
BAC84_F06,1,1q23.3,163211259,163358011,146752,-,-
BAC156_L03,1,1q23.3,163217406,163293702,76296,-,-
BAC110_M15,1,1q23.3,163293706,163398474,104768,-,-
BAC193_B11,1,1q23.3,163293709,163382924,89215,-,-
BAC34_E23,1,1q23.3,163293711,163442919,149208,-,-
BAC165_H23,1,1q23.3,163311416,163397373,85957,-,-
BAC153_O16,1,1q23.3,163398464,163482139,83675,-,-
BAC190_B22,1,1q23.3,163421930,163541318,119388,-,-
BAC39_G14,1,1q23.3,163434340,163596947,162607,-,-
BAC101_D02,1,1q23.3,163515828,163605225,89397,-,-
BAC142_M09,1,1q23.3,163580653,163671848,91195,-,-
BAC24_H13,1,1q23.3,163600608,163750157,149549,-,-
BAC125_D22,1,1q23.3,163634858,163742090,107232,-,-
BAC243_F23,1,1q23.3,163646216,163742090,95874,-,-
BAC84_L16,1,1q23.3,163671842,163789766,117924,-,-
BAC55_D02,1,1q23.3,163671842,163760281,88439,-,-
BAC236_E16,1,1q23.3,163712541,163789745,77204,-,-
BAC179_N10,1,1q23.3-1q24.1,163745223,163871349,126126,-,-
BAC184_N12,1,1q23.3-1q24.1,163789763,163927417,137654,-,-
BAC68_O11,1,1q24.1,163804412,163894036,89624,-,-
BAC127_G10,1,1q24.1,163951141,164080695,129554,-,-
BAC235_E09,1,1q24.1,164055708,164139648,83940,-,-
BAC142_L23,1,1q24.1,164317919,164418542,100623,-,-
BAC51_J18,1,1q24.1,164428716,164530239,101523,-,-
BAC2_P15,1,1q24.1,164481294,164570962,89668,-,-
BAC222_D14,1,1q24.1,164538967,164626351,87384,-,-
BAC46_H23,1,1q24.1,164560202,164657293,97091,-,-
BAC181_D14,1,1q24.1,164578062,164657364,79302,-,-
BAC130_I18,1,1q24.1,164664702,164742255,77553,-,-
BAC142_P10,1,1q24.1,164742311,164856609,114298,-,-
BAC86_A05,1,1q24.1,164826751,164910612,83861,-,-
BAC177_L21,1,1q24.1,164839994,164938009,98015,-,-
BAC86_C22,1,1q24.1,164873062,164883786,10724,-,-
BAC64_D12,1,1q24.1,164898931,165000427,101496,-,-
BAC167_I13,1,1q24.1,164916581,165020372,103791,-,-
BAC171_M20,1,1q24.1,164955486,165060863,105377,-,-
BAC35_O14,1,1q24.1,164961162,165054688,93526,-,-
BAC9_B04,1,1q24.1,165037345,165150562,113217,-,-
BAC177_K20,1,1q24.1,165178880,165251341,72461,-,-
BAC124_D16,1,1q24.1,165307439,165425919,118480,-,-
BAC131_A01,1,1q24.1-1q24.2,165467229,165565201,97972,-,-
BAC137_P06,1,1q24.2,165512526,165601087,88561,-,-
BAC206_E21,1,1q24.2,165541744,165632406,90662,-,-
BAC52_N15,1,1q24.2,165565200,165660902,95702,-,-
BAC124_I22,1,1q24.2,165565323,165703103,137780,-,-
BAC169_K12,1,1q24.2,165659234,165735920,76686,-,-
BAC221_L12,1,1q24.2,165698030,165786348,88318,-,-
BAC80_E20,1,1q24.2,165801402,165897949,96547,-,-
BAC171_I17,1,1q24.2,165818603,165933930,115327,-,-
BAC178_H08,1,1q24.2,166137107,166205565,68458,-,-
BAC198_J01,1,1q24.2,166170180,166257965,87785,-,-
BAC105_F09,1,1q24.2,166208571,166292747,84176,-,-
BAC205_G14,1,1q24.2,166297627,166377826,80199,-,-
BAC20_F05,1,1q24.2,166308317,166404384,96067,-,-
BAC191_H23,1,1q24.2,166379766,166469229,89463,-,-
BAC88_L03,1,1q24.2,166392187,166475692,83505,-,-
BAC27_M04,1,1q24.2,166392585,166413043,20458,-,-
BAC232_L22,1,1q24.2,166397003,166478426,81423,-,-
BAC96_G08,1,1q24.2,166440998,166547676,106678,-,-
BAC44_K12,1,1q24.2,166453892,166547676,93784,-,-
BAC228_A22,1,1q24.2,166494495,166581678,87183,-,-
BAC21_E22,1,1q24.2,166496491,166614372,117881,-,-
BAC78_A05,1,1q24.2,166717172,166816529,99357,-,-
BAC147_M02,1,1q24.2,166883442,166946722,63280,-,-
BAC231_C23,1,1q24.2,166911209,166985817,74608,-,-
BAC226_O05,1,1q24.2,166920924,167017421,96497,-,-
BAC29_C01,1,1q24.2,166964435,167084594,120159,-,-
BAC243_B01,1,1q24.2,166971723,167056069,84346,-,-
BAC140_K01,1,1q24.2,167125125,167215285,90160,-,-
BAC237_F23,1,1q24.2,167215547,167337616,122069,-,-
BAC97_K06,1,1q24.2,167230776,167337616,106840,-,-
BAC37_K19,1,1q24.2,167372690,167466294,93604,-,-
BAC113_N14,1,1q24.2,167392488,167511922,119434,-,-
BAC51_D15,1,1q24.2,167404117,167491689,87572,-,-
BAC100_P12,1,1q24.2,167497109,167596191,99082,-,-
BAC91_B14,1,1q24.2,167565282,167671934,106652,-,-
BAC237_G24,1,1q24.2,167657882,167737340,79458,-,-
BAC186_K16,1,1q24.2,167737335,167838116,100781,-,-
BAC73_D09,1,1q24.2,167795877,167916837,120960,-,-
BAC11_P06,1,1q24.2,167851382,168022147,170765,-,-
BAC148_J02,1,1q24.2,167851791,167951635,99844,-,-
BAC213_P13,1,1q24.2,167858856,167937211,78355,-,-
BAC61_G12,1,1q24.2,167863566,167984757,121191,-,-
BAC78_L22,1,1q24.2,167894016,167998832,104816,-,-
BAC234_O23,1,1q24.2,167943240,168030023,86783,-,-
BAC25_C17,1,1q24.2,167954603,168062969,108366,-,-
BAC155_L11,1,1q24.2,167984010,168085833,101823,-,-
BAC143_E16,1,1q24.2,168009167,168101803,92636,-,-
BAC100_A21,1,1q24.2,168037877,168143366,105489,-,-
BAC30_D15,1,1q24.2,168046636,168166282,119646,-,-
BAC123_A08,1,1q24.2,168069132,168169158,100026,-,-
BAC5_L16,1,1q24.2,168097180,168212886,115706,-,-
BAC124_C11,1,1q24.2,168122363,168238583,116220,-,-
BAC191_P22,1,1q24.2,168283835,168363088,79253,-,-
BAC38_M04,1,1q24.2,168302495,168386529,84034,-,-
BAC248_P23,1,1q24.2,168386039,168487443,101404,-,-
BAC160_M14,1,1q24.2,168410010,168486048,76038,-,-
BAC195_F18,1,1q24.2,168445460,168529194,83734,-,-
BAC139_K05,1,1q24.2,168476364,168561834,85470,-,-
BAC236_D19,1,1q24.2,168562570,168673888,111318,-,-
BAC233_P05,1,1q24.2,168575179,168693688,118509,-,-
BAC29_F07,1,1q24.2,168648407,168756288,107881,-,-
BAC101_H09,1,1q24.2,168693900,168791851,97951,-,-
BAC39_I17,1,1q24.2,168757817,168881658,123841,-,-
BAC196_J23,1,1q24.2,168835571,168895398,59827,-,-
BAC242_J21,1,1q24.2,168840781,168950445,109664,-,-
BAC158_I17,1,1q24.2,168873169,168967922,94753,-,-
BAC158_F17,1,1q24.2,168873169,168967922,94753,-,-
BAC84_E09,1,1q24.2,168971229,169079406,108177,-,-
BAC154_F02,1,1q24.2,168994976,169080355,85379,-,-
BAC147_D23,1,1q24.2-1q24.3,169080349,169162530,82181,-,-
BAC75_J08,1,1q24.3,169105321,169228237,122916,-,-
BAC197_G16,1,1q24.3,169364201,169464914,100713,-,-
BAC119_O07,1,1q24.3,169418414,169551054,132640,-,-
BAC142_O17,1,1q24.3,169471581,169603664,132083,-,-
BAC78_P06,1,1q24.3,169490423,169594597,104174,-,-
BAC30_N10,1,1q24.3,169523071,169612975,89904,-,-
BAC200_K13,1,1q24.3,169530495,169627155,96660,-,-
BAC97_J14,1,1q24.3,169534715,169633586,98871,-,-
BAC190_O12,1,1q24.3,169664081,169744350,80269,-,-
BAC173_B07,1,1q24.3,169712633,169788600,75967,-,-
BAC125_N11,1,1q24.3,169727391,169870490,143099,-,-
BAC64_O18,1,1q24.3,169866974,169972740,105766,-,-
BAC188_L14,1,1q24.3,169903226,170022421,119195,-,-
BAC33_E24,1,1q24.3,169919393,170009380,89987,-,-
BAC78_B15,1,1q24.3,169997433,170102423,104990,-,-
BAC218_A24,1,1q24.3,170086139,170194797,108658,-,-
BAC224_B15,1,1q24.3,170094848,170185272,90424,-,-
BAC74_E12,1,1q24.3,170114158,170214574,100416,-,-
BAC62_A08,1,1q24.3,170114158,170211398,97240,-,-
BAC86_M09,1,1q24.3,170185360,170295247,109887,-,-
BAC42_J23,1,1q24.3,170444452,170582627,138175,-,-
BAC49_D10,1,1q24.3,170525041,170630365,105324,-,-
BAC53_D13,1,1q24.3,170546276,170691570,145294,-,-
BAC134_P08,1,1q24.3,170623705,170702650,78945,-,-
BAC60_C18,1,1q24.3,170694874,170806554,111680,-,-
BAC72_N18,1,1q24.3,171025880,171130475,104595,-,-
BAC177_M05,1,1q24.3,171036182,171125641,89459,-,-
BAC176_J11,1,1q24.3,171036182,171149766,113584,-,-
BAC104_F02,1,1q24.3-1q25.1,171119019,171211783,92764,-,-
BAC56_E11,1,1q25.1,171322993,171455414,132421,-,-
BAC141_D08,1,1q25.1,171357011,171439920,82909,-,-
BAC42_F04,1,1q25.1,171374921,171488650,113729,-,-
BAC124_O02,1,1q25.1,171388497,171485147,96650,-,-
BAC118_C21,1,1q25.1,171468947,171598559,129612,-,-
BAC237_K16,1,1q25.1,171707953,171822755,114802,-,-
BAC238_K06,1,1q25.1,171785614,171877318,91704,-,-
BAC20_H19,1,1q25.1,171800964,171896717,95753,-,-
BAC227_G06,1,1q25.1,171969366,172048226,78860,-,-
BAC244_F13,1,1q25.1,172027618,172114099,86481,-,-
BAC26_L17,1,1q25.1,172114427,172233125,118698,-,-
BAC169_B12,1,1q25.1,172114444,172207488,93044,-,-
BAC32_C10,1,1q25.1,172146366,172240923,94557,-,-
BAC155_J12,1,1q25.1,172148478,172233129,84651,-,-
BAC149_C10,1,1q25.1,172161801,172272597,110796,-,-
BAC178_J17,1,1q25.1,172219359,172339915,120556,-,-
BAC58_M16,1,1q25.1,172237894,172313756,75862,-,-
BAC237_N11,1,1q25.1,172273211,172380417,107206,-,-
BAC167_A14,1,1q25.1,172286452,172393703,107251,-,-
BAC42_A02,1,1q25.1,172291707,172424717,133010,-,-
BAC4_D10,1,1q25.1,172342981,172424717,81736,-,-
BAC108_K22,1,1q25.1,172375071,172454293,79222,-,-
BAC67_L03,1,1q25.1,172375071,172466520,91449,-,-
BAC94_J09,1,1q25.1,172388961,172496155,107194,-,-
BAC169_H03,1,1q25.1,172408909,172504678,95769,-,-
BAC201_P14,1,1q25.1,172454999,172555190,100191,-,-
BAC220_J12,1,1q25.1,172473310,172580543,107233,-,-
BAC25_C18,1,1q25.1,172516926,172601769,84843,-,-
BAC114_A15,1,1q25.1,172615925,172709097,93172,-,-
BAC65_P08,1,1q25.1,172628292,172735190,106898,-,-
BAC120_O20,1,1q25.1,172636348,172735017,98669,-,-
BAC133_P08,1,1q25.1,172662746,172757839,95093,-,-
BAC112_D03,1,1q25.1,172663086,172750008,86922,-,-
BAC131_I11,1,1q25.1,172798877,172876124,77247,-,-
BAC127_B20,1,1q25.1,172937832,173024226,86394,-,-
BAC108_J22,1,1q25.1,172968086,173042547,74461,-,-
BAC188_B17,1,1q25.1,173037907,173122165,84258,-,-
BAC101_A14,1,1q25.1,173125919,173216155,90236,-,-
BAC162_E12,1,1q25.1,173186812,173276253,89441,-,-
BAC188_N02,1,1q25.1,173190345,173276253,85908,-,-
BAC92_M05,1,1q25.1,173215592,173309829,94237,-,-
BAC184_C13,1,1q25.1,173238273,173330468,92195,-,-
BAC182_O01,1,1q25.1,173238273,173341274,103001,-,-
BAC125_D13,1,1q25.1,173276252,173397354,121102,-,-
BAC136_B11,1,1q25.1,173302741,173397362,94621,-,-
BAC162_D06,1,1q25.1,173367736,173469641,101905,-,-
BAC54_L06,1,1q25.1,173450709,173546527,95818,-,-
BAC132_N14,1,1q25.1,173481127,173570720,89593,-,-
BAC108_J21,1,1q25.1,173497383,173581484,84101,-,-
BAC150_I06,1,1q25.1,173514610,173627843,113233,-,-
BAC198_L12,1,1q25.1,173554354,173650485,96131,-,-
BAC38_D04,1,1q25.1,173586099,173709021,122922,-,-
BAC33_I11,1,1q25.1,173600525,173703068,102543,-,-
BAC175_F22,1,1q25.1,173600529,173728218,127689,-,-
BAC8_J02,1,1q25.1,173615790,173703058,87268,-,-
BAC211_P11,1,1q25.1,173616037,173703066,87029,-,-
BAC67_A14,1,1q25.1,173624062,173699805,75743,-,-
BAC237_N09,1,1q25.1,173630033,173703068,73035,-,-
BAC161_L06,1,1q25.1,173659775,173753767,93992,-,-
BAC148_G06,1,1q25.1,173709040,173821514,112474,-,-
BAC69_C22,1,1q25.1,173728211,173815130,86919,-,-
BAC37_O23,1,1q25.1,173728216,173843014,114798,-,-
BAC89_O12,1,1q25.1,173745024,173842136,97112,-,-
BAC176_P21,1,1q25.1,173785593,173873560,87967,-,-
BAC21_O22,1,1q25.1,173804152,173899223,95071,-,-
BAC157_J09,1,1q25.1,173842166,173925203,83037,-,-
BAC143_N13,1,1q25.1,173867509,173986540,119031,-,-
BAC58_E06,1,1q25.1,173882217,173996880,114663,-,-
BAC236_D02,1,1q25.1,173882835,173973242,90407,-,-
BAC151_B06,1,1q25.1,173915012,174024915,109903,-,-
BAC23_E06,1,1q25.1,173973313,174053339,80026,-,-
BAC237_F11,1,1q25.1,174013011,174132867,119856,-,-
BAC234_A02,1,1q25.1,174033029,174115771,82742,-,-
BAC170_D15,1,1q25.1,174037777,174115764,77987,-,-
BAC130_I12,1,1q25.1,174037806,174132837,95031,-,-
BAC150_O02,1,1q25.1,174115763,174210681,94918,-,-
BAC44_J13,1,1q25.1-1q25.2,174268224,174426225,158001,-,-
BAC175_M18,1,1q25.1-1q25.2,174268674,174370765,102091,-,-
BAC75_E20,1,1q25.1-1q25.2,174275352,174370757,95405,-,-
BAC64_P10,1,1q25.2,174370759,174501433,130674,-,-
BAC53_I22,1,1q25.2,174431315,174546456,115141,-,-
BAC135_D04,1,1q25.2,174592388,174680319,87931,-,-
BAC131_L22,1,1q25.2,174713924,174880494,166570,-,-
BAC128_K04,1,1q25.2,174727751,174829103,101352,-,-
BAC81_O11,1,1q25.2,174778372,174920066,141694,-,-
BAC246_J03,1,1q25.2,174949257,175056558,107301,-,-
BAC232_J17,1,1q25.2,174949332,175047528,98196,-,-
BAC235_A01,1,1q25.2,175037894,175134385,96491,-,-
BAC42_N24,1,1q25.2,175047526,175126036,78510,-,-
BAC77_D06,1,1q25.2,175075507,175181859,106352,-,-
BAC176_A15,1,1q25.2,175083324,175182202,98878,-,-
BAC181_G20,1,1q25.2,175107996,175181864,73868,-,-
BAC129_P13,1,1q25.2,175213806,175293346,79540,-,-
BAC147_G12,1,1q25.2,175287001,175374468,87467,-,-
BAC81_C10,1,1q25.2,175290549,175361704,71155,-,-
BAC153_N01,1,1q25.2,175298687,175374468,75781,-,-
BAC140_G01,1,1q25.2,175311424,175393401,81977,-,-
BAC231_G17,1,1q25.2,175320607,175403166,82559,-,-
BAC240_P10,1,1q25.2,175480412,175571671,91259,-,-
BAC173_C13,1,1q25.2,175536964,175649615,112651,-,-
BAC38_M10,1,1q25.2,175578315,175599087,20772,-,-
BAC51_C01,1,1q25.2,175682907,175797136,114229,-,-
BAC120_E23,1,1q25.2,175703033,175804582,101549,-,-
BAC142_P22,1,1q25.2,175744838,175850060,105222,-,-
BAC165_J01,1,1q25.2,175807126,175923997,116871,-,-
BAC82_B23,1,1q25.2,176003825,176147484,143659,-,-
BAC65_O21,1,1q25.2,176024031,176154425,130394,-,-
BAC198_N24,1,1q25.2,176035261,176131894,96633,-,-
BAC102_E04,1,1q25.2,176038277,176133322,95045,-,-
BAC185_G06,1,1q25.2,176057308,176158621,101313,-,-
BAC158_B04,1,1q25.2,176059810,176156021,96211,-,-
BAC232_I19,1,1q25.2,176060015,176147486,87471,-,-
BAC151_B07,1,1q25.2,176116359,176203082,86723,-,-
BAC249_N03,1,1q25.2,176132146,176239077,106931,-,-
BAC92_H20,1,1q25.2,176133319,176239017,105698,-,-
BAC97_L17,1,1q25.2,176156013,176239077,83064,-,-
BAC226_B07,1,1q25.2,176232731,176334550,101819,-,-
BAC123_C10,1,1q25.2,176239071,176328171,89100,-,-
BAC69_A11,1,1q25.2,176254589,176342567,87978,-,-
BAC29_D15,1,1q25.2,176334622,176457113,122491,-,-
BAC67_J01,1,1q25.2,176368221,176458452,90231,-,-
BAC120_L02,1,1q25.2,176389016,176506114,117098,-,-
BAC86_B19,1,1q25.2,176470441,176550442,80001,-,-
BAC151_O12,1,1q25.2,176487031,176592941,105910,-,-
BAC46_A06,1,1q25.2,176645059,176746496,101437,-,-
BAC185_H06,1,1q25.2,176673929,176754854,80925,-,-
BAC154_H03,1,1q25.2,176733917,176821137,87220,-,-
BAC179_H18,1,1q25.2,176736962,176835068,98106,-,-
BAC149_K21,1,1q25.2,176746008,176849001,102993,-,-
BAC107_I06,1,1q25.2,176746008,176869107,123099,-,-
BAC38_B13,1,1q25.2,176762621,176852907,90286,-,-
BAC43_N17,1,1q25.2,176763205,176852684,89479,-,-
BAC52_D05,1,1q25.2,176764594,176858440,93846,-,-
BAC110_C16,1,1q25.2,176787201,176878986,91785,-,-
BAC162_D07,1,1q25.2,176812551,176914583,102032,-,-
BAC117_N09,1,1q25.2,176835064,176914583,79519,-,-
BAC124_P11,1,1q25.2,176896644,177000850,104206,-,-
BAC80_B01,1,1q25.2,176914576,177058089,143513,-,-
BAC73_L05,1,1q25.2,176915254,177000850,85596,-,-
BAC195_A09,1,1q25.2,176933282,177021474,88192,-,-
BAC84_I03,1,1q25.2,177000932,177117956,117024,-,-
BAC185_E11,1,1q25.2,177133728,177237138,103410,-,-
BAC163_F23,1,1q25.2,177153967,177235082,81115,-,-
BAC249_N11,1,1q25.2,177155881,177241691,85810,-,-
BAC59_O11,1,1q25.2,177300569,177391492,90923,-,-
BAC246_H03,1,1q25.2,177327385,177426262,98877,-,-
BAC199_A02,1,1q25.2,177413863,177522017,108154,-,-
BAC90_C16,1,1q25.2,177413863,177522015,108152,-,-
BAC161_K23,1,1q25.2,177414993,177521877,106884,-,-
BAC65_B14,1,1q25.2,177589400,177711244,121844,-,-
BAC101_P19,1,1q25.2,177592731,177728196,135465,-,-
BAC101_K16,1,1q25.2,177606264,177712626,106362,-,-
BAC179_I11,1,1q25.2,177706087,177787981,81894,-,-
BAC20_C23,1,1q25.2,177743263,177829285,86022,-,-
BAC78_P02,1,1q25.2,177766986,177872615,105629,-,-
BAC30_A17,1,1q25.2,177791853,177894480,102627,-,-
BAC171_A05,1,1q25.2,177806744,177886158,79414,-,-
BAC136_K18,1,1q25.2,177940464,178027576,87112,-,-
BAC197_K07,1,1q25.2,177952439,178027575,75136,-,-
BAC186_F08,1,1q25.2,177955223,178071807,116584,-,-
BAC118_B20,1,1q25.2,177985705,178080032,94327,-,-
BAC18_L15,1,1q25.2,178000365,178131676,131311,-,-
BAC204_P19,1,1q25.2,178018228,178122177,103949,-,-
BAC42_I03,1,1q25.2,178062763,178164071,101308,-,-
BAC34_O05,1,1q25.2,178062811,178213531,150720,-,-
BAC240_B14,1,1q25.2,178084294,178163437,79143,-,-
BAC106_G17,1,1q25.2,178084297,178215148,130851,-,-
BAC150_L07,1,1q25.2,178122395,178202686,80291,-,-
BAC180_B17,1,1q25.2,178127938,178268465,140527,-,-
BAC39_N16,1,1q25.2,178129654,178249130,119476,-,-
BAC39_M18,1,1q25.2,178140403,178256336,115933,-,-
BAC25_L24,1,1q25.2,178148443,178362758,214315,-,-
BAC180_I17,1,1q25.2,178174111,178256336,82225,-,-
BAC180_L04,1,1q25.2,178202747,178268465,65718,-,-
BAC223_O20,1,1q25.2,178213987,178295383,81396,-,-
BAC136_M09,1,1q25.2,178239718,178329997,90279,-,-
BAC85_P19,1,1q25.2,178270913,178283037,12124,-,-
BAC220_D08,1,1q25.2,178339342,178432847,93505,-,-
BAC46_A09,1,1q25.2,178344940,178442575,97635,-,-
BAC199_J06,1,1q25.2,178348013,178433377,85364,-,-
BAC130_N18,1,1q25.2,178378706,178476682,97976,-,-
BAC243_I15,1,1q25.2,178432937,178533057,100120,-,-
BAC144_E10,1,1q25.2,178440068,178520568,80500,-,-
BAC241_L19,1,1q25.2,178442634,178518730,76096,-,-
BAC102_I24,1,1q25.2,178442658,178550837,108179,-,-
BAC20_O02,1,1q25.2-1q25.3,178518887,178628843,109956,-,-
BAC97_N05,1,1q25.2-1q25.3,178545814,178661387,115573,-,-
BAC53_F10,1,1q25.2-1q25.3,178578650,178686845,108195,-,-
BAC73_D04,1,1q25.3,178687024,178775476,88452,-,-
BAC221_K08,1,1q25.3,178688967,178811665,122698,-,-
BAC151_E06,1,1q25.3,178739232,178835431,96199,-,-
BAC95_P03,1,1q25.3,178743553,178877137,133584,-,-
BAC155_O21,1,1q25.3,178745937,178828085,82148,-,-
BAC61_D04,1,1q25.3,178746665,178807499,60834,-,-
BAC97_F05,1,1q25.3,178762164,178875751,113587,-,-
BAC106_B07,1,1q25.3,178765415,178875743,110328,-,-
BAC12_D01,1,1q25.3,178783111,178915302,132191,-,-
BAC146_K02,1,1q25.3,178788186,178883356,95170,-,-
BAC60_E16,1,1q25.3,178837530,178984013,146483,-,-
BAC248_P01,1,1q25.3,178877131,178983697,106566,-,-
BAC235_D06,1,1q25.3,178915668,179049217,133549,-,-
BAC75_M18,1,1q25.3,178940037,179047367,107330,-,-
BAC24_I21,1,1q25.3,179086391,179181580,95189,-,-
BAC90_E08,1,1q25.3,179095151,179220419,125268,-,-
BAC56_G22,1,1q25.3,179099465,179213937,114472,-,-
BAC232_E05,1,1q25.3,179125566,179207190,81624,-,-
BAC151_A09,1,1q25.3,179131833,179258787,126954,-,-
BAC166_E10,1,1q25.3,179277683,179387543,109860,-,-
BAC100_B12,1,1q25.3,179278706,179397304,118598,-,-
BAC240_C13,1,1q25.3,179363372,179460851,97479,-,-
BAC214_J16,1,1q25.3,179460844,179548394,87550,-,-
BAC73_G06,1,1q25.3,179464372,179548710,84338,-,-
BAC25_B08,1,1q25.3,179520573,179613897,93324,-,-
BAC84_A22,1,1q25.3,179521240,179618493,97253,-,-
BAC197_J08,1,1q25.3,179545090,179655307,110217,-,-
BAC132_P03,1,1q25.3,179547478,179640478,93000,-,-
BAC11_E10,1,1q25.3,179547483,179640478,92995,-,-
BAC52_I03,1,1q25.3,179574458,179716521,142063,-,-
BAC46_B20,1,1q25.3,179613914,179706502,92588,-,-
BAC136_K24,1,1q25.3,179621656,179719924,98268,-,-
BAC53_O12,1,1q25.3,179625870,179719919,94049,-,-
BAC79_O22,1,1q25.3,179640474,179731014,90540,-,-
BAC227_N01,1,1q25.3,179640510,179730982,90472,-,-
BAC230_L21,1,1q25.3,179722320,179802365,80045,-,-
BAC233_K03,1,1q25.3,179722320,179831250,108930,-,-
BAC100_D01,1,1q25.3,179746808,179837981,91173,-,-
BAC146_G05,1,1q25.3,179752910,179889672,136762,-,-
BAC81_N15,1,1q25.3,179853408,179976160,122752,-,-
BAC60_I15,1,1q25.3,179872575,180029272,156697,-,-
BAC172_H16,1,1q25.3,179996345,180078966,82621,-,-
BAC204_C03,1,1q25.3,180004658,180090137,85479,-,-
BAC178_G15,1,1q25.3,180004673,180118751,114078,-,-
BAC73_J22,1,1q25.3,180038318,180119332,81014,-,-
BAC31_P23,1,1q25.3,180123238,180325100,201862,-,-
BAC37_D09,1,1q25.3,180123272,180325100,201828,-,-
BAC247_C14,1,1q25.3,180231866,180316589,84723,-,-
BAC246_N12,1,1q25.3,180232665,180316292,83627,-,-
BAC228_O08,1,1q25.3,180252095,180364367,112272,-,-
BAC158_O05,1,1q25.3,180267314,180352909,85595,-,-
BAC158_B01,1,1q25.3,180316288,180395189,78901,-,-
BAC124_G23,1,1q25.3,180417358,180526514,109156,-,-
BAC35_M16,1,1q25.3,180476620,180614540,137920,-,-
BAC124_E11,1,1q25.3,180482852,180583862,101010,-,-
BAC220_D21,1,1q25.3,180484792,180576183,91391,-,-
BAC102_J23,1,1q25.3,180504644,180529422,24778,-,-
BAC61_L20,1,1q25.3,180529416,180632711,103295,-,-
BAC59_C17,1,1q25.3,180619611,180768611,149000,-,-
BAC107_G10,1,1q25.3,180673882,180760421,86539,-,-
BAC29_K04,1,1q25.3,180685156,180792724,107568,-,-
BAC124_L23,1,1q25.3,180760413,180868090,107677,-,-
BAC108_L01,1,1q25.3,180760413,180868081,107668,-,-
BAC167_O18,1,1q25.3,180783551,180917109,133558,-,-
BAC197_D12,1,1q25.3,180783551,180859168,75617,-,-
BAC53_G01,1,1q25.3,180866049,181061303,195254,-,-
BAC9_H08,1,1q25.3,180912092,181024201,112109,-,-
BAC86_H17,1,1q25.3,180989931,181118621,128690,-,-
BAC225_E10,1,1q25.3,180999564,181064028,64464,-,-
BAC175_N12,1,1q25.3,181002172,181118621,116449,-,-
BAC110_B02,1,1q25.3,181223233,181329549,106316,-,-
BAC116_G22,1,1q25.3,181238145,181370963,132818,-,-
BAC52_C07,1,1q25.3,181283131,181395573,112442,-,-
BAC205_C09,1,1q25.3,181312894,181477310,164416,-,-
BAC252_G17,1,1q25.3,181342564,181527931,185367,-,-
BAC166_F21,1,1q25.3,181375258,181479658,104400,-,-
BAC52_F16,1,1q25.3,181389613,181477959,88346,-,-
BAC64_A05,1,1q25.3,181395673,181477197,81524,-,-
BAC39_E10,1,1q25.3,181490667,181587983,97316,-,-
BAC42_N20,1,1q25.3,181501367,181655634,154267,-,-
BAC16_K21,1,1q25.3,181565518,181661745,96227,-,-
BAC10_B13,1,1q25.3,181571312,181670405,99093,-,-
BAC193_B16,1,1q25.3,181695213,181777493,82280,-,-
BAC84_M02,1,1q25.3,181717599,181827929,110330,-,-
BAC250_F19,1,1q25.3,182012968,182139890,126922,-,-
BAC51_P23,1,1q25.3,182068196,182201579,133383,-,-
BAC120_O04,1,1q25.3,182073914,182172882,98968,-,-
BAC189_F12,1,1q25.3,182124408,182196420,72012,-,-
BAC177_D11,1,1q25.3,182233440,182339344,105904,-,-
BAC165_M06,1,1q25.3,182305293,182391601,86308,-,-
BAC159_A08,1,1q25.3,182320421,182398451,78030,-,-
BAC61_D02,1,1q25.3,182368696,182480538,111842,-,-
BAC113_C13,1,1q25.3,182379241,182476344,97103,-,-
BAC239_G19,1,1q25.3,182629151,182749008,119857,-,-
BAC70_J03,1,1q25.3,182707909,182791729,83820,-,-
BAC76_F02,1,1q25.3,182712427,182822490,110063,-,-
BAC249_F07,1,1q25.3,182717159,182791725,74566,-,-
BAC66_J14,1,1q25.3,182721562,182867290,145728,-,-
BAC179_B21,1,1q25.3,182750450,182838115,87665,-,-
BAC142_D11,1,1q25.3,182750481,182822490,72009,-,-
BAC34_K16,1,1q25.3,182768784,182855966,87182,-,-
BAC51_L19,1,1q25.3,182801760,182895689,93929,-,-
BAC12_M03,1,1q25.3,182838109,182930595,92486,-,-
BAC149_A01,1,1q25.3,182902479,182985373,82894,-,-
BAC86_O21,1,1q25.3,182954570,183058743,104173,-,-
BAC235_L12,1,1q25.3,182962352,183044718,82366,-,-
BAC222_M20,1,1q25.3,182987204,183080995,93791,-,-
BAC146_J21,1,1q25.3,183023744,183102908,79164,-,-
BAC45_N11,1,1q25.3,183079796,183228755,148959,-,-
BAC81_K19,1,1q25.3,183385240,183514984,129744,-,-
BAC129_P19,1,1q25.3,183436836,183506708,69872,-,-
BAC124_G12,1,1q25.3,183527564,183611761,84197,-,-
BAC199_L20,1,1q25.3,183551303,183660793,109490,-,-
BAC26_F04,1,1q25.3,183625325,183721566,96241,-,-
BAC66_O12,1,1q25.3,183626184,183713346,87162,-,-
BAC233_G07,1,1q25.3,183698701,183798515,99814,-,-
BAC116_B10,1,1q25.3,183744828,183895985,151157,-,-
BAC148_E02,1,1q25.3-1q31.1,183896178,184001870,105692,-,-
BAC130_D04,1,1q25.3-1q31.1,183914301,184001877,87576,-,-
BAC240_A19,1,1q25.3-1q31.1,183998062,184088696,90634,-,-
BAC116_D08,1,1q31.1,184010660,184151489,140829,-,-
BAC97_J10,1,1q31.1,184058151,184190226,132075,-,-
BAC16_F08,1,1q31.1,184077712,184176431,98719,-,-
BAC178_H19,1,1q31.1,184409777,184528293,118516,-,-
BAC179_J05,1,1q31.1,184428455,184509746,81291,-,-
BAC106_E20,1,1q31.1,184439740,184578547,138807,-,-
BAC109_M23,1,1q31.1,184595583,184734108,138525,-,-
BAC20_F12,1,1q31.1,184632796,184646189,13393,-,-
BAC220_B13,1,1q31.1,184739596,184841058,101462,-,-
BAC105_L16,1,1q31.1,184785857,184883436,97579,-,-
BAC116_J15,1,1q31.1,185091213,185176720,85507,-,-
BAC186_P04,1,1q31.1,185106162,185223935,117773,-,-
BAC27_G22,1,1q31.1,185183091,185361248,178157,-,-
BAC96_N14,1,1q31.1,185355315,185468059,112744,-,-
BAC234_F13,1,1q31.1,185481058,185569806,88748,-,-
BAC73_M16,1,1q31.1,185570047,185659922,89875,-,-
BAC37_E06,1,1q31.1,185608908,185735634,126726,-,-
BAC26_L15,1,1q31.1,185682413,185789368,106955,-,-
BAC226_E19,1,1q31.1,185693277,185803582,110305,-,-
BAC180_C20,1,1q31.1,185803580,185896575,92995,-,-
BAC48_O04,1,1q31.1,185807929,185896562,88633,-,-
BAC82_F04,1,1q31.1,185824555,185947933,123378,-,-
BAC53_F12,1,1q31.1,185984855,186086944,102089,-,-
BAC182_M11,1,1q31.1,186014363,186097253,82890,-,-
BAC187_H13,1,1q31.1,186030630,186098780,68150,-,-
BAC196_N18,1,1q31.1,186050207,186141795,91588,-,-
BAC82_F03,1,1q31.1,186050222,186151129,100907,-,-
BAC165_F02,1,1q31.1,186142536,186259579,117043,-,-
BAC101_L12,1,1q31.1,186227500,186300959,73459,-,-
BAC53_G23,1,1q31.1,186331156,186416442,85286,-,-
BAC167_K09,1,1q31.1,186389902,186472454,82552,-,-
BAC210_M22,1,1q31.1,186649946,186722712,72766,-,-
BAC118_H20,1,1q31.1,186697716,186779645,81929,-,-
BAC225_I03,1,1q31.1,186901728,186985435,83707,-,-
BAC233_B09,1,1q31.1,186924176,186995137,70961,-,-
BAC57_J21,1,1q31.1,186999711,187113316,113605,-,-
BAC97_M15,1,1q31.1,187488608,187601428,112820,-,-
BAC86_G20,1,1q31.1,187504039,187601428,97389,-,-
BAC137_B03,1,1q31.1,187518533,187587496,68963,-,-
BAC141_O18,1,1q31.1,187525433,187618142,92709,-,-
BAC33_H03,1,1q31.1,187546839,187710032,163193,-,-
BAC108_F04,1,1q31.1,187754179,187839829,85650,-,-
BAC60_M10,1,1q31.1,187796267,187888150,91883,-,-
BAC161_F05,1,1q31.1,187902881,187992444,89563,-,-
BAC203_E14,1,1q31.1,188022957,188121739,98782,-,-
BAC247_O23,1,1q31.1,188455821,188543548,87727,-,-
BAC95_M15,1,1q31.1,188455974,188550500,94526,-,-
BAC233_E09,1,1q31.1,188561900,188656689,94789,-,-
BAC51_K13,1,1q31.1,188579624,188666710,87086,-,-
BAC26_M21,1,1q31.1,188871111,188986060,114949,-,-
BAC156_B09,1,1q31.1-1q31.2,188920230,189025129,104899,-,-
BAC176_D11,1,1q31.2,189006263,189108086,101823,-,-
BAC196_E11,1,1q31.2,189136176,189233892,97716,-,-
BAC149_N05,1,1q31.2,189291452,189381515,90063,-,-
BAC130_N15,1,1q31.2,190043206,190121943,78737,-,-
BAC231_G13,1,1q31.2,190206061,190291059,84998,-,-
BAC221_L02,1,1q31.2,190472117,190567822,95705,-,-
BAC25_H07,1,1q31.2,190653724,190752099,98375,-,-
BAC147_P23,1,1q31.2,190819320,190901065,81745,-,-
BAC35_H13,1,1q31.2,190946920,191078916,131996,-,-
BAC95_B14,1,1q31.2,191080662,191221254,140592,-,-
BAC37_K06,1,1q31.2,191123459,191173726,50267,-,-
BAC84_G14,1,1q31.2,191253926,191337026,83100,-,-
BAC184_P08,1,1q31.2,191298036,191390472,92436,-,-
BAC97_D09,1,1q31.2,191337213,191429334,92121,-,-
BAC84_N05,1,1q31.2,191337213,191431839,94626,-,-
BAC163_O05,1,1q31.2,191486523,191558522,71999,-,-
BAC135_O24,1,1q31.2,191591582,191679484,87902,-,-
BAC1_H22,1,1q31.2,191843879,191937704,93825,-,-
BAC54_M16,1,1q31.2,191861177,191950035,88858,-,-
BAC34_L20,1,1q31.2,191870345,191962037,91692,-,-
BAC127_E02,1,1q31.2,191931502,192055563,124061,-,-
BAC18_E20,1,1q31.3,192404699,192521944,117245,-,-
BAC46_P03,1,1q31.3,192537150,192658170,121020,-,-
BAC33_P10,1,1q31.3,193017912,193112600,94688,-,-
BAC125_M13,1,1q31.3,193024925,193112600,87675,-,-
BAC121_A14,1,1q31.3,193111708,193209552,97844,-,-
BAC234_K02,1,1q31.3,193294151,193379414,85263,-,-
BAC25_H04,1,1q31.3,193494321,193593586,99265,-,-
BAC163_N12,1,1q31.3,193613877,193743433,129556,-,-
BAC96_D04,1,1q31.3,193658216,193752428,94212,-,-
BAC218_N21,1,1q31.3,193743427,193843790,100363,-,-
BAC240_F12,1,1q31.3,193765554,193895396,129842,-,-
BAC152_I18,1,1q31.3,193772307,193907232,134925,-,-
BAC141_M20,1,1q31.3,193848753,193951635,102882,-,-
BAC226_C23,1,1q31.3,193856498,193937118,80620,-,-
BAC188_N07,1,1q31.3,193970713,194062226,91513,-,-
BAC76_D06,1,1q31.3,194089346,194165970,76624,-,-
BAC162_J12,1,1q31.3,194274365,194363002,88637,-,-
BAC194_J17,1,1q31.3,194371633,194451701,80068,-,-
BAC126_C24,1,1q31.3,194535931,194624075,88144,-,-
BAC149_I24,1,1q31.3,194727152,194827752,100600,-,-
BAC248_A13,1,1q31.3,194806275,194899608,93333,-,-
BAC141_B20,1,1q31.3,195042460,195273056,230596,yes,-
BAC230_A09,1,1q31.3,195052193,195136070,83877,yes,-
BAC67_K11,1,1q31.3,195072444,195214596,142152,yes,-
BAC124_E17,1,1q31.3,195113759,195194707,80948,yes,-
BAC57_O06,1,1q31.3,195249551,195365061,115510,yes,-
BAC230_C13,1,1q31.3,195373830,195464067,90237,-,-
BAC122_O14,1,1q31.3,195391319,195474922,83603,-,-
BAC126_C03,1,1q31.3,195391344,195474926,83582,-,-
BAC103_N19,1,1q31.3,195424249,195516090,91841,-,-
BAC169_B23,1,1q31.3,195514821,195599692,84871,-,-
BAC147_J09,1,1q31.3,195551711,195650369,98658,-,-
BAC110_C06,1,1q31.3,195559991,195636528,76537,-,-
BAC160_P20,1,1q31.3,195569762,195660571,90809,-,-
BAC27_I24,1,1q31.3,195576129,195666515,90386,-,-
BAC168_B15,1,1q31.3,195890472,195976786,86314,-,-
BAC166_H04,1,1q31.3,195890588,195981063,90475,-,-
BAC165_B01,1,1q31.3,196019734,196116762,97028,-,-
BAC62_H11,1,1q31.3,196078648,196169723,91075,-,-
BAC147_E04,1,1q31.3,196193065,196278986,85921,-,-
BAC240_P06,1,1q31.3,196258887,196353380,94493,-,-
BAC65_F17,1,1q31.3,196290828,196377538,86710,-,-
BAC189_B03,1,1q31.3,196806705,196892324,85619,-,-
BAC235_N04,1,1q31.3,196899273,196988990,89717,-,-
BAC105_P13,1,1q31.3,197091253,197202904,111651,-,-
BAC20_L15,1,1q31.3,197185622,197346279,160657,-,-
BAC218_I21,1,1q31.3-1q32.1,197403754,197500988,97234,-,-
BAC61_K10,1,1q31.3-1q32.1,197413478,197518078,104600,-,-
BAC112_G04,1,1q32.1,197504556,197605542,100986,-,-
BAC81_C03,1,1q32.1,197516112,197628803,112691,-,-
BAC168_P20,1,1q32.1,197587906,197683783,95877,-,-
BAC126_K21,1,1q32.1,197722662,197814336,91674,-,-
BAC45_E05,1,1q32.1,197868742,198010508,141766,-,-
BAC170_E22,1,1q32.1,198010625,198103760,93135,-,-
BAC141_C15,1,1q32.1,198066738,198149068,82330,-,-
BAC246_M07,1,1q32.1,198142087,198268059,125972,-,-
BAC22_P06,1,1q32.1,198148243,198231447,83204,-,-
BAC60_F23,1,1q32.1,198243626,198381705,138079,-,-
BAC235_O02,1,1q32.1,198272933,198381705,108772,-,-
BAC30_L15,1,1q32.1,198413239,198511490,98251,-,-
BAC192_E15,1,1q32.1,198434664,198515348,80684,-,-
BAC140_I10,1,1q32.1,198438138,198515394,77256,-,-
BAC82_B16,1,1q32.1,198438138,198529665,91527,-,-
BAC122_L11,1,1q32.1,198511483,198599143,87660,-,-
BAC126_E01,1,1q32.1,198511486,198599143,87657,-,-
BAC186_M05,1,1q32.1,198574343,198665737,91394,-,-
BAC107_P03,1,1q32.1,198655065,198762609,107544,-,-
BAC175_K22,1,1q32.1,198679449,198783177,103728,-,-
BAC97_A02,1,1q32.1,198679449,198791123,111674,-,-
BAC188_J02,1,1q32.1,198709207,198783177,73970,-,-
BAC148_H09,1,1q32.1,198742584,198850009,107425,-,-
BAC165_J05,1,1q32.1,198825449,198898445,72996,-,-
BAC60_O10,1,1q32.1,198846964,199011734,164770,-,-
BAC183_O07,1,1q32.1,199029897,199141039,111142,-,-
BAC168_D06,1,1q32.1,199029897,199146860,116963,-,-
BAC193_G14,1,1q32.1,199037479,199126794,89315,-,-
BAC205_N17,1,1q32.1,199041852,199141039,99187,-,-
BAC247_A15,1,1q32.1,199086969,199169842,82873,-,-
BAC150_G05,1,1q32.1,199146962,199245363,98401,-,-
BAC44_F15,1,1q32.1,199183596,199285695,102099,-,-
BAC146_A01,1,1q32.1,199183720,199268803,85083,-,-
BAC182_N23,1,1q32.1,199192918,199285718,92800,-,-
BAC156_B07,1,1q32.1,199204033,199277203,73170,-,-
BAC148_F16,1,1q32.1,199225506,199311860,86354,-,-
BAC151_N23,1,1q32.1,199285712,199413273,127561,-,-
BAC66_E15,1,1q32.1,199413591,199543721,130130,-,-
BAC115_I19,1,1q32.1,199463978,199539863,75885,-,-
BAC65_K08,1,1q32.1,199463978,199565655,101677,-,-
BAC122_D15,1,1q32.1,199472309,199565655,93346,-,-
BAC57_K05,1,1q32.1,199476964,199565655,88691,-,-
BAC42_N01,1,1q32.1,199514591,199599087,84496,-,-
BAC59_M15,1,1q32.1,199525113,199653796,128683,-,-
BAC223_G03,1,1q32.1,199525695,199630817,105122,-,-
BAC193_P07,1,1q32.1,199537963,199646600,108637,-,-
BAC190_F05,1,1q32.1,199565649,199678307,112658,-,-
BAC56_I04,1,1q32.1,199565669,199672130,106461,-,-
BAC68_F08,1,1q32.1,199595158,199678325,83167,-,-
BAC124_L18,1,1q32.1,199633580,199711629,78049,-,-
BAC45_N04,1,1q32.1,199678323,199819300,140977,-,-
BAC71_C05,1,1q32.1,199690624,199798396,107772,-,-
BAC197_J24,1,1q32.1,199712041,199833986,121945,-,-
BAC91_B05,1,1q32.1,199748930,199858559,109629,-,-
BAC178_B05,1,1q32.1,199800431,199896789,96358,-,-
BAC230_F02,1,1q32.1,199833997,199953802,119805,-,-
BAC127_E13,1,1q32.1,199846557,199981492,134935,-,-
BAC149_P04,1,1q32.1,199995081,200094934,99853,-,-
BAC34_L14,1,1q32.1,200017963,200131250,113287,-,-
BAC237_G02,1,1q32.1,200054657,200164684,110027,-,-
BAC196_P10,1,1q32.1,200070344,200153345,83001,-,-
BAC71_N02,1,1q32.1,200095105,200187546,92441,-,-
BAC91_L03,1,1q32.1,200119324,200252812,133488,-,-
BAC104_N09,1,1q32.1,200169523,200292556,123033,-,-
BAC34_D08,1,1q32.1,200181241,200261003,79762,-,-
BAC236_N14,1,1q32.1,200235526,200330045,94519,-,-
BAC148_P01,1,1q32.1,200271070,200363018,91948,-,-
BAC82_L23,1,1q32.1,200415808,200510420,94612,-,-
BAC194_B08,1,1q32.1,200445623,200527357,81734,-,-
BAC186_E09,1,1q32.1,200446446,200522810,76364,-,-
BAC119_O14,1,1q32.1,200501874,200612615,110741,-,-
BAC24_H09,1,1q32.1,200510417,200612616,102199,-,-
BAC52_L02,1,1q32.1,200513846,200612620,98774,-,-
BAC51_O21,1,1q32.1,200785189,200875963,90774,-,-
BAC55_E03,1,1q32.1,200850987,200977290,126303,-,-
BAC51_E16,1,1q32.1,200869548,200977050,107502,-,-
BAC46_I17,1,1q32.1,200878285,200974968,96683,-,-
BAC130_L06,1,1q32.1,200981287,201081716,100429,-,-
BAC86_P13,1,1q32.1,200984754,201087011,102257,-,-
BAC37_E02,1,1q32.1,201049151,201177183,128032,-,-
BAC146_A06,1,1q32.1,201081711,201200587,118876,-,-
BAC34_E11,1,1q32.1,201087007,201252063,165056,-,-
BAC46_M14,1,1q32.1,201183978,201272573,88595,-,-
BAC80_G04,1,1q32.1,201203980,201303959,99979,-,-
BAC186_A14,1,1q32.1,201205751,201292223,86472,-,-
BAC142_M04,1,1q32.1,201361019,201476040,115021,-,-
BAC168_J01,1,1q32.1,201367041,201438123,71082,-,-
BAC141_D16,1,1q32.1,201439936,201532481,92545,-,-
BAC168_F04,1,1q32.1,201505863,201619614,113751,-,-
BAC217_K11,1,1q32.1,201517069,201612553,95484,-,-
BAC244_C18,1,1q32.1,201580289,201710326,130037,-,-
BAC92_A07,1,1q32.1,201645776,201761945,116169,-,-
BAC37_E19,1,1q32.1,201705319,201856320,151001,-,-
BAC33_O02,1,1q32.1,201753439,201856317,102878,-,-
BAC96_G14,1,1q32.1,201761937,201857026,95089,-,-
BAC214_B04,1,1q32.1,201762281,201857017,94736,-,-
BAC61_N19,1,1q32.1,201783310,201914490,131180,-,-
BAC24_K18,1,1q32.1,201783367,201875864,92497,-,-
BAC235_B04,1,1q32.1,201788956,201885931,96975,-,-
BAC197_E04,1,1q32.1,201789193,201828785,39592,-,-
BAC51_M18,1,1q32.1,201856319,201982193,125874,-,-
BAC188_L10,1,1q32.1,201875896,201962176,86280,-,-
BAC140_K05,1,1q32.1,201889752,201982193,92441,-,-
BAC97_M24,1,1q32.1,201893370,201972216,78846,-,-
BAC63_A05,1,1q32.1,201948949,202082490,133541,-,-
BAC240_K02,1,1q32.1,201965996,202048886,82890,-,-
BAC97_N15,1,1q32.1,202027296,202117140,89844,-,-
BAC97_J04,1,1q32.1,202027296,202129481,102185,-,-
BAC43_C11,1,1q32.1,202060876,202176618,115742,-,-
BAC42_K05,1,1q32.1,202090720,202228626,137906,-,-
BAC186_D20,1,1q32.1,202141909,202228607,86698,-,-
BAC153_C12,1,1q32.1,202181035,202263420,82385,-,-
BAC226_H23,1,1q32.1,202231518,202334692,103174,-,-
BAC181_F12,1,1q32.1,202329658,202409563,79905,-,-
BAC2_N16,1,1q32.1,202414700,202519928,105228,-,-
BAC124_H22,1,1q32.1,202442800,202550446,107646,-,-
BAC223_J07,1,1q32.1,202482954,202579089,96135,-,-
BAC148_G04,1,1q32.1,202644986,202736401,91415,-,-
BAC143_B22,1,1q32.1,202650681,202736399,85718,-,-
BAC133_O15,1,1q32.1,202654299,202780723,126424,-,-
BAC124_O13,1,1q32.1,202739130,202818489,79359,-,-
BAC132_D22,1,1q32.1,202751751,202870604,118853,-,-
BAC152_O13,1,1q32.1,202751792,202845215,93423,-,-
BAC58_D10,1,1q32.1,202799498,202939486,139988,-,-
BAC71_L13,1,1q32.1,202824486,202917899,93413,-,-
BAC60_J04,1,1q32.1,202857998,202937588,79590,-,-
BAC76_K02,1,1q32.1,202869847,202961743,91896,-,-
BAC176_O02,1,1q32.1,202870595,202954092,83497,-,-
BAC242_N14,1,1q32.1,202880614,202973762,93148,-,-
BAC233_K16,1,1q32.1,202880618,202964879,84261,-,-
BAC146_F10,1,1q32.1,202939497,203016263,76766,-,-
BAC200_O14,1,1q32.1,203042488,203129574,87086,-,-
BAC33_K10,1,1q32.1,203078083,203198217,120134,-,-
BAC218_I15,1,1q32.1,203133509,203204030,70521,-,-
BAC129_O23,1,1q32.1,203147877,203230227,82350,-,-
BAC196_N06,1,1q32.1,203316356,203387075,70719,-,-
BAC208_N09,1,1q32.1,203331364,203421773,90409,-,-
BAC60_K04,1,1q32.1,203480260,203574788,94528,-,-
BAC178_L15,1,1q32.1,203486533,203582918,96385,-,-
BAC78_O15,1,1q32.1,203512300,203609210,96910,-,-
BAC93_M07,1,1q32.1,203525991,203655156,129165,-,-
BAC187_I09,1,1q32.1,203568808,203662261,93453,-,-
BAC149_C18,1,1q32.1,203582912,203667460,84548,-,-
BAC120_P17,1,1q32.1,203657550,203795996,138446,-,-
BAC244_E15,1,1q32.1,203662260,203780082,117822,-,-
BAC109_M08,1,1q32.1,203692111,203779849,87738,-,-
BAC50_G21,1,1q32.1,203716581,203819452,102871,-,-
BAC109_O06,1,1q32.1,203807489,203820956,13467,-,-
BAC237_E19,1,1q32.1,203819447,203904226,84779,-,-
BAC179_N07,1,1q32.1,203819447,203856130,36683,-,-
BAC230_K05,1,1q32.1,203819448,203904210,84762,-,-
BAC141_F16,1,1q32.1,203821453,203904210,82757,-,-
BAC171_G04,1,1q32.1,203832756,203937152,104396,-,-
BAC200_M13,1,1q32.1,203856311,203960012,103701,-,-
BAC214_G12,1,1q32.1,203877879,203963178,85299,-,-
BAC105_N04,1,1q32.1,203937044,204014805,77761,-,-
BAC39_N13,1,1q32.1,204263266,204346885,83619,-,-
BAC120_P04,1,1q32.1,204327312,204468998,141686,-,-
BAC227_I20,1,1q32.1,204344543,204468936,124393,-,-
BAC183_J13,1,1q32.1,204357423,204438581,81158,-,-
BAC35_I07,1,1q32.1,204360082,204451805,91723,-,-
BAC180_K10,1,1q32.1,204380813,204451903,71090,-,-
BAC105_D17,1,1q32.1,204380813,204494123,113310,-,-
BAC40_E16,1,1q32.1,204556876,204681399,124523,-,-
BAC235_K10,1,1q32.1,204634723,204753456,118733,-,-
BAC166_C10,1,1q32.1,204646294,204765450,119156,-,-
BAC44_E17,1,1q32.1,204774629,204875817,101188,-,-
BAC240_P24,1,1q32.1,204782404,204875817,93413,-,-
BAC242_L13,1,1q32.1,204799017,204893435,94418,-,-
BAC130_B04,1,1q32.1,204860852,204943833,82981,-,-
BAC219_H13,1,1q32.1,204861288,204948645,87357,-,-
BAC200_E24,1,1q32.1,204944662,205035069,90407,-,-
BAC180_O04,1,1q32.1,204961293,205043410,82117,-,-
BAC187_P09,1,1q32.1,204961321,205043426,82105,-,-
BAC238_F08,1,1q32.1,204968108,205075742,107634,-,-
BAC169_P11,1,1q32.1,205120073,205213896,93823,-,-
BAC68_P16,1,1q32.1,205159208,205286407,127199,-,-
BAC163_M14,1,1q32.1-1q32.2,205235608,205324703,89095,-,-
BAC189_I09,1,1q32.1-1q32.2,205249548,205339329,89781,-,-
BAC52_O08,1,1q32.1-1q32.2,205269994,205369350,99356,-,-
BAC176_F13,1,1q32.2,205464619,205554132,89513,-,-
BAC27_P10,1,1q32.2,205501976,205592631,90655,-,-
BAC52_G11,1,1q32.2,205541327,205653677,112350,-,-
BAC157_C19,1,1q32.2,205648093,205725465,77372,-,-
BAC199_D02,1,1q32.2,205648106,205741705,93599,-,-
BAC11_P02,1,1q32.2,205806299,205912586,106287,-,-
BAC64_I10,1,1q32.2,205869635,206014614,144979,-,-
BAC29_F08,1,1q32.2,205882525,205981194,98669,-,-
BAC211_P12,1,1q32.2,205943239,206026353,83114,-,-
BAC243_I16,1,1q32.2,205954042,206026679,72637,-,-
BAC142_P19,1,1q32.2,205954042,206061650,107608,-,-
BAC181_G08,1,1q32.2,205997300,206061650,64350,-,-
BAC75_H03,1,1q32.2,205997300,206085986,88686,-,-
BAC247_H16,1,1q32.2,206026722,206118066,91344,-,-
BAC51_M01,1,1q32.2,206199916,206287307,87391,-,-
BAC201_N13,1,1q32.2,206215181,206292896,77715,-,-
BAC20_F07,1,1q32.2,206222120,206317403,95283,-,-
BAC143_O16,1,1q32.2,206222263,206309214,86951,-,-
BAC233_F05,1,1q32.2,206243020,206376090,133070,-,-
BAC177_J10,1,1q32.2,206259224,206375559,116335,-,-
BAC232_F08,1,1q32.2,206301994,206410792,108798,-,-
BAC92_M08,1,1q32.2,206309209,206418884,109675,-,-
BAC112_I03,1,1q32.2,206458382,206555905,97523,-,-
BAC6_F21,1,1q32.2,206542126,206636921,94795,-,-
BAC41_D06,1,1q32.2,206546536,206706920,160384,-,-
BAC24_N17,1,1q32.2,206558780,206636917,78137,-,-
BAC11_A10,1,1q32.2,206558780,206684313,125533,-,-
BAC59_H07,1,1q32.2,206596777,206700486,103709,-,-
BAC146_M20,1,1q32.2,206607124,206710722,103598,-,-
BAC74_H10,1,1q32.2,206700614,206791864,91250,-,-
BAC234_O02,1,1q32.2,206804991,206913680,108689,-,-
BAC37_N16,1,1q32.2,206904213,207013355,109142,-,-
BAC178_M05,1,1q32.2,206907406,206993339,85933,-,-
BAC235_I21,1,1q32.2,206919228,207020523,101295,-,-
BAC246_F21,1,1q32.2,207082949,207160973,78024,-,-
BAC49_B23,1,1q32.2,207145528,207205915,60387,-,-
BAC250_E14,1,1q32.2,207160969,207252119,91150,-,-
BAC36_M04,1,1q32.2,207337787,207429311,91524,-,-
BAC239_I09,1,1q32.2,207425949,207507003,81054,-,-
BAC150_L09,1,1q32.2,207483412,207594590,111178,-,-
BAC102_N21,1,1q32.2,207483413,207581538,98125,-,-
BAC113_E06,1,1q32.2,207485701,207570065,84364,-,-
BAC120_E15,1,1q32.2,207500829,207585262,84433,-,-
BAC37_G15,1,1q32.2,207588420,207692258,103838,-,-
BAC119_O11,1,1q32.2,207588453,207681043,92590,-,-
BAC59_K21,1,1q32.2,207645420,207779902,134482,-,-
BAC88_K16,1,1q32.2,207668743,207793096,124353,-,-
BAC55_L23,1,1q32.2,207681041,207774169,93128,-,-
BAC55_J04,1,1q32.2,207692253,207790092,97839,-,-
BAC224_L17,1,1q32.2,207752083,207848613,96530,-,-
BAC2_E17,1,1q32.2,207774506,207909705,135199,-,-
BAC143_M01,1,1q32.2,207786017,207863536,77519,-,-
BAC118_L22,1,1q32.2,207823468,207922661,99193,-,-
BAC52_G07,1,1q32.2,207825190,207922660,97470,-,-
BAC249_A17,1,1q32.2,207922894,208018496,95602,-,-
BAC127_C02,1,1q32.2,207928638,208008380,79742,-,-
BAC157_N13,1,1q32.2,207934790,208020266,85476,-,-
BAC83_I06,1,1q32.2,207936438,208047194,110756,-,-
BAC89_D09,1,1q32.2,207952238,208051166,98928,-,-
BAC196_G12,1,1q32.2,208001203,208089158,87955,-,-
BAC196_H12,1,1q32.2,208001203,208089158,87955,-,-
BAC55_A08,1,1q32.2,208007779,208162096,154317,-,-
BAC154_C04,1,1q32.2,208090449,208165599,75150,-,-
BAC133_D03,1,1q32.2,208103853,208187203,83350,-,-
BAC116_N14,1,1q32.2,208224419,208236865,12446,-,-
BAC109_B18,1,1q32.2,208252690,208340096,87406,-,-
BAC132_N06,1,1q32.2,208283565,208478584,195019,-,-
BAC100_N03,1,1q32.2,208283565,208416458,132893,-,-
BAC92_J15,1,1q32.2,208357976,208516027,158051,-,-
BAC221_F06,1,1q32.2,208398906,208525942,127036,-,-
BAC97_K22,1,1q32.2,208480205,208565907,85702,-,-
BAC184_L08,1,1q32.2,208492275,208589046,96771,-,-
BAC29_N10,1,1q32.2,208503719,208595348,91629,-,-
BAC230_P17,1,1q32.2,208525514,208595348,69834,-,-
BAC2_F17,1,1q32.2,208526124,208638519,112395,-,-
BAC76_M16,1,1q32.2,208625438,208713807,88369,-,-
BAC181_B23,1,1q32.2,208703123,208781391,78268,-,-
BAC139_L04,1,1q32.2,208719503,208844046,124543,-,-
BAC230_G23,1,1q32.2,208810371,208940284,129913,-,-
BAC197_E24,1,1q32.2,208820108,208899334,79226,-,-
BAC83_N15,1,1q32.2,208843504,208936025,92521,-,-
BAC154_J19,1,1q32.2,208864454,208936025,71571,-,-
BAC234_N14,1,1q32.2,208890714,208965954,75240,-,-
BAC31_A12,1,1q32.2,208965948,209101050,135102,-,-
BAC89_H04,1,1q32.2,209071346,209207415,136069,-,-
BAC123_L05,1,1q32.2,209098940,209211725,112785,-,-
BAC209_A21,1,1q32.2,209202554,209334458,131904,-,-
BAC88_M17,1,1q32.2,209314083,209415526,101443,-,-
BAC103_O12,1,1q32.2,209356818,209475286,118468,-,-
BAC29_N12,1,1q32.2-1q32.3,209439564,209532428,92864,-,-
BAC193_F17,1,1q32.2-1q32.3,209464135,209532483,68348,-,-
BAC97_P14,1,1q32.2-1q32.3,209475375,209587321,111946,-,-
BAC94_P18,1,1q32.3,209532486,209626639,94153,-,-
BAC75_D19,1,1q32.3,209587323,209675238,87915,-,-
BAC92_A19,1,1q32.3,209636935,209783921,146986,-,-
BAC148_E23,1,1q32.3,209692311,209806626,114315,-,-
BAC144_L15,1,1q32.3,209697102,209792379,95277,-,-
BAC78_E22,1,1q32.3,209711384,209811288,99904,-,-
BAC248_M24,1,1q32.3,209790710,209901347,110637,-,-
BAC84_O24,1,1q32.3,209811287,209908586,97299,-,-
BAC177_D02,1,1q32.3,209873293,209979530,106237,-,-
BAC230_G20,1,1q32.3,209878734,209979529,100795,-,-
BAC48_F13,1,1q32.3,209901405,209992698,91293,-,-
BAC230_G21,1,1q32.3,210025590,210106884,81294,-,-
BAC65_F02,1,1q32.3,210053727,210203411,149684,-,-
BAC34_P19,1,1q32.3,210116120,210198342,82222,-,-
BAC179_D13,1,1q32.3,210170017,210275444,105427,-,-
BAC67_I05,1,1q32.3,210187729,210307635,119906,-,-
BAC110_B07,1,1q32.3,210210740,210307636,96896,-,-
BAC24_O12,1,1q32.3,210223536,210314168,90632,-,-
BAC240_E11,1,1q32.3,210223831,210315384,91553,-,-
BAC187_N05,1,1q32.3,210223831,210314169,90338,-,-
BAC192_D11,1,1q32.3,210232708,210314561,81853,-,-
BAC128_P05,1,1q32.3,210274340,210370624,96284,-,-
BAC195_E04,1,1q32.3,210307629,210365298,57669,-,-
BAC120_J02,1,1q32.3,210409751,210491008,81257,-,-
BAC59_G19,1,1q32.3,210631876,210703418,71542,-,-
BAC78_H23,1,1q32.3,210699233,210787991,88758,-,-
BAC76_G08,1,1q32.3,210701550,210821749,120199,-,-
BAC24_D10,1,1q32.3,210701553,210795459,93906,-,-
BAC244_N22,1,1q32.3,210795454,210880069,84615,-,-
BAC31_F05,1,1q32.3,210824355,210949708,125353,-,-
BAC42_C19,1,1q32.3,210824373,210928406,104033,-,-
BAC50_A16,1,1q32.3,210922289,211031107,108818,-,-
BAC90_D22,1,1q32.3,210982222,211073892,91670,-,-
BAC145_M19,1,1q32.3,211002371,211104477,102106,-,-
BAC105_A21,1,1q32.3,211002371,211066394,64023,-,-
BAC169_N15,1,1q32.3,211027542,211117651,90109,-,-
BAC80_A19,1,1q32.3,211027578,211119342,91764,-,-
BAC198_D24,1,1q32.3,211050860,211141055,90195,-,-
BAC63_O02,1,1q32.3,211103856,211195125,91269,-,-
BAC72_I02,1,1q32.3,211164134,211246612,82478,-,-
BAC83_K06,1,1q32.3,211328964,211445423,116459,-,-
BAC152_P21,1,1q32.3,211341699,211455175,113476,-,-
BAC15_K06,1,1q32.3,211368234,211469715,101481,-,-
BAC208_P04,1,1q32.3,211457627,211538274,80647,-,-
BAC32_O04,1,1q32.3,211507272,211600198,92926,-,-
BAC238_C14,1,1q32.3,211517238,211608832,91594,-,-
BAC169_A07,1,1q32.3,211741878,211807206,65328,-,-
BAC43_J07,1,1q32.3,211789891,211971424,181533,-,-
BAC118_C09,1,1q32.3,211799266,211916380,117114,-,-
BAC37_O19,1,1q32.3,211799266,211899260,99994,-,-
BAC150_H05,1,1q32.3,211816750,211898910,82160,-,-
BAC235_M02,1,1q32.3,211832760,211908356,75596,-,-
BAC227_D03,1,1q32.3,211853582,212000439,146857,-,-
BAC165_D15,1,1q32.3,211969755,212091980,122225,-,-
BAC43_C20,1,1q32.3-1q41,211971422,212110162,138740,-,-
BAC169_E13,1,1q32.3-1q41,212047004,212139863,92859,-,-
BAC106_B11,1,1q32.3-1q41,212073848,212161480,87632,-,-
BAC137_H02,1,1q32.3-1q41,212079938,212183717,103779,-,-
BAC22_I23,1,1q32.3-1q41,212083441,212183717,100276,-,-
BAC100_L08,1,1q32.3-1q41,212092572,212187911,95339,-,-
BAC50_O14,1,1q41,212100789,212186182,85393,-,-
BAC237_L02,1,1q41,212120769,212240828,120059,-,-
BAC132_K07,1,1q41,212120769,212204829,84060,-,-
BAC57_N17,1,1q41,212185136,212282511,97375,-,-
BAC180_D14,1,1q41,212257216,212378147,120931,-,-
BAC222_B22,1,1q41,212281485,212380979,99494,-,-
BAC147_J03,1,1q41,212333067,212415423,82356,-,-
BAC10_O02,1,1q41,212380973,212484147,103174,-,-
BAC194_B09,1,1q41,212457542,212554525,96983,-,-
BAC88_K10,1,1q41,212543089,212720415,177326,-,-
BAC194_E04,1,1q41,212585583,212675196,89613,-,-
BAC41_M19,1,1q41,212597287,212734407,137120,-,-
BAC154_H10,1,1q41,212637062,212737498,100436,-,-
BAC135_F18,1,1q41,212658385,212734410,76025,-,-
BAC78_A21,1,1q41,212679773,212782929,103156,-,-
BAC186_L11,1,1q41,212757470,212833620,76150,-,-
BAC83_P14,1,1q41,212802319,212900501,98182,-,-
BAC200_K05,1,1q41,212837029,212944336,107307,yes,-
BAC162_P09,1,1q41,212863541,212961718,98177,-,-
BAC182_M22,1,1q41,212984958,213046337,61379,-,-
BAC130_F04,1,1q41,213132865,213198865,66000,-,-
BAC184_D22,1,1q41,213190863,213267273,76410,-,-
BAC75_N15,1,1q41,213198511,213301557,103046,-,-
BAC141_D04,1,1q41,213343504,213422346,78842,-,-
BAC33_B16,1,1q41,213393395,213513380,119985,-,-
BAC147_D13,1,1q41,213576694,213658953,82259,-,-
BAC118_K19,1,1q41,213617313,213718569,101256,-,-
BAC58_F03,1,1q41,213642501,213739605,97104,-,-
BAC104_P06,1,1q41,213805892,213891462,85570,-,-
BAC127_L17,1,1q41,213843348,213915283,71935,-,-
BAC240_O03,1,1q41,213845058,213937367,92309,-,-
BAC146_P02,1,1q41,213861314,213965778,104464,-,-
BAC29_K08,1,1q41,213970881,214117122,146241,-,-
BAC162_B04,1,1q41,214016445,214094913,78468,-,-
BAC226_G22,1,1q41,214115267,214195027,79760,-,-
BAC150_D03,1,1q41,214149851,214242433,92582,-,-
BAC2_A24,1,1q41,214152726,214259236,106510,-,-
BAC26_M10,1,1q41,214692043,214789808,97765,-,-
BAC183_J01,1,1q41,214743487,214829223,85736,-,-
BAC80_N22,1,1q41,214797647,214886519,88872,-,-
BAC183_F11,1,1q41,214997419,215081807,84388,-,-
BAC226_M15,1,1q41,215031330,215114177,82847,-,-
BAC130_P11,1,1q41,215063708,215175996,112288,-,-
BAC228_P08,1,1q41,215082039,215170392,88353,-,-
BAC10_N01,1,1q41,215128478,215210356,81878,-,-
BAC248_A24,1,1q41,215259286,215340639,81353,-,-
BAC95_I07,1,1q41,215307116,215385648,78532,-,-
BAC81_N19,1,1q41,215307116,215480056,172940,-,-
BAC103_E19,1,1q41,215337264,215451102,113838,-,-
BAC63_K05,1,1q41,215418488,215524701,106213,-,-
BAC72_E16,1,1q41,215418491,215538764,120273,-,-
BAC226_O10,1,1q41,215485666,215577384,91718,-,-
BAC50_N16,1,1q41,215493546,215654401,160855,-,-
BAC52_E09,1,1q41,215559422,215676419,116997,-,-
BAC129_P03,1,1q41,215695145,215799797,104652,-,-
BAC55_M19,1,1q41,215800182,215905820,105638,-,-
BAC96_I18,1,1q41,215815059,215908828,93769,-,-
BAC198_J15,1,1q41,215942267,216034750,92483,-,-
BAC101_D21,1,1q41,216005349,216166790,161441,-,-
BAC82_H24,1,1q41,216087535,216258540,171005,-,-
BAC49_G23,1,1q41,216171426,216294531,123105,-,-
BAC188_H19,1,1q41,216304526,216388769,84243,-,-
BAC241_K08,1,1q41,216396580,216506460,109880,-,-
BAC56_J03,1,1q41,216412401,216500577,88176,-,-
BAC8_K17,1,1q41,216508854,216603853,94999,-,-
BAC193_I01,1,1q41,216537374,216651193,113819,-,-
BAC170_F20,1,1q41,216537374,216630296,92922,-,-
BAC143_I07,1,1q41,216603860,216693694,89834,-,-
BAC196_A19,1,1q41,216626644,216720692,94048,-,-
BAC185_E22,1,1q41,216746099,216824686,78587,-,-
BAC233_D05,1,1q41,216865412,216967157,101745,-,-
BAC159_E12,1,1q41,216912015,216990306,78291,-,-
BAC33_C09,1,1q41,217015217,217156690,141473,-,-
BAC178_D13,1,1q41,217156688,217248366,91678,-,-
BAC53_P05,1,1q41,217167228,217288954,121726,-,-
BAC43_I21,1,1q41,217227528,217374445,146917,-,-
BAC66_N23,1,1q41,217625529,217729987,104458,-,-
BAC243_E09,1,1q41,217748879,217828172,79293,-,-
BAC198_E01,1,1q41,217756743,217845778,89035,-,-
BAC243_L12,1,1q41,217828166,217912311,84145,-,-
BAC49_L18,1,1q41,217828230,217912266,84036,-,-
BAC66_K08,1,1q41,217828552,217918232,89680,-,-
BAC224_C18,1,1q41,217908206,218028302,120096,-,-
BAC185_I08,1,1q41,217908206,218012064,103858,-,-
BAC26_D03,1,1q41,217912182,218028302,116120,-,-
BAC194_P19,1,1q41,217918622,218016742,98120,-,-
BAC176_C03,1,1q41,217992520,218107187,114667,-,-
BAC235_G19,1,1q41,218035768,218107187,71419,-,-
BAC89_G17,1,1q41,218140051,218236536,96485,-,-
BAC162_E24,1,1q41,218140082,218233488,93406,-,-
BAC8_C06,1,1q41,218185952,218280815,94863,-,-
BAC237_D13,1,1q41,218218495,218308480,89985,-,-
BAC107_B01,1,1q41,218238903,218387348,148445,-,-
BAC238_F02,1,1q41,218402309,218544405,142096,-,-
BAC195_G02,1,1q41,218527332,218603194,75862,-,-
BAC235_G18,1,1q41,218576836,218690398,113562,-,-
BAC156_C04,1,1q41,218749703,218850321,100618,-,-
BAC88_B04,1,1q41,218821554,218940442,118888,-,-
BAC183_O13,1,1q41,218826814,218926819,100005,-,-
BAC31_F08,1,1q41,218841278,218948326,107048,-,-
BAC135_J14,1,1q41,218850908,218996550,145642,-,-
BAC187_D23,1,1q41,218851201,218961622,110421,-,-
BAC222_J03,1,1q41,218915192,219011572,96380,-,-
BAC30_E17,1,1q41,219163419,219258996,95577,-,-
BAC76_E04,1,1q41,219189178,219333270,144092,-,-
BAC179_P24,1,1q41,219262200,219365703,103503,-,-
BAC193_P12,1,1q41,219328375,219425546,97171,-,-
BAC69_N03,1,1q41,219358655,219488386,129731,-,-
BAC78_P21,1,1q41,219388622,219488386,99764,-,-
BAC90_N01,1,1q41,219442642,219542998,100356,-,-
BAC2_E19,1,1q41,219446165,219554043,107878,-,-
BAC250_B11,1,1q41,219521058,219615461,94403,-,-
BAC130_D22,1,1q41,219543019,219633745,90726,-,-
BAC193_N12,1,1q41,219587069,219675945,88876,-,-
BAC150_E21,1,1q41,219653302,219733960,80658,-,-
BAC148_N09,1,1q41,219671700,219763294,91594,-,-
BAC156_A18,1,1q41,219672677,219766736,94059,-,-
BAC123_H10,1,1q41,219935200,220017595,82395,-,-
BAC240_A15,1,1q41,220017744,220118928,101184,-,-
BAC135_E18,1,1q41,220063502,220162846,99344,-,-
BAC48_F03,1,1q41,220118947,220257311,138364,-,-
BAC107_D04,1,1q41,220192428,220285773,93345,-,-
BAC237_J17,1,1q41,220232479,220314301,81822,-,-
BAC188_B13,1,1q41,220261793,220337396,75603,-,-
BAC33_H10,1,1q41,220313597,220402283,88686,-,-
BAC21_I10,1,1q41,220439879,220521679,81800,-,-
BAC120_B12,1,1q41,220459348,220564033,104685,-,-
BAC199_N04,1,1q41,220464220,220589167,124947,-,-
BAC229_M12,1,1q41,220466242,220564033,97791,-,-
BAC175_D12,1,1q41,220596402,220678373,81971,-,-
BAC67_N14,1,1q41,220651316,220745766,94450,-,-
BAC186_M22,1,1q41,220688307,220772225,83918,-,-
BAC1_C06,1,1q41,220741339,220835767,94428,-,-
BAC54_B18,1,1q41,220874535,220968208,93673,-,-
BAC83_G24,1,1q41,220885469,221002407,116938,-,-
BAC209_E22,1,1q41,220972766,221064124,91358,-,-
BAC68_G06,1,1q41,220984755,221109523,124768,-,-
BAC34_K24,1,1q41,221015906,221112109,96203,-,-
BAC129_B14,1,1q41,221038499,221109556,71057,-,-
BAC194_D23,1,1q41,221064346,221145626,81280,-,-
BAC165_B10,1,1q41,221081195,221168829,87634,-,-
BAC59_O06,1,1q41,221084599,221177654,93055,-,-
BAC101_M13,1,1q41,221109550,221255095,145545,-,-
BAC24_H06,1,1q41,221145643,221298942,153299,-,-
BAC243_B13,1,1q41,221189049,221284483,95434,-,-
BAC142_C09,1,1q41,221334688,221437031,102343,-,-
BAC167_H04,1,1q41,221447978,221555184,107206,-,-
BAC31_N17,1,1q41,221519430,221628240,108810,-,-
BAC247_N07,1,1q41,221588778,221667449,78671,-,-
BAC58_P07,1,1q41,221615121,221702455,87334,-,-
BAC63_G04,1,1q41,221680458,221774966,94508,-,-
BAC167_N18,1,1q41,221867361,221984332,116971,-,-
BAC1_A22,1,1q41,221886284,221984586,98302,-,-
BAC142_I09,1,1q41,221933863,222049460,115597,-,-
BAC193_P09,1,1q41,221984679,222093737,109058,-,-
BAC24_M07,1,1q41-1q42.11,221988072,222121541,133469,-,-
BAC42_F06,1,1q41-1q42.11,222004901,222113251,108350,-,-
BAC247_O13,1,1q41-1q42.11,222059718,222157674,97956,-,-
BAC84_B19,1,1q41-1q42.11,222093734,222195645,101911,-,-
BAC70_L17,1,1q42.11,222290529,222444924,154395,-,-
BAC214_E20,1,1q42.11,222353884,222413179,59295,-,-
BAC36_D12,1,1q42.11,222404862,222514984,110122,-,-
BAC241_J18,1,1q42.11,222418981,222482632,63651,-,-
BAC18_J09,1,1q42.11,222424502,222567144,142642,-,-
BAC194_A19,1,1q42.11,222447417,222517494,70077,-,-
BAC248_B02,1,1q42.11,222501445,222631736,130291,-,-
BAC55_H16,1,1q42.11,222501445,222612801,111356,-,-
BAC8_I05,1,1q42.11,222515219,222612751,97532,-,-
BAC88_O03,1,1q42.11-1q42.12,222636985,222760219,123234,-,-
BAC178_I04,1,1q42.11-1q42.12,222663087,222772302,109215,-,-
BAC14_I15,1,1q42.11-1q42.12,222666394,222857163,190769,-,-
BAC162_C19,1,1q42.11-1q42.12,222666396,222753434,87038,-,-
BAC231_D19,1,1q42.12,222714559,222798426,83867,-,-
BAC130_N10,1,1q42.12,222789734,222881541,91807,-,-
BAC246_M05,1,1q42.12,222800512,222879357,78845,-,-
BAC91_I13,1,1q42.12,222800513,222926030,125517,-,-
BAC171_N08,1,1q42.12,222846093,222904208,58115,-,-
BAC237_D19,1,1q42.12,222848038,222940030,91992,-,-
BAC191_B16,1,1q42.12,222879392,222946226,66834,-,-
BAC228_D21,1,1q42.12,222904230,222996883,92653,-,-
BAC90_F16,1,1q42.12,222942495,223070968,128473,-,-
BAC169_C15,1,1q42.12,222946220,223032251,86031,-,-
BAC244_G16,1,1q42.12,222981626,223103583,121957,-,-
BAC228_N11,1,1q42.12,223021361,223138331,116970,-,-
BAC105_A19,1,1q42.12,223031045,223138786,107741,-,-
BAC121_A24,1,1q42.12,223032611,223144506,111895,-,-
BAC148_N02,1,1q42.12,223046281,223125728,79447,-,-
BAC188_H07,1,1q42.12,223056851,223118032,61181,-,-
BAC170_G06,1,1q42.12,223097661,223201634,103973,-,-
BAC77_I19,1,1q42.12,223108745,223200496,91751,-,-
BAC241_L01,1,1q42.12,223133071,223257595,124524,-,-
BAC236_A09,1,1q42.12,223298322,223406252,107930,-,-
BAC50_A18,1,1q42.12,223460602,223584150,123548,-,-
BAC199_H23,1,1q42.12,223471016,223583644,112628,-,-
BAC189_K01,1,1q42.12,223527125,223621035,93910,-,-
BAC119_N17,1,1q42.12,223590907,223687848,96941,-,-
BAC139_G10,1,1q42.12,223621029,223716960,95931,-,-
BAC198_D09,1,1q42.12,223639342,223741710,102368,-,-
BAC156_D20,1,1q42.12,223656568,223741707,85139,-,-
BAC15_O22,1,1q42.12,223825360,223918800,93440,-,-
BAC114_N15,1,1q42.12,223830242,223965965,135723,-,-
BAC239_C22,1,1q42.12,223876666,223965999,89333,-,-
BAC218_P22,1,1q42.12,223959845,224082784,122939,-,-
BAC193_B17,1,1q42.12,224068192,224158548,90356,-,-
BAC25_F10,1,1q42.12,224068206,224158548,90342,-,-
BAC160_J18,1,1q42.12,224128934,224247269,118335,-,-
BAC140_N18,1,1q42.12,224129568,224252703,123135,-,-
BAC224_D18,1,1q42.12,224158546,224242081,83535,-,-
BAC21_O09,1,1q42.12,224175028,224284009,108981,-,-
BAC19_A21,1,1q42.12,224225159,224337301,112142,-,-
BAC100_N04,1,1q42.12,224245431,224350632,105201,-,-
BAC60_P19,1,1q42.12,224317711,224427659,109948,-,-
BAC190_C11,1,1q42.12,224337304,224420395,83091,-,-
BAC234_E16,1,1q42.12,224416796,224493254,76458,-,-
BAC163_P08,1,1q42.12,224542082,224565481,23399,-,-
BAC129_P15,1,1q42.12,224570793,224657263,86470,-,-
BAC140_O16,1,1q42.12,224657264,224758269,101005,-,-
BAC171_N09,1,1q42.12,224657266,224746674,89408,-,-
BAC185_I20,1,1q42.12,224660828,224757750,96922,-,-
BAC40_K11,1,1q42.12,224790863,224885458,94595,-,-
BAC233_D15,1,1q42.12,224797579,224886359,88780,-,-
BAC63_A22,1,1q42.12,224797749,224885490,87741,-,-
BAC167_N17,1,1q42.12,224848191,224927991,79800,-,-
BAC246_F01,1,1q42.12,224893397,225039007,145610,-,-
BAC106_J15,1,1q42.12,224932317,225061263,128946,-,-
BAC183_G12,1,1q42.12,224932317,225037213,104896,-,-
BAC50_H09,1,1q42.12,224932318,225037213,104895,-,-
BAC170_F02,1,1q42.12,224948364,225037213,88849,-,-
BAC116_L20,1,1q42.12,224958749,225071866,113117,-,-
BAC237_F20,1,1q42.12,224964204,225039594,75390,-,-
BAC46_J08,1,1q42.12-1q42.13,225039133,225144622,105489,-,-
BAC35_G02,1,1q42.12-1q42.13,225039167,225140818,101651,-,-
BAC38_O03,1,1q42.12-1q42.13,225046664,225141083,94419,-,-
BAC39_G04,1,1q42.12-1q42.13,225069532,225175214,105682,-,-
BAC78_C10,1,1q42.12-1q42.13,225082232,225164471,82239,-,-
BAC141_P22,1,1q42.13,225148339,225265023,116684,yes,-
BAC110_D15,1,1q42.13,225154994,225251157,96163,yes,-
BAC149_F12,1,1q42.13,225171300,225255910,84610,yes,-
BAC120_G03,1,1q42.13,225297454,225393793,96339,-,-
BAC197_M13,1,1q42.13,225356309,225434530,78221,-,-
BAC37_O01,1,1q42.13,225358229,225458266,100037,-,-
BAC68_D18,1,1q42.13,225439003,225570575,131572,-,-
BAC163_L21,1,1q42.13,225439003,225553416,114413,-,-
BAC221_G21,1,1q42.13,225729010,225807974,78964,-,-
BAC182_D06,1,1q42.13,225814811,225911517,96706,-,-
BAC52_I18,1,1q42.13,225882661,226013335,130674,-,-
BAC107_J03,1,1q42.13,225921086,226013370,92284,-,-
BAC69_A08,1,1q42.13,226165224,226252812,87588,-,-
BAC117_P12,1,1q42.13,226187363,226307239,119876,-,-
BAC243_K03,1,1q42.13,226218834,226319700,100866,-,-
BAC190_G17,1,1q42.13,226226879,226305768,78889,-,-
BAC33_D24,1,1q42.13,226305389,226378101,72712,-,-
BAC157_L17,1,1q42.13,226306082,226389269,83187,-,-
BAC33_F04,1,1q42.13,226310960,226452473,141513,-,-
BAC97_G19,1,1q42.13,226339235,226440506,101271,-,-
BAC237_N17,1,1q42.13,226351543,226440506,88963,-,-
BAC26_N01,1,1q42.13,226351543,226440887,89344,-,-
BAC249_F23,1,1q42.13,226351566,226465710,114144,-,-
BAC230_F23,1,1q42.13,226469256,226544711,75455,-,-
BAC218_A14,1,1q42.13,226494720,226628421,133701,-,-
BAC193_G15,1,1q42.13,226529857,226628421,98564,-,-
BAC247_K18,1,1q42.13,226628415,226702632,74217,-,-
BAC28_L09,1,1q42.13,226905195,227023675,118480,-,-
BAC151_G16,1,1q42.13,226912819,227018316,105497,-,-
BAC67_G17,1,1q42.13,226933916,227018316,84400,-,-
BAC40_M22,1,1q42.13,226955370,227052173,96803,-,-
BAC84_O11,1,1q42.13,226996992,227118276,121284,-,-
BAC71_L14,1,1q42.13,227038783,227203248,164465,-,-
BAC132_I07,1,1q42.13,227039268,227117972,78704,-,-
BAC125_A12,1,1q42.13,227102194,227191937,89743,-,-
BAC151_D11,1,1q42.13,227130657,227224712,94055,-,-
BAC10_D03,1,1q42.13,227181073,227287026,105953,-,-
BAC49_J11,1,1q42.13,227181123,227258524,77401,-,-
BAC76_G17,1,1q42.13,227191471,227272448,80977,-,-
BAC24_O06,1,1q42.13,227371003,227480966,109963,-,-
BAC59_L08,1,1q42.13,227380168,227472744,92576,-,-
BAC38_D19,1,1q42.13,227434313,227562399,128086,-,-
BAC51_K10,1,1q42.13,227513116,227744235,231119,-,-
BAC46_K20,1,1q42.13,227537186,227644333,107147,-,-
BAC136_C09,1,1q42.13,227550218,227629120,78902,-,-
BAC38_F02,1,1q42.13,227562448,227647996,85548,-,-
BAC162_F09,1,1q42.13,227596354,227686741,90387,-,-
BAC120_D22,1,1q42.13,227669959,227830039,160080,-,-
BAC14_A01,1,1q42.13,227686924,227824859,137935,-,-
BAC131_N11,1,1q42.13,227703107,227826317,123210,-,-
BAC85_D03,1,1q42.13,227703160,227805078,101918,-,-
BAC128_O05,1,1q42.13,227706843,227821428,114585,-,-
BAC148_O06,1,1q42.13,227707302,227785708,78406,-,-
BAC48_D11,1,1q42.13,227724094,227821433,97339,-,-
BAC74_M14,1,1q42.13,227726545,227826303,99758,-,-
BAC223_G21,1,1q42.13,227730015,227826317,96302,-,-
BAC36_K12,1,1q42.13,227744346,227892416,148070,-,-
BAC248_B10,1,1q42.13,227747759,227824859,77100,-,-
BAC16_O11,1,1q42.13,227890888,227997312,106424,-,-
BAC210_N16,1,1q42.13,227896898,227996931,100033,-,-
BAC131_D19,1,1q42.13,227997315,228095220,97905,-,-
BAC100_F16,1,1q42.13,228011804,228095220,83416,-,-
BAC163_E17,1,1q42.13,228026775,228113089,86314,-,-
BAC218_F06,1,1q42.13,228026775,228124541,97766,-,-
BAC49_E13,1,1q42.13,228044526,228142433,97907,-,-
BAC35_C06,1,1q42.13,228189823,228306766,116943,-,-
BAC183_D17,1,1q42.13,228221903,228306464,84561,-,-
BAC152_I23,1,1q42.13,228343125,228448853,105728,-,-
BAC152_M03,1,1q42.13,228423415,228520978,97563,-,-
BAC248_D17,1,1q42.13,228439264,228511570,72306,-,-
BAC90_F01,1,1q42.13,228544219,228651515,107296,-,-
BAC33_I15,1,1q42.13,228581070,228702873,121803,-,-
BAC33_N17,1,1q42.13-1q42.2,228632925,228819067,186142,-,-
BAC224_M08,1,1q42.13-1q42.2,228710214,228824302,114088,-,-
BAC194_G06,1,1q42.13-1q42.2,228718388,228811727,93339,-,-
BAC91_I03,1,1q42.13-1q42.2,228729497,228824305,94808,-,-
BAC118_G09,1,1q42.13-1q42.2,228777903,228889488,111585,-,-
BAC130_N22,1,1q42.13-1q42.2,228794106,228819067,24961,-,-
BAC40_P07,1,1q42.2,228819896,228934245,114349,-,-
BAC185_K07,1,1q42.2,228879978,228958510,78532,-,-
BAC175_P11,1,1q42.2,228884438,229017222,132784,-,-
BAC158_B23,1,1q42.2,228889790,228982223,92433,-,-
BAC151_O20,1,1q42.2,228889826,228958510,68684,-,-
BAC122_G17,1,1q42.2,228932038,229075810,143772,-,-
BAC31_P08,1,1q42.2,228983710,229153346,169636,-,-
BAC32_B16,1,1q42.2,228983710,229057653,73943,-,-
BAC82_J05,1,1q42.2,229001731,229097726,95995,-,-
BAC76_G15,1,1q42.2,229046175,229149930,103755,-,-
BAC32_E04,1,1q42.2,229049671,229136193,86522,-,-
BAC226_A02,1,1q42.2,229160922,229252808,91886,-,-
BAC68_M15,1,1q42.2,229217190,229381704,164514,-,-
BAC119_J24,1,1q42.2,229280473,229386572,106099,-,-
BAC33_J11,1,1q42.2,229283885,229386641,102756,-,-
BAC234_K16,1,1q42.2,229342801,229420828,78027,-,-
BAC217_L02,1,1q42.2,229381989,229459775,77786,-,-
BAC115_M09,1,1q42.2,229395477,229514362,118885,-,-
BAC29_O11,1,1q42.2,229459770,229545537,85767,-,-
BAC100_A10,1,1q42.2,229459770,229573641,113871,-,-
BAC230_G13,1,1q42.2,229483273,229587984,104711,-,-
BAC42_M12,1,1q42.2,229483282,229591730,108448,-,-
BAC237_P07,1,1q42.2,229534018,229627606,93588,-,-
BAC70_H03,1,1q42.2,229609891,229716637,106746,-,-
BAC35_O11,1,1q42.2,229737529,229808643,71114,-,-
BAC147_E05,1,1q42.2,229746480,229833503,87023,-,-
BAC116_L06,1,1q42.2,229936905,230037021,100116,-,-
BAC90_M24,1,1q42.2,229965110,230059446,94336,-,-
BAC115_F17,1,1q42.2,230045621,230124785,79164,-,-
BAC150_I07,1,1q42.2,230059462,230149587,90125,-,-
BAC197_B10,1,1q42.2,230064259,230182328,118069,-,-
BAC117_N05,1,1q42.2,230078938,230181967,103029,-,-
BAC46_N01,1,1q42.2,230112027,230201054,89027,-,-
BAC92_M20,1,1q42.2,230235465,230331468,96003,-,-
BAC152_P22,1,1q42.2,230296210,230390128,93918,-,-
BAC189_E03,1,1q42.2,230354275,230438336,84061,-,-
BAC173_C17,1,1q42.2,230359892,230450413,90521,-,-
BAC60_M06,1,1q42.2,230367057,230500165,133108,-,-
BAC158_I24,1,1q42.2,230393146,230472747,79601,-,-
BAC196_K15,1,1q42.2,230437978,230521297,83319,-,-
BAC84_L07,1,1q42.2,230526662,230693261,166599,-,-
BAC239_A12,1,1q42.2,230646993,230768530,121537,-,-
BAC90_F06,1,1q42.2,230696927,230789004,92077,-,-
BAC118_H14,1,1q42.2,230699239,230856312,157073,-,-
BAC186_G05,1,1q42.2,230799453,230874432,74979,-,-
BAC248_I06,1,1q42.2,230879580,230974573,94993,-,-
BAC156_A05,1,1q42.2,230886498,230989374,102876,-,-
BAC81_L09,1,1q42.2,230894596,231006226,111630,-,-
BAC21_K18,1,1q42.2,230898674,231036872,138198,-,-
BAC70_L09,1,1q42.2,230910159,230972456,62297,-,-
BAC10_E13,1,1q42.2,231006220,231139406,133186,-,-
BAC152_H03,1,1q42.2,231093096,231213978,120882,-,-
BAC75_C16,1,1q42.2,231182695,231270388,87693,-,-
BAC108_A04,1,1q42.2,231185777,231238599,52822,-,-
BAC119_I13,1,1q42.2,231198647,231346811,148164,-,-
BAC230_F19,1,1q42.2,231227304,231336033,108729,-,-
BAC175_A21,1,1q42.2,231290844,231417491,126647,-,-
BAC63_H03,1,1q42.2,231306941,231397976,91035,-,-
BAC230_A20,1,1q42.2,231397971,231496182,98211,-,-
BAC189_E06,1,1q42.2,231468304,231551115,82811,-,-
BAC80_L07,1,1q42.2,231563381,231748543,185162,-,-
BAC106_H11,1,1q42.2,231563437,231642845,79408,-,-
BAC180_B07,1,1q42.2,231569010,231643626,74616,-,-
BAC15_F14,1,1q42.2,231579009,231668739,89730,-,-
BAC32_N02,1,1q42.2,231685362,231784482,99120,-,-
BAC28_H18,1,1q42.2,231731321,231836036,104715,-,-
BAC151_H13,1,1q42.2,231769717,231843702,73985,-,-
BAC161_B11,1,1q42.2,231837852,231914596,76744,-,-
BAC217_M05,1,1q42.2,231855497,231952784,97287,-,-
BAC133_F24,1,1q42.2,231864268,231926035,61767,-,-
BAC229_P05,1,1q42.2,232148952,232224369,75417,-,-
BAC183_D12,1,1q42.2,232159229,232239559,80330,-,-
BAC239_G22,1,1q42.2,232161626,232261716,100090,-,-
BAC97_H21,1,1q42.2,232217409,232307438,90029,-,-
BAC160_M11,1,1q42.2,232294342,232380814,86472,-,-
BAC219_P10,1,1q42.2,232307510,232418121,110611,-,-
BAC150_B06,1,1q42.2,232350152,232443412,93260,-,-
BAC116_E16,1,1q42.2,232566147,232657784,91637,-,-
BAC66_P01,1,1q42.2-1q42.3,232637152,232727287,90135,-,-
BAC177_I21,1,1q42.2-1q42.3,232639145,232710871,71726,-,-
BAC48_L13,1,1q42.3,232730234,232818633,88399,-,-
BAC12_E24,1,1q42.3,232732457,232799216,66759,-,-
BAC7_I24,1,1q42.3,232787186,232806190,19004,-,-
BAC128_N19,1,1q42.3,232818688,232854852,36164,-,-
BAC128_M20,1,1q42.3,232818688,232854852,36164,-,-
BAC248_N23,1,1q42.3,232819140,232906359,87219,-,-
BAC161_H21,1,1q42.3,232819156,232910242,91086,-,-
BAC106_M01,1,1q42.3,232830819,232841026,10207,-,-
BAC165_A15,1,1q42.3,232907687,233030020,122333,-,-
BAC116_O05,1,1q42.3,232935122,233021633,86511,-,-
BAC243_E13,1,1q42.3,232935129,233032931,97802,-,-
BAC226_M23,1,1q42.3,232949588,233040972,91384,-,-
BAC224_N04,1,1q42.3,233056835,233121005,64170,-,-
BAC58_E14,1,1q42.3,233058739,233160582,101843,-,-
BAC110_D12,1,1q42.3,233095586,233243161,147575,-,-
BAC233_A09,1,1q42.3,233145796,233230055,84259,-,-
BAC97_E04,1,1q42.3,233362266,233471461,109195,-,-
BAC175_F19,1,1q42.3,233362777,233464524,101747,-,-
BAC195_H03,1,1q42.3,233381412,233454991,73579,-,-
BAC38_N12,1,1q42.3,233381412,233510884,129472,-,-
BAC71_K14,1,1q42.3,233517623,233638947,121324,-,-
BAC117_L02,1,1q42.3,233536981,233627880,90899,-,-
BAC5_K23,1,1q42.3,233540961,233638752,97791,-,-
BAC172_D21,1,1q42.3,233589326,233677301,87975,-,-
BAC66_K12,1,1q42.3,233597379,233726244,128865,-,-
BAC20_D14,1,1q42.3,233597382,233718818,121436,-,-
BAC146_G18,1,1q42.3,233624031,233704027,79996,-,-
BAC115_K17,1,1q42.3,233759035,233852265,93230,-,-
BAC66_E17,1,1q42.3,233806449,233915413,108964,-,-
BAC190_D09,1,1q42.3,233833525,233899509,65984,-,-
BAC110_L18,1,1q42.3,233833525,233955356,121831,-,-
BAC40_B24,1,1q42.3,233928439,234034630,106191,-,-
BAC140_O02,1,1q42.3,234009148,234087407,78259,-,-
BAC23_O23,1,1q42.3,234009167,234127266,118099,-,-
BAC49_B19,1,1q42.3,234070515,234161139,90624,-,-
BAC230_N07,1,1q42.3,234078511,234157314,78803,-,-
BAC124_B08,1,1q42.3,234112378,234224564,112186,-,-
BAC145_N14,1,1q42.3,234127263,234224440,97177,-,-
BAC24_I20,1,1q42.3,234223015,234334035,111020,-,-
BAC78_G14,1,1q42.3,234246246,234353258,107012,-,-
BAC222_K01,1,1q42.3,234351974,234445039,93065,-,-
BAC227_G18,1,1q42.3,234353283,234445039,91756,-,-
BAC181_M02,1,1q42.3-1q43,234506592,234613925,107333,-,-
BAC66_H22,1,1q42.3-1q43,234543448,234726276,182828,-,-
BAC58_F19,1,1q43,234611333,234775118,163785,-,-
BAC154_D19,1,1q43,234634139,234726704,92565,-,-
BAC66_I19,1,1q43,234664179,234778718,114539,-,-
BAC156_I22,1,1q43,234676640,234778718,102078,-,-
BAC19_K05,1,1q43,234677778,234775118,97340,-,-
BAC66_H21,1,1q43,234681359,234778741,97382,-,-
BAC65_A13,1,1q43,234694904,234793127,98223,-,-
BAC40_F20,1,1q43,234701840,234792963,91123,-,-
BAC217_H23,1,1q43,234701841,234793127,91286,-,-
BAC108_L13,1,1q43,234748147,234839373,91226,-,-
BAC41_P18,1,1q43,234778733,234893913,115180,-,-
BAC221_D19,1,1q43,234778733,234880765,102032,-,-
BAC55_N05,1,1q43,234801090,234890426,89336,-,-
BAC73_P20,1,1q43,234805723,234899624,93901,-,-
BAC149_I05,1,1q43,234834494,234961951,127457,-,-
BAC211_L17,1,1q43,234855246,234959943,104697,-,-
BAC102_O07,1,1q43,234929300,235054333,125033,-,-
BAC100_B02,1,1q43,234948124,235041084,92960,-,-
BAC81_E02,1,1q43,234976646,235101126,124480,-,-
BAC51_L15,1,1q43,234990715,235108599,117884,-,-
BAC100_E16,1,1q43,234992621,235079497,86876,-,-
BAC148_F15,1,1q43,235003759,235081364,77605,-,-
BAC97_D21,1,1q43,235091835,235170006,78171,-,-
BAC217_P06,1,1q43,235110800,235219608,108808,-,-
BAC32_G13,1,1q43,235212761,235330032,117271,-,-
BAC234_B09,1,1q43,235282176,235379217,97041,-,-
BAC136_H23,1,1q43,235340346,235433582,93236,-,-
BAC185_N18,1,1q43,235381097,235463027,81930,-,-
BAC53_J19,1,1q43,235457059,235588777,131718,-,-
BAC91_M05,1,1q43,235457903,235596521,138618,-,-
BAC41_P13,1,1q43,235464818,235590931,126113,-,-
BAC60_G16,1,1q43,235564510,235670533,106023,-,-
BAC66_D22,1,1q43,235645460,235771556,126096,-,-
BAC49_K16,1,1q43,235651967,235771437,119470,-,-
BAC132_D14,1,1q43,235802635,235915148,112513,-,-
BAC200_C10,1,1q43,235915143,235961759,46616,-,-
BAC101_G11,1,1q43,235920430,236016687,96257,-,-
BAC81_O05,1,1q43,236078560,236167559,88999,-,-
BAC169_M22,1,1q43,236114269,236208322,94053,-,-
BAC189_L08,1,1q43,236192904,236278758,85854,-,-
BAC68_I09,1,1q43,236336049,236448426,112377,-,-
BAC42_A15,1,1q43,236440454,236618350,177896,-,-
BAC143_D07,1,1q43,236445254,236539419,94165,-,-
BAC71_C18,1,1q43,236448421,236543174,94753,-,-
BAC129_L23,1,1q43,236479944,236560007,80063,-,-
BAC10_F14,1,1q43,236534523,236724662,190139,-,-
BAC108_G14,1,1q43,236566644,236661820,95176,-,-
BAC204_J13,1,1q43,236571647,236662875,91228,-,-
BAC124_C09,1,1q43,236702850,236842338,139488,-,-
BAC162_P24,1,1q43,236752272,236856835,104563,-,-
BAC241_G05,1,1q43,236864549,236951716,87167,-,-
BAC100_B10,1,1q43,237134782,237240866,106084,-,-
BAC147_A02,1,1q43,237160330,237174906,14576,-,-
BAC170_F18,1,1q43,237224918,237294679,69761,-,-
BAC132_P11,1,1q43,237243651,237359888,116237,-,-
BAC230_C09,1,1q43,237243653,237353501,109848,-,-
BAC240_O01,1,1q43,237287790,237371485,83695,-,-
BAC188_F14,1,1q43,237404338,237505104,100766,-,-
BAC38_F12,1,1q43,237558149,237688567,130418,-,-
BAC195_E24,1,1q43,237596293,237701874,105581,-,-
BAC109_J11,1,1q43,237609486,237709627,100141,-,-
BAC39_I24,1,1q43,237673021,237765665,92644,-,-
BAC171_H09,1,1q43,237712318,237831818,119500,-,-
BAC127_C24,1,1q43,237786875,237905220,118345,-,-
BAC63_F18,1,1q43,237823722,237945782,122060,-,-
BAC150_E22,1,1q43,237824225,237905220,80995,-,-
BAC50_G19,1,1q43,237848394,237931959,83565,-,-
BAC80_F15,1,1q43,237881926,237986317,104391,-,-
BAC180_N23,1,1q43,238004929,238096965,92036,-,-
BAC227_O06,1,1q43,238017342,238091104,73762,-,-
BAC233_G09,1,1q43,238040045,238117837,77792,-,-
BAC42_C02,1,1q43,238143092,238226926,83834,-,-
BAC143_F17,1,1q43,238162521,238251001,88480,-,-
BAC25_A19,1,1q43,238256420,238340566,84146,-,-
BAC144_G03,1,1q43,238653863,238738545,84682,-,-
BAC125_A23,1,1q43,238666862,238816426,149564,-,-
BAC221_A17,1,1q43,238696581,238783535,86954,-,-
BAC218_M01,1,1q43,238698951,238779895,80944,-,-
BAC147_M23,1,1q43,238698951,238816426,117475,-,-
BAC151_C07,1,1q43,238881210,238971836,90626,-,-
BAC218_O10,1,1q43,238958350,239046442,88092,-,-
BAC19_F18,1,1q43,239128242,239220191,91949,-,-
BAC61_F01,1,1q43,239190739,239281922,91183,-,-
BAC178_H01,1,1q43,239305640,239396543,90903,-,-
BAC49_N01,1,1q43,239338044,239456105,118061,-,-
BAC53_F16,1,1q43,239421615,239528784,107169,-,-
BAC63_E04,1,1q43,239454931,239560404,105473,-,-
BAC43_A07,1,1q43,239649056,239771801,122745,-,-
BAC12_O13,1,1q43,239691658,239840070,148412,-,-
BAC37_P24,1,1q43,239744361,239840081,95720,-,-
BAC185_C14,1,1q43,239744536,239839640,95104,-,-
BAC151_D05,1,1q43,239777065,239877742,100677,-,-
BAC188_J12,1,1q43,239840074,239908785,68711,-,-
BAC252_K03,1,1q43,239877738,239979867,102129,-,-
BAC215_L02,1,1q43,239913186,239995229,82043,-,-
BAC26_O05,1,1q43,239940317,240043270,102953,-,-
BAC117_J09,1,1q43,239992713,240066745,74032,-,-
BAC200_E09,1,1q43,239998509,240083060,84551,-,-
BAC67_L13,1,1q43,240004403,240103393,98990,-,-
BAC123_O01,1,1q43,240120770,240246651,125881,-,-
BAC239_N18,1,1q43,240198626,240277859,79233,-,-
BAC107_P05,1,1q43,240659355,240768946,109591,-,-
BAC49_P19,1,1q43,240659355,240755434,96079,-,-
BAC200_P23,1,1q43,240660447,240752817,92370,-,-
BAC80_G12,1,1q43,240663676,240768946,105270,-,-
BAC247_A21,1,1q43,240696153,240768946,72793,-,-
BAC88_D08,1,1q43,240836326,240864754,28428,-,-
BAC182_F03,1,1q43,240921298,241022217,100919,-,-
BAC46_C14,1,1q43,240925398,241026088,100690,-,-
BAC192_J15,1,1q43,240970322,241059526,89204,-,-
BAC76_P22,1,1q43,240970322,241171849,201527,-,-
BAC221_H16,1,1q43,241074142,241157104,82962,-,-
BAC208_F10,1,1q43,241077739,241177189,99450,-,-
BAC132_O20,1,1q43,241136278,241216230,79952,-,-
BAC15_M05,1,1q43,241148136,241308705,160569,-,-
BAC158_N01,1,1q43,241188778,241270206,81428,-,-
BAC129_L21,1,1q43,241197970,241291970,94000,-,-
BAC233_F21,1,1q43,241226327,241326644,100317,-,-
BAC51_A13,1,1q43,241246615,241386751,140136,-,-
BAC100_K09,1,1q43,241270552,241373087,102535,-,-
BAC218_C20,1,1q43,241291970,241362103,70133,-,-
BAC149_M01,1,1q43,241401776,241510311,108535,-,-
BAC82_E11,1,1q43,241464441,241563869,99428,-,-
BAC55_O07,1,1q43,241464506,241606226,141720,-,-
BAC239_M10,1,1q43,241483726,241592417,108691,-,-
BAC118_P08,1,1q43,241493933,241584088,90155,-,-
BAC198_H18,1,1q43,241509560,241592417,82857,-,-
BAC63_G14,1,1q43,241584082,241688254,104172,-,-
BAC173_N11,1,1q43,241592709,241678048,85339,-,-
BAC168_C19,1,1q43-1q44,241619615,241721132,101517,-,-
BAC222_E02,1,1q43-1q44,241619770,241732398,112628,-,-
BAC217_H11,1,1q44,241783472,241841533,58061,-,-
BAC156_J05,1,1q44,242045489,242133411,87922,-,-
BAC168_F18,1,1q44,242045725,242133437,87712,-,-
BAC43_F23,1,1q44,242157330,242255234,97904,-,-
BAC134_B22,1,1q44,242206934,242307214,100280,-,-
BAC183_E14,1,1q44,242237500,242345939,108439,-,-
BAC221_A18,1,1q44,242237516,242323005,85489,-,-
BAC2_P19,1,1q44,242297970,242389721,91751,-,-
BAC71_K03,1,1q44,242305372,242435522,130150,-,-
BAC142_F06,1,1q44,242347882,242425038,77156,-,-
BAC132_O19,1,1q44,242426995,242554397,127402,-,-
BAC175_M19,1,1q44,242457200,242593900,136700,-,-
BAC125_O02,1,1q44,242457200,242565414,108214,-,-
BAC64_K02,1,1q44,242478442,242648737,170295,-,-
BAC37_C05,1,1q44,242495369,242658406,163037,-,-
BAC80_M16,1,1q44,242641682,242761349,119667,-,-
BAC123_O10,1,1q44,242684993,242808066,123073,-,-
BAC22_G05,1,1q44,242747163,242842063,94900,-,-
BAC81_G10,1,1q44,242846796,242962135,115339,-,-
BAC110_H07,1,1q44,242894178,243059788,165610,-,-
BAC151_N10,1,1q44,242926963,243038058,111095,-,-
BAC241_O14,1,1q44,242979396,243089196,109800,-,-
BAC223_H06,1,1q44,242988492,243077629,89137,-,-
BAC219_I15,1,1q44,243059947,243174085,114138,-,-
BAC160_M24,1,1q44,243068261,243166033,97772,-,-
BAC128_G20,1,1q44,243129800,243223784,93984,-,-
BAC34_K18,1,1q44,243184883,243329197,144314,-,-
BAC252_I24,1,1q44,243237564,243324788,87224,-,-
BAC132_M10,1,1q44,243240118,243331679,91561,-,-
BAC88_C16,1,1q44,243251379,243399253,147874,-,-
BAC50_M16,1,1q44,243258959,243354261,95302,-,-
BAC119_B16,1,1q44,243281452,243399165,117713,-,-
BAC157_H10,1,1q44,243332721,243413698,80977,-,-
BAC41_C08,1,1q44,243337793,243399165,61372,-,-
BAC110_G08,1,1q44,243449151,243531620,82469,-,-
BAC171_C05,1,1q44,243456787,243547335,90548,-,-
BAC104_K05,1,1q44,243474399,243568077,93678,-,-
BAC184_I16,1,1q44,243559036,243632677,73641,-,-
BAC171_G11,1,1q44,243581619,243661096,79477,-,-
BAC53_A07,1,1q44,243590496,243690788,100292,-,-
BAC31_F19,1,1q44,243611432,243741210,129778,-,-
BAC249_J20,1,1q44,243628344,243709252,80908,-,-
BAC208_H09,1,1q44,243639164,243724230,85066,-,-
BAC143_H13,1,1q44,243639760,243722282,82522,-,-
BAC127_C01,1,1q44,243643056,243769130,126074,-,-
BAC180_H22,1,1q44,243661288,243741205,79917,-,-
BAC224_L12,1,1q44,243788385,243882614,94229,-,-
BAC92_E04,1,1q44,243788386,243946384,157998,-,-
BAC84_F17,1,1q44,243871620,243987483,115863,-,-
BAC92_P16,1,1q44,243882607,243983857,101250,-,-
BAC109_E07,1,1q44,243884425,243991465,107040,-,-
BAC132_P04,1,1q44,243946378,244027451,81073,-,-
BAC32_N01,1,1q44,244029685,244124252,94567,-,-
BAC155_I01,1,1q44,244124549,244216742,92193,-,-
BAC134_E18,1,1q44,244133362,244270213,136851,-,-
BAC186_F14,1,1q44,244157148,244264440,107292,-,-
BAC103_P12,1,1q44,244174189,244255596,81407,-,-
BAC159_G01,1,1q44,244194922,244288561,93639,-,-
BAC170_A16,1,1q44,244216735,244303641,86906,-,-
BAC125_I17,1,1q44,244260967,244356615,95648,-,-
BAC169_D11,1,1q44,244423808,244511369,87561,-,-
BAC162_L07,1,1q44,244436903,244524528,87625,-,-
BAC8_K13,1,1q44,244613794,244767759,153965,-,-
BAC192_F12,1,1q44,244621959,244713600,91641,-,-
BAC223_N09,1,1q44,244636449,244727797,91348,-,-
BAC125_M18,1,1q44,244651099,244826322,175223,-,-
BAC100_K22,1,1q44,244767751,244865022,97271,-,-
BAC238_N11,1,1q44,244773996,244870738,96742,-,-
BAC155_H22,1,1q44,244894370,245013609,119239,-,-
BAC64_N04,1,1q44,244898565,245013608,115043,-,-
BAC101_K14,1,1q44,244909125,245062764,153639,-,-
BAC51_P20,1,1q44,245039246,245182426,143180,-,-
BAC248_N13,1,1q44,245081272,245190015,108743,-,-
BAC67_N06,1,1q44,245207530,245303267,95737,-,-
BAC55_I16,1,1q44,245282883,245420180,137297,-,-
BAC59_F24,1,1q44,245296623,245451168,154545,-,-
BAC97_H18,1,1q44,245303330,245415593,112263,-,-
BAC71_O14,1,1q44,245309766,245415593,105827,-,-
BAC186_H10,1,1q44,245312940,245390763,77823,-,-
BAC150_H23,1,1q44,245312940,245435767,122827,-,-
BAC118_D20,1,1q44,245374719,245475964,101245,-,-
BAC60_P06,1,1q44,245449148,245572069,122921,-,-
BAC107_J02,1,1q44,245481669,245573820,92151,-,-
BAC12_E08,1,1q44,245610225,245687101,76876,-,-
BAC168_K20,1,1q44,245624018,245718337,94319,-,-
BAC183_I06,1,1q44,245772259,245845260,73001,-,-
BAC221_I23,1,1q44,245824695,245912686,87991,-,-
BAC40_C04,1,1q44,245862006,246054340,192334,-,-
BAC197_D18,1,1q44,245929832,246007535,77703,-,-
BAC165_J11,1,1q44,245950030,246042366,92336,-,-
BAC38_P06,1,1q44,245975650,246084832,109182,-,-
BAC58_B04,1,1q44,245995781,246083216,87435,-,-
BAC149_M17,1,1q44,246261346,246357568,96222,-,-
BAC183_A07,1,1q44,246261645,246350114,88469,-,-
BAC200_O19,1,1q44,246307136,246412081,104945,-,-
BAC241_F21,1,1q44,246350109,246461836,111727,-,-
BAC56_J22,1,1q44,246449755,246547456,97701,-,-
BAC233_L17,1,1q44,246452761,246545487,92726,-,-
BAC176_G10,1,1q44,246468807,246570679,101872,-,-
BAC24_P18,1,1q44,246468807,246593250,124443,yes,-
BAC46_H15,1,1q44,246506385,246654546,148161,yes,-
BAC225_B05,1,1q44,246570674,246648236,77562,yes,-
BAC217_N09,1,1q44,246590034,246688895,98861,yes,-
BAC157_M24,1,1q44,246590050,246668389,78339,yes,-
BAC218_N17,1,1q44,246590319,246665145,74826,yes,-
BAC61_J15,1,1q44,246709081,246798531,89450,yes,-
BAC170_J05,1,1q44,246799049,246886333,87284,yes,-
BAC170_F17,1,1q44,246799049,246943096,144047,yes,-
BAC217_C14,1,1q44,246854517,246943080,88563,yes,-
BAC200_I01,1,1q44,247037134,247126674,89540,-,-
BAC53_N07,1,1q44,247047218,247124928,77710,-,-
BAC78_I12,1,1q44,247085331,247197616,112285,-,-
BAC234_C09,2,2p25.3,47767,154090,106323,-,-
BAC167_M21,2,2p25.3,55095,148470,93375,-,-
BAC124_M07,2,2p25.3,103598,189562,85964,-,-
BAC160_F12,2,2p25.3,103630,201900,98270,-,-
BAC135_B14,2,2p25.3,184543,292411,107868,-,-
BAC76_G16,2,2p25.3,201895,292411,90516,-,-
BAC165_F07,2,2p25.3,240699,320642,79943,-,-
BAC120_H01,2,2p25.3,264477,366133,101656,-,-
BAC40_L04,2,2p25.3,308414,413022,104608,-,-
BAC159_C05,2,2p25.3,308424,393223,84799,-,-
BAC172_C21,2,2p25.3,308486,395212,86726,-,-
BAC239_F10,2,2p25.3,372693,470178,97485,-,-
BAC95_C16,2,2p25.3,375331,470875,95544,-,-
BAC158_E05,2,2p25.3,397276,495692,98416,-,-
BAC225_L14,2,2p25.3,415053,554371,139318,-,-
BAC190_P15,2,2p25.3,484897,592342,107445,-,-
BAC107_A14,2,2p25.3,495694,603948,108254,-,-
BAC95_I18,2,2p25.3,530976,672270,141294,yes,-
BAC58_L23,2,2p25.3,554350,648291,93941,-,-
BAC19_E24,2,2p25.3,643308,793207,149899,yes,-
BAC160_A02,2,2p25.3,672315,750109,77794,-,-
BAC88_J01,2,2p25.3,674261,754367,80106,-,-
BAC43_E03,2,2p25.3,676046,771000,94954,-,-
BAC122_H18,2,2p25.3,685823,848489,162666,-,-
BAC37_K02,2,2p25.3,772424,882763,110339,-,-
BAC106_I22,2,2p25.3,784600,875290,90690,-,-
BAC199_D14,2,2p25.3,784612,882763,98151,-,-
BAC61_O13,2,2p25.3,841760,925974,84214,-,-
BAC218_M04,2,2p25.3,890168,1023547,133379,-,-
BAC108_J02,2,2p25.3,899796,1025966,126170,-,-
BAC231_J17,2,2p25.3,909626,1005235,95609,-,-
BAC72_D17,2,2p25.3,925971,1005235,79264,-,-
BAC40_N18,2,2p25.3,925979,1045047,119068,-,-
BAC230_H18,2,2p25.3,945069,1057187,112118,-,-
BAC179_C13,2,2p25.3,986028,1069568,83540,-,-
BAC1_J08,2,2p25.3,1027089,1117062,89973,-,-
BAC193_N07,2,2p25.3,1050314,1141423,91109,-,-
BAC27_O17,2,2p25.3,1057361,1148505,91144,-,-
BAC140_I04,2,2p25.3,1060324,1151748,91424,-,-
BAC142_D17,2,2p25.3,1069752,1151748,81996,-,-
BAC238_D16,2,2p25.3,1069752,1199632,129880,-,-
BAC143_G04,2,2p25.3,1085601,1215443,129842,-,-
BAC29_J18,2,2p25.3,1085780,1202441,116661,-,-
BAC19_I16,2,2p25.3,1287887,1358443,70556,-,-
BAC18_C19,2,2p25.3,1369749,1469985,100236,-,-
BAC69_O10,2,2p25.3,1382231,1501092,118861,-,-
BAC57_L10,2,2p25.3,1438695,1532459,93764,-,-
BAC22_H01,2,2p25.3,1464331,1553282,88951,-,-
BAC25_O22,2,2p25.3,1582372,1613347,30975,-,-
BAC29_I23,2,2p25.3,1675605,1764346,88741,-,-
BAC101_H13,2,2p25.3,1709420,1799192,89772,-,-
BAC105_M13,2,2p25.3,1764336,1865215,100879,-,-
BAC220_P19,2,2p25.3,1773036,1894044,121008,-,-
BAC168_H20,2,2p25.3,1860706,1938289,77583,-,-
BAC69_F03,2,2p25.3,1861646,1973838,112192,-,-
BAC202_G02,2,2p25.3,1884840,1973817,88977,-,-
BAC32_C14,2,2p25.3,1946255,2138340,192085,-,-
BAC146_B11,2,2p25.3,2031232,2154382,123150,-,-
BAC56_C23,2,2p25.3,2038660,2153809,115149,-,-
BAC66_B14,2,2p25.3,2042616,2075729,33113,-,-
BAC112_O02,2,2p25.3,2185723,2305372,119649,-,-
BAC39_B09,2,2p25.3,2194910,2298168,103258,-,-
BAC190_N13,2,2p25.3,2228216,2307702,79486,-,-
BAC235_D12,2,2p25.3,2228220,2309269,81049,-,-
BAC242_C04,2,2p25.3,2398096,2535512,137416,-,-
BAC194_P10,2,2p25.3,2398339,2502026,103687,-,-
BAC100_A19,2,2p25.3,2415357,2502027,86670,-,-
BAC89_F09,2,2p25.3,2424405,2535512,111107,-,-
BAC153_L04,2,2p25.3,2435102,2510820,75718,-,-
BAC19_D07,2,2p25.3,2488378,2623869,135491,-,-
BAC43_A22,2,2p25.3,2516225,2662990,146765,-,-
BAC68_D03,2,2p25.3,2550255,2643300,93045,-,-
BAC31_K05,2,2p25.3,2550258,2644937,94679,-,-
BAC34_P09,2,2p25.3,2575480,2668847,93367,-,-
BAC158_B22,2,2p25.3,2585316,2678141,92825,-,-
BAC181_J06,2,2p25.3,2649920,2762264,112344,-,-
BAC247_B21,2,2p25.3,2708627,2791285,82658,-,-
BAC70_E12,2,2p25.3,2708724,2795774,87050,-,-
BAC128_K10,2,2p25.3,2738292,2869158,130866,-,-
BAC229_A12,2,2p25.3,2740261,2827068,86807,-,-
BAC142_O22,2,2p25.3,2740261,2824409,84148,-,-
BAC19_N03,2,2p25.3,2762946,2886655,123709,-,-
BAC200_K20,2,2p25.3,2824402,2910085,85683,-,-
BAC58_B10,2,2p25.3,2876449,2992104,115655,-,-
BAC196_E23,2,2p25.3,2910080,2992077,81997,-,-
BAC104_B20,2,2p25.3,3035186,3116235,81049,-,-
BAC150_A21,2,2p25.3,3058853,3151465,92612,-,-
BAC55_N09,2,2p25.3,3058866,3151464,92598,-,-
BAC173_B09,2,2p25.3,3152012,3232713,80701,-,-
BAC36_E24,2,2p25.3,3255179,3344893,89714,-,-
BAC33_A03,2,2p25.3,3364309,3455863,91554,-,-
BAC167_K16,2,2p25.3,3379796,3456165,76369,-,-
BAC181_I07,2,2p25.3,3655131,3734218,79087,yes,-
BAC115_E17,2,2p25.3,3658443,3748131,89688,-,-
BAC228_D18,2,2p25.3,3669860,3748144,78284,yes,-
BAC128_F10,2,2p25.3,3693880,3803051,109171,-,-
BAC57_P02,2,2p25.3,3730615,3844102,113487,-,-
BAC200_M18,2,2p25.3,3740239,3859154,118915,-,-
BAC100_E21,2,2p25.3,3751617,3889900,138283,-,-
BAC133_F09,2,2p25.3,3899956,3991453,91497,-,-
BAC125_M11,2,2p25.3,3938239,4033075,94836,-,-
BAC148_B13,2,2p25.3,3975552,4076371,100819,-,-
BAC165_N24,2,2p25.3,3990235,4085061,94826,-,-
BAC103_B18,2,2p25.3,4033076,4166734,133658,-,-
BAC88_D20,2,2p25.3,4036627,4139036,102409,-,-
BAC143_H19,2,2p25.3,4060718,4142847,82129,-,-
BAC161_A08,2,2p25.3,4068882,4151909,83027,-,-
BAC96_G13,2,2p25.3-2p25.2,4262073,4347118,85045,-,-
BAC117_L19,2,2p25.2,4329496,4464120,134624,-,-
BAC58_J18,2,2p25.2,4338193,4444738,106545,-,-
BAC173_O10,2,2p25.2,4416746,4517541,100795,-,-
BAC169_B04,2,2p25.2,4494878,4573968,79090,-,-
BAC32_O18,2,2p25.2,4517539,4607794,90255,-,-
BAC73_C10,2,2p25.2,4618645,4710930,92285,-,-
BAC19_A02,2,2p25.2,4728007,4807464,79457,-,-
BAC102_D14,2,2p25.2,4797560,4889417,91857,-,-
BAC155_L04,2,2p25.2,4878866,4964158,85292,-,-
BAC58_O18,2,2p25.2,5173390,5325793,152403,-,-
BAC78_I11,2,2p25.2,5251432,5403699,152267,-,-
BAC89_J13,2,2p25.2,5279106,5414179,135073,-,-
BAC165_B05,2,2p25.2,5307870,5398902,91032,-,-
BAC249_P05,2,2p25.2,5388021,5498222,110201,-,-
BAC40_L22,2,2p25.2,5414214,5624031,209817,-,-
BAC157_A11,2,2p25.2,5456793,5552343,95550,-,-
BAC161_G05,2,2p25.2,5467436,5545664,78228,-,-
BAC46_L21,2,2p25.2,5498316,5591854,93538,-,-
BAC69_J07,2,2p25.2,5554873,5643120,88247,-,-
BAC140_C09,2,2p25.2,5563056,5673464,110408,-,-
BAC25_O14,2,2p25.2,5627152,5829782,202630,-,-
BAC146_P05,2,2p25.2,5657079,5752087,95008,-,-
BAC215_O18,2,2p25.2,5675776,5767618,91842,-,-
BAC140_K03,2,2p25.2,5687973,5769314,81341,-,-
BAC12_M18,2,2p25.2,5848731,5963586,114855,-,-
BAC161_D16,2,2p25.2,5848838,5947286,98448,-,-
BAC34_P10,2,2p25.2,5862775,5953846,91071,-,-
BAC148_H03,2,2p25.2,5923128,6014623,91495,-,-
BAC132_E08,2,2p25.2,5952112,6060717,108605,-,-
BAC233_D06,2,2p25.2,5965876,6068378,102502,-,-
BAC117_M19,2,2p25.2,6005272,6097846,92574,-,-
BAC67_G09,2,2p25.2,6005336,6100652,95316,-,-
BAC208_N13,2,2p25.2,6068666,6155687,87021,-,-
BAC113_O03,2,2p25.2,6091522,6183864,92342,-,-
BAC43_B18,2,2p25.2,6103480,6239639,136159,-,-
BAC246_D16,2,2p25.2,6201718,6327595,125877,-,-
BAC37_J15,2,2p25.2,6207935,6342031,134096,-,-
BAC250_L06,2,2p25.2,6231777,6307682,75905,-,-
BAC28_E11,2,2p25.2,6231848,6337595,105747,-,-
BAC175_I23,2,2p25.2,6233671,6341625,107954,-,-
BAC146_H08,2,2p25.2,6322113,6411378,89265,-,-
BAC219_C13,2,2p25.2,6341723,6445435,103712,-,-
BAC64_K16,2,2p25.2,6428960,6540256,111296,-,-
BAC188_D04,2,2p25.2,6509188,6596054,86866,-,-
BAC22_E15,2,2p25.2,6540254,6630540,90286,-,-
BAC33_G23,2,2p25.2,6698290,6793898,95608,-,-
BAC193_F15,2,2p25.2,6848265,6947436,99171,-,-
BAC22_I01,2,2p25.2,6867289,6980155,112866,-,-
BAC34_O23,2,2p25.2-2p25.1,6902705,7014363,111658,-,-
BAC133_M23,2,2p25.2-2p25.1,6905053,7001081,96028,-,-
BAC66_C10,2,2p25.2-2p25.1,6935849,7031973,96124,-,-
BAC64_A17,2,2p25.1,7013841,7126749,112908,-,-
BAC143_O24,2,2p25.1,7014374,7100936,86562,-,-
BAC175_A19,2,2p25.1,7043845,7161555,117710,-,-
BAC24_G10,2,2p25.1,7051596,7154062,102466,-,-
BAC160_C24,2,2p25.1,7062869,7172451,109582,-,-
BAC91_J08,2,2p25.1,7112764,7207191,94427,-,-
BAC234_H03,2,2p25.1,7177225,7263441,86216,-,-
BAC63_B11,2,2p25.1,7177225,7267137,89912,-,-
BAC160_M13,2,2p25.1,7195597,7296392,100795,-,-
BAC141_D11,2,2p25.1,7267174,7369116,101942,-,-
BAC236_B10,2,2p25.1,7273851,7383698,109847,-,-
BAC107_M11,2,2p25.1,7374893,7499467,124574,-,-
BAC36_E14,2,2p25.1,7428414,7565767,137353,-,-
BAC190_P13,2,2p25.1,7446841,7569260,122419,-,-
BAC27_H22,2,2p25.1,7476570,7615305,138735,-,-
BAC24_N22,2,2p25.1,7499487,7655000,155513,-,-
BAC68_A14,2,2p25.1,7511401,7622949,111548,-,-
BAC239_K07,2,2p25.1,7524447,7580851,56404,-,-
BAC42_P23,2,2p25.1,7537569,7638572,101003,-,-
BAC199_N18,2,2p25.1,7743937,7813253,69316,-,-
BAC151_D19,2,2p25.1,7826829,7969113,142284,-,-
BAC148_N03,2,2p25.1,7924225,8004377,80152,-,-
BAC102_D17,2,2p25.1,7924225,8007591,83366,-,-
BAC242_J15,2,2p25.1,7931545,8023755,92210,-,-
BAC101_N14,2,2p25.1,7948413,8056515,108102,-,-
BAC162_B20,2,2p25.1,7949034,8024698,75664,-,-
BAC19_E13,2,2p25.1,7949042,8052846,103804,-,-
BAC233_A19,2,2p25.1,7954191,8052846,98655,-,-
BAC123_J02,2,2p25.1,7954191,8052846,98655,-,-
BAC45_E16,2,2p25.1,7962231,8056494,94263,-,-
BAC88_P03,2,2p25.1,7965332,8052846,87514,-,-
BAC196_I08,2,2p25.1,8004369,8096831,92462,-,-
BAC135_L13,2,2p25.1,8052839,8138979,86140,-,-
BAC67_J16,2,2p25.1,8096825,8206378,109553,-,-
BAC59_P14,2,2p25.1,8135918,8245792,109874,-,-
BAC22_O20,2,2p25.1,8180826,8301644,120818,-,-
BAC65_P06,2,2p25.1,8182419,8271229,88810,-,-
BAC106_K22,2,2p25.1,8326613,8419807,93194,-,-
BAC150_N15,2,2p25.1,8393425,8514150,120725,-,-
BAC92_H17,2,2p25.1,8404012,8524994,120982,-,-
BAC61_D23,2,2p25.1,8405628,8514153,108525,-,-
BAC117_K17,2,2p25.1,8419815,8519939,100124,-,-
BAC100_H21,2,2p25.1,8463104,8591439,128335,-,-
BAC49_D17,2,2p25.1,8519948,8674348,154400,-,-
BAC181_C10,2,2p25.1,8576992,8664469,87477,-,-
BAC134_F06,2,2p25.1,8606225,8688766,82541,-,-
BAC91_I12,2,2p25.1,8669616,8787952,118336,-,-
BAC219_L21,2,2p25.1,8704585,8809595,105010,-,-
BAC43_B23,2,2p25.1,8727871,8801430,73559,-,-
BAC188_G17,2,2p25.1,8732961,8814590,81629,-,-
BAC37_J13,2,2p25.1,8745593,8864531,118938,-,-
BAC168_A02,2,2p25.1,8756130,8846248,90118,-,-
BAC150_O03,2,2p25.1,8802443,8891060,88617,-,-
BAC100_A16,2,2p25.1,8805873,8894961,89088,-,-
BAC73_C04,2,2p25.1,8864547,8958306,93759,-,-
BAC198_L18,2,2p25.1,8895313,8949750,54437,-,-
BAC155_N06,2,2p25.1,8907796,9051057,143261,-,-
BAC200_M12,2,2p25.1,8937134,9026302,89168,-,-
BAC189_O11,2,2p25.1,8939595,9013944,74349,-,-
BAC249_L04,2,2p25.1,8997177,9099691,102514,-,-
BAC68_K02,2,2p25.1,9026435,9119166,92731,-,-
BAC116_I10,2,2p25.1,9048853,9156614,107761,-,-
BAC139_F17,2,2p25.1,9079097,9165110,86013,-,-
BAC96_O16,2,2p25.1,9079099,9165110,86011,-,-
BAC115_G14,2,2p25.1,9079102,9165108,86006,-,-
BAC1_M10,2,2p25.1,9099686,9217737,118051,-,-
BAC238_J01,2,2p25.1,9099700,9200919,101219,-,-
BAC219_P15,2,2p25.1,9158516,9250822,92306,-,-
BAC59_E06,2,2p25.1,9158516,9250822,92306,-,-
BAC182_M04,2,2p25.1,9165105,9262608,97503,-,-
BAC97_H09,2,2p25.1,9211339,9301244,89905,-,-
BAC172_H07,2,2p25.1,9237013,9383797,146784,-,-
BAC53_C03,2,2p25.1,9250817,9383797,132980,-,-
BAC101_D17,2,2p25.1,9266716,9356847,90131,-,-
BAC20_P03,2,2p25.1,9266728,9356847,90119,-,-
BAC175_A08,2,2p25.1,9288901,9413796,124895,-,-
BAC137_C17,2,2p25.1,9423118,9548894,125776,-,-
BAC125_G20,2,2p25.1,9432704,9561417,128713,-,-
BAC67_D11,2,2p25.1,9432707,9605440,172733,-,-
BAC177_J22,2,2p25.1,9442380,9543360,100980,-,-
BAC142_N14,2,2p25.1,9451763,9536258,84495,-,-
BAC56_K09,2,2p25.1,9453623,9561417,107794,-,-
BAC175_M03,2,2p25.1,9477831,9556675,78844,-,-
BAC83_G06,2,2p25.1,9486790,9581619,94829,-,-
BAC80_K19,2,2p25.1,9486790,9687223,200433,-,-
BAC122_L07,2,2p25.1,9492394,9606553,114159,-,-
BAC116_L01,2,2p25.1,9616877,9700258,83381,-,-
BAC52_E08,2,2p25.1,9622907,9686330,63423,-,-
BAC252_M01,2,2p25.1,9623017,9714740,91723,-,-
BAC226_F02,2,2p25.1,9631129,9711855,80726,-,-
BAC52_G19,2,2p25.1,9631165,9793332,162167,-,-
BAC249_D03,2,2p25.1,9811246,9872026,60780,-,-
BAC244_I18,2,2p25.1,9819427,9915861,96434,-,-
BAC142_E06,2,2p25.1,9819427,9908267,88840,-,-
BAC175_K11,2,2p25.1,9819453,9947650,128197,-,-
BAC149_N06,2,2p25.1,9831974,9947650,115676,-,-
BAC82_K13,2,2p25.1,9869082,9973940,104858,-,-
BAC162_D19,2,2p25.1,9888754,9985438,96684,-,-
BAC11_M10,2,2p25.1,9891869,10022680,130811,-,-
BAC142_I12,2,2p25.1,9915858,10021420,105562,-,-
BAC151_M18,2,2p25.1,10048403,10153038,104635,-,-
BAC188_F15,2,2p25.1,10104887,10230783,125896,-,-
BAC32_G19,2,2p25.1,10104892,10186566,81674,-,-
BAC246_H15,2,2p25.1,10129254,10207114,77860,-,-
BAC126_P05,2,2p25.1,10153036,10241668,88632,-,-
BAC69_F23,2,2p25.1,10185978,10302239,116261,-,-
BAC42_E20,2,2p25.1,10193966,10288078,94112,-,-
BAC186_D08,2,2p25.1,10193966,10268025,74059,-,-
BAC165_O21,2,2p25.1,10213910,10316006,102096,-,-
BAC165_G18,2,2p25.1,10230777,10323165,92388,-,-
BAC159_O04,2,2p25.1,10307394,10411917,104523,-,-
BAC37_C20,2,2p25.1,10385526,10467728,82202,-,-
BAC105_M04,2,2p25.1,10400548,10488476,87928,-,-
BAC221_G15,2,2p25.1,10457468,10557573,100105,-,-
BAC29_C11,2,2p25.1,10459498,10557552,98054,-,-
BAC76_D18,2,2p25.1,10467751,10559495,91744,-,-
BAC48_J03,2,2p25.1,10542854,10640917,98063,-,-
BAC180_D22,2,2p25.1,10557583,10657585,100002,-,-
BAC228_P03,2,2p25.1,10657713,10751538,93825,-,-
BAC97_P22,2,2p25.1,10688427,10828740,140313,-,-
BAC91_A06,2,2p25.1,10697442,10804820,107378,-,-
BAC63_O06,2,2p25.1,10763342,10859044,95702,-,-
BAC140_F11,2,2p25.1,10858198,10986785,128587,-,-
BAC181_M01,2,2p25.1,10859038,10955051,96013,-,-
BAC61_F15,2,2p25.1,10866952,10986758,119806,-,-
BAC70_J13,2,2p25.1,10938361,11087015,148654,-,-
BAC97_B12,2,2p25.1,10958568,11041603,83035,-,-
BAC120_C23,2,2p25.1,10986779,11129716,142937,-,-
BAC240_L15,2,2p25.1,11062407,11151907,89500,-,-
BAC191_C10,2,2p25.1,11152690,11235229,82539,-,-
BAC53_K07,2,2p25.1,11203631,11350004,146373,-,-
BAC60_C11,2,2p25.1,11226073,11342838,116765,-,-
BAC54_O22,2,2p25.1,11226074,11325062,98988,-,-
BAC6_N19,2,2p25.1,11279869,11451893,172024,-,-
BAC161_C13,2,2p25.1,11329674,11408936,79262,-,-
BAC161_E14,2,2p25.1,11342969,11447217,104248,-,-
BAC82_J23,2,2p25.1,11384170,11473543,89373,-,-
BAC40_H12,2,2p25.1,11387294,11463835,76541,-,-
BAC96_L17,2,2p25.1,11432753,11531034,98281,-,-
BAC169_C17,2,2p25.1,11439750,11531034,91284,-,-
BAC90_E03,2,2p25.1,11447332,11608522,161190,-,-
BAC248_D11,2,2p25.1,11459805,11561305,101500,-,-
BAC191_G07,2,2p25.1,11468878,11564292,95414,-,-
BAC33_G19,2,2p25.1,11473697,11582389,108692,-,-
BAC61_C16,2,2p25.1,11531134,11653401,122267,-,-
BAC77_G21,2,2p25.1,11583492,11692207,108715,-,-
BAC73_D07,2,2p25.1,11594892,11723410,128518,-,-
BAC64_H04,2,2p25.1,11600875,11687965,87090,-,-
BAC97_P23,2,2p25.1,11650642,11756532,105890,-,-
BAC217_G24,2,2p25.1,11667211,11752155,84944,-,-
BAC175_J23,2,2p25.1,11677415,11772161,94746,-,-
BAC186_B06,2,2p25.1,11677444,11761890,84446,-,-
BAC161_C09,2,2p25.1,11722662,11802626,79964,-,-
BAC163_O18,2,2p25.1,11756541,11846740,90199,-,-
BAC121_H18,2,2p25.1,11779554,11867737,88183,-,-
BAC58_I06,2,2p25.1,11824899,11919798,94899,-,-
BAC249_D17,2,2p25.1,11919836,12000566,80730,-,-
BAC25_E12,2,2p25.1,11924209,12056492,132283,-,-
BAC154_L01,2,2p25.1,12079443,12090512,11069,-,-
BAC247_O03,2,2p25.1,12088006,12195825,107819,-,-
BAC230_A16,2,2p25.1,12088718,12197247,108529,-,-
BAC222_P20,2,2p25.1,12102107,12202517,100410,-,-
BAC247_B10,2,2p25.1,12111952,12186676,74724,-,-
BAC233_H07,2,2p25.1,12221680,12311483,89803,-,-
BAC83_A17,2,2p25.1,12267457,12359651,92194,-,-
BAC5_P24,2,2p25.1,12321198,12412225,91027,-,-
BAC247_A19,2,2p25.1,12358548,12469188,110640,-,-
BAC80_L03,2,2p25.1,12379962,12483014,103052,-,-
BAC144_C22,2,2p25.1,12430177,12534822,104645,-,-
BAC156_A21,2,2p25.1,12455025,12529056,74031,-,-
BAC46_M12,2,2p25.1,12455036,12560047,105011,-,-
BAC100_H23,2,2p25.1,12550749,12657618,106869,-,-
BAC34_N12,2,2p25.1-2p24.3,12698366,12805351,106985,-,-
BAC127_E12,2,2p24.3,12836745,12997273,160528,-,-
BAC116_K16,2,2p24.3,12836747,12929166,92419,-,-
BAC242_I15,2,2p24.3,12894338,13011964,117626,-,-
BAC44_B05,2,2p24.3,13138543,13233516,94973,-,-
BAC218_M11,2,2p24.3,13299242,13389623,90381,-,-
BAC165_J07,2,2p24.3,13477638,13617426,139788,-,-
BAC172_B20,2,2p24.3,13576103,13662150,86047,-,-
BAC75_O18,2,2p24.3,13576362,13686190,109828,-,-
BAC237_F07,2,2p24.3,13577097,13686190,109093,-,-
BAC19_J10,2,2p24.3,13834205,13955526,121321,-,-
BAC145_A18,2,2p24.3,13865065,13954123,89058,-,-
BAC12_G19,2,2p24.3,13888875,13975777,86902,-,-
BAC244_D09,2,2p24.3,13911598,14008152,96554,-,-
BAC189_N20,2,2p24.3,14110023,14199699,89676,-,-
BAC191_E18,2,2p24.3,14241384,14327508,86124,-,-
BAC17_O03,2,2p24.3,14243631,14327712,84081,-,-
BAC226_F06,2,2p24.3,14550451,14638234,87783,-,-
BAC22_G06,2,2p24.3,14603634,14767030,163396,-,-
BAC82_I21,2,2p24.3,14639358,14742644,103286,-,-
BAC102_I02,2,2p24.3,14734886,14826235,91349,-,-
BAC122_A01,2,2p24.3,14928264,15032184,103920,-,-
BAC11_L11,2,2p24.3,15008484,15138305,129821,-,-
BAC146_E18,2,2p24.3,15063276,15153373,90097,-,-
BAC243_K01,2,2p24.3,15254653,15361118,106465,-,-
BAC88_N23,2,2p24.3,15375182,15469812,94630,-,-
BAC22_H10,2,2p24.3,15443846,15529984,86138,-,-
BAC1_F17,2,2p24.3,15511373,15613467,102094,-,-
BAC151_F06,2,2p24.3,15515422,15605138,89716,-,-
BAC224_I08,2,2p24.3,15542041,15618936,76895,-,-
BAC141_N03,2,2p24.3,15703591,15791890,88299,-,-
BAC141_P04,2,2p24.3,15779353,15868211,88858,-,-
BAC192_B05,2,2p24.3,15784629,15888264,103635,-,-
BAC152_O08,2,2p24.3,15828769,15916281,87512,-,-
BAC173_H14,2,2p24.3,15889598,15987721,98123,-,-
BAC126_A24,2,2p24.3,15898106,16032719,134613,-,-
BAC197_H18,2,2p24.3,15916424,16018838,102414,-,-
BAC166_I10,2,2p24.3,15916424,16022760,106336,-,-
BAC126_O17,2,2p24.3,15955513,16047893,92380,-,-
BAC58_F24,2,2p24.3,15964944,16078966,114022,-,-
BAC71_M04,2,2p24.3,15989805,16079199,89394,-,-
BAC248_N21,2,2p24.3,16017502,16099548,82046,-,-
BAC118_K14,2,2p24.3,16022754,16099784,77030,-,-
BAC189_H06,2,2p24.3,16047971,16153035,105064,-,-
BAC242_G09,2,2p24.3,16264280,16334893,70613,-,-
BAC146_E14,2,2p24.3,16265664,16391060,125396,-,-
BAC107_J04,2,2p24.3,16418739,16515733,96994,-,-
BAC167_I11,2,2p24.3,16424405,16520435,96030,-,-
BAC27_O23,2,2p24.3,16485850,16588449,102599,-,-
BAC142_M05,2,2p24.3,16524161,16621456,97295,-,-
BAC78_O01,2,2p24.3,16588594,16695300,106706,-,-
BAC61_E01,2,2p24.3,16684545,16823910,139365,-,-
BAC56_D12,2,2p24.3,16685639,16868249,182610,-,-
BAC194_N20,2,2p24.3,16695295,16780091,84796,-,-
BAC141_K13,2,2p24.3,16796292,16859185,62893,-,-
BAC91_C05,2,2p24.3,16811852,16891655,79803,-,-
BAC54_F12,2,2p24.3,16866169,16961085,94916,-,-
BAC225_F08,2,2p24.3-2p24.2,16961079,17057333,96254,-,-
BAC15_E03,2,2p24.2,17019227,17097860,78633,-,-
BAC103_M14,2,2p24.2,17128354,17244330,115976,-,-
BAC108_N09,2,2p24.2,17154290,17239118,84828,-,-
BAC229_G19,2,2p24.2,17155123,17244330,89207,-,-
BAC125_E24,2,2p24.2,17244324,17383320,138996,-,-
BAC223_C10,2,2p24.2,17319165,17417063,97898,-,-
BAC142_G04,2,2p24.2,17455585,17538290,82705,-,-
BAC218_M15,2,2p24.2,17469416,17607057,137641,-,-
BAC127_G06,2,2p24.2,17607052,17707591,100539,-,-
BAC61_O21,2,2p24.2,17611766,17706875,95109,-,-
BAC23_H17,2,2p24.2,17727652,17817721,90069,-,-
BAC122_P15,2,2p24.2,17764690,17848613,83923,-,-
BAC162_C16,2,2p24.2,17781208,17924528,143320,-,-
BAC27_A15,2,2p24.2,17790426,17883212,92786,-,-
BAC66_A12,2,2p24.2,17790606,17891629,101023,-,-
BAC5_P03,2,2p24.2,17848605,17962056,113451,-,-
BAC243_P23,2,2p24.2,17890588,17976666,86078,-,-
BAC55_I10,2,2p24.2,17897426,17992758,95332,-,-
BAC238_E11,2,2p24.2,17912047,17989866,77819,-,-
BAC186_K15,2,2p24.2,17926280,18017854,91574,-,-
BAC108_J14,2,2p24.2,17953004,18084582,131578,-,-
BAC132_B05,2,2p24.2,17962109,18055131,93022,-,-
BAC175_K17,2,2p24.2,18090070,18189680,99610,-,-
BAC82_D21,2,2p24.2,18155882,18247047,91165,-,-
BAC140_A17,2,2p24.2,18188698,18282279,93581,-,-
BAC200_A09,2,2p24.2,18364351,18452722,88371,-,-
BAC49_C13,2,2p24.2,18460924,18573851,112927,-,-
BAC173_O03,2,2p24.2,18465257,18565886,100629,-,-
BAC172_C08,2,2p24.2,18591450,18675683,84233,-,-
BAC232_J07,2,2p24.2,18591486,18684958,93472,-,-
BAC68_L13,2,2p24.2,18686545,18782719,96174,-,-
BAC73_E06,2,2p24.2,18734271,18832804,98533,-,-
BAC41_H10,2,2p24.2,18786906,18881545,94639,-,-
BAC141_B15,2,2p24.2,18851386,18964266,112880,-,-
BAC239_E04,2,2p24.2,18874822,18964249,89427,-,-
BAC227_A08,2,2p24.2,18877614,18977364,99750,-,-
BAC40_A07,2,2p24.2,18937626,19048456,110830,-,-
BAC179_N06,2,2p24.2-2p24.1,18987480,19106321,118841,-,-
BAC243_M15,2,2p24.2-2p24.1,19006824,19123271,116447,-,-
BAC12_M01,2,2p24.2-2p24.1,19053044,19153854,100810,-,-
BAC146_D15,2,2p24.2-2p24.1,19063555,19153864,90309,-,-
BAC40_M09,2,2p24.2-2p24.1,19097769,19251913,154144,-,-
BAC163_N10,2,2p24.1,19153858,19337897,184039,-,-
BAC239_O18,2,2p24.1,19162402,19295682,133280,-,-
BAC81_A21,2,2p24.1,19288397,19390934,102537,-,-
BAC114_C24,2,2p24.1,19311163,19431715,120552,-,-
BAC120_G18,2,2p24.1,19337931,19432313,94382,-,-
BAC160_C12,2,2p24.1,19345614,19429535,83921,-,-
BAC64_N19,2,2p24.1,19345614,19429535,83921,-,-
BAC160_A21,2,2p24.1,19554828,19642216,87388,-,-
BAC75_M02,2,2p24.1,19644142,19767615,123473,-,-
BAC67_H05,2,2p24.1,19702836,19788740,85904,-,-
BAC92_E20,2,2p24.1,19773734,19876387,102653,-,-
BAC80_F11,2,2p24.1,19788781,19889996,101215,-,-
BAC200_P06,2,2p24.1,19859966,19871575,11609,-,-
BAC77_J16,2,2p24.1,19885871,19969149,83278,-,-
BAC39_F04,2,2p24.1,19890361,19989057,98696,-,-
BAC139_N12,2,2p24.1,19936835,20017395,80560,-,-
BAC84_J06,2,2p24.1,19943495,20027592,84097,-,-
BAC241_I04,2,2p24.1,19981405,20061807,80402,-,-
BAC67_B17,2,2p24.1,20029749,20200866,171117,-,-
BAC50_P07,2,2p24.1,20062019,20186543,124524,-,-
BAC142_D19,2,2p24.1,20062033,20186556,124523,-,-
BAC140_A01,2,2p24.1,20084025,20188969,104944,-,-
BAC186_O14,2,2p24.1,20157258,20225291,68033,-,-
BAC66_L21,2,2p24.1,20179341,20285755,106414,-,-
BAC96_C02,2,2p24.1,20179341,20282416,103075,-,-
BAC1_N02,2,2p24.1,20200860,20294923,94063,-,-
BAC230_P09,2,2p24.1,20227181,20360612,133431,-,-
BAC167_M04,2,2p24.1,20320446,20412754,92308,-,-
BAC82_G13,2,2p24.1,20399449,20581602,182153,-,-
BAC32_F07,2,2p24.1,20399449,20509299,109850,-,-
BAC63_G21,2,2p24.1,20430179,20523758,93579,-,-
BAC42_F18,2,2p24.1,20468634,20600611,131977,-,-
BAC117_P04,2,2p24.1,20491071,20628776,137705,-,-
BAC140_G08,2,2p24.1,20509856,20610087,100231,-,-
BAC100_D04,2,2p24.1,20509856,20683751,173895,-,-
BAC84_L14,2,2p24.1,20513694,20610087,96393,-,-
BAC51_A22,2,2p24.1,20581624,20712850,131226,-,-
BAC153_C13,2,2p24.1,20759157,20831592,72435,-,-
BAC173_A16,2,2p24.1,20835042,20933723,98681,-,-
BAC155_M22,2,2p24.1,20861084,20942809,81725,-,-
BAC171_J02,2,2p24.1,20897479,20981834,84355,-,-
BAC69_J24,2,2p24.1,21082837,21175769,92932,-,-
BAC193_B06,2,2p24.1,21122336,21198374,76038,-,-
BAC168_F11,2,2p24.1,21132837,21214265,81428,-,-
BAC175_N17,2,2p24.1,21331551,21408750,77199,-,-
BAC224_K10,2,2p24.1,21466566,21557095,90529,-,-
BAC88_N09,2,2p24.1,21525275,21698589,173314,-,-
BAC76_N03,2,2p24.1,21529009,21664270,135261,-,-
BAC141_M15,2,2p24.1,21606042,21698587,92545,-,-
BAC185_A11,2,2p24.1,21608008,21691600,83592,-,-
BAC252_F15,2,2p24.1,21676951,21798397,121446,-,-
BAC149_E24,2,2p24.1,21802648,21907817,105169,-,-
BAC139_F21,2,2p24.1,21890301,21968490,78189,-,-
BAC149_N04,2,2p24.1,22004685,22143597,138912,-,-
BAC162_C15,2,2p24.1,22097590,22190900,93310,-,-
BAC20_E18,2,2p24.1,22175089,22270196,95107,-,-
BAC176_F09,2,2p24.1,22360095,22443403,83308,-,-
BAC150_B18,2,2p24.1,22376711,22473504,96793,-,-
BAC96_E09,2,2p24.1,22420159,22538210,118051,-,-
BAC142_L07,2,2p24.1,22441189,22537157,95968,-,-
BAC152_G10,2,2p24.1,22448995,22539762,90767,-,-
BAC184_M21,2,2p24.1,22454049,22540213,86164,-,-
BAC41_H23,2,2p24.1,22557119,22666802,109683,-,-
BAC52_D21,2,2p24.1,22616651,22729871,113220,-,-
BAC144_H21,2,2p24.1,22724322,22829237,104915,-,-
BAC168_O17,2,2p24.1,22741809,22824288,82479,-,-
BAC149_K04,2,2p24.1,22772621,22881094,108473,-,-
BAC139_B10,2,2p24.1,22775827,22857823,81996,-,-
BAC40_D22,2,2p24.1,22861045,22975349,114304,-,-
BAC64_M02,2,2p24.1,23006850,23138274,131424,-,-
BAC122_I04,2,2p24.1,23009266,23138864,129598,-,-
BAC50_M17,2,2p24.1,23070106,23156109,86003,-,-
BAC168_G10,2,2p24.1,23127010,23243251,116241,-,-
BAC250_P04,2,2p24.1,23138267,23243243,104976,-,-
BAC221_H20,2,2p24.1,23160722,23243261,82539,-,-
BAC157_K22,2,2p24.1,23199745,23297227,97482,-,-
BAC107_L02,2,2p24.1,23248698,23406364,157666,-,-
BAC183_B18,2,2p24.1,23301394,23378613,77219,-,-
BAC106_P13,2,2p24.1,23329593,23432280,102687,-,-
BAC95_E21,2,2p24.1,23337657,23470551,132894,-,-
BAC116_G23,2,2p24.1,23347406,23432562,85156,-,-
BAC227_O01,2,2p24.1,23376512,23453705,77193,-,-
BAC90_E09,2,2p24.1,23378607,23465258,86651,-,-
BAC32_O23,2,2p24.1,23378616,23487755,109139,-,-
BAC12_A05,2,2p24.1,23408217,23598502,190285,-,-
BAC139_N14,2,2p24.1,23408217,23491477,83260,-,-
BAC89_H16,2,2p24.1,23490629,23607987,117358,-,-
BAC82_H11,2,2p24.1,23512295,23628953,116658,-,-
BAC5_P18,2,2p24.1,23512295,23607987,95692,-,-
BAC197_M18,2,2p24.1,23552819,23729821,177002,-,-
BAC132_L13,2,2p24.1,23570480,23659831,89351,-,-
BAC30_P17,2,2p24.1,23599550,23693626,94076,-,-
BAC126_E04,2,2p24.1,23602292,23712473,110181,-,-
BAC122_L23,2,2p24.1,23602554,23712473,109919,-,-
BAC220_H01,2,2p24.1,23607986,23713302,105316,-,-
BAC172_N09,2,2p24.1,23629154,23729821,100667,-,-
BAC217_N05,2,2p24.1,23643014,23729822,86808,-,-
BAC23_N05,2,2p24.1,23659825,23770646,110821,-,-
BAC31_P10,2,2p24.1,23713828,23824867,111039,-,-
BAC247_P13,2,2p24.1,23770636,23893209,122573,-,-
BAC118_J10,2,2p24.1-2p23.3,23847224,23938568,91344,-,-
BAC120_L01,2,2p23.3,23912712,23998748,86036,-,-
BAC20_H13,2,2p23.3,23916629,24030262,113633,-,-
BAC42_L24,2,2p23.3,23944246,24030268,86022,-,-
BAC33_H13,2,2p23.3,23978807,24074902,96095,-,-
BAC155_N20,2,2p23.3,24036078,24134577,98499,-,-
BAC21_E13,2,2p23.3,24036117,24143900,107783,-,-
BAC120_M19,2,2p23.3,24041180,24146077,104897,-,-
BAC235_G23,2,2p23.3,24058755,24143900,85145,-,-
BAC146_F07,2,2p23.3,24075344,24191542,116198,-,-
BAC113_H09,2,2p23.3,24102027,24182279,80252,-,-
BAC224_C06,2,2p23.3,24155661,24259610,103949,-,-
BAC67_F10,2,2p23.3,24201966,24288369,86403,-,-
BAC156_H21,2,2p23.3,24345445,24435642,90197,-,-
BAC219_J19,2,2p23.3,24409334,24529354,120020,-,-
BAC160_D01,2,2p23.3,24409334,24498542,89208,-,-
BAC249_C20,2,2p23.3,24409334,24487688,78354,-,-
BAC126_E20,2,2p23.3,24467790,24635475,167685,-,-
BAC153_B02,2,2p23.3,24487910,24584538,96628,-,-
BAC236_F18,2,2p23.3,24558740,24692067,133327,-,-
BAC63_H10,2,2p23.3,24591168,24677451,86283,-,-
BAC130_L03,2,2p23.3,24635686,24651235,15549,-,-
BAC156_K16,2,2p23.3,24681260,24897654,216394,-,-
BAC81_D23,2,2p23.3,24711102,24823409,112307,-,-
BAC158_B03,2,2p23.3,24737914,24821281,83367,-,-
BAC180_N04,2,2p23.3,24762924,24854176,91252,-,-
BAC162_I07,2,2p23.3,24767959,24860116,92157,-,-
BAC224_G06,2,2p23.3,24823722,24914257,90535,-,-
BAC223_J12,2,2p23.3,24914248,25022981,108733,-,-
BAC16_C16,2,2p23.3,25020749,25157248,136499,-,-
BAC120_C08,2,2p23.3,25020749,25140753,120004,-,-
BAC144_C13,2,2p23.3,25049590,25164482,114892,-,-
BAC102_I09,2,2p23.3,25070348,25157773,87425,-,-
BAC131_A11,2,2p23.3,25070359,25194325,123966,-,-
BAC235_G13,2,2p23.3,25073191,25150103,76912,-,-
BAC161_N02,2,2p23.3,25073192,25164453,91261,-,-
BAC188_A21,2,2p23.3,25107576,25194294,86718,-,-
BAC239_C21,2,2p23.3,25190306,25320072,129766,-,-
BAC236_G05,2,2p23.3,25192367,25320139,127772,-,-
BAC33_N21,2,2p23.3,25192367,25327078,134711,-,-
BAC32_H12,2,2p23.3,25194371,25372285,177914,-,-
BAC190_D14,2,2p23.3,25229217,25327088,97871,-,-
BAC149_B10,2,2p23.3,25229217,25393108,163891,-,-
BAC226_N19,2,2p23.3,25239261,25320072,80811,-,-
BAC145_O21,2,2p23.3,25239264,25354874,115610,-,-
BAC169_J18,2,2p23.3,25239306,25327074,87768,-,-
BAC73_K20,2,2p23.3,25250485,25403092,152607,-,-
BAC148_M20,2,2p23.3,25327090,25450089,122999,-,-
BAC32_J18,2,2p23.3,25329554,25425886,96332,-,-
BAC120_A21,2,2p23.3,25336855,25450114,113259,-,-
BAC170_C03,2,2p23.3,25348860,25425886,77026,-,-
BAC34_O19,2,2p23.3,25362358,25450083,87725,-,-
BAC123_E12,2,2p23.3,25390924,25487307,96383,-,-
BAC91_N18,2,2p23.3,25439085,25522293,83208,-,-
BAC14_K09,2,2p23.3,25441310,25530221,88911,-,-
BAC200_B20,2,2p23.3,25462157,25552063,89906,-,-
BAC65_I19,2,2p23.3,25551564,25662527,110963,-,-
BAC122_K08,2,2p23.3,25560042,25720583,160541,-,-
BAC160_I12,2,2p23.3,25666479,25767652,101173,-,-
BAC27_I20,2,2p23.3,25666479,25780434,113955,-,-
BAC8_F12,2,2p23.3,25715253,25798720,83467,-,-
BAC214_A02,2,2p23.3,25720645,25798715,78070,-,-
BAC82_H12,2,2p23.3,25744093,25839862,95769,-,-
BAC161_D17,2,2p23.3,25767647,25883014,115367,-,-
BAC18_H02,2,2p23.3,25810916,25915442,104526,-,-
BAC157_K01,2,2p23.3,25883325,26001540,118215,-,-
BAC149_F15,2,2p23.3,25915473,26001540,86067,-,-
BAC59_L13,2,2p23.3,25936730,26056202,119472,-,-
BAC141_L09,2,2p23.3,25960568,26056202,95634,-,-
BAC235_F18,2,2p23.3,25960568,26082075,121507,-,-
BAC175_G10,2,2p23.3,25992865,26085528,92663,-,-
BAC150_F12,2,2p23.3,26003874,26090261,86387,-,-
BAC182_O19,2,2p23.3,26003891,26088554,84663,-,-
BAC24_M20,2,2p23.3,26066912,26149416,82504,-,-
BAC123_C09,2,2p23.3,26082186,26197486,115300,-,-
BAC160_A01,2,2p23.3,26085522,26207747,122225,-,-
BAC81_L16,2,2p23.3,26098544,26207747,109203,-,-
BAC37_E18,2,2p23.3,26118465,26225873,107408,-,-
BAC128_A04,2,2p23.3,26133341,26268596,135255,-,-
BAC11_A07,2,2p23.3,26170223,26266344,96121,-,-
BAC50_F18,2,2p23.3,26197600,26297729,100129,-,-
BAC30_P02,2,2p23.3,26207755,26297804,90049,-,-
BAC195_L03,2,2p23.3,26225896,26328063,102167,-,-
BAC53_C20,2,2p23.3,26226155,26328088,101933,-,-
BAC249_I21,2,2p23.3,26258532,26380408,121876,-,-
BAC41_O09,2,2p23.3,26266338,26389737,123399,-,-
BAC235_A05,2,2p23.3,26270856,26352405,81549,-,-
BAC148_E06,2,2p23.3,26375134,26458580,83446,yes,-
BAC11_O08,2,2p23.3,26412749,26521515,108766,yes,-
BAC223_N12,2,2p23.3,26434010,26509379,75369,-,-
BAC210_L17,2,2p23.3,26484423,26583653,99230,-,-
BAC45_B08,2,2p23.3,26504591,26607093,102502,-,-
BAC105_O16,2,2p23.3,26511563,26609724,98161,-,-
BAC126_N01,2,2p23.3,26563553,26666433,102880,-,-
BAC125_J09,2,2p23.3,26563553,26666630,103077,-,-
BAC78_E15,2,2p23.3,26581826,26672858,91032,-,-
BAC127_B07,2,2p23.3,26622040,26762933,140893,-,-
BAC186_C17,2,2p23.3,26673135,26762936,89801,-,-
BAC189_C20,2,2p23.3,26717319,26831736,114417,yes,-
BAC233_M03,2,2p23.3,26733830,26842351,108521,yes,-
BAC162_K22,2,2p23.3,26743556,26858795,115239,yes,-
BAC75_B07,2,2p23.3,26744353,26847688,103335,yes,-
BAC165_M17,2,2p23.3,26808874,26906595,97721,-,-
BAC170_D22,2,2p23.3,26808912,26906595,97683,-,-
BAC217_G09,2,2p23.3,26831730,26906595,74865,-,-
BAC121_K19,2,2p23.3,26842406,26960884,118478,-,-
BAC149_J15,2,2p23.3,26874676,26949456,74780,-,-
BAC232_N10,2,2p23.3,26883036,26992448,109412,-,-
BAC200_I16,2,2p23.3,26906692,27015991,109299,-,-
BAC147_G01,2,2p23.3,26906692,27002396,95704,-,-
BAC56_J10,2,2p23.3,26913069,27015991,102922,-,-
BAC38_E08,2,2p23.3,26949459,27047991,98532,-,-
BAC180_L10,2,2p23.3,26980086,27070780,90694,-,-
BAC175_G06,2,2p23.3,26985291,27056442,71151,-,-
BAC19_F13,2,2p23.3,27018388,27157480,139092,-,-
BAC150_O08,2,2p23.3,27029003,27135482,106479,-,-
BAC76_L07,2,2p23.3,27059661,27139548,79887,-,-
BAC225_G03,2,2p23.3,27067674,27157480,89806,-,-
BAC151_O14,2,2p23.3,27084883,27187441,102558,-,-
BAC197_E10,2,2p23.3,27095066,27214934,119868,-,-
BAC181_O18,2,2p23.3,27115124,27214923,99799,-,-
BAC156_K04,2,2p23.3,27199770,27445824,246054,-,-
BAC7_M22,2,2p23.3,27205255,27325823,120568,-,-
BAC51_B02,2,2p23.3,27205256,27313186,107930,-,-
BAC173_M01,2,2p23.3,27312990,27419617,106627,-,-
BAC129_H21,2,2p23.3,27312996,27395701,82705,-,-
BAC200_D22,2,2p23.3,27340002,27459829,119827,-,-
BAC160_H11,2,2p23.3,27340002,27420704,80702,-,-
BAC148_C03,2,2p23.3,27354501,27430751,76250,-,-
BAC183_A06,2,2p23.3,27368660,27464155,95495,-,-
BAC144_J21,2,2p23.3,27401275,27482373,81098,-,-
BAC2_K18,2,2p23.3,27446048,27528694,82646,-,-
BAC229_L05,2,2p23.3,27482845,27579405,96560,-,-
BAC80_N03,2,2p23.2,27700230,27805156,104926,-,-
BAC181_C08,2,2p23.2,27700230,27792976,92746,-,-
BAC193_I02,2,2p23.2,27701278,27805154,103876,-,-
BAC128_D04,2,2p23.2,27734860,27829368,94508,-,-
BAC119_H16,2,2p23.2,27805149,27892067,86918,-,-
BAC69_C11,2,2p23.2,27850362,27946251,95889,-,-
BAC247_C05,2,2p23.2,27875697,27990708,115011,-,-
BAC61_J02,2,2p23.2,27900332,28002769,102437,-,-
BAC154_I12,2,2p23.2,27923876,28002769,78893,-,-
BAC192_N17,2,2p23.2,27923899,28011968,88069,-,-
BAC35_E08,2,2p23.2,28002766,28089559,86793,-,-
BAC176_M18,2,2p23.2,28031430,28116119,84689,-,-
BAC106_D09,2,2p23.2,28133177,28233845,100668,-,-
BAC114_I02,2,2p23.2,28227305,28379980,152675,-,-
BAC169_G08,2,2p23.2,28233848,28348204,114356,-,-
BAC60_G13,2,2p23.2,28278778,28379987,101209,-,-
BAC7_A06,2,2p23.2,28361658,28456953,95295,-,-
BAC106_G24,2,2p23.2,28361935,28519193,157258,-,-
BAC40_F12,2,2p23.2,28368823,28573588,204765,-,-
BAC154_E22,2,2p23.2,28374418,28485910,111492,-,-
BAC117_J18,2,2p23.2,28379030,28457011,77981,-,-
BAC32_E12,2,2p23.2,28404217,28504346,100129,-,-
BAC52_J16,2,2p23.2,28445114,28573589,128475,-,-
BAC230_P06,2,2p23.2,28493555,28564917,71362,-,-
BAC170_B08,2,2p23.2,28564907,28656493,91586,-,-
BAC214_M22,2,2p23.2,28574514,28656187,81673,-,-
BAC63_H05,2,2p23.2,28622516,28722715,100199,-,-
BAC76_F10,2,2p23.2,28728739,28850313,121574,-,-
BAC118_F04,2,2p23.2,28728761,28918013,189252,-,-
BAC237_O06,2,2p23.2,28736848,28824850,88002,-,-
BAC117_C07,2,2p23.2,28745079,28879185,134106,-,-
BAC122_D11,2,2p23.2,28745089,28885886,140797,-,-
BAC49_C08,2,2p23.2,28745121,28831983,86862,-,-
BAC171_K11,2,2p23.2,28771103,28858698,87595,-,-
BAC30_L11,2,2p23.2,28771103,28916753,145650,-,-
BAC97_K05,2,2p23.2,28975130,29134349,159219,-,-
BAC156_N19,2,2p23.2,29005889,29134348,128459,-,-
BAC219_P19,2,2p23.2,29014972,29122526,107554,-,-
BAC243_H22,2,2p23.2,29024703,29123937,99234,-,-
BAC234_K08,2,2p23.2,29024705,29103301,78596,-,-
BAC50_P21,2,2p23.2,29035603,29168116,132513,-,-
BAC142_L04,2,2p23.2,29037725,29123934,86209,-,-
BAC124_G04,2,2p23.2,29116363,29251597,135234,-,-
BAC191_F03,2,2p23.2,29130258,29219545,89287,-,-
BAC33_B24,2,2p23.2,29219783,29382775,162992,-,-
BAC97_N06,2,2p23.2,29261994,29373063,111069,-,-
BAC109_C18,2,2p23.2,29267417,29402579,135162,-,-
BAC199_F04,2,2p23.2,29276096,29363298,87202,-,-
BAC42_E15,2,2p23.2,29282676,29368711,86035,-,-
BAC115_D01,2,2p23.2,29303820,29402556,98736,-,-
BAC220_P04,2,2p23.2,29307052,29402611,95559,-,-
BAC230_L09,2,2p23.2,29315488,29390390,74902,-,-
BAC224_C03,2,2p23.2,29368723,29457621,88898,-,-
BAC41_L22,2,2p23.2,29396998,29511999,115001,-,-
BAC155_N11,2,2p23.2,29427653,29515517,87864,-,-
BAC248_A16,2,2p23.2,29437223,29534382,97159,-,-
BAC21_O03,2,2p23.2,29493376,29592349,98973,-,-
BAC218_F02,2,2p23.2,29592353,29678496,86143,-,-
BAC247_C15,2,2p23.2,29592356,29682517,90161,-,-
BAC70_C18,2,2p23.2,29633211,29739733,106522,-,-
BAC60_G02,2,2p23.2,29640372,29792435,152063,-,-
BAC165_K01,2,2p23.2,29646764,29727558,80794,-,-
BAC252_B21,2,2p23.2-2p23.1,29670178,29819569,149391,-,-
BAC194_D06,2,2p23.2,29670178,29759969,89791,-,-
BAC238_O20,2,2p23.2-2p23.1,29750914,29843586,92672,-,-
BAC46_B15,2,2p23.1,30028696,30126300,97604,-,-
BAC220_B01,2,2p23.1,30058221,30155753,97532,-,-
BAC49_G01,2,2p23.1,30061646,30159022,97376,-,-
BAC115_H02,2,2p23.1,30079743,30193631,113888,-,-
BAC60_O20,2,2p23.1,30079743,30176802,97059,-,-
BAC36_E11,2,2p23.1,30099606,30182279,82673,-,-
BAC32_I13,2,2p23.1,30117173,30244289,127116,-,-
BAC249_N15,2,2p23.1,30125921,30166396,40475,-,-
BAC162_J05,2,2p23.1,30228064,30347664,119600,-,-
BAC145_C14,2,2p23.1,30326569,30395860,69291,-,-
BAC161_O09,2,2p23.1,30345223,30438013,92790,-,-
BAC57_E22,2,2p23.1,30347723,30473445,125722,-,-
BAC172_G21,2,2p23.1,30360561,30455225,94664,-,-
BAC219_I07,2,2p23.1,30426386,30507731,81345,-,-
BAC218_G23,2,2p23.1,30426386,30578847,152461,-,-
BAC24_C17,2,2p23.1,30426417,30564459,138042,-,-
BAC248_D22,2,2p23.1,30572389,30644603,72214,-,-
BAC42_H17,2,2p23.1,30639512,30866849,227337,-,-
BAC49_I06,2,2p23.1,30722694,30889279,166585,-,-
BAC117_B16,2,2p23.1,30733899,30846061,112162,-,-
BAC41_I01,2,2p23.1,30744950,30866857,121907,-,-
BAC246_M04,2,2p23.1,30757559,30851832,94273,-,-
BAC244_M16,2,2p23.1,30798862,30866857,67995,-,-
BAC54_F14,2,2p23.1,30846068,30952998,106930,-,-
BAC165_G02,2,2p23.1,30941562,31026628,85066,-,-
BAC165_C19,2,2p23.1,30941562,31035848,94286,-,-
BAC178_E11,2,2p23.1,30962714,31044169,81455,-,-
BAC29_O23,2,2p23.1,30965796,31114365,148569,-,-
BAC48_C15,2,2p23.1,30984255,31083202,98947,-,-
BAC147_G20,2,2p23.1,31035842,31146867,111025,-,-
BAC177_E09,2,2p23.1,31063408,31146865,83457,-,-
BAC155_P10,2,2p23.1,31075558,31170358,94800,-,-
BAC179_C05,2,2p23.1,31093254,31187631,94377,-,-
BAC10_M24,2,2p23.1,31102664,31187631,84967,-,-
BAC144_F01,2,2p23.1,31202817,31295209,92392,-,-
BAC220_L18,2,2p23.1,31247535,31346185,98650,-,-
BAC237_P10,2,2p23.1,31252830,31345659,92829,-,-
BAC155_K10,2,2p23.1,31270877,31353763,82886,-,-
BAC24_F01,2,2p23.1,31270877,31380862,109985,-,-
BAC96_F10,2,2p23.1,31296191,31421176,124985,-,-
BAC137_N18,2,2p23.1,31350404,31438791,88387,-,-
BAC29_A19,2,2p23.1,31354167,31425296,71129,-,-
BAC127_D17,2,2p23.1,31406604,31505380,98776,-,-
BAC175_J02,2,2p23.1,31426142,31517981,91839,-,-
BAC139_O18,2,2p23.1,31426148,31533382,107234,-,-
BAC176_J10,2,2p23.1,31796428,31875788,79360,-,-
BAC63_I02,2,2p23.1-2p22.3,31828555,31907588,79033,-,-
BAC141_D21,2,2p23.1-2p22.3,31845855,31973587,127732,-,-
BAC83_O21,2,2p23.1-2p22.3,31890638,31965485,74847,-,-
BAC60_E05,2,2p22.3,31946531,32076209,129678,-,-
BAC123_C01,2,2p22.3,31988760,32072380,83620,-,-
BAC230_H12,2,2p22.3,32010671,32094422,83751,-,-
BAC223_K14,2,2p22.3,32115571,32200535,84964,-,-
BAC222_E12,2,2p22.3,32198742,32308136,109394,-,-
BAC167_A02,2,2p22.3,32200913,32298668,97755,-,-
BAC58_I14,2,2p22.3,32229029,32298666,69637,-,-
BAC143_L22,2,2p22.3,32251396,32355837,104441,-,-
BAC17_B07,2,2p22.3,32276481,32355887,79406,-,-
BAC46_A07,2,2p22.3,32276792,32373894,97102,-,-
BAC75_G07,2,2p22.3,32355907,32466952,111045,-,-
BAC57_C20,2,2p22.3,32355909,32466952,111043,-,-
BAC41_A24,2,2p22.3,32363813,32459301,95488,-,-
BAC41_B13,2,2p22.3,32382496,32500002,117506,-,-
BAC29_N14,2,2p22.3,32387680,32512074,124394,-,-
BAC2_D05,2,2p22.3,32387680,32470221,82541,-,-
BAC97_G22,2,2p22.3,32393785,32505838,112053,-,-
BAC53_K14,2,2p22.3,32393787,32470229,76442,-,-
BAC247_E11,2,2p22.3,32394631,32475234,80603,-,-
BAC223_O13,2,2p22.3,32394631,32481236,86605,-,-
BAC110_E18,2,2p22.3,32481927,32583523,101596,-,-
BAC229_L17,2,2p22.3,32500114,32612918,112804,-,-
BAC235_E14,2,2p22.3,32580389,32679683,99294,-,-
BAC124_B04,2,2p22.3,32679676,32783493,103817,-,-
BAC37_J10,2,2p22.3,32714620,32828048,113428,-,-
BAC27_G24,2,2p22.3,32800390,32893566,93176,-,-
BAC223_M07,2,2p22.3,32861204,32989089,127885,-,-
BAC30_J20,2,2p22.3,32865775,32958866,93091,-,-
BAC78_E13,2,2p22.3,32893886,33020217,126331,-,-
BAC24_J07,2,2p22.3,32905671,33007748,102077,-,-
BAC194_B15,2,2p22.3,32923004,33012179,89175,-,-
BAC116_C18,2,2p22.3,32930620,33042432,111812,-,-
BAC195_K10,2,2p22.3,33007989,33097855,89866,-,-
BAC163_E14,2,2p22.3,33042426,33147652,105226,-,-
BAC244_P09,2,2p22.3,33045973,33155725,109752,-,-
BAC141_C16,2,2p22.3,33134622,33254716,120094,-,-
BAC177_M08,2,2p22.3,33161558,33280518,118960,-,-
BAC15_O17,2,2p22.3,33203845,33319047,115202,-,-
BAC170_H21,2,2p22.3,33241536,33342053,100517,-,-
BAC146_E21,2,2p22.3,33340463,33451124,110661,-,-
BAC147_A04,2,2p22.3,33380851,33472860,92009,-,-
BAC40_L02,2,2p22.3,33480234,33599731,119497,-,-
BAC32_P09,2,2p22.3,33491607,33577084,85477,-,-
BAC199_F22,2,2p22.3,33495488,33599732,104244,-,-
BAC129_F11,2,2p22.3,33510070,33599731,89661,-,-
BAC175_H03,2,2p22.3,33511318,33599733,88415,-,-
BAC152_P11,2,2p22.3,33511318,33596120,84802,-,-
BAC136_M07,2,2p22.3,33514929,33566866,51937,-,-
BAC180_F07,2,2p22.3,33599720,33682975,83255,-,-
BAC45_J12,2,2p22.3,33676342,33762277,85935,-,-
BAC61_I19,2,2p22.3,33750910,33861000,110090,-,-
BAC83_D07,2,2p22.3,33782703,33875352,92649,-,-
BAC34_G04,2,2p22.3,33844107,33854410,10303,-,-
BAC144_J20,2,2p22.3,34010040,34091444,81404,-,-
BAC109_I17,2,2p22.3,34024193,34103555,79362,-,-
BAC158_P08,2,2p22.3,34028095,34117453,89358,-,-
BAC158_M09,2,2p22.3,34028095,34117491,89396,-,-
BAC65_F06,2,2p22.3,34149767,34248551,98784,-,-
BAC171_I09,2,2p22.3,34157177,34269946,112769,-,-
BAC24_E13,2,2p22.3,34157183,34250630,93447,-,-
BAC57_K19,2,2p22.3,34182487,34357709,175222,-,-
BAC91_F12,2,2p22.3,34246666,34327961,81295,-,-
BAC81_O09,2,2p22.3,34323673,34415231,91558,-,-
BAC38_O17,2,2p22.3,34402486,34500985,98499,-,-
BAC56_M08,2,2p22.3,34422848,34512114,89266,-,-
BAC151_M22,2,2p22.3,34472201,34561265,89064,-,-
BAC76_A19,2,2p22.3,34487719,34572585,84866,-,-
BAC5_P07,2,2p22.3,34512580,34602310,89730,-,-
BAC180_H23,2,2p22.3,34640342,34777223,136881,-,-
BAC139_K04,2,2p22.3,34660474,34757940,97466,-,-
BAC222_P13,2,2p22.3,34665690,34766136,100446,-,-
BAC96_N13,2,2p22.3,34982907,35071870,88963,-,-
BAC93_M18,2,2p22.3,35051228,35155012,103784,-,-
BAC44_M01,2,2p22.3,35551225,35634209,82984,-,-
BAC49_B17,2,2p22.3,35634947,35721059,86112,-,-
BAC228_J21,2,2p22.3,35720025,35805341,85316,-,-
BAC90_P18,2,2p22.3,35759124,35880508,121384,-,-
BAC122_N20,2,2p22.3,35764147,35843566,79419,-,-
BAC126_A15,2,2p22.3,35764147,35843557,79410,-,-
BAC228_C22,2,2p22.3,35766475,35827553,61078,-,-
BAC166_F20,2,2p22.3,35956139,36040757,84618,-,-
BAC89_M07,2,2p22.3,36015438,36089608,74170,-,-
BAC197_K14,2,2p22.3,36133532,36218263,84731,-,-
BAC67_N04,2,2p22.3,36156949,36315664,158715,-,-
BAC42_K23,2,2p22.3,36159724,36314217,154493,-,-
BAC106_L08,2,2p22.3,36278830,36365157,86327,-,-
BAC131_O11,2,2p22.2,36456746,36539724,82978,-,-
BAC69_L18,2,2p22.2,36474183,36623928,149745,-,-
BAC153_L15,2,2p22.2,36497022,36605130,108108,-,-
BAC88_H07,2,2p22.2,36553196,36669262,116066,-,-
BAC125_A20,2,2p22.2,36561364,36657263,95899,-,-
BAC43_A02,2,2p22.2,36561484,36662948,101464,-,-
BAC115_F05,2,2p22.2,36660999,36746127,85128,-,-
BAC153_M17,2,2p22.2,36698393,36777716,79323,-,-
BAC186_J23,2,2p22.2,36720910,36821358,100448,-,-
BAC109_B09,2,2p22.2,36733745,36828981,95236,-,-
BAC125_L18,2,2p22.2,36790292,36935130,144838,-,-
BAC114_I09,2,2p22.2,36794953,36888406,93453,-,-
BAC32_G02,2,2p22.2,36935443,37031402,95959,-,-
BAC165_G04,2,2p22.2,36936423,37022773,86350,-,-
BAC73_A19,2,2p22.2,36945776,37077046,131270,-,-
BAC32_P16,2,2p22.2,37006739,37124111,117372,-,-
BAC144_G23,2,2p22.2,37010529,37100466,89937,-,-
BAC84_A24,2,2p22.2,37054302,37174078,119776,-,-
BAC70_J07,2,2p22.2,37142501,37239218,96717,-,-
BAC22_H22,2,2p22.2,37142505,37295988,153483,-,-
BAC167_P22,2,2p22.2,37164354,37266364,102010,-,-
BAC152_B01,2,2p22.2,37198803,37295988,97185,-,-
BAC226_L21,2,2p22.2,37293081,37380158,87077,-,-
BAC125_D15,2,2p22.2,37376998,37495911,118913,-,-
BAC79_N19,2,2p22.2,37425160,37565741,140581,-,-
BAC18_J24,2,2p22.2,37842469,37948146,105677,-,-
BAC75_H22,2,2p22.2,37855124,37966459,111335,-,-
BAC235_L14,2,2p22.2,37877524,38004122,126598,-,-
BAC30_A15,2,2p22.2,37907671,38001877,94206,-,-
BAC137_H19,2,2p22.2,37907806,38006199,98393,-,-
BAC31_N13,2,2p22.2,38194561,38284928,90367,-,-
BAC191_C14,2,2p22.2,38203187,38331652,128465,-,-
BAC242_G17,2,2p22.2,38238292,38254890,16598,-,-
BAC179_N22,2,2p22.2,38247668,38331652,83984,-,-
BAC125_P20,2,2p22.2-2p22.1,38275697,38465110,189413,-,-
BAC139_M11,2,2p22.2-2p22.1,38331659,38431408,99749,-,-
BAC163_B09,2,2p22.2-2p22.1,38331752,38465111,133359,-,-
BAC1_O12,2,2p22.1,38498782,38599606,100824,-,-
BAC36_O24,2,2p22.1,38508643,38599605,90962,-,-
BAC180_G02,2,2p22.1,38686596,38790199,103603,-,-
BAC153_E18,2,2p22.1,38704490,38790199,85709,-,-
BAC243_I07,2,2p22.1,38707221,38790199,82978,-,-
BAC108_H07,2,2p22.1,38813271,38980933,167662,-,-
BAC57_J19,2,2p22.1,38814290,38942339,128049,-,-
BAC237_B21,2,2p22.1,38824586,38935154,110568,-,-
BAC195_D16,2,2p22.1,38864296,38954403,90107,-,-
BAC127_C18,2,2p22.1,38927805,39028461,100656,-,-
BAC152_E06,2,2p22.1,39101555,39177171,75616,-,-
BAC144_A18,2,2p22.1,39135000,39231809,96809,-,-
BAC172_P04,2,2p22.1,39161172,39228988,67816,-,-
BAC175_P06,2,2p22.1,39172958,39291262,118304,-,-
BAC88_K17,2,2p22.1,39232566,39324534,91968,-,-
BAC224_I17,2,2p22.1,39313863,39392220,78357,-,-
BAC154_P12,2,2p22.1,39346068,39468408,122340,-,-
BAC29_I13,2,2p22.1,39432997,39543812,110815,-,-
BAC117_O03,2,2p22.1,39461424,39553584,92160,-,-
BAC89_C10,2,2p22.1,39478956,39578172,99216,-,-
BAC77_O11,2,2p22.1,39532983,39631018,98035,-,-
BAC124_C14,2,2p22.1,39586434,39669394,82960,-,-
BAC55_F02,2,2p22.1,39660461,39807027,146566,-,-
BAC36_E04,2,2p22.1,39843328,39967844,124516,-,-
BAC248_M04,2,2p22.1,39918844,40009380,90536,-,-
BAC185_H24,2,2p22.1,40018368,40117237,98869,-,-
BAC20_D15,2,2p22.1,40036297,40178264,141967,-,-
BAC141_B13,2,2p22.1,40081529,40165941,84412,-,-
BAC119_P18,2,2p22.1,40387106,40499731,112625,-,-
BAC161_D13,2,2p22.1,40446574,40564992,118418,-,-
BAC8_C13,2,2p22.1,40670582,40768923,98341,-,-
BAC152_C20,2,2p22.1,40708989,40790134,81145,-,-
BAC137_I11,2,2p22.1,41143836,41227396,83560,-,-
BAC162_B16,2,2p22.1,41261719,41346099,84380,-,-
BAC122_E15,2,2p22.1,41283643,41385939,102296,-,-
BAC185_D06,2,2p22.1,41502529,41586019,83490,-,-
BAC238_I07,2,2p22.1-2p21,41580351,41685955,105604,-,-
BAC170_G08,2,2p22.1-2p21,41592552,41679871,87319,-,-
BAC166_J10,2,2p22.1-2p21,41593558,41666430,72872,-,-
BAC78_K18,2,2p21,41654961,41737910,82949,-,-
BAC198_K15,2,2p21,41725287,41812301,87014,-,-
BAC167_B05,2,2p21,41737904,41842250,104346,-,-
BAC34_O12,2,2p21,41818521,41949603,131082,yes,-
BAC232_N09,2,2p21,41861315,41983789,122474,yes,-
BAC8_O01,2,2p21,41890695,42033016,142321,yes,-
BAC38_O02,2,2p21,41894041,41983789,89748,yes,-
BAC106_D23,2,2p21,41949598,42038708,89110,-,-
BAC64_E18,2,2p21,41993070,42079055,85985,-,-
BAC90_E16,2,2p21,42018481,42126003,107522,-,-
BAC125_J08,2,2p21,42067446,42199329,131883,-,-
BAC252_H02,2,2p21,42079048,42198859,119811,-,-
BAC151_F16,2,2p21,42102520,42242070,139550,-,-
BAC28_L17,2,2p21,42154216,42276782,122566,-,-
BAC160_I05,2,2p21,42177194,42276782,99588,-,-
BAC33_E23,2,2p21,42199324,42318970,119646,-,-
BAC121_H24,2,2p21,42214116,42339549,125433,-,-
BAC144_I08,2,2p21,42219748,42301325,81577,-,-
BAC124_G17,2,2p21,42312800,42432177,119377,-,-
BAC60_J21,2,2p21,42318287,42432162,113875,-,-
BAC73_A14,2,2p21,42377278,42474866,97588,-,-
BAC39_I06,2,2p21,42422067,42522909,100842,-,-
BAC129_J02,2,2p21,42524217,42626293,102076,-,-
BAC4_F14,2,2p21,42524981,42593191,68210,-,-
BAC182_E24,2,2p21,42544374,42626293,81919,-,-
BAC194_O19,2,2p21,42611888,42704150,92262,-,-
BAC51_B13,2,2p21,42626481,42800764,174283,-,-
BAC135_O13,2,2p21,42719723,42822308,102585,-,-
BAC117_A07,2,2p21,42778296,42880917,102621,-,-
BAC191_L18,2,2p21,42794463,42880917,86454,-,-
BAC84_G02,2,2p21,42828205,42919792,91587,-,-
BAC72_H13,2,2p21,42874698,43015505,140807,-,-
BAC78_J11,2,2p21,42882477,42980743,98266,-,-
BAC20_N06,2,2p21,42892106,42977331,85225,-,-
BAC142_O04,2,2p21,42914956,42990613,75657,-,-
BAC248_O03,2,2p21,42914960,42999841,84881,-,-
BAC70_F02,2,2p21,42914976,43043947,128971,-,-
BAC34_D09,2,2p21,42919895,43043890,123995,-,-
BAC176_J14,2,2p21,42920033,43015501,95468,-,-
BAC232_J18,2,2p21,42965547,43052882,87335,-,-
BAC50_N20,2,2p21,42999875,43122217,122342,-,-
BAC77_E24,2,2p21,43066449,43158618,92169,-,-
BAC233_C08,2,2p21,43099855,43194189,94334,-,-
BAC58_L09,2,2p21,43109945,43197424,87479,-,-
BAC151_P01,2,2p21,43254619,43330736,76117,-,-
BAC32_B10,2,2p21,43254619,43352084,97465,-,-
BAC155_L22,2,2p21,43274127,43365557,91430,-,-
BAC182_A01,2,2p21,43362856,43408941,46085,-,-
BAC218_F14,2,2p21,43365567,43467540,101973,-,-
BAC56_J20,2,2p21,43383781,43490492,106711,-,-
BAC242_I17,2,2p21,43548656,43657922,109266,-,-
BAC92_A15,2,2p21,43625886,43714171,88285,-,-
BAC168_L15,2,2p21,43699957,43780407,80450,-,-
BAC175_A17,2,2p21,43714165,43803855,89690,-,-
BAC80_E21,2,2p21,43714165,43799180,85015,-,-
BAC252_A09,2,2p21,43831333,43923319,91986,-,-
BAC165_G19,2,2p21,43838387,43969438,131051,-,-
BAC39_E11,2,2p21,43917126,44017528,100402,-,-
BAC89_B02,2,2p21,44025791,44112258,86467,-,-
BAC140_O23,2,2p21,44044109,44128479,84370,-,-
BAC161_H07,2,2p21,44072149,44159032,86883,-,-
BAC42_E09,2,2p21,44076837,44224389,147552,-,-
BAC128_B22,2,2p21,44145732,44264229,118497,-,-
BAC175_A24,2,2p21,44152663,44237031,84368,-,-
BAC50_L04,2,2p21,44159027,44264227,105200,-,-
BAC134_H20,2,2p21,44172268,44255346,83078,-,-
BAC30_A01,2,2p21,44294799,44473966,179167,-,-
BAC106_A05,2,2p21,44336920,44429525,92605,-,-
BAC218_N22,2,2p21,44354317,44443493,89176,-,-
BAC23_N22,2,2p21,44440340,44535138,94798,-,-
BAC236_D24,2,2p21,44575966,44673504,97538,-,-
BAC227_F19,2,2p21,44631349,44706264,74915,-,-
BAC148_I08,2,2p21,44683235,44766952,83717,-,-
BAC79_O07,2,2p21,44683246,44833625,150379,-,-
BAC249_G07,2,2p21,44744205,44822981,78776,-,-
BAC29_K07,2,2p21,44856517,44975922,119405,-,-
BAC200_O21,2,2p21,44857585,44883456,25871,-,-
BAC206_H19,2,2p21,44908840,44995366,86526,-,-
BAC9_N02,2,2p21,44957521,45073906,116385,-,-
BAC155_A13,2,2p21,44968735,45044779,76044,-,-
BAC249_J08,2,2p21,44969122,45044779,75657,-,-
BAC32_A06,2,2p21,44979087,45092543,113456,-,-
BAC183_G23,2,2p21,45044773,45146740,101967,-,-
BAC157_C04,2,2p21,45045927,45142576,96649,-,-
BAC76_E08,2,2p21,45045927,45134947,89020,-,-
BAC45_F08,2,2p21,45183005,45285922,102917,-,-
BAC243_H01,2,2p21,45223949,45313823,89874,-,-
BAC252_H15,2,2p21,45232260,45341018,108758,-,-
BAC26_L24,2,2p21,45322169,45402515,80346,-,-
BAC148_D13,2,2p21,45328386,45405113,76727,-,-
BAC37_H01,2,2p21,45328386,45435325,106939,-,-
BAC97_B10,2,2p21,45372939,45520751,147812,-,-
BAC171_D16,2,2p21,45372939,45463791,90852,-,-
BAC118_H19,2,2p21,45559103,45647463,88360,-,-
BAC182_B08,2,2p21,45642455,45719612,77157,-,-
BAC104_N21,2,2p21,45662061,45769527,107466,-,-
BAC99_M23,2,2p21,45762873,45844042,81169,-,-
BAC168_J04,2,2p21,45787079,45868629,81550,-,-
BAC73_H13,2,2p21,45787140,45886167,99027,-,-
BAC120_O11,2,2p21,45829549,45907239,77690,-,-
BAC237_P14,2,2p21,45849646,45930936,81290,-,-
BAC135_N14,2,2p21,45849647,45932080,82433,-,-
BAC50_L01,2,2p21,45935161,46053085,117924,-,-
BAC171_K04,2,2p21,45938104,46019406,81302,-,-
BAC50_B09,2,2p21,45987852,46082386,94534,-,-
BAC143_E05,2,2p21,46020814,46129899,109085,-,-
BAC194_F06,2,2p21,46087329,46165052,77723,-,-
BAC187_A07,2,2p21,46165384,46241492,76108,-,-
BAC60_G11,2,2p21,46201892,46302053,100161,-,-
BAC36_G04,2,2p21,46201894,46331198,129304,-,-
BAC185_M23,2,2p21,46203890,46322818,118928,-,-
BAC196_D14,2,2p21,46225615,46322827,97212,-,-
BAC137_F06,2,2p21,46225683,46308324,82641,-,-
BAC116_B20,2,2p21,46241655,46333107,91452,-,-
BAC25_C11,2,2p21,46241655,46339728,98073,-,-
BAC226_B02,2,2p21,46302048,46383377,81329,-,-
BAC192_E12,2,2p21,46402623,46489964,87341,-,-
BAC226_B24,2,2p21,46464898,46572652,107754,-,-
BAC145_J08,2,2p21,46491808,46591114,99306,-,-
BAC34_J06,2,2p21,46682983,46844073,161090,-,-
BAC161_N15,2,2p21,46682984,46760624,77640,-,-
BAC1_D20,2,2p21,46700647,46822590,121943,-,-
BAC72_H02,2,2p21,46736778,46822554,85776,-,-
BAC162_O24,2,2p21,46784981,46801578,16597,-,-
BAC184_A14,2,2p21,46866012,46956325,90313,-,-
BAC239_L20,2,2p21,46871886,46953212,81326,-,-
BAC96_N05,2,2p21,46941380,47036985,95605,-,-
BAC12_B07,2,2p21,46954697,47036985,82288,-,-
BAC150_E02,2,2p21,47016455,47142491,126036,-,-
BAC52_B15,2,2p21,47055176,47134551,79375,-,-
BAC33_C05,2,2p21,47070526,47183203,112677,-,-
BAC149_H18,2,2p21,47099345,47171747,72402,-,-
BAC123_B22,2,2p21,47112717,47227043,114326,-,-
BAC236_O17,2,2p21,47142485,47227044,84559,-,-
BAC176_M07,2,2p21,47157074,47264430,107356,-,-
BAC44_H14,2,2p21,47184970,47291674,106704,-,-
BAC65_P15,2,2p21,47210035,47294928,84893,-,-
BAC34_M02,2,2p21,47227223,47308501,81278,-,-
BAC27_P08,2,2p21,47278604,47351730,73126,-,-
BAC108_F08,2,2p21,47289747,47385460,95713,-,-
BAC223_E13,2,2p21,47291721,47365702,73981,-,-
BAC169_G12,2,2p21,47512239,47599861,87622,-,-
BAC218_D07,2,2p21-2p16.3,47586100,47697564,111464,-,-
BAC188_I04,2,2p16.3,47639438,47714790,75352,-,-
BAC244_A04,2,2p16.3,47666879,47752601,85722,-,-
BAC120_P03,2,2p16.3,47724540,47881802,157262,-,-
BAC78_I04,2,2p16.3,47748629,47830914,82285,-,-
BAC118_O22,2,2p16.3,47799544,47899054,99510,-,-
BAC128_G06,2,2p16.3,47877670,47963725,86055,-,-
BAC78_K17,2,2p16.3,47900931,48027230,126299,-,-
BAC81_N01,2,2p16.3,47909587,48022308,112721,-,-
BAC133_I16,2,2p16.3,47971072,48055471,84399,-,-
BAC170_G22,2,2p16.3,47974203,48054937,80734,-,-
BAC33_J18,2,2p16.3,47979954,48096834,116880,-,-
BAC195_F11,2,2p16.3,48000857,48096821,95964,-,-
BAC208_P08,2,2p16.3,48162587,48251110,88523,-,-
BAC33_J08,2,2p16.3,48171278,48287331,116053,-,-
BAC161_H11,2,2p16.3,48180436,48274195,93759,-,-
BAC67_K05,2,2p16.3,48219103,48369145,150042,-,-
BAC51_C12,2,2p16.3,48268377,48365692,97315,-,-
BAC92_F10,2,2p16.3,48379217,48486972,107755,-,-
BAC42_P14,2,2p16.3,48382956,48491801,108845,-,-
BAC211_D08,2,2p16.3,48393072,48498666,105594,-,-
BAC10_N11,2,2p16.3,48411704,48491807,80103,-,-
BAC22_I16,2,2p16.3,48486967,48622976,136009,-,-
BAC194_E12,2,2p16.3,48488957,48580202,91245,-,-
BAC240_L03,2,2p16.3,48491801,48580202,88401,-,-
BAC161_N03,2,2p16.3,48538680,48621088,82408,-,-
BAC67_P08,2,2p16.3,48540403,48643292,102889,-,-
BAC51_F05,2,2p16.3,48558959,48658970,100011,-,-
BAC23_C13,2,2p16.3,48580349,48668591,88242,-,-
BAC155_D06,2,2p16.3,48580603,48666814,86211,-,-
BAC60_C16,2,2p16.3,48580603,48694224,113621,-,-
BAC90_H01,2,2p16.3,48606312,48694220,87908,-,-
BAC243_O23,2,2p16.3,48618554,48730123,111569,-,-
BAC113_D07,2,2p16.3,48621090,48711491,90401,-,-
BAC14_K19,2,2p16.3,49001621,49092344,90723,-,-
BAC186_K01,2,2p16.3,49148912,49266983,118071,-,-
BAC90_P03,2,2p16.3,49291338,49389679,98341,-,-
BAC178_J11,2,2p16.3,49329909,49409074,79165,-,-
BAC61_H14,2,2p16.3,49382908,49482652,99744,-,-
BAC130_J01,2,2p16.3,49568036,49675730,107694,-,-
BAC82_O03,2,2p16.3,49685503,49778417,92914,-,-
BAC148_F07,2,2p16.3,49688892,49783408,94516,-,-
BAC1_H21,2,2p16.3,49765892,49942394,176502,-,-
BAC28_F15,2,2p16.3,49788464,49939013,150549,-,-
BAC194_K16,2,2p16.3,49980514,50082707,102193,-,-
BAC95_M18,2,2p16.3,50101747,50186764,85017,-,-
BAC221_H17,2,2p16.3,50786699,50869989,83290,-,-
BAC248_N06,2,2p16.3,51050408,51131316,80908,-,-
BAC35_L06,2,2p16.3,51050441,51131260,80819,-,-
BAC132_H07,2,2p16.3,51071274,51177318,106044,-,-
BAC177_D23,2,2p16.3,51444142,51527796,83654,-,-
BAC191_J13,2,2p16.3,51458034,51546314,88280,-,-
BAC58_B22,2,2p16.3,51480257,51581328,101071,-,-
BAC121_A06,2,2p16.3,51554889,51639437,84548,-,-
BAC241_D06,2,2p16.3,51859905,51948771,88866,-,-
BAC230_M22,2,2p16.3,51859905,51966171,106266,-,-
BAC78_G06,2,2p16.3,52055295,52145719,90424,-,-
BAC102_I06,2,2p16.3,52307633,52422206,114573,-,-
BAC161_H12,2,2p16.3,52466215,52552387,86172,-,-
BAC108_E04,2,2p16.3,52548637,52666319,117682,-,-
BAC186_F04,2,2p16.3,52557741,52666295,108554,-,-
BAC43_G23,2,2p16.2,52754870,52906255,151385,-,-
BAC27_C12,2,2p16.2,52792650,52949782,157132,-,-
BAC91_A01,2,2p16.2,52792653,52885953,93300,-,-
BAC15_I05,2,2p16.2,53256123,53359228,103105,-,-
BAC193_L02,2,2p16.2,53315294,53412305,97011,-,-
BAC153_I15,2,2p16.2,53498304,53614292,115988,-,-
BAC38_O14,2,2p16.2,53617933,53724310,106377,-,-
BAC175_N16,2,2p16.2,53694725,53790701,95976,-,-
BAC84_N03,2,2p16.2,53697101,53791408,94307,-,-
BAC73_I11,2,2p16.2,53715457,53800297,84840,-,-
BAC86_A08,2,2p16.2,53790697,53879215,88518,-,-
BAC25_P18,2,2p16.2,53790757,53879215,88458,-,-
BAC22_O10,2,2p16.2,53800296,53962206,161910,-,-
BAC248_B06,2,2p16.2,53829374,53951014,121640,-,-
BAC83_D05,2,2p16.2,53975696,54105532,129836,-,-
BAC53_M16,2,2p16.2,54035939,54162573,126634,-,-
BAC41_C06,2,2p16.2,54035939,54163298,127359,-,-
BAC23_L18,2,2p16.2,54035968,54118637,82669,-,-
BAC119_F11,2,2p16.2,54043055,54208592,165537,-,-
BAC115_O23,2,2p16.2,54208600,54286267,77667,-,-
BAC115_L20,2,2p16.2,54315503,54417117,101614,-,-
BAC26_L16,2,2p16.2,54412757,54518555,105798,-,-
BAC65_N07,2,2p16.2,54442694,54555635,112941,-,-
BAC62_B12,2,2p16.2,54442726,54554478,111752,-,-
BAC96_H13,2,2p16.2,54453127,54571657,118530,-,-
BAC18_F04,2,2p16.2,54477863,54609244,131381,-,-
BAC218_P08,2,2p16.2,54488462,54571657,83195,-,-
BAC26_K05,2,2p16.2,54489678,54588345,98667,-,-
BAC73_I18,2,2p16.2,54497063,54605804,108741,-,-
BAC57_L16,2,2p16.2,54634476,54736803,102327,-,-
BAC59_D21,2,2p16.2,54644967,54759707,114740,-,-
BAC66_L12,2,2p16.2,54679309,54790758,111449,-,-
BAC252_P04,2,2p16.2-2p16.1,54707715,54803774,96059,-,-
BAC57_B24,2,2p16.2-2p16.1,54756752,54891665,134913,-,-
BAC234_L01,2,2p16.2-2p16.1,54770206,54845546,75340,-,-
BAC34_I22,2,2p16.1,54810291,54916125,105834,-,-
BAC155_F16,2,2p16.1,54825078,54905992,80914,-,-
BAC248_F09,2,2p16.1,54832152,54907967,75815,-,-
BAC109_K06,2,2p16.1,54845540,54929158,83618,-,-
BAC176_F19,2,2p16.1,54849839,54937258,87419,-,-
BAC56_N09,2,2p16.1,55145912,55249277,103365,-,-
BAC102_H01,2,2p16.1,55201460,55307198,105738,-,-
BAC147_O07,2,2p16.1,55237134,55334431,97297,-,-
BAC95_L13,2,2p16.1,55238886,55348420,109534,-,-
BAC69_I11,2,2p16.1,55239346,55334454,95108,-,-
BAC66_D21,2,2p16.1,55244370,55336013,91643,-,-
BAC34_E24,2,2p16.1,55262198,55351059,88861,-,-
BAC20_D23,2,2p16.1,55264144,55416320,152176,-,-
BAC142_J18,2,2p16.1,55313631,55399482,85851,-,-
BAC142_K18,2,2p16.1,55313631,55399492,85861,-,-
BAC70_C10,2,2p16.1,55569788,55681952,112164,-,-
BAC50_G03,2,2p16.1,55637374,55756333,118959,-,-
BAC64_C16,2,2p16.1,55664120,55756333,92213,-,-
BAC84_D09,2,2p16.1,55695315,55793673,98358,-,-
BAC45_O08,2,2p16.1,55706958,55872965,166007,-,-
BAC219_F09,2,2p16.1,55742782,55828177,85395,-,-
BAC30_K07,2,2p16.1,55771899,55866482,94583,-,-
BAC61_H16,2,2p16.1,55865409,55954648,89239,-,-
BAC52_L15,2,2p16.1,55983358,56073517,90159,-,-
BAC154_H21,2,2p16.1,56047423,56126799,79376,-,-
BAC234_J06,2,2p16.1,56142765,56247599,104834,-,-
BAC84_C24,2,2p16.1,56198926,56348670,149744,-,-
BAC95_L24,2,2p16.1,56315811,56400362,84551,-,-
BAC248_E01,2,2p16.1,56368629,56447990,79361,-,-
BAC41_E18,2,2p16.1,56394166,56537316,143150,-,-
BAC133_N02,2,2p16.1,56503153,56585795,82642,-,-
BAC142_G22,2,2p16.1,56535405,56625443,90038,-,-
BAC159_N10,2,2p16.1,56540891,56649676,108785,-,-
BAC60_I12,2,2p16.1,56647983,56852460,204477,-,-
BAC44_K03,2,2p16.1,56698739,56852427,153688,-,-
BAC240_H12,2,2p16.1,56747387,56833395,86008,-,-
BAC160_J03,2,2p16.1,56747602,56824843,77241,-,-
BAC162_N01,2,2p16.1,56999313,57110819,111506,-,-
BAC46_K12,2,2p16.1,57236314,57332148,95834,-,-
BAC140_F24,2,2p16.1,57287231,57364761,77530,-,-
BAC67_A18,2,2p16.1,57846835,57952510,105675,-,-
BAC122_P10,2,2p16.1,57900841,57982107,81266,-,-
BAC126_C06,2,2p16.1,57900841,57982107,81266,-,-
BAC233_A13,2,2p16.1,58046654,58143589,96935,-,-
BAC199_O04,2,2p16.1,58104306,58189678,85372,-,-
BAC28_N05,2,2p16.1,58264582,58348695,84113,-,-
BAC160_F24,2,2p16.1,58305825,58388441,82616,-,-
BAC46_L17,2,2p16.1,58381996,58504770,122774,-,-
BAC143_A07,2,2p16.1,58414985,58498510,83525,-,-
BAC95_G20,2,2p16.1,58541783,58637597,95814,-,-
BAC100_N08,2,2p16.1,58562104,58645464,83360,-,-
BAC242_J03,2,2p16.1,58635147,58648233,13086,-,-
BAC132_A02,2,2p16.1,58694979,58783808,88829,-,-
BAC91_H24,2,2p16.1,59004020,59087896,83876,-,-
BAC97_N17,2,2p16.1,59099695,59215989,116294,-,-
BAC219_N20,2,2p16.1,59205854,59311703,105849,-,-
BAC119_J04,2,2p16.1,59504913,59617397,112484,-,-
BAC71_P02,2,2p16.1,59512458,59632106,119648,-,-
BAC80_E11,2,2p16.1,59632099,59738753,106654,-,-
BAC220_N07,2,2p16.1,59738747,59838632,99885,-,-
BAC91_C23,2,2p16.1,59812883,59911962,99079,-,-
BAC10_B21,2,2p16.1,59824015,59914777,90762,-,-
BAC172_N16,2,2p16.1,59824018,59955524,131506,-,-
BAC43_D13,2,2p16.1,59852384,60004962,152578,-,-
BAC232_C07,2,2p16.1,59878977,59945182,66205,-,-
BAC142_E10,2,2p16.1,59878977,59956685,77708,-,-
BAC19_I09,2,2p16.1,59879013,59974187,95174,-,-
BAC129_G11,2,2p16.1,59926117,60009301,83184,-,-
BAC124_I21,2,2p16.1,59966777,60069906,103129,-,-
BAC228_M24,2,2p16.1,60055592,60129358,73766,-,-
BAC219_M06,2,2p16.1,60077645,60176391,98746,-,-
BAC167_O14,2,2p16.1,60080100,60151749,71649,-,-
BAC188_N17,2,2p16.1,60213201,60366491,153290,-,-
BAC58_M06,2,2p16.1,60278859,60369421,90562,-,-
BAC171_E18,2,2p16.1,60334986,60419520,84534,-,-
BAC219_A21,2,2p16.1,60350798,60456689,105891,-,-
BAC247_D13,2,2p16.1,60393567,60497487,103920,-,-
BAC227_E24,2,2p16.1,60393588,60485265,91677,-,-
BAC167_A23,2,2p16.1,60564600,60649263,84663,-,-
BAC106_K06,2,2p16.1,60601771,60706235,104464,-,-
BAC186_M16,2,2p16.1,60636952,60708136,71184,-,-
BAC78_O03,2,2p16.1,60651116,60735224,84108,-,-
BAC135_L20,2,2p16.1,60756469,60842245,85776,-,-
BAC84_O02,2,2p16.1,60790054,60882455,92401,-,-
BAC28_N18,2,2p16.1,60848358,61007727,159369,-,-
BAC218_N08,2,2p16.1,60920114,60994867,74753,-,-
BAC122_G07,2,2p16.1,60935505,61035526,100021,-,-
BAC59_I02,2,2p16.1,60943915,61081424,137509,-,-
BAC252_K20,2,2p15,61249205,61264973,15768,-,-
BAC116_H24,2,2p15,61268950,61368835,99885,-,-
BAC141_D03,2,2p15,61414435,61491252,76817,-,-
BAC29_N18,2,2p15,61460626,61552533,91907,-,-
BAC114_H23,2,2p15,61470770,61569039,98269,-,-
BAC97_I09,2,2p15,61554121,61675399,121278,-,-
BAC39_B07,2,2p15,61568197,61708461,140264,-,-
BAC149_M20,2,2p15,61615640,61732927,117287,-,-
BAC141_I16,2,2p15,61695080,61788405,93325,-,-
BAC243_F05,2,2p15,61699749,61812616,112867,-,-
BAC120_B23,2,2p15,61701852,61798555,96703,-,-
BAC219_O18,2,2p15,61708456,61812614,104158,-,-
BAC195_B04,2,2p15,61719034,61798555,79521,-,-
BAC141_K06,2,2p15,61741332,61829211,87879,-,-
BAC91_B23,2,2p15,61755706,61854654,98948,-,-
BAC67_O16,2,2p15,61755710,61853833,98123,-,-
BAC55_C11,2,2p15,61790929,61939934,149005,-,-
BAC187_G06,2,2p15,61790966,61922758,131792,-,-
BAC122_I17,2,2p15,61798549,61960941,162392,-,-
BAC42_F16,2,2p15,61818769,61912508,93739,-,-
BAC70_O14,2,2p15,61836398,61912492,76094,-,-
BAC53_L16,2,2p15,61860133,61976588,116455,-,-
BAC146_E12,2,2p15,61872852,61976528,103676,-,-
BAC252_N02,2,2p15,61922752,62027249,104497,-,-
BAC147_I10,2,2p15,62043419,62129802,86383,-,-
BAC155_J09,2,2p15,62044320,62122582,78262,-,-
BAC25_F18,2,2p15,62044322,62139744,95422,-,-
BAC129_P23,2,2p15,62044331,62162545,118214,-,-
BAC27_L11,2,2p15,62058890,62158452,99562,-,-
BAC229_A13,2,2p15,62111368,62184804,73436,-,-
BAC100_N20,2,2p15,62158447,62299621,141174,-,-
BAC237_A24,2,2p15,62162574,62258413,95839,-,-
BAC229_G13,2,2p15,62214203,62299621,85418,-,-
BAC220_F07,2,2p15,62225762,62332636,106874,-,-
BAC43_D23,2,2p15,62225765,62336901,111136,-,-
BAC80_E23,2,2p15,62240639,62402207,161568,-,-
BAC232_M20,2,2p15,62242149,62338717,96568,-,-
BAC91_B07,2,2p15,62245259,62346988,101729,-,-
BAC65_I10,2,2p15,62265657,62359764,94107,-,-
BAC25_D12,2,2p15,62371728,62459743,88015,-,-
BAC48_N15,2,2p15,62428469,62598515,170046,-,-
BAC199_P18,2,2p15,62440484,62528336,87852,-,-
BAC21_I04,2,2p15,62472941,62556941,84000,-,-
BAC31_H06,2,2p15,62494431,62566973,72542,-,-
BAC194_L16,2,2p15,62534686,62645988,111302,-,-
BAC107_G03,2,2p15,62608004,62702768,94764,-,-
BAC191_N16,2,2p15,62608126,62699419,91293,-,-
BAC64_B09,2,2p15,62622063,62717699,95636,-,-
BAC27_O13,2,2p15,62825696,62923255,97559,-,-
BAC4_B18,2,2p15,62834433,62936989,102556,-,-
BAC247_C12,2,2p15,62841667,62933706,92039,-,-
BAC66_C21,2,2p15,62884407,62980790,96383,-,-
BAC233_P11,2,2p15,63127699,63254757,127058,-,-
BAC65_P24,2,2p15,63127731,63278269,150538,-,-
BAC109_G17,2,2p15,63140246,63254722,114476,-,-
BAC52_J17,2,2p15,63329868,63455779,125911,-,-
BAC58_D20,2,2p15,63566901,63581884,14983,-,-
BAC32_K02,2,2p15,63582328,63668294,85966,-,-
BAC40_K23,2,2p15,63611122,63723873,112751,-,-
BAC230_J19,2,2p15,63687936,63791601,103665,-,-
BAC78_K12,2,2p14,64008507,64113239,104732,-,-
BAC186_G13,2,2p14,64055082,64175791,120709,-,-
BAC57_C17,2,2p14,64072752,64175791,103039,-,-
BAC125_A19,2,2p14,64084040,64182282,98242,-,-
BAC197_I14,2,2p14,64182483,64273108,90625,-,-
BAC228_F20,2,2p14,64291195,64392853,101658,-,-
BAC32_K19,2,2p14,64323406,64411807,88401,-,-
BAC102_L17,2,2p14,64348739,64441818,93079,-,-
BAC228_D13,2,2p14,64477357,64565014,87657,-,-
BAC109_M17,2,2p14,64632981,64727445,94464,-,-
BAC77_E18,2,2p14,64688604,64776545,87941,-,-
BAC101_J14,2,2p14,64690438,64784925,94487,-,-
BAC53_J10,2,2p14,64793300,64921251,127951,-,-
BAC224_D01,2,2p14,64827915,64945260,117345,-,-
BAC102_F22,2,2p14,64846034,64962852,116818,-,-
BAC18_C06,2,2p14,64876169,64975439,99270,-,-
BAC109_P12,2,2p14,64921289,65100943,179654,-,-
BAC120_J17,2,2p14,64926264,65039746,113482,-,-
BAC52_M18,2,2p14,64928176,65053954,125778,-,-
BAC163_D18,2,2p14,65000073,65084564,84491,-,-
BAC200_E12,2,2p14,65005173,65091778,86605,-,-
BAC173_C22,2,2p14,65045888,65160771,114883,-,-
BAC116_I02,2,2p14,65050496,65138148,87652,-,-
BAC126_J01,2,2p14,65143887,65296708,152821,-,-
BAC37_E24,2,2p14,65161910,65289922,128012,-,-
BAC151_O22,2,2p14,65188739,65289922,101183,-,-
BAC219_A13,2,2p14,65207526,65289922,82396,-,-
BAC150_C11,2,2p14,65221041,65350619,129578,-,-
BAC175_N03,2,2p14,65318844,65405191,86347,-,-
BAC76_M17,2,2p14,65331745,65421637,89892,-,-
BAC56_C11,2,2p14,65331768,65461179,129411,-,-
BAC240_K13,2,2p14,65350613,65431571,80958,-,-
BAC65_I09,2,2p14,65377839,65455622,77783,-,-
BAC228_A05,2,2p14,65390671,65494432,103761,-,-
BAC76_D05,2,2p14,65409022,65501648,92626,-,-
BAC115_M18,2,2p14,65508841,65615291,106450,-,-
BAC73_K10,2,2p14,65513289,65615268,101979,-,-
BAC75_G14,2,2p14,65523458,65718511,195053,-,-
BAC193_J04,2,2p14,65625504,65693148,67644,-,-
BAC122_H15,2,2p14,65675400,65836834,161434,-,-
BAC192_B07,2,2p14,65675406,65837782,162376,-,-
BAC15_M23,2,2p14,65751913,65849841,97928,-,-
BAC127_M05,2,2p14,65775059,65874355,99296,-,-
BAC55_F04,2,2p14,65962372,66063656,101284,-,-
BAC151_F23,2,2p14,66237096,66328755,91659,-,-
BAC200_N09,2,2p14,66239801,66325850,86049,-,-
BAC202_K02,2,2p14,66253032,66333562,80530,-,-
BAC28_L19,2,2p14,66256850,66356644,99794,-,-
BAC73_K21,2,2p14,66325845,66418060,92215,-,-
BAC236_I16,2,2p14,66361058,66465794,104736,-,-
BAC224_D13,2,2p14,66409340,66494164,84824,-,-
BAC33_J06,2,2p14,66432648,66519392,86744,-,-
BAC22_D16,2,2p14,66494164,66571636,77472,-,-
BAC103_F09,2,2p14,66500267,66636168,135901,-,-
BAC12_G01,2,2p14,66500267,66617870,117603,-,-
BAC149_C15,2,2p14,66500268,66603436,103168,-,-
BAC69_J22,2,2p14,66581079,66727511,146432,-,-
BAC109_F11,2,2p14,66639195,66716043,76848,-,-
BAC102_I20,2,2p14,66904161,66980353,76192,-,-
BAC252_G21,2,2p14,67043864,67169617,125753,-,-
BAC45_K09,2,2p14,67368971,67463551,94580,-,-
BAC59_C21,2,2p14,67381771,67501206,119435,-,-
BAC230_L01,2,2p14,67448680,67541187,92507,-,-
BAC16_E17,2,2p14,67545407,67619983,74576,-,-
BAC145_B02,2,2p14,67613266,67684596,71330,-,-
BAC140_N16,2,2p14,67783557,67873808,90251,-,-
BAC66_H20,2,2p14,67840678,67921077,80399,-,-
BAC180_G10,2,2p14,67876134,67975774,99640,-,-
BAC107_P13,2,2p14,67876134,67975773,99639,-,-
BAC155_J14,2,2p14,67929776,68033801,104025,-,-
BAC34_M22,2,2p14,67952460,68092304,139844,-,-
BAC43_E06,2,2p14,68060405,68153836,93431,-,-
BAC41_F12,2,2p14,68144886,68256974,112088,-,-
BAC52_O12,2,2p14,68186438,68296825,110387,-,-
BAC42_B23,2,2p14,68276872,68487008,210136,-,-
BAC89_F14,2,2p14,68283816,68419922,136106,-,-
BAC69_O24,2,2p14,68299378,68397103,97725,-,-
BAC237_M01,2,2p14,68533975,68614781,80806,-,-
BAC178_O10,2,2p14,68558950,68575386,16436,-,-
BAC226_M01,2,2p14,68657813,68768181,110368,-,-
BAC50_C05,2,2p14,68671298,68814303,143005,-,-
BAC220_J13,2,2p14,68672371,68748493,76122,-,-
BAC36_O13,2,2p14,68691421,68814305,122884,-,-
BAC113_G10,2,2p14,68811305,68922296,110991,-,-
BAC163_H12,2,2p14,68820512,68903598,83086,-,-
BAC152_L07,2,2p14,68829719,68904336,74617,-,-
BAC71_F13,2,2p14,68854354,68931565,77211,-,-
BAC236_M09,2,2p14,68860081,68938553,78472,-,-
BAC84_O07,2,2p14,68878602,69002945,124343,-,-
BAC121_M21,2,2p14,68949435,68989078,39643,-,-
BAC81_D19,2,2p14,68951000,69058747,107747,-,-
BAC120_P16,2,2p14,69008334,69182283,173949,-,-
BAC33_N09,2,2p14,69097183,69198637,101454,-,-
BAC181_I19,2,2p14,69103179,69170114,66935,-,-
BAC150_O14,2,2p14,69117610,69198642,81032,-,-
BAC199_B05,2,2p14,69151502,69229956,78454,-,-
BAC49_H13,2,2p14,69209046,69343536,134490,-,-
BAC6_H24,2,2p14,69287223,69427185,139962,-,-
BAC181_I15,2,2p14,69287224,69368010,80786,-,-
BAC113_C18,2,2p14,69287224,69426882,139658,-,-
BAC183_G18,2,2p14,69304229,69372700,68471,-,-
BAC206_A02,2,2p14,69323557,69427181,103624,-,-
BAC38_E22,2,2p14,69329148,69421980,92832,-,-
BAC140_C22,2,2p14,69368108,69455257,87149,-,-
BAC217_C13,2,2p14,69372352,69478938,106586,-,-
BAC100_I05,2,2p14,69391269,69513309,122040,-,-
BAC152_F19,2,2p14,69394752,69517736,122984,-,-
BAC69_D12,2,2p14,69398290,69520160,121870,-,-
BAC227_B14,2,2p14,69422006,69512028,90022,-,-
BAC135_G12,2,2p14,69422006,69527499,105493,-,-
BAC199_A16,2,2p14,69422006,69512025,90019,-,-
BAC57_D02,2,2p14,69437393,69549151,111758,-,-
BAC38_G09,2,2p14,69512128,69615050,102922,-,-
BAC25_G12,2,2p14,69527493,69645503,118010,-,-
BAC132_L02,2,2p14,69527495,69689388,161893,-,-
BAC228_B17,2,2p14,69535253,69615050,79797,-,-
BAC32_P13,2,2p14,69588063,69719869,131806,-,-
BAC88_P05,2,2p14,69614628,69697971,83343,-,-
BAC248_C14,2,2p14,69615042,69700131,85089,-,-
BAC44_H16,2,2p14,69635456,69723173,87717,-,-
BAC53_C21,2,2p14,69649088,69763230,114142,-,-
BAC32_J07,2,2p14,69653917,69755326,101409,-,-
BAC78_C13,2,2p14,69689406,69778411,89005,-,-
BAC199_M12,2,2p14,69705837,69825738,119901,-,-
BAC159_O08,2,2p14,69734538,69839051,104513,-,-
BAC165_G22,2,2p14,69779411,69857149,77738,-,-
BAC117_P18,2,2p14,69857492,69981463,123971,-,-
BAC21_P16,2,2p14,69989892,70014932,25040,-,-
BAC185_B22,2,2p14,70089001,70148560,59559,-,-
BAC175_B08,2,2p14,70104857,70179769,74912,-,-
BAC51_O18,2,2p14,70145020,70309196,164176,-,-
BAC132_L21,2,2p14,70180283,70281595,101312,-,-
BAC106_J11,2,2p14,70180283,70310240,129957,-,-
BAC123_D21,2,2p14,70196458,70345673,149215,-,-
BAC36_N08,2,2p14,70196458,70277688,81230,-,-
BAC221_C12,2,2p14,70294804,70382402,87598,-,-
BAC219_I02,2,2p14,70300395,70400847,100452,-,-
BAC178_C10,2,2p14,70310224,70400847,90623,-,-
BAC76_N13,2,2p14,70310229,70444703,134474,-,-
BAC192_J05,2,2p14,70346379,70445038,98659,-,-
BAC72_D12,2,2p14,70382420,70480096,97676,-,-
BAC165_A07,2,2p14,70384823,70480098,95275,-,-
BAC100_C03,2,2p14-2p13.3,70411344,70505263,93919,-,-
BAC10_H13,2,2p14-2p13.3,70411344,70543904,132560,-,-
BAC24_A22,2,2p14-2p13.3,70499683,70630854,131171,-,-
BAC116_E02,2,2p13.3,70541038,70654612,113574,-,-
BAC240_H13,2,2p13.3,70543912,70646135,102223,-,-
BAC134_J19,2,2p13.3,70572846,70654614,81768,-,-
BAC70_F07,2,2p13.3,70606697,70736121,129424,-,-
BAC23_O06,2,2p13.3,70606730,70713131,106401,-,-
BAC151_M12,2,2p13.3,70662907,70748722,85815,-,-
BAC146_K01,2,2p13.3,70684431,70822122,137691,-,-
BAC195_O23,2,2p13.3,70684432,70798033,113601,-,-
BAC75_K24,2,2p13.3,70755862,70861223,105361,-,-
BAC132_L09,2,2p13.3,70779384,70861225,81841,-,-
BAC217_F11,2,2p13.3,70788788,70923606,134818,-,-
BAC42_O08,2,2p13.3,70788790,70942468,153678,-,-
BAC155_H09,2,2p13.3,70808676,70870726,62050,-,-
BAC171_C02,2,2p13.3,70822115,70924710,102595,-,-
BAC125_D19,2,2p13.3,70822115,70930654,108539,-,-
BAC195_H07,2,2p13.3,70942461,71023112,80651,-,-
BAC248_D13,2,2p13.3,70955356,71044752,89396,-,-
BAC42_H11,2,2p13.3,70960325,71060355,100030,-,-
BAC72_L11,2,2p13.3,71000790,71104778,103988,-,-
BAC157_J23,2,2p13.3,71023108,71130494,107386,-,-
BAC143_N17,2,2p13.3,71110120,71197944,87824,-,-
BAC39_D05,2,2p13.3,71137700,71224647,86947,yes,-
BAC175_K01,2,2p13.3,71151078,71235323,84245,yes,-
BAC166_O10,2,2p13.3,71168911,71254128,85217,-,-
BAC171_D07,2,2p13.3,71170125,71260822,90697,yes,-
BAC218_A03,2,2p13.3,71235318,71330855,95537,-,-
BAC182_C21,2,2p13.3,71372003,71462443,90440,-,-
BAC148_L03,2,2p13.3,71437709,71529900,92191,-,-
BAC192_O05,2,2p13.3,71462437,71559916,97479,-,-
BAC100_D10,2,2p13.3,71468816,71579253,110437,-,-
BAC45_F10,2,2p13.3,71476104,71574834,98730,-,-
BAC22_A17,2,2p13.3,71534951,71761721,226770,-,-
BAC50_D16,2,2p13.3,71544334,71705575,161241,-,-
BAC150_N22,2,2p13.3,71565530,71657460,91930,-,-
BAC86_N16,2,2p13.3,71637915,71727677,89762,-,-
BAC234_D01,2,2p13.3,71666174,71761738,95564,-,-
BAC188_P22,2,2p13.3,71713332,71853049,139717,-,-
BAC71_C02,2,2p13.3,71726581,71819475,92894,-,-
BAC123_P20,2,2p13.3,71761732,71883380,121648,-,-
BAC145_L06,2,2p13.3,71776658,71861400,84742,-,-
BAC22_K21,2,2p13.3,71914778,72022085,107307,-,-
BAC78_B23,2,2p13.3,71914778,71991086,76308,-,-
BAC25_O19,2,2p13.3,71969727,72098947,129220,-,-
BAC76_E15,2,2p13.3,72012976,72110812,97836,-,-
BAC69_M06,2,2p13.3,72030750,72154740,123990,-,-
BAC157_B24,2,2p13.3,72038278,72175156,136878,-,-
BAC78_J16,2,2p13.3,72118708,72239675,120967,-,-
BAC36_B08,2,2p13.3,72133215,72221687,88472,-,-
BAC40_G02,2,2p13.3,72138034,72239656,101622,-,-
BAC103_C09,2,2p13.3,72204462,72265757,61295,-,-
BAC233_H19,2,2p13.3,72425816,72509012,83196,-,-
BAC224_I13,2,2p13.3-2p13.2,72529651,72628165,98514,-,-
BAC186_E13,2,2p13.3-2p13.2,72535305,72624653,89348,-,-
BAC187_E03,2,2p13.3-2p13.2,72542538,72646241,103703,-,-
BAC50_I01,2,2p13.3-2p13.2,72542538,72634443,91905,-,-
BAC6_N23,2,2p13.3-2p13.2,72579886,72688841,108955,-,-
BAC83_P03,2,2p13.2,72688840,72779250,90410,-,-
BAC181_K16,2,2p13.2,72770528,72864475,93947,-,-
BAC128_N02,2,2p13.2,72779268,72872587,93319,-,-
BAC123_H13,2,2p13.2,72798840,72883903,85063,-,-
BAC95_O01,2,2p13.2,72835049,72918892,83843,-,-
BAC113_E10,2,2p13.2,72918886,73029700,110814,-,-
BAC199_N01,2,2p13.2,72918886,72992035,73149,-,-
BAC150_N24,2,2p13.2,72929564,73008698,79134,-,-
BAC202_J16,2,2p13.2,73047893,73158136,110243,-,-
BAC159_K05,2,2p13.2,73091547,73191311,99764,-,-
BAC116_B16,2,2p13.2,73134146,73219024,84878,-,-
BAC86_D16,2,2p13.2,73197320,73293511,96191,-,-
BAC165_F20,2,2p13.2,73214717,73320867,106150,-,-
BAC168_J21,2,2p13.2,73219021,73314919,95898,-,-
BAC58_C10,2,2p13.2,73293502,73452470,158968,-,-
BAC170_B19,2,2p13.2,73301406,73405192,103786,-,-
BAC81_I15,2,2p13.2,73331811,73505020,173209,-,-
BAC218_H07,2,2p13.2,73370598,73499393,128795,-,-
BAC163_M09,2,2p13.2,73379239,73464994,85755,-,-
BAC151_B20,2,2p13.2,73383043,73533754,150711,-,-
BAC86_K23,2,2p13.2,73404790,73507798,103008,-,-
BAC140_P04,2,2p13.2,73482227,73553191,70964,-,-
BAC155_A20,2,2p13.2,73568098,73671915,103817,-,-
BAC95_C12,2,2p13.2,73610097,73711292,101195,-,-
BAC246_J13,2,2p13.2,73626714,73717673,90959,-,-
BAC75_F05,2,2p13.2,73631494,73739814,108320,-,-
BAC165_L07,2,2p13.2,73675557,73773824,98267,-,-
BAC140_H03,2,2p13.2,73714616,73816118,101502,-,-
BAC168_M03,2,2p13.2,73801442,73871910,70468,yes,-
BAC74_N04,2,2p13.2-2p13.1,73811920,73908740,96820,yes,-
BAC134_M11,2,2p13.2-2p13.1,73831903,73908525,76622,yes,-
BAC228_C19,2,2p13.2-2p13.1,73832189,73914187,81998,yes,-
BAC21_D08,2,2p13.2-2p13.1,73832189,73923821,91632,yes,-
BAC176_K09,2,2p13.2-2p13.1,73840031,73975370,135339,yes,-
BAC146_O05,2,2p13.2-2p13.1,73840031,73908740,68709,yes,-
BAC142_H07,2,2p13.2-2p13.1,73860403,73914187,53784,-,-
BAC77_L04,2,2p13.2-2p13.1,73860407,73945847,85440,-,-
BAC181_M04,2,2p13.1,73908732,74017809,109077,-,-
BAC229_M15,2,2p13.1,73914287,74074911,160624,-,-
BAC181_G16,2,2p13.1,73926786,74013489,86703,-,-
BAC45_G07,2,2p13.1,73926790,74029486,102696,-,-
BAC101_O11,2,2p13.1,73944535,74029500,84965,-,-
BAC35_F11,2,2p13.1,73975370,74060371,85001,-,-
BAC83_E08,2,2p13.1,74046629,74138556,91927,-,-
BAC149_D09,2,2p13.1,74074942,74171651,96709,-,-
BAC155_F09,2,2p13.1,74192527,74307112,114585,-,-
BAC107_F03,2,2p13.1,74216046,74335238,119192,-,-
BAC224_H15,2,2p13.1,74235790,74318170,82380,-,-
BAC119_H24,2,2p13.1,74246617,74350856,104239,-,-
BAC62_D06,2,2p13.1,74254943,74349845,94902,-,-
BAC179_L23,2,2p13.1,74281194,74350857,69663,-,-
BAC236_E09,2,2p13.1,74284101,74387024,102923,-,-
BAC16_O17,2,2p13.1,74368590,74525046,156456,-,-
BAC136_I08,2,2p13.1,74418315,74532849,114534,-,-
BAC6_B05,2,2p13.1,74433354,74525046,91692,-,-
BAC29_D07,2,2p13.1,74448292,74531175,82883,-,-
BAC23_O04,2,2p13.1,74480555,74569121,88566,-,-
BAC14_M07,2,2p13.1,74490175,74573164,82989,-,-
BAC200_O07,2,2p13.1,74490175,74590122,99947,-,-
BAC189_A01,2,2p13.1,74539520,74620261,80741,-,-
BAC183_G17,2,2p13.1,74597619,74694940,97321,-,-
BAC235_I08,2,2p13.1,74655829,74727150,71321,-,-
BAC50_L22,2,2p13.1,74785981,74905928,119947,-,-
BAC132_E23,2,2p13.1,74827850,74928151,100301,-,-
BAC125_P10,2,2p13.1,74828111,74979401,151290,-,-
BAC11_M13,2,2p13.1,74831112,74848642,17530,-,-
BAC238_F20,2,2p13.1,74833863,74935256,101393,-,-
BAC180_G22,2,2p13.1,74848753,74930317,81564,-,-
BAC40_N24,2,2p13.1,74848759,74978900,130141,-,-
BAC151_P22,2,2p13.1,74928367,75023795,95428,-,-
BAC195_E20,2,2p13.1,74932326,75007901,75575,-,-
BAC192_J08,2,2p13.1,74978896,75061735,82839,-,-
BAC46_F09,2,2p13.1,74978924,75139378,160454,-,-
BAC148_L20,2,2p13.1-2p12,75364164,75451894,87730,-,-
BAC176_C13,2,2p12,75567837,75706091,138254,-,-
BAC218_G15,2,2p12,75590941,75718841,127900,-,-
BAC18_J03,2,2p12,75642875,75781223,138348,-,-
BAC155_B03,2,2p12,75681258,75811777,130519,-,-
BAC30_O21,2,2p12,75715106,75877791,162685,-,-
BAC126_N03,2,2p12,75742352,75843600,101248,-,-
BAC129_D21,2,2p12,75753136,75848929,95793,-,-
BAC247_G05,2,2p12,75878093,75957828,79735,-,-
BAC2_J07,2,2p12,76095690,76193895,98205,-,-
BAC187_E22,2,2p12,76353554,76445433,91879,-,-
BAC68_M18,2,2p12,76388722,76505825,117103,-,-
BAC114_C03,2,2p12,76388725,76459528,70803,-,-
BAC92_C01,2,2p12,76395230,76538113,142883,-,-
BAC135_N01,2,2p12,76460222,76537291,77069,-,-
BAC84_I02,2,2p12,76546958,76653725,106767,-,-
BAC119_D09,2,2p12,76657948,76755874,97926,-,-
BAC231_J09,2,2p12,76711695,76799484,87789,-,-
BAC236_H06,2,2p12,76731002,76815481,84479,-,-
BAC248_P13,2,2p12,76907066,76993932,86866,-,-
BAC136_J03,2,2p12,77782904,77881415,98511,-,-
BAC50_H21,2,2p12,77800458,77881322,80864,-,-
BAC97_C04,2,2p12,77808971,77914379,105408,-,-
BAC110_P11,2,2p12,77941056,78060150,119094,-,-
BAC158_N05,2,2p12,77956379,78036133,79754,-,-
BAC96_D08,2,2p12,78033795,78149783,115988,-,-
BAC181_E15,2,2p12,78047018,78139984,92966,-,-
BAC185_J18,2,2p12,78209796,78299535,89739,-,-
BAC35_E11,2,2p12,78237712,78400642,162930,-,-
BAC182_B13,2,2p12,78364954,78461989,97035,-,-
BAC33_F14,2,2p12,78364954,78400880,35926,-,-
BAC117_D07,2,2p12,78388250,78496667,108417,-,-
BAC130_K02,2,2p12,78563604,78664110,100506,-,-
BAC186_P14,2,2p12,78609087,78693571,84484,-,-
BAC103_O05,2,2p12,78613934,78710273,96339,-,-
BAC181_N17,2,2p12,78728880,78810074,81194,-,-
BAC91_B06,2,2p12,78882966,79000472,117506,-,-
BAC171_D11,2,2p12,78912108,79018298,106190,-,-
BAC209_C01,2,2p12,78935041,78981270,46229,-,-
BAC175_I07,2,2p12,79000465,79125829,125364,-,-
BAC182_L22,2,2p12,79009154,79124946,115792,-,-
BAC10_L08,2,2p12,79028271,79125825,97554,-,-
BAC128_C12,2,2p12,79124561,79259043,134482,yes,-
BAC31_C04,2,2p12,79140907,79251880,110973,yes,-
BAC72_K02,2,2p12,79160706,79256942,96236,yes,-
BAC8_B13,2,2p12,79283577,79365268,81691,-,-
BAC116_B02,2,2p12,79324161,79426242,102081,-,-
BAC90_K19,2,2p12,79527317,79634609,107292,-,-
BAC150_I22,2,2p12,79580338,79682195,101857,-,-
BAC144_A07,2,2p12,79589139,79670559,81420,-,-
BAC202_J22,2,2p12,79817312,79921400,104088,-,-
BAC103_E03,2,2p12,79944702,80058367,113665,-,-
BAC148_E21,2,2p12,79974748,80058367,83619,-,-
BAC16_C13,2,2p12,79974748,80064220,89472,-,-
BAC141_F07,2,2p12,80058556,80173059,114503,-,-
BAC172_E17,2,2p12,80254209,80381861,127652,-,-
BAC135_H04,2,2p12,80318684,80426207,107523,-,-
BAC65_J13,2,2p12,80343086,80448034,104948,-,-
BAC106_H15,2,2p12,80357640,80448680,91040,-,-
BAC127_M08,2,2p12,80410454,80487751,77297,-,-
BAC58_O22,2,2p12,80453692,80544257,90565,-,-
BAC83_A19,2,2p12,80608851,80737284,128433,-,-
BAC252_P20,2,2p12,80660360,80752233,91873,-,-
BAC123_C06,2,2p12,80666764,80818242,151478,-,-
BAC248_O17,2,2p12,80695344,80802645,107301,-,-
BAC190_A16,2,2p12,80724970,80826678,101708,-,-
BAC64_M19,2,2p12,80744510,80846264,101754,-,-
BAC151_A19,2,2p12,80828520,80916092,87572,-,-
BAC137_D15,2,2p12,81021711,81117912,96201,-,-
BAC66_J03,2,2p12,81121154,81220740,99586,-,-
BAC32_P04,2,2p12,81282177,81446995,164818,-,-
BAC188_G14,2,2p12,81310766,81388342,77576,-,-
BAC103_J08,2,2p12,81312352,81446995,134643,-,-
BAC25_M09,2,2p12,81390768,81500378,109610,-,-
BAC76_D09,2,2p12,81493551,81587534,93983,-,-
BAC179_M12,2,2p12,81499940,81600608,100668,-,-
BAC118_C10,2,2p12,81777311,81809058,31747,-,-
BAC179_K24,2,2p12,81896075,81993855,97780,-,-
BAC30_H05,2,2p12,81943050,82067224,124174,-,-
BAC45_P18,2,2p12,81986598,82074390,87792,-,-
BAC2_P18,2,2p12,82040127,82120943,80816,-,-
BAC132_E13,2,2p12,82246114,82329728,83614,-,-
BAC22_A16,2,2p12,82382745,82514316,131571,-,-
BAC168_D04,2,2p12,82393740,82480372,86632,-,-
BAC162_L10,2,2p12,82496094,82572503,76409,-,-
BAC150_K05,2,2p12,82504362,82579940,75578,-,-
BAC51_B16,2,2p12,82520133,82667230,147097,-,-
BAC69_J21,2,2p12,82558366,82649207,90841,-,-
BAC193_E18,2,2p12,82597736,82670823,73087,-,-
BAC31_E03,2,2p12,82935811,83040021,104210,-,-
BAC83_L17,2,2p12,82950489,83040021,89532,-,-
BAC237_J02,2,2p12,83109345,83198782,89437,-,-
BAC190_J02,2,2p12,83198850,83277220,78370,-,-
BAC168_B20,2,2p12,83297290,83380941,83651,-,-
BAC56_C08,2,2p12,83297290,83400773,103483,-,-
BAC24_C15,2,2p11.2,83935391,84026292,90901,-,-
BAC106_H04,2,2p11.2,83946781,84056257,109476,-,-
BAC101_F07,2,2p11.2,83954249,84049607,95358,-,-
BAC132_P16,2,2p11.2,83996541,84072018,75477,-,-
BAC148_A20,2,2p11.2,84026649,84113744,87095,-,-
BAC183_J18,2,2p11.2,84114174,84209211,95037,-,-
BAC125_H18,2,2p11.2,84115953,84240152,124199,-,-
BAC246_N01,2,2p11.2,84127279,84196820,69541,-,-
BAC65_N18,2,2p11.2,84169706,84309133,139427,-,-
BAC63_G18,2,2p11.2,84250476,84356132,105656,-,-
BAC136_I12,2,2p11.2,84318324,84409736,91412,-,-
BAC11_M17,2,2p11.2,84329254,84476308,147054,-,-
BAC63_D06,2,2p11.2,84346806,84455135,108329,-,-
BAC158_I06,2,2p11.2,84455132,84546129,90997,-,-
BAC18_F18,2,2p11.2,84546164,84664652,118488,-,-
BAC230_J23,2,2p11.2,84551149,84664682,113533,-,-
BAC218_K16,2,2p11.2,84566973,84647297,80324,-,-
BAC118_J03,2,2p11.2,84572227,84684945,112718,-,-
BAC106_B22,2,2p11.2,84580653,84676921,96268,-,-
BAC90_B15,2,2p11.2,84664678,84832320,167642,-,-
BAC27_M08,2,2p11.2,84746559,84860532,113973,-,-
BAC213_A15,2,2p11.2,84792406,84869444,77038,-,-
BAC185_D04,2,2p11.2,84804718,84887703,82985,-,-
BAC133_C06,2,2p11.2,84886584,84979175,92591,-,-
BAC12_E15,2,2p11.2,84918700,85006430,87730,-,-
BAC122_K20,2,2p11.2,84949651,85111693,162042,-,-
BAC236_L23,2,2p11.2,84986909,85123595,136686,-,-
BAC127_N22,2,2p11.2,84999539,85106177,106638,-,-
BAC86_I19,2,2p11.2,84999539,85115673,116134,-,-
BAC237_F03,2,2p11.2,85044882,85126381,81499,-,-
BAC82_K14,2,2p11.2,85065610,85173423,107813,-,-
BAC118_C11,2,2p11.2,85071300,85088249,16949,-,-
BAC100_E02,2,2p11.2,85129711,85226408,96697,-,-
BAC165_H11,2,2p11.2,85173656,85278747,105091,-,-
BAC244_D16,2,2p11.2,85253802,85323982,70180,-,-
BAC104_F03,2,2p11.2,85272555,85398616,126061,-,-
BAC117_D20,2,2p11.2,85365900,85469678,103778,-,-
BAC27_H08,2,2p11.2,85365928,85462750,96822,-,-
BAC95_D03,2,2p11.2,85419160,85571309,152149,-,-
BAC240_N06,2,2p11.2,85419162,85538842,119680,-,-
BAC181_E21,2,2p11.2,85469669,85546033,76364,-,-
BAC90_O05,2,2p11.2,85538836,85631147,92311,yes,-
BAC151_J20,2,2p11.2,85546549,85631145,84596,yes,-
BAC151_I12,2,2p11.2,85572268,85663960,91692,-,-
BAC8_C14,2,2p11.2,85596428,85741737,145309,yes,-
BAC189_F23,2,2p11.2,85641472,85757227,115755,yes,-
BAC116_N22,2,2p11.2,85796736,85882467,85731,-,-
BAC230_A06,2,2p11.2,85824916,85955997,131081,-,-
BAC84_L20,2,2p11.2,85824947,85938674,113727,-,-
BAC3_L18,2,2p11.2,85825090,85959106,134016,-,-
BAC52_D11,2,2p11.2,85838896,85923354,84458,-,-
BAC60_P17,2,2p11.2,85871052,86041790,170738,-,-
BAC233_P14,2,2p11.2,85892065,85992162,100097,-,-
BAC84_E23,2,2p11.2,85918898,85999225,80327,-,-
BAC169_B10,2,2p11.2,85938667,86019660,80993,-,-
BAC33_I13,2,2p11.2,85946708,86030034,83326,-,-
BAC40_H17,2,2p11.2,85956017,86041769,85752,-,-
BAC158_I04,2,2p11.2,86001434,86069475,68041,-,-
BAC103_M19,2,2p11.2,86030118,86134516,104398,-,-
BAC131_H20,2,2p11.2,86041424,86140659,99235,-,-
BAC241_O13,2,2p11.2,86071614,86160853,89239,-,-
BAC154_E09,2,2p11.2,86075677,86187254,111577,-,-
BAC43_L13,2,2p11.2,86084559,86182904,98345,-,-
BAC240_B01,2,2p11.2,86129894,86247729,117835,-,-
BAC250_M11,2,2p11.2,86129896,86222705,92809,-,-
BAC241_P05,2,2p11.2,86187280,86280641,93361,-,-
BAC154_M21,2,2p11.2,86222736,86316224,93488,-,-
BAC97_O22,2,2p11.2,86280635,86377055,96420,-,-
BAC59_J09,2,2p11.2,86316219,86396563,80344,-,-
BAC167_D07,2,2p11.2,86321841,86432827,110986,-,-
BAC244_B07,2,2p11.2,86385384,86474758,89374,-,-
BAC132_F09,2,2p11.2,86408008,86494702,86694,-,-
BAC141_J13,2,2p11.2,86408008,86516993,108985,-,-
BAC131_H23,2,2p11.2,86461920,86559724,97804,-,-
BAC191_L07,2,2p11.2,86528527,86607695,79168,-,-
BAC244_C12,2,2p11.2,86567794,86684454,116660,-,-
BAC157_O23,2,2p11.2,86620999,86703164,82165,-,-
BAC43_N08,2,2p11.2,86684449,86694518,10069,-,-
BAC127_D08,2,2p11.2,86692694,86797120,104426,-,-
BAC12_K17,2,2p11.2,86767855,86860226,92371,-,-
BAC180_B15,2,2p11.2,86778524,86892827,114303,-,-
BAC223_H21,2,2p11.2,86795458,86872077,76619,-,-
BAC39_H07,2,2p11.2,86838515,86955303,116788,-,-
BAC95_J01,2,2p11.2,86860472,86968661,108189,-,-
BAC103_M09,2,2p11.2,86887811,86984831,97020,-,-
BAC171_E09,2,2p11.2,86987318,87057876,70558,-,-
BAC1_F22,2,2p11.2,87047085,87134480,87395,-,-
BAC46_J17,2,2p11.2,87094693,87197978,103285,-,-
BAC201_B04,2,2p11.2,87164592,87252694,88102,-,-
BAC81_H09,2,2p11.2,87259404,87354919,95515,-,-
BAC239_E03,2,2p11.2,87277075,87352963,75888,-,-
BAC244_G06,2,2p11.2,87309302,87388912,79610,-,-
BAC170_L13,2,2p11.2,87315342,87449380,134038,-,-
BAC144_P10,2,2p11.2,87354946,87462568,107622,-,-
BAC224_P09,2,2p11.2,87388950,87574749,185799,-,-
BAC40_J06,2,2p11.2,87405434,87418349,12915,-,-
BAC32_J17,2,2p11.2,87425559,87453402,27843,-,-
BAC140_O09,2,2p11.2,87449655,87537765,88110,-,-
BAC150_E11,2,2p11.2,87526535,87606624,80089,-,-
BAC97_O15,2,2p11.2,87527572,87650097,122525,-,-
BAC42_O12,2,2p11.2,87527578,87611987,84409,-,-
BAC151_P13,2,2p11.2,87546885,87629451,82566,-,-
BAC106_B23,2,2p11.2,87598221,87734997,136776,-,-
BAC137_A11,2,2p11.2,87631165,87734997,103832,-,-
BAC71_E06,2,2p11.2,87683320,87755630,72310,-,-
BAC91_P01,2,2p11.2,87720773,87890387,169614,-,-
BAC57_N16,2,2p11.2,87774227,87890573,116346,-,-
BAC234_A20,2,2p11.2,88033029,88143128,110099,-,-
BAC117_J17,2,2p11.2,88189465,88334431,144966,-,-
BAC237_D24,2,2p11.2,88215215,88299524,84309,-,-
BAC119_N20,2,2p11.2,88215215,88354745,139530,-,-
BAC121_F23,2,2p11.2,88299524,88385983,86459,-,-
BAC211_F11,2,2p11.2,88384402,88472388,87986,-,-
BAC144_I12,2,2p11.2,88413128,88502417,89289,-,-
BAC236_I18,2,2p11.2,88472716,88562252,89536,-,-
BAC90_C11,2,2p11.2,88498799,88641169,142370,-,-
BAC142_N12,2,2p11.2,88554394,88640143,85749,-,-
BAC105_O02,2,2p11.2,88554397,88641313,86916,-,-
BAC35_F20,2,2p11.2,88585810,88688945,103135,-,-
BAC118_N13,2,2p11.2,88602233,88733599,131366,-,-
BAC58_J22,2,2p11.2,88604048,88700288,96240,-,-
BAC80_G14,2,2p11.2,88655749,88744871,89122,-,-
BAC41_M04,2,2p11.2,88658557,88744871,86314,-,-
BAC228_D04,2,2p11.2,88700283,88774983,74700,-,-
BAC173_M07,2,2p11.2,88726515,88805823,79308,-,-
BAC242_N07,2,2p11.2,88827577,88927591,100014,-,-
BAC147_G14,2,2p11.2,88860094,88990197,130103,-,-
BAC161_F07,2,2p11.2,88880805,88996371,115566,-,-
BAC148_C01,2,2p11.2,88880805,88986203,105398,-,-
BAC232_N11,2,2p11.2,88930838,89033130,102292,-,-
BAC95_P04,2,2p11.2,88954789,89033130,78341,-,-
BAC186_C09,2,2p11.2,89033496,89125186,91690,-,-
BAC14_C22,2,2p11.2,89125933,89224360,98427,-,-
BAC158_N15,2,2p11.2,89584546,89677587,93041,-,-
BAC139_H05,2,2p11.2,89622843,89704779,81936,-,-
BAC222_F23,2,2p11.2,89632868,89751698,118830,-,-
BAC234_L11,2,2p11.2,89650400,89737174,86774,-,-
BAC184_M23,2,2p11.2-2p11.1,90991782,91006828,15046,-,-
BAC183_E19,2,2p11.1,91017257,91163546,146289,-,-
BAC232_O17,2,2p11.1,91039013,91133826,94813,-,-
BAC78_N08,2,2p11.1,91044935,91157830,112895,-,-
BAC30_E19,2,2p11.1,91044943,91133904,88961,-,-
BAC60_F18,2,2p11.1,91044958,91171290,126332,-,-
BAC120_H19,2,2p11.1,91048050,91125642,77592,-,-
BAC80_F20,2,2p11.1,91050120,91134553,84433,-,-
BAC200_H06,2,2p11.1,91050120,91156624,106504,-,-
BAC161_E08,2,2p11.1,91050147,91181737,131590,-,-
BAC122_P20,2,2p11.1,91134857,91262909,128052,-,-
BAC102_P22,2,2p11.1,91154295,91252616,98321,-,-
BAC244_P03,2,2p11.1,91169663,91277800,108137,-,-
BAC177_P11,2,2p11.1,91177809,91274038,96229,-,-
BAC235_G22,2,2p11.1,91182244,91262557,80313,-,-
BAC240_C05,2,2p11.1,91224922,91318938,94016,-,-
BAC168_J06,2,2p11.1,91318933,91436242,117309,-,-
BAC31_K06,2,2p11.1,91321943,91421062,99119,-,-
BAC73_J05,2,2p11.1,91334067,91422011,87944,-,-
BAC109_B22,2,2p11.1,91415497,91501702,86205,-,-
BAC157_J04,2,2q11.1,94743868,94841569,97701,-,-
BAC198_I02,2,2q11.1,94756988,94823794,66806,-,-
BAC37_D01,2,2q11.1,94777517,94875046,97529,-,-
BAC92_D24,2,2q11.1,94970214,95124107,153893,-,-
BAC19_D22,2,2q11.1,94981428,95084025,102597,-,-
BAC205_D03,2,2q11.1,95015131,95085837,70706,-,-
BAC146_M07,2,2q11.1,95069333,95158703,89370,-,-
BAC116_A24,2,2q11.1,95071236,95147891,76655,-,-
BAC82_O11,2,2q11.1,95072848,95243046,170198,-,-
BAC78_A10,2,2q11.1,95135507,95242901,107394,-,-
BAC51_D13,2,2q11.1,95227468,95341687,114219,-,-
BAC168_N14,2,2q11.1,95234810,95340650,105840,-,-
BAC36_P01,2,2q11.1,95243174,95341756,98582,-,-
BAC63_A18,2,2q11.1,95292910,95393015,100105,-,-
BAC37_E04,2,2q11.1,95293037,95371339,78302,-,-
BAC162_L11,2,2q11.1,95300251,95407545,107294,-,-
BAC150_C09,2,2q11.1,95388100,95471240,83140,-,-
BAC237_D07,2,2q11.1,95400643,95486199,85556,-,-
BAC237_H04,2,2q11.1,95407637,95486270,78633,-,-
BAC184_G19,2,2q11.1,95433124,95563335,130211,-,-
BAC105_G14,2,2q11.1,95443473,95563332,119859,-,-
BAC44_G13,2,2q11.1,95486318,95598732,112414,-,-
BAC120_D24,2,2q11.1-2q11.2,95621683,95719947,98264,-,-
BAC198_B14,2,2q11.2,95731945,95809300,77355,-,-
BAC96_P04,2,2q11.2,95822110,95910286,88176,-,-
BAC199_D22,2,2q11.2,95839473,95954625,115152,-,-
BAC129_O19,2,2q11.2,95911584,95999905,88321,-,-
BAC105_N17,2,2q11.2,96134514,96293363,158849,-,-
BAC31_N19,2,2q11.2,96186597,96375279,188682,-,-
BAC234_D11,2,2q11.2,96190763,96286925,96162,-,-
BAC236_B18,2,2q11.2,96190843,96267737,76894,-,-
BAC208_P17,2,2q11.2,96197722,96305470,107748,-,-
BAC240_E15,2,2q11.2,96222355,96322931,100576,-,-
BAC51_M11,2,2q11.2,96222374,96353991,131617,-,-
BAC65_I03,2,2q11.2,96230468,96322931,92463,-,-
BAC217_M15,2,2q11.2,96267734,96383202,115468,-,-
BAC248_P09,2,2q11.2,96303645,96387139,83494,-,-
BAC40_H05,2,2q11.2,96350292,96494963,144671,-,-
BAC40_G20,2,2q11.2,96437891,96556356,118465,-,-
BAC240_C01,2,2q11.2,96463823,96544516,80693,-,-
BAC84_C16,2,2q11.2,96468674,96556375,87701,-,-
BAC249_K20,2,2q11.2,96479252,96556337,77085,-,-
BAC91_L09,2,2q11.2,96522276,96625132,102856,-,-
BAC80_G07,2,2q11.2,96607803,96723821,116018,-,-
BAC120_P19,2,2q11.2,96625127,96720396,95269,-,-
BAC167_I16,2,2q11.2,96653358,96742913,89555,-,-
BAC163_N16,2,2q11.2,96698604,96789411,90807,-,-
BAC124_P18,2,2q11.2,96705487,96786683,81196,-,-
BAC218_B13,2,2q11.2,96831921,96961285,129364,-,-
BAC236_B01,2,2q11.2,96840067,96936186,96119,-,-
BAC127_F09,2,2q11.2,96840078,96938606,98528,-,-
BAC195_G23,2,2q11.2,96841703,96936186,94483,-,-
BAC228_P05,2,2q11.2,96869301,96961286,91985,-,-
BAC221_F16,2,2q11.2,96936180,97030403,94223,-,-
BAC107_D15,2,2q11.2,96940281,97035212,94931,-,-
BAC125_G07,2,2q11.2,96983295,97058454,75159,-,-
BAC249_I17,2,2q11.2,97116534,97201561,85027,-,-
BAC8_G10,2,2q11.2,97525604,97621069,95465,-,-
BAC82_L04,2,2q11.2,97653355,97779792,126437,-,-
BAC38_B22,2,2q11.2,97667968,97789434,121466,-,-
BAC217_H04,2,2q11.2,97668179,97746892,78713,-,-
BAC154_J22,2,2q11.2,97709980,97818183,108203,-,-
BAC65_F23,2,2q11.2,97747133,97834637,87504,-,-
BAC13_B16,2,2q11.2,97807712,97934375,126663,-,-
BAC90_O24,2,2q11.2,97899853,97986873,87020,-,-
BAC66_K03,2,2q11.2,97899853,97986873,87020,-,-
BAC178_E13,2,2q11.2,97902014,97986873,84859,-,-
BAC158_F06,2,2q11.2,97917434,98012524,95090,-,-
BAC147_N15,2,2q11.2,97918681,98015926,97245,-,-
BAC169_K11,2,2q11.2,97928699,98035999,107300,-,-
BAC23_P11,2,2q11.2,97984469,98071183,86714,-,-
BAC150_N02,2,2q11.2,97984479,98073983,89504,-,-
BAC133_C22,2,2q11.2,97986867,98087241,100374,-,-
BAC147_M17,2,2q11.2,98012678,98093158,80480,-,-
BAC217_C16,2,2q11.2,98050788,98135213,84425,-,-
BAC121_N03,2,2q11.2,98093269,98103412,10143,-,-
BAC229_A19,2,2q11.2,98175032,98259356,84324,-,-
BAC168_G18,2,2q11.2,98252795,98366620,113825,-,-
BAC101_N06,2,2q11.2,98304535,98401019,96484,-,-
BAC163_L13,2,2q11.2,98334070,98417595,83525,-,-
BAC219_G21,2,2q11.2,98335300,98435599,100299,-,-
BAC152_L08,2,2q11.2,98359557,98458140,98583,-,-
BAC59_A07,2,2q11.2,98417589,98546052,128463,-,-
BAC163_C22,2,2q11.2,98459189,98579536,120347,-,-
BAC86_K04,2,2q11.2,98486406,98572887,86481,-,-
BAC139_N09,2,2q11.2,98573199,98656779,83580,-,-
BAC141_P23,2,2q11.2,98592288,98692655,100367,-,-
BAC109_J20,2,2q11.2,98692647,98870368,177721,-,-
BAC96_D16,2,2q11.2,98692647,98829668,137021,-,-
BAC171_B17,2,2q11.2,98712077,98797028,84951,-,-
BAC20_G04,2,2q11.2,98716023,98816894,100871,-,-
BAC244_B09,2,2q11.2,98717810,98822105,104295,-,-
BAC59_K04,2,2q11.2,98718407,98804592,86185,-,-
BAC171_L13,2,2q11.2,98797418,98870368,72950,-,-
BAC33_L04,2,2q11.2,98804585,98923245,118660,-,-
BAC204_C06,2,2q11.2,98817231,98923244,106013,-,-
BAC56_P18,2,2q11.2,98833945,98930144,96199,-,-
BAC103_J02,2,2q11.2,98904126,98991427,87301,-,-
BAC187_I12,2,2q11.2,99116739,99237306,120567,-,-
BAC51_G03,2,2q11.2,99116745,99227705,110960,-,-
BAC85_F20,2,2q11.2,99162820,99244306,81486,-,-
BAC24_A21,2,2q11.2,99227746,99343565,115819,-,-
BAC126_B11,2,2q11.2,99237457,99371895,134438,-,-
BAC126_L23,2,2q11.2,99237457,99371782,134325,-,-
BAC76_F09,2,2q11.2,99241662,99393748,152086,-,-
BAC132_M23,2,2q11.2,99256755,99343565,86810,-,-
BAC234_K04,2,2q11.2,99274106,99382108,108002,-,-
BAC197_O08,2,2q11.2,99421109,99555614,134505,-,-
BAC135_E12,2,2q11.2,99465172,99555614,90442,-,-
BAC82_E03,2,2q11.2,99551267,99646853,95586,-,-
BAC140_F06,2,2q11.2,99608761,99694469,85708,-,-
BAC26_O20,2,2q11.2,99671972,99756176,84204,-,-
BAC182_L21,2,2q11.2,99759881,99844472,84591,-,-
BAC27_C18,2,2q11.2,99766074,99883270,117196,-,-
BAC170_N06,2,2q11.2,99792853,99924534,131681,-,-
BAC40_N03,2,2q11.2,99799545,99879218,79673,-,-
BAC68_P17,2,2q11.2,99916803,100000745,83942,-,-
BAC136_I14,2,2q11.2,100167457,100255401,87944,-,-
BAC227_N15,2,2q11.2,100176343,100270340,93997,-,-
BAC218_G12,2,2q11.2,100183346,100270340,86994,-,-
BAC237_B16,2,2q11.2,100183346,100285440,102094,-,-
BAC181_D15,2,2q11.2,100213784,100327398,113614,-,-
BAC61_N14,2,2q11.2,100213784,100381270,167486,-,-
BAC125_O17,2,2q11.2,100222712,100405645,182933,-,-
BAC226_K06,2,2q11.2,100255672,100332883,77211,-,-
BAC187_K07,2,2q11.2,100283495,100356299,72804,-,-
BAC39_P04,2,2q11.2,100294910,100467178,172268,-,-
BAC100_O15,2,2q11.2,100439313,100550640,111327,-,-
BAC65_F01,2,2q11.2,100453548,100550640,97092,-,-
BAC130_E18,2,2q11.2,100463214,100575765,112551,-,-
BAC191_A06,2,2q11.2,100467172,100550640,83468,-,-
BAC102_M09,2,2q11.2,100496878,100581630,84752,-,-
BAC243_L07,2,2q11.2,100581625,100690561,108936,-,-
BAC218_D12,2,2q11.2,100669833,100770254,100421,-,-
BAC234_D22,2,2q11.2,100733001,100839597,106596,-,-
BAC30_A19,2,2q11.2,100734695,100834461,99766,-,-
BAC32_D14,2,2q11.2,100735201,100857874,122673,-,-
BAC195_N04,2,2q11.2,100736450,100839900,103450,-,-
BAC40_F06,2,2q11.2,100767563,100857944,90381,-,-
BAC211_H10,2,2q11.2,100840212,100948180,107968,-,-
BAC68_G24,2,2q11.2,100867581,100977813,110232,-,-
BAC60_F22,2,2q11.2,100949566,101050252,100686,-,-
BAC34_F23,2,2q11.2,100951090,101050252,99162,-,-
BAC169_D15,2,2q11.2,100959557,101048041,88484,-,-
BAC136_L21,2,2q11.2,100993476,101123251,129775,-,-
BAC43_L03,2,2q11.2,101038549,101137170,98621,-,-
BAC76_H20,2,2q11.2,101073025,101185360,112335,-,-
BAC144_B09,2,2q11.2,101108997,101186504,77507,-,-
BAC222_E04,2,2q11.2,101121780,101208772,86992,-,-
BAC157_L16,2,2q11.2,101146014,101245533,99519,-,-
BAC20_P15,2,2q11.2,101168287,101245310,77023,-,-
BAC232_M04,2,2q11.2,101239611,101356922,117311,-,-
BAC197_H06,2,2q11.2,101265004,101354555,89551,-,-
BAC55_N07,2,2q11.2,101346288,101529066,182778,-,-
BAC123_E22,2,2q11.2,101357287,101492834,135547,-,-
BAC31_I12,2,2q11.2,101412075,101499031,86956,-,-
BAC129_J08,2,2q11.2,101439475,101528371,88896,-,-
BAC151_I13,2,2q11.2,101486385,101585940,99555,-,-
BAC197_D21,2,2q11.2,101548929,101660697,111768,-,-
BAC95_B02,2,2q11.2,101585934,101677048,91114,-,-
BAC66_E12,2,2q11.2,101631464,101722315,90851,-,-
BAC96_P09,2,2q11.2,101700190,101796799,96609,-,-
BAC206_A20,2,2q11.2,101702503,101784542,82039,-,-
BAC46_B11,2,2q11.2,101751788,101885736,133948,-,-
BAC237_P12,2,2q11.2,101757445,101833997,76552,-,-
BAC71_M12,2,2q11.2,101907751,102023706,115955,-,-
BAC83_G19,2,2q11.2,101928352,102070628,142276,-,-
BAC196_B15,2,2q11.2,101952468,102070628,118160,-,-
BAC165_M01,2,2q11.2,101953643,102072090,118447,-,-
BAC61_L07,2,2q11.2,101953643,102027916,74273,-,-
BAC97_O02,2,2q11.2-2q12.1,102027909,102134325,106416,-,-
BAC46_L22,2,2q12.1,102103595,102199489,95894,-,-
BAC106_O14,2,2q12.1,102176905,102261085,84180,-,-
BAC142_A06,2,2q12.1,102295756,102379625,83869,-,-
BAC119_N22,2,2q12.1,102314152,102435142,120990,-,-
BAC90_O18,2,2q12.1,102371216,102452177,80961,-,-
BAC180_J15,2,2q12.1,102452170,102539384,87214,-,-
BAC190_B20,2,2q12.1,102562752,102668240,105488,-,-
BAC67_P14,2,2q12.1,102582383,102676561,94178,-,-
BAC24_D14,2,2q12.1,102623503,102719195,95692,-,-
BAC162_E02,2,2q12.1,102737291,102838934,101643,-,-
BAC97_M19,2,2q12.1,102758068,102880696,122628,-,-
BAC162_E20,2,2q12.1,102781796,102854716,72920,-,-
BAC243_P19,2,2q12.1,102840994,102927174,86180,-,-
BAC155_J01,2,2q12.1,102955795,103148925,193130,-,-
BAC21_G22,2,2q12.1,103020386,103110607,90221,-,-
BAC235_I16,2,2q12.1,103028144,103148926,120782,-,-
BAC20_O04,2,2q12.1,103069462,103184674,115212,-,-
BAC246_J14,2,2q12.1,103069463,103159600,90137,-,-
BAC243_J20,2,2q12.1,103110650,103184457,73807,-,-
BAC134_G02,2,2q12.1,103141739,103276775,135036,-,-
BAC149_D04,2,2q12.1,103149164,103256765,107601,-,-
BAC186_B17,2,2q12.1,103229530,103312764,83234,-,-
BAC229_F17,2,2q12.1,103309341,103399177,89836,-,-
BAC193_I09,2,2q12.1,103467009,103545812,78803,-,-
BAC228_H11,2,2q12.1,103504190,103588847,84657,-,-
BAC117_B10,2,2q12.1,103626440,103714004,87564,-,-
BAC194_H11,2,2q12.1,103680862,103777583,96721,-,-
BAC160_L06,2,2q12.1,103735179,103819038,83859,-,-
BAC139_O12,2,2q12.1,103738520,103816788,78268,-,-
BAC123_B11,2,2q12.1,103857273,103960888,103615,-,-
BAC63_D21,2,2q12.1,104202540,104354843,152303,-,-
BAC195_G18,2,2q12.1,104345476,104460654,115178,-,-
BAC181_G15,2,2q12.1,104388327,104462442,74115,-,-
BAC229_J07,2,2q12.1,104414231,104509087,94856,-,-
BAC226_B17,2,2q12.1,104493889,104578734,84845,-,-
BAC204_D05,2,2q12.1,104518270,104611711,93441,-,-
BAC123_L03,2,2q12.1,104669434,104769109,99675,-,-
BAC36_H22,2,2q12.1,104773145,104878334,105189,-,-
BAC85_E10,2,2q12.1,104925897,105010103,84206,-,-
BAC80_M18,2,2q12.1,104954002,105054894,100892,-,-
BAC165_D09,2,2q12.1,104988316,105065083,76767,-,-
BAC74_L06,2,2q12.1,105015382,105098945,83563,-,-
BAC100_F13,2,2q12.1,105065076,105208172,143096,-,-
BAC236_H13,2,2q12.1,105065076,105149759,84683,-,-
BAC168_L04,2,2q12.1,105098962,105210542,111580,-,-
BAC43_A12,2,2q12.1,105114739,105191070,76331,-,-
BAC101_H06,2,2q12.1,105183312,105285228,101916,-,-
BAC154_G10,2,2q12.1-2q12.2,105256658,105345014,88356,-,-
BAC149_D19,2,2q12.1-2q12.2,105256658,105345014,88356,-,-
BAC179_E19,2,2q12.1-2q12.2,105280057,105366976,86919,-,-
BAC145_O14,2,2q12.1-2q12.2,105282686,105359121,76435,-,-
BAC197_P10,2,2q12.2,105325864,105425501,99637,-,-
BAC249_E17,2,2q12.2,105336510,105425322,88812,-,-
BAC246_P13,2,2q12.2,105361728,105446433,84705,-,-
BAC192_G02,2,2q12.2,105383592,105537908,154316,-,-
BAC228_L18,2,2q12.2,105446675,105534768,88093,-,-
BAC36_P12,2,2q12.2,105454145,105543898,89753,-,-
BAC32_N09,2,2q12.2,105537937,105652668,114731,-,-
BAC134_G12,2,2q12.2,105657322,105768241,110919,-,-
BAC50_K20,2,2q12.2,105716676,105871813,155137,-,-
BAC120_B02,2,2q12.2,105732958,105833041,100083,-,-
BAC146_G15,2,2q12.2,105811070,105879366,68296,-,-
BAC16_H20,2,2q12.2,105824431,105905813,81382,-,-
BAC252_O08,2,2q12.2,105837772,105938616,100844,-,-
BAC218_D16,2,2q12.2,105846733,105995036,148303,-,-
BAC135_M02,2,2q12.2,105871825,105976833,105008,-,-
BAC105_A20,2,2q12.2,105879404,105975652,96248,-,-
BAC65_B13,2,2q12.2,105916128,106028637,112509,-,-
BAC202_P02,2,2q12.2,105938603,106039813,101210,-,-
BAC125_G01,2,2q12.2,105965550,106067672,102122,-,-
BAC6_N15,2,2q12.2,105965565,106153554,187989,-,-
BAC58_H06,2,2q12.2,105981099,106069258,88159,-,-
BAC189_E10,2,2q12.2,105981393,106067672,86279,-,-
BAC24_D18,2,2q12.2,106024950,106191546,166596,-,-
BAC105_G12,2,2q12.2,106024983,106117441,92458,-,-
BAC144_N06,2,2q12.2,106067360,106166752,99392,-,-
BAC136_H01,2,2q12.2,106067666,106196339,128673,-,-
BAC246_H07,2,2q12.2,106069368,106191546,122178,-,-
BAC56_B21,2,2q12.2,106082039,106196361,114322,-,-
BAC158_C21,2,2q12.2,106152811,106247283,94472,-,-
BAC158_D21,2,2q12.2,106152823,106247283,94460,-,-
BAC189_A22,2,2q12.2,106178129,106273921,95792,-,-
BAC46_M11,2,2q12.2,106196354,106414360,218006,-,-
BAC193_A03,2,2q12.2,106200498,106291631,91133,-,-
BAC248_A05,2,2q12.2,106200502,106303304,102802,-,-
BAC42_K16,2,2q12.2,106226860,106332692,105832,-,-
BAC74_E13,2,2q12.2,106297519,106387011,89492,-,-
BAC123_G04,2,2q12.2,106332788,106430602,97814,-,-
BAC66_L10,2,2q12.2,106338708,106427081,88373,-,-
BAC167_F13,2,2q12.2,106433780,106521041,87261,-,-
BAC158_M21,2,2q12.2,106433780,106518639,84859,-,-
BAC221_O11,2,2q12.2,106441694,106518627,76933,-,-
BAC217_H17,2,2q12.2,106441694,106515377,73683,-,-
BAC175_L06,2,2q12.2,106521034,106661503,140469,-,-
BAC151_M02,2,2q12.2,106572703,106654080,81377,-,-
BAC43_B01,2,2q12.2,106582563,106680715,98152,-,-
BAC177_B22,2,2q12.2,106593218,106697604,104386,-,-
BAC82_P19,2,2q12.3,106823926,106939150,115224,-,-
BAC199_M06,2,2q12.3,106866511,106985976,119465,-,-
BAC177_C07,2,2q12.3,106906603,107008945,102342,-,-
BAC41_M18,2,2q12.3,106906603,107019062,112459,-,-
BAC123_P16,2,2q12.3,106923954,107056542,132588,-,-
BAC57_F13,2,2q12.3,106939157,107073540,134383,-,-
BAC49_J10,2,2q12.3,106963993,107073520,109527,-,-
BAC238_B10,2,2q12.3,106989220,107079077,89857,-,-
BAC26_I18,2,2q12.3,107055825,107153611,97786,-,-
BAC211_O19,2,2q12.3,107185787,107272143,86356,-,-
BAC21_H22,2,2q12.3,107199861,107310040,110179,-,-
BAC123_D10,2,2q12.3,107220088,107307881,87793,-,-
BAC22_A10,2,2q12.3,107226637,107361314,134677,-,-
BAC222_I14,2,2q12.3,107237261,107324863,87602,-,-
BAC13_G10,2,2q12.3,107292006,107399666,107660,-,-
BAC223_I10,2,2q12.3,107403146,107494553,91407,-,-
BAC224_K23,2,2q12.3,107441271,107530854,89583,-,-
BAC18_D22,2,2q12.3,107494562,107597719,103157,-,-
BAC211_D09,2,2q12.3,107566732,107658529,91797,-,-
BAC100_L20,2,2q12.3,107657399,107764050,106651,-,-
BAC126_F21,2,2q12.3,107874307,108037559,163252,-,-
BAC117_H06,2,2q12.3,108054013,108152981,98968,-,-
BAC20_N21,2,2q12.3,108058568,108163543,104975,-,-
BAC92_D16,2,2q12.3,108099453,108208965,109512,-,-
BAC199_B06,2,2q12.3,108211076,108299885,88809,-,-
BAC34_K17,2,2q12.3,108218534,108353109,134575,-,-
BAC89_A10,2,2q12.3,108241545,108321588,80043,-,-
BAC203_C04,2,2q12.3,108321802,108443923,122121,-,-
BAC160_I06,2,2q12.3,108427493,108491553,64060,-,-
BAC152_L22,2,2q12.3,108427521,108545219,117698,-,-
BAC161_K16,2,2q12.3,108441751,108536324,94573,-,-
BAC90_H19,2,2q12.3-2q13,108489590,108616748,127158,-,-
BAC76_J20,2,2q12.3,108489619,108596760,107141,-,-
BAC46_C12,2,2q12.3-2q13,108511101,108617675,106574,-,-
BAC41_L14,2,2q12.3-2q13,108524845,108628282,103437,-,-
BAC14_M17,2,2q12.3-2q13,108545540,108647981,102441,-,-
BAC95_B16,2,2q13,108625759,108719368,93609,-,-
BAC14_E10,2,2q13,108726103,108827546,101443,-,-
BAC15_D10,2,2q13,108759269,108846157,86888,-,-
BAC52_N05,2,2q13,108787097,108877615,90518,-,-
BAC19_E19,2,2q13,108789754,108921518,131764,-,-
BAC244_B10,2,2q13,108851267,108951611,100344,-,-
BAC236_M13,2,2q13,108863124,108951612,88488,-,-
BAC50_J06,2,2q13,108927717,109045534,117817,-,-
BAC46_K21,2,2q13,108956748,109044153,87405,-,-
BAC234_I13,2,2q13,108975201,109073951,98750,-,-
BAC71_B11,2,2q13,108975203,109073019,97816,-,-
BAC173_E02,2,2q13,109032622,109163773,131151,-,-
BAC88_K03,2,2q13,109073248,109163863,90615,-,-
BAC147_B15,2,2q13,109114596,109189800,75204,-,-
BAC150_C19,2,2q13,109131850,109226071,94221,-,-
BAC36_O10,2,2q13,109157706,109261527,103821,-,-
BAC186_L18,2,2q13,109158334,109261532,103198,-,-
BAC184_I18,2,2q13,109302127,109378358,76231,-,-
BAC219_J17,2,2q13,109347550,109431044,83494,-,-
BAC51_M16,2,2q13,109637608,109723735,86127,-,-
BAC151_B16,2,2q13,109643879,109744069,100190,-,-
BAC95_D01,2,2q13,109643879,109727506,83627,-,-
BAC117_E03,2,2q13,109670641,109776045,105404,-,-
BAC233_H16,2,2q13,109671625,109760461,88836,-,-
BAC120_K17,2,2q13,109770663,109932539,161876,-,-
BAC26_G05,2,2q13,109801143,109811515,10372,-,-
BAC105_H05,2,2q13,109878023,109985062,107039,-,-
BAC54_E15,2,2q13,109878023,109985685,107662,-,-
BAC7_M18,2,2q13,109885513,109987995,102482,-,-
BAC117_D24,2,2q13,109890801,109985685,94884,-,-
BAC73_K07,2,2q13,109891504,109993944,102440,-,-
BAC137_J24,2,2q13,109929063,110012843,83780,-,-
BAC63_B14,2,2q13,109931776,110023601,91825,-,-
BAC175_F08,2,2q13,109985975,110068271,82296,-,-
BAC122_D23,2,2q13,109988083,110151681,163598,-,-
BAC22_B16,2,2q13,110008699,110136655,127956,-,-
BAC61_N16,2,2q13,110012838,110151699,138861,-,-
BAC247_M01,2,2q13,110012840,110177413,164573,-,-
BAC236_P21,2,2q13,110170682,110255486,84804,-,-
BAC191_G23,2,2q13,110170682,110249396,78714,-,-
BAC238_H07,2,2q13,110170685,110255486,84801,-,-
BAC190_P08,2,2q13,110187476,110272544,85068,-,-
BAC234_C14,2,2q13,110776884,111164765,387881,-,-
BAC160_O13,2,2q13,111118684,111209887,91203,-,-
BAC128_L11,2,2q13,111188798,111317246,128448,-,-
BAC142_M14,2,2q13,111195969,111313289,117320,-,-
BAC71_D08,2,2q13,111195969,111289412,93443,-,-
BAC135_J20,2,2q13,111220152,111313289,93137,-,-
BAC162_I09,2,2q13,111234206,111310786,76580,-,-
BAC179_O14,2,2q13,111317238,111401652,84414,-,-
BAC219_L02,2,2q13,111336557,111429477,92920,-,-
BAC154_J05,2,2q13,111341260,111450984,109724,-,-
BAC234_I11,2,2q13,111345488,111442736,97248,-,-
BAC160_G17,2,2q13,111345489,111432586,87097,-,-
BAC6_P20,2,2q13,111378144,111510876,132732,-,-
BAC46_F08,2,2q13,111382723,111505911,123188,-,-
BAC19_F20,2,2q13,111451290,111554856,103566,-,-
BAC248_A15,2,2q13,111523494,111652783,129289,-,-
BAC133_L02,2,2q13,111608686,111694236,85550,-,-
BAC11_K03,2,2q13,111608686,111702626,93940,-,-
BAC32_F10,2,2q13,111764460,111857773,93313,-,-
BAC147_K03,2,2q13,111906608,112033692,127084,-,-
BAC224_N02,2,2q13,111995098,112093159,98061,-,-
BAC65_E05,2,2q13,111999417,112084370,84953,-,-
BAC147_G06,2,2q13,112045552,112131302,85750,-,-
BAC189_I06,2,2q13,112047416,112163368,115952,-,-
BAC237_E05,2,2q13,112089362,112205147,115785,-,-
BAC101_A02,2,2q13,112093154,112177379,84225,-,-
BAC64_P15,2,2q13,112094813,112200314,105501,-,-
BAC89_K04,2,2q13,112114725,112203904,89179,-,-
BAC59_E17,2,2q13,112147218,112205134,57916,-,-
BAC157_I04,2,2q13,112163362,112247272,83910,-,-
BAC123_E04,2,2q13,112163362,112252552,89190,-,-
BAC97_M16,2,2q13,112247265,112341205,93940,-,-
BAC151_D23,2,2q13,112308830,112406838,98008,-,-
BAC165_B14,2,2q13,112351872,112436052,84180,-,-
BAC167_A20,2,2q13,112396400,112486275,89875,-,-
BAC154_H11,2,2q13,112428988,112504134,75146,-,-
BAC147_B19,2,2q13,112436047,112521014,84967,-,-
BAC236_L21,2,2q13,112436058,112554768,118710,-,-
BAC223_I11,2,2q13,112461088,112552623,91535,-,-
BAC7_M12,2,2q13,112564822,112674320,109498,-,-
BAC80_D11,2,2q13,112575419,112691801,116382,-,-
BAC220_D23,2,2q13,112580639,112674320,93681,-,-
BAC92_N17,2,2q13,112601041,112698738,97697,-,-
BAC236_G06,2,2q13,112610583,112727976,117393,-,-
BAC106_O22,2,2q13,112667861,112761524,93663,-,-
BAC42_D13,2,2q13,112719039,112823774,104735,-,-
BAC136_G18,2,2q13,112973532,113116644,143112,-,-
BAC52_F14,2,2q13,113021552,113105572,84020,-,-
BAC4_H22,2,2q13,113236850,113328002,91152,-,-
BAC92_N03,2,2q13,113246673,113352588,105915,-,-
BAC237_H03,2,2q13,113255776,113351401,95625,-,-
BAC139_C18,2,2q13,113268174,113353906,85732,-,-
BAC184_D06,2,2q13,113309183,113402028,92845,-,-
BAC231_E19,2,2q13,113329392,113430105,100713,-,-
BAC240_G11,2,2q13,113352758,113444718,91960,-,-
BAC194_I09,2,2q13,113352781,113462727,109946,-,-
BAC61_E09,2,2q13,113353905,113443566,89661,-,-
BAC10_M21,2,2q13,113353911,113497996,144085,-,-
BAC234_G10,2,2q13,113389644,113490584,100940,-,-
BAC102_P21,2,2q13,113390994,113515202,124208,-,-
BAC90_G06,2,2q13,113392997,113484210,91213,-,-
BAC144_B05,2,2q13,113405971,113497375,91404,-,-
BAC192_A07,2,2q13,113475899,113564244,88345,-,-
BAC150_F03,2,2q13,113489254,113575206,85952,-,-
BAC147_H15,2,2q13,113542404,113622898,80494,-,-
BAC83_K08,2,2q13,113598269,113693474,95205,-,-
BAC175_K19,2,2q13,113598269,113706908,108639,-,-
BAC175_G15,2,2q13,113609449,113719083,109634,-,-
BAC194_G18,2,2q13,113619137,113639340,20203,-,-
BAC184_C10,2,2q13,113622892,113706908,84016,-,-
BAC150_L21,2,2q13,113639335,113742576,103241,-,-
BAC148_B14,2,2q13-2q14.1,113777064,113863702,86638,-,-
BAC26_B23,2,2q14.1,113808042,113927623,119581,-,-
BAC234_C12,2,2q14.1,113863968,113943943,79975,-,-
BAC1_J20,2,2q14.1,113863976,113969414,105438,-,-
BAC247_P09,2,2q14.1,113969455,114049749,80294,-,-
BAC193_C19,2,2q14.1,114049743,114134884,85141,-,-
BAC178_M19,2,2q14.1,114064089,114175773,111684,-,-
BAC155_I08,2,2q14.1,114091095,114186341,95246,-,-
BAC180_B12,2,2q14.1,114140300,114235518,95218,-,-
BAC167_B17,2,2q14.1,114140300,114247212,106912,-,-
BAC48_D12,2,2q14.1,114175777,114362403,186626,-,-
BAC84_L19,2,2q14.1,114241184,114381195,140011,-,-
BAC76_K07,2,2q14.1,114263028,114359543,96515,-,-
BAC101_L16,2,2q14.1,114264830,114355392,90562,-,-
BAC68_P18,2,2q14.1,114352988,114443010,90022,-,-
BAC27_G23,2,2q14.1,114475992,114580910,104918,-,-
BAC122_A06,2,2q14.1,114476660,114565108,88448,-,-
BAC157_E11,2,2q14.1,114525329,114631670,106341,-,-
BAC105_L15,2,2q14.1,114543404,114629179,85775,-,-
BAC105_C05,2,2q14.1,114686854,114773903,87049,-,-
BAC234_K11,2,2q14.1,114698493,114773904,75411,-,-
BAC145_F16,2,2q14.1,114740793,114856683,115890,-,-
BAC78_G04,2,2q14.1,114851280,114956767,105487,-,-
BAC185_N17,2,2q14.1,114856722,114947135,90413,-,-
BAC173_G01,2,2q14.1,114862237,114928503,66266,-,-
BAC189_E01,2,2q14.1,115131786,115231877,100091,-,-
BAC223_P05,2,2q14.1,115238415,115322237,83822,-,-
BAC67_C16,2,2q14.1,115284887,115364761,79874,-,-
BAC195_J04,2,2q14.1,115348903,115436582,87679,-,-
BAC38_D06,2,2q14.1,115433120,115529317,96197,-,-
BAC109_O09,2,2q14.1,115437745,115548857,111112,-,-
BAC51_C05,2,2q14.1,115444194,115621189,176995,-,-
BAC18_L20,2,2q14.1,115447987,115534959,86972,-,-
BAC169_F17,2,2q14.1,115511573,115599517,87944,-,-
BAC119_A11,2,2q14.1,115554714,115670882,116168,-,-
BAC142_M21,2,2q14.1,115653714,115706324,52610,-,-
BAC100_B11,2,2q14.1,115703411,115798060,94649,-,-
BAC149_C16,2,2q14.1,115786897,115876618,89721,-,-
BAC167_P18,2,2q14.1,115859836,115959961,100125,-,-
BAC107_E05,2,2q14.1,115863347,115958011,94664,-,-
BAC20_A02,2,2q14.1,115870213,115958000,87787,-,-
BAC161_L02,2,2q14.1,115936125,116061895,125770,-,-
BAC126_E09,2,2q14.1,115939336,116061895,122559,-,-
BAC122_P07,2,2q14.1,115939407,116061895,122488,-,-
BAC71_P06,2,2q14.1,116059966,116178504,118538,-,-
BAC139_L14,2,2q14.1,116135690,116253020,117330,-,-
BAC150_A09,2,2q14.1,116253016,116339452,86436,-,-
BAC124_H04,2,2q14.1,116289514,116403596,114082,-,-
BAC49_L10,2,2q14.1,116336195,116428619,92424,-,-
BAC33_O06,2,2q14.1,116368521,116396609,28088,-,-
BAC18_G10,2,2q14.1,116412486,116506466,93980,-,-
BAC165_B15,2,2q14.1,116645434,116728050,82616,-,-
BAC168_D12,2,2q14.1,116717395,116788228,70833,-,-
BAC30_M21,2,2q14.1,116877561,116973493,95932,-,-
BAC123_J03,2,2q14.1,116924935,117031086,106151,-,-
BAC96_M14,2,2q14.1,117017241,117120938,103697,-,-
BAC117_B19,2,2q14.1,117056713,117184294,127581,-,-
BAC78_B17,2,2q14.1,117082084,117181237,99153,-,-
BAC91_D22,2,2q14.1,117082096,117184007,101911,-,-
BAC120_K20,2,2q14.1,117083913,117165369,81456,-,-
BAC78_P15,2,2q14.1,117107148,117220197,113049,-,-
BAC190_P21,2,2q14.1,117184346,117316424,132078,-,-
BAC224_L22,2,2q14.1,117251395,117333335,81940,-,-
BAC213_C21,2,2q14.1,117434141,117495112,60971,-,-
BAC202_J12,2,2q14.1,117455851,117568312,112461,-,-
BAC145_H06,2,2q14.1,117476523,117564316,87793,-,-
BAC24_B08,2,2q14.1,117520813,117618729,97916,-,-
BAC19_J07,2,2q14.1,117740185,117841792,101607,-,-
BAC29_P21,2,2q14.1,117848681,117985944,137263,-,-
BAC130_G22,2,2q14.1,117896198,117981585,85387,-,-
BAC178_J08,2,2q14.1,117953162,118054646,101484,-,-
BAC145_C07,2,2q14.1,117981821,118076028,94207,-,-
BAC48_J18,2,2q14.1,118091071,118172234,81163,-,-
BAC224_O09,2,2q14.1,118141463,118255997,114534,-,-
BAC166_K08,2,2q14.1,118172251,118255997,83746,-,-
BAC248_A20,2,2q14.1,118235899,118327394,91495,-,-
BAC88_J10,2,2q14.1,118272065,118381858,109793,-,-
BAC10_J19,2,2q14.1,118378155,118477440,99285,-,-
BAC21_A18,2,2q14.1,118378192,118497041,118849,-,-
BAC123_G15,2,2q14.1,118442393,118575127,132734,-,-
BAC91_H05,2,2q14.1-2q14.2,118579186,118697459,118273,-,-
BAC154_N01,2,2q14.1-2q14.2,118589880,118695710,105830,-,-
BAC176_F24,2,2q14.2,118615296,118708309,93013,-,-
BAC65_M15,2,2q14.2,118619761,118743267,123506,-,-
BAC179_H16,2,2q14.2,118662533,118736577,74044,-,-
BAC156_P12,2,2q14.2,118703457,118809395,105938,-,-
BAC34_M07,2,2q14.2,118771222,118865839,94617,-,-
BAC132_D01,2,2q14.2,118844199,118931190,86991,-,-
BAC80_L23,2,2q14.2,118844199,118962818,118619,-,-
BAC200_G23,2,2q14.2,118870788,118939011,68223,-,-
BAC89_J09,2,2q14.2,118924647,119030593,105946,-,-
BAC20_F09,2,2q14.2,118945853,119069779,123926,-,-
BAC191_G03,2,2q14.2,118951320,119082891,131571,-,-
BAC168_A22,2,2q14.2,118966671,119066802,100131,-,-
BAC40_I01,2,2q14.2,119030651,119128629,97978,-,-
BAC148_O12,2,2q14.2,119041706,119139098,97392,-,-
BAC167_C07,2,2q14.2,119051835,119128547,76712,-,-
BAC26_O17,2,2q14.2,119128824,119244959,116135,-,-
BAC104_E10,2,2q14.2,119139092,119261141,122049,-,-
BAC185_G02,2,2q14.2,119139092,119265053,125961,-,-
BAC229_N03,2,2q14.2,119162806,119265053,102247,-,-
BAC148_N10,2,2q14.2,119197764,119270745,72981,-,-
BAC92_C18,2,2q14.2,119201690,119288454,86764,-,-
BAC189_M20,2,2q14.2,119201690,119299779,98089,-,-
BAC143_G24,2,2q14.2,119233409,119344014,110605,-,-
BAC131_L05,2,2q14.2,119305109,119390052,84943,-,-
BAC134_J08,2,2q14.2,119338333,119457960,119627,-,-
BAC32_O10,2,2q14.2,119540821,119625195,84374,-,-
BAC144_N22,2,2q14.2,119581172,119695799,114627,-,-
BAC218_P02,2,2q14.2,119590396,119701845,111449,-,-
BAC249_E04,2,2q14.2,119640843,119718048,77205,-,-
BAC25_A01,2,2q14.2,119695872,119811088,115216,-,-
BAC44_A12,2,2q14.2,119701921,119824683,122762,-,-
BAC132_G17,2,2q14.2,119718057,119824715,106658,-,-
BAC175_C12,2,2q14.2,119729080,119820595,91515,-,-
BAC190_A18,2,2q14.2,119729080,119825300,96220,-,-
BAC31_G06,2,2q14.2,119729084,119852771,123687,-,-
BAC75_G19,2,2q14.2,119729105,119826103,96998,-,-
BAC163_K02,2,2q14.2,119729193,119832158,102965,-,-
BAC122_F15,2,2q14.2,119729257,119825300,96043,-,-
BAC39_J16,2,2q14.2,119769731,119865360,95629,-,-
BAC97_H06,2,2q14.2,119769731,119859525,89794,-,-
BAC172_I02,2,2q14.2,119769731,119880108,110377,-,-
BAC193_C08,2,2q14.2,119832200,119933950,101750,-,-
BAC145_A13,2,2q14.2,119859520,119945733,86213,-,-
BAC200_E10,2,2q14.2,119894634,119987040,92406,-,-
BAC215_D22,2,2q14.2,119934173,120032004,97831,-,-
BAC227_F04,2,2q14.2,119945727,120033877,88150,-,-
BAC165_E13,2,2q14.2,119956620,120038380,81760,-,-
BAC192_N09,2,2q14.2,120015198,120104697,89499,-,-
BAC120_P15,2,2q14.2,120032057,120138160,106103,-,-
BAC103_E07,2,2q14.2,120050969,120138160,87191,-,-
BAC63_B02,2,2q14.2,120055736,120161371,105635,-,-
BAC154_F22,2,2q14.2,120055978,120146811,90833,-,-
BAC142_J08,2,2q14.2,120067493,120137901,70408,-,-
BAC221_L03,2,2q14.2,120170976,120268599,97623,-,-
BAC237_C05,2,2q14.2,120325410,120416923,91513,-,-
BAC132_F03,2,2q14.2,120328350,120416923,88573,-,-
BAC148_A13,2,2q14.2,120367380,120443066,75686,-,-
BAC78_J24,2,2q14.2,120399465,120480249,80784,-,-
BAC193_L06,2,2q14.2,120471839,120558434,86595,-,-
BAC135_L12,2,2q14.2,120482302,120558979,76677,-,-
BAC179_F16,2,2q14.2,120572006,120688587,116581,-,-
BAC74_G19,2,2q14.2,120579767,120676577,96810,-,-
BAC83_M04,2,2q14.2,120755581,120842939,87358,-,-
BAC38_M13,2,2q14.2,120877739,120967276,89537,-,-
BAC181_J13,2,2q14.2,120888644,120961605,72961,-,-
BAC240_B24,2,2q14.2,120889001,120984056,95055,-,-
BAC220_D19,2,2q14.2,120927612,120980053,52441,-,-
BAC184_K18,2,2q14.2,120944846,121049410,104564,-,-
BAC128_N20,2,2q14.2,120944847,121078537,133690,-,-
BAC29_L06,2,2q14.2,121003037,121098818,95781,-,-
BAC197_H05,2,2q14.2,121023083,121146320,123237,-,-
BAC140_F20,2,2q14.2,121178487,121280949,102462,-,-
BAC189_I16,2,2q14.2,121181916,121279557,97641,-,-
BAC149_B12,2,2q14.2,121187949,121280949,93000,-,-
BAC161_A09,2,2q14.2,121212938,121315578,102640,-,-
BAC208_A22,2,2q14.2,121315652,121405752,90100,-,-
BAC167_A01,2,2q14.2,121323610,121415398,91788,-,-
BAC235_P19,2,2q14.2,121332476,121415397,82921,-,-
BAC168_G02,2,2q14.2,121386838,121488586,101748,-,-
BAC78_N16,2,2q14.2,121521834,121611647,89813,-,-
BAC80_G21,2,2q14.2,121521836,121638044,116208,-,-
BAC144_L02,2,2q14.2,121529685,121614364,84679,-,-
BAC250_B13,2,2q14.2,121534940,121611629,76689,-,-
BAC227_O05,2,2q14.2,121534961,121651136,116175,-,-
BAC218_O15,2,2q14.2,121559412,121651136,91724,-,-
BAC130_H08,2,2q14.2,121588021,121669433,81412,-,-
BAC54_K21,2,2q14.2,121651263,121770967,119704,-,-
BAC186_D09,2,2q14.2,121791451,121878673,87222,-,-
BAC125_B16,2,2q14.2,121830747,121928683,97936,-,-
BAC129_C13,2,2q14.2,121835555,121912452,76897,-,-
BAC128_M06,2,2q14.2,121835657,121924782,89125,-,-
BAC238_D10,2,2q14.2,121909338,121987004,77666,-,-
BAC42_P03,2,2q14.2,121934510,122011028,76518,-,-
BAC110_B13,2,2q14.2-2q14.3,122015321,122127227,111906,-,-
BAC69_B18,2,2q14.2-2q14.3,122037604,122134229,96625,-,-
BAC50_F08,2,2q14.2-2q14.3,122038899,122144357,105458,-,-
BAC192_C06,2,2q14.3,122108905,122203890,94985,-,-
BAC181_K14,2,2q14.3,122127222,122245580,118358,-,-
BAC61_I12,2,2q14.3,122127222,122210605,83383,-,-
BAC52_L10,2,2q14.3,122180228,122279866,99638,-,-
BAC24_A07,2,2q14.3,122198181,122279874,81693,-,-
BAC169_N17,2,2q14.3,122210617,122334777,124160,-,-
BAC103_M21,2,2q14.3,122210619,122299024,88405,-,-
BAC228_D08,2,2q14.3,122213998,122302796,88798,-,-
BAC195_E19,2,2q14.3,122262777,122337574,74797,-,-
BAC78_H22,2,2q14.3,122264602,122358474,93872,-,-
BAC95_O18,2,2q14.3,122303232,122391841,88609,-,-
BAC48_G12,2,2q14.3,122307038,122462364,155326,-,-
BAC81_I07,2,2q14.3,122332019,122449252,117233,-,-
BAC166_I06,2,2q14.3,122337852,122426563,88711,-,-
BAC24_D07,2,2q14.3,122343974,122442644,98670,-,-
BAC196_O09,2,2q14.3,122378691,122471771,93080,-,-
BAC190_M02,2,2q14.3,122378716,122500917,122201,-,-
BAC51_A02,2,2q14.3,122392610,122480536,87926,-,-
BAC226_N09,2,2q14.3,122399598,122501243,101645,-,-
BAC17_E07,2,2q14.3,122426590,122489099,62509,-,-
BAC53_G22,2,2q14.3,122443055,122547766,104711,-,-
BAC34_J04,2,2q14.3,122466225,122643601,177376,-,-
BAC10_F01,2,2q14.3,122466225,122569550,103325,-,-
BAC170_L01,2,2q14.3,122483140,122568078,84938,-,-
BAC48_G13,2,2q14.3,122514714,122619478,104764,-,-
BAC248_K13,2,2q14.3,122587133,122680867,93734,-,-
BAC71_E15,2,2q14.3,122608019,122688878,80859,-,-
BAC117_P15,2,2q14.3,122699580,122838930,139350,-,-
BAC32_B19,2,2q14.3,122725415,122907445,182030,-,-
BAC247_N10,2,2q14.3,122735965,122843188,107223,-,-
BAC105_O17,2,2q14.3,122740649,122819979,79330,-,-
BAC147_P04,2,2q14.3,122789706,122896708,107002,-,-
BAC154_A22,2,2q14.3,122791326,122873297,81971,-,-
BAC199_O12,2,2q14.3,122958644,123036186,77542,-,-
BAC23_L07,2,2q14.3,123050920,123140685,89765,-,-
BAC31_B13,2,2q14.3,123063571,123154848,91277,-,-
BAC66_J21,2,2q14.3,123154098,123254578,100480,-,-
BAC61_I11,2,2q14.3,123222261,123325378,103117,-,-
BAC226_P01,2,2q14.3,123318219,123420297,102078,-,-
BAC186_B23,2,2q14.3,123369657,123448924,79267,-,-
BAC250_J07,2,2q14.3,123466819,123560899,94080,-,-
BAC197_L14,2,2q14.3,123581258,123675221,93963,-,-
BAC169_P06,2,2q14.3,123622693,123733136,110443,-,-
BAC172_C22,2,2q14.3,123687117,123792646,105529,-,-
BAC36_K07,2,2q14.3,123839377,123967994,128617,-,-
BAC33_L10,2,2q14.3,123999597,124104531,104934,-,-
BAC61_D21,2,2q14.3,124099686,124190504,90818,-,-
BAC40_H24,2,2q14.3,124145017,124236123,91106,-,-
BAC45_O07,2,2q14.3,124221462,124340892,119430,-,-
BAC115_M07,2,2q14.3,124253172,124342423,89251,-,-
BAC182_F10,2,2q14.3,124325691,124412681,86990,-,-
BAC77_C10,2,2q14.3,124412676,124511220,98544,-,-
BAC110_N10,2,2q14.3,124595229,124682109,86880,-,-
BAC29_C05,2,2q14.3,124607396,124746250,138854,-,-
BAC29_A10,2,2q14.3,124702737,124810000,107263,-,-
BAC154_G03,2,2q14.3,124735448,124816602,81154,-,-
BAC222_M19,2,2q14.3,124740046,124824356,84310,-,-
BAC123_G06,2,2q14.3,124876218,124988875,112657,-,-
BAC125_O23,2,2q14.3,124880061,125023285,143224,-,-
BAC124_F14,2,2q14.3,125030395,125128692,98297,-,-
BAC186_O01,2,2q14.3,125040851,125115173,74322,-,-
BAC160_C02,2,2q14.3,125183306,125247811,64505,-,-
BAC193_D20,2,2q14.3,125273116,125379845,106729,-,-
BAC66_A24,2,2q14.3,125379837,125491125,111288,-,-
BAC49_O21,2,2q14.3,125451753,125471105,19352,-,-
BAC100_K07,2,2q14.3,125476010,125582620,106610,-,-
BAC193_G07,2,2q14.3,125581857,125667720,85863,-,-
BAC125_C18,2,2q14.3,125652260,125745903,93643,-,-
BAC48_K06,2,2q14.3,126000562,126084986,84424,-,-
BAC31_K16,2,2q14.3,126032827,126117194,84367,-,-
BAC226_K13,2,2q14.3,126235822,126330882,95060,-,-
BAC168_F05,2,2q14.3,126287128,126381291,94163,-,-
BAC236_D13,2,2q14.3,126730896,126820048,89152,-,-
BAC78_L08,2,2q14.3,126810661,126900235,89574,-,-
BAC30_E12,2,2q14.3,126854084,126944832,90748,-,-
BAC110_J15,2,2q14.3,126860973,126924998,64025,-,-
BAC75_J12,2,2q14.3,127009579,127101009,91430,-,-
BAC140_B20,2,2q14.3,127026000,127103016,77016,-,-
BAC146_L04,2,2q14.3,127026025,127114878,88853,-,-
BAC2_O16,2,2q14.3,127074546,127169770,95224,-,-
BAC115_N15,2,2q14.3,127181655,127287449,105794,-,-
BAC101_M01,2,2q14.3,127234305,127340693,106388,-,-
BAC86_A20,2,2q14.3,127234389,127317346,82957,-,-
BAC39_B12,2,2q14.3,127237259,127329852,92593,-,-
BAC132_D17,2,2q14.3,127268203,127351954,83751,-,-
BAC235_N22,2,2q14.3,127268203,127374992,106789,-,-
BAC154_J20,2,2q14.3,127268203,127351954,83751,-,-
BAC89_J03,2,2q14.3,127320053,127405285,85232,-,-
BAC95_H23,2,2q14.3,127331493,127430734,99241,-,-
BAC217_H13,2,2q14.3,127366389,127438211,71822,-,-
BAC226_D07,2,2q14.3,127370319,127462158,91839,-,-
BAC97_F13,2,2q14.3,127370319,127485958,115639,-,-
BAC232_N07,2,2q14.3,127370319,127483157,112838,-,-
BAC15_E16,2,2q14.3,127370359,127460900,90541,-,-
BAC182_B07,2,2q14.3,127380570,127460900,80330,-,-
BAC236_G02,2,2q14.3,127405282,127492500,87218,-,-
BAC46_F11,2,2q14.3,127406319,127491426,85107,-,-
BAC18_J10,2,2q14.3,127501876,127606230,104354,-,-
BAC89_E09,2,2q14.3,127528686,127651612,122926,-,-
BAC32_E20,2,2q14.3,127598518,127758158,159640,-,-
BAC73_E07,2,2q14.3,127618891,127714542,95651,-,-
BAC195_C07,2,2q14.3,127671528,127761679,90151,-,-
BAC107_H11,2,2q14.3,127671586,127769538,97952,-,-
BAC129_L20,2,2q14.3,127769538,127793694,24156,-,-
BAC86_M22,2,2q14.3,127813082,127924616,111534,-,-
BAC63_N08,2,2q14.3,127813108,127940689,127581,-,-
BAC156_P17,2,2q14.3,127813579,127907012,93433,-,-
BAC217_P22,2,2q14.3,127839988,127940689,100701,-,-
BAC197_F20,2,2q14.3,127978839,128057785,78946,-,-
BAC195_L05,2,2q14.3,128004117,128116761,112644,-,-
BAC92_C19,2,2q14.3,128160576,128238331,77755,-,-
BAC90_L04,2,2q14.3,128196270,128292261,95991,-,-
BAC95_P14,2,2q14.3,128218344,128299570,81226,-,-
BAC167_G03,2,2q14.3,128292944,128374147,81203,-,-
BAC10_J05,2,2q14.3,128299566,128414098,114532,-,-
BAC50_F02,2,2q14.3,128299671,128396895,97224,-,-
BAC100_K02,2,2q14.3,128305633,128430069,124436,-,-
BAC139_L05,2,2q14.3,128324792,128467097,142305,-,-
BAC230_P20,2,2q14.3,128353018,128467038,114020,-,-
BAC155_K06,2,2q14.3,128413057,128490476,77419,-,-
BAC95_N01,2,2q14.3,128430277,128565773,135496,-,-
BAC63_H02,2,2q14.3,128459270,128587612,128342,-,-
BAC16_B12,2,2q14.3,128459475,128564948,105473,-,-
BAC246_I20,2,2q14.3,128488284,128573804,85520,-,-
BAC170_B18,2,2q14.3,128490468,128576953,86485,-,-
BAC60_H14,2,2q14.3,128518844,128631175,112331,-,-
BAC39_O21,2,2q14.3,128634648,128762559,127911,-,-
BAC219_N21,2,2q14.3,128668697,128762566,93869,-,-
BAC84_B07,2,2q14.3,128677811,128780827,103016,-,-
BAC116_L02,2,2q14.3,128678369,128783625,105256,-,-
BAC103_K05,2,2q14.3,128678369,128762563,84194,-,-
BAC97_J22,2,2q14.3,128687470,128794421,106951,-,-
BAC222_F20,2,2q14.3,128687488,128853106,165618,-,-
BAC193_I05,2,2q14.3,128697021,128780699,83678,-,-
BAC107_P09,2,2q14.3,128697303,128841810,144507,-,-
BAC84_D08,2,2q14.3,128851579,128942837,91258,-,-
BAC44_K13,2,2q14.3,128853298,128942837,89539,-,-
BAC27_C17,2,2q14.3,128853304,128975751,122447,-,-
BAC96_M24,2,2q14.3,128882770,128951251,68481,-,-
BAC186_J16,2,2q14.3,128882774,128985739,102965,-,-
BAC50_E06,2,2q14.3,128899977,128998625,98648,-,-
BAC64_J05,2,2q14.3,128916813,129003905,87092,-,-
BAC76_K04,2,2q14.3,129188700,129293613,104913,-,-
BAC24_D02,2,2q14.3,129200961,129345566,144605,-,-
BAC82_M08,2,2q14.3,129212201,129293574,81373,-,-
BAC15_O09,2,2q14.3,129212201,129307633,95432,-,-
BAC24_B07,2,2q14.3,129231387,129274594,43207,-,-
BAC125_L10,2,2q14.3,129350094,129521117,171023,-,-
BAC104_M24,2,2q14.3,129350106,129447625,97519,-,-
BAC152_N13,2,2q14.3,129395541,129529770,134229,-,-
BAC131_H19,2,2q14.3,129439175,129536894,97719,-,-
BAC113_B14,2,2q14.3-2q21.1,129521116,129617385,96269,-,-
BAC108_F12,2,2q21.1,129610253,129741200,130947,-,-
BAC78_C01,2,2q21.1,129617747,129718828,101081,-,-
BAC122_E08,2,2q21.1,129645158,129741417,96259,-,-
BAC10_N20,2,2q21.1,129668019,129803752,135733,-,-
BAC50_E08,2,2q21.1,129731231,129826377,95146,-,-
BAC237_J23,2,2q21.1,129745436,129827327,81891,-,-
BAC227_J14,2,2q21.1,129813779,129894339,80560,-,-
BAC118_F21,2,2q21.1,129815099,129986927,171828,-,-
BAC109_G08,2,2q21.1,129851865,129986734,134869,-,-
BAC69_H10,2,2q21.1,129865652,129951515,85863,-,-
BAC153_F05,2,2q21.1,129897226,129996476,99250,-,-
BAC95_D20,2,2q21.1,129951607,130023963,72356,-,-
BAC199_L12,2,2q21.1,129985408,130102730,117322,-,-
BAC81_P21,2,2q21.1,129998885,130086604,87719,-,-
BAC21_A22,2,2q21.1,130046662,130211476,164814,-,-
BAC55_I04,2,2q21.1,130057813,130162261,104448,-,-
BAC25_D10,2,2q21.1,130118566,130231513,112947,-,-
BAC18_G04,2,2q21.1,130179401,130282403,103002,-,-
BAC169_F09,2,2q21.1,130259286,130365846,106560,-,-
BAC230_K19,2,2q21.1,130260611,130365076,104465,-,-
BAC100_O03,2,2q21.1,130282749,130344786,62037,-,-
BAC191_O23,2,2q21.1,130300149,130377484,77335,-,-
BAC55_P13,2,2q21.1,130321054,130414220,93166,-,-
BAC169_H15,2,2q21.1,130365837,130477912,112075,yes,-
BAC64_P09,2,2q21.1,130421968,130519616,97648,yes,-
BAC145_J20,2,2q21.1,130491367,130582289,90922,-,-
BAC11_N05,2,2q21.1,130576821,130660290,83469,yes,-
BAC246_A09,2,2q21.1,130576837,130678198,101361,yes,-
BAC31_B03,2,2q21.1,130686346,130852601,166255,yes,-
BAC248_K04,2,2q21.1,130724017,130855153,131136,yes,-
BAC40_F08,2,2q21.1,130760807,130853677,92870,yes,-
BAC133_G11,2,2q21.1,130766362,130852300,85938,yes,-
BAC74_M05,2,2q21.1,130890042,130965448,75406,-,-
BAC231_M05,2,2q21.1,131013701,131112501,98800,-,-
BAC105_I15,2,2q21.1,131075528,131184641,109113,-,-
BAC39_N01,2,2q21.1,131109228,131236465,127237,yes,-
BAC115_N09,2,2q21.1,131164836,131274654,109818,yes,-
BAC36_G16,2,2q21.1,131178396,131329513,151117,yes,-
BAC37_G20,2,2q21.1,131187568,131285633,98065,yes,-
BAC10_F21,2,2q21.1,131187568,131287853,100285,-,-
BAC233_C13,2,2q21.1,131193662,131274653,80991,yes,-
BAC134_K14,2,2q21.1,131236457,131343895,107438,-,-
BAC59_D04,2,2q21.1,131287845,131400742,112897,-,-
BAC102_I16,2,2q21.1,131319756,131415946,96190,-,-
BAC187_E08,2,2q21.1,131485817,131569043,83226,-,-
BAC171_O01,2,2q21.1,131492730,131597035,104305,-,-
BAC252_N10,2,2q21.1,131532876,131664273,131397,-,-
BAC239_P09,2,2q21.1,131579186,131667403,88217,-,-
BAC175_O08,2,2q21.1,131582850,131667401,84551,-,-
BAC230_F03,2,2q21.1,131896323,131974547,78224,yes,-
BAC46_O07,2,2q21.1,131937084,132038174,101090,yes,-
BAC40_A22,2,2q21.1,132064215,132152749,88534,-,-
BAC119_A13,2,2q21.1,132077893,132187206,109313,-,-
BAC44_G12,2,2q21.1,132090282,132184767,94485,-,-
BAC26_D13,2,2q21.1-2q21.2,132143041,132294191,151150,-,-
BAC51_O23,2,2q21.2,132332031,132423031,91000,-,-
BAC32_M13,2,2q21.2,132627683,132716650,88967,-,-
BAC127_A06,2,2q21.2,132723533,132820880,97347,-,-
BAC11_H06,2,2q21.2,132735478,132763248,27770,-,-
BAC57_O08,2,2q21.2,132768246,132907115,138869,-,-
BAC153_B08,2,2q21.2,132801312,132893680,92368,-,-
BAC188_B11,2,2q21.2,132820902,132903524,82622,-,-
BAC82_F12,2,2q21.2,132848189,132985491,137302,-,-
BAC33_M07,2,2q21.2,132950029,133060729,110700,-,-
BAC96_O20,2,2q21.2,132986805,133154585,167780,-,-
BAC101_O02,2,2q21.2,132986805,133110894,124089,-,-
BAC159_M01,2,2q21.2,133006677,133097437,90760,-,-
BAC248_D07,2,2q21.2,133032928,133135007,102079,-,-
BAC147_E07,2,2q21.2,133034239,133114781,80542,-,-
BAC43_D19,2,2q21.2,133111324,133222098,110774,-,-
BAC197_O15,2,2q21.2,133111332,133203555,92223,-,-
BAC103_M06,2,2q21.2,133173031,133284419,111388,-,-
BAC162_C18,2,2q21.2,133191891,133294175,102284,-,-
BAC217_K16,2,2q21.2,133214060,133302817,88757,-,-
BAC183_J02,2,2q21.2,133227375,133362761,135386,-,-
BAC176_O16,2,2q21.2,133227375,133336410,109035,-,-
BAC150_M04,2,2q21.2,133253341,133358419,105078,-,-
BAC54_C13,2,2q21.2,133297494,133456076,158582,-,-
BAC252_J17,2,2q21.2,133302834,133392954,90120,-,-
BAC97_C23,2,2q21.2,133362807,133450606,87799,-,-
BAC75_I07,2,2q21.2,133362809,133454993,92184,-,-
BAC149_G10,2,2q21.2,133384841,133521898,137057,-,-
BAC221_K11,2,2q21.2,133444587,133534763,90176,-,-
BAC191_O20,2,2q21.2,133455012,133528162,73150,-,-
BAC2_F08,2,2q21.2,133640725,133817849,177124,-,-
BAC28_J14,2,2q21.2,133687022,133816445,129423,-,-
BAC48_A07,2,2q21.2,133721698,133827034,105336,-,-
BAC78_K22,2,2q21.2,133723330,133809137,85807,-,-
BAC244_K15,2,2q21.2,133735724,133811415,75691,-,-
BAC146_F24,2,2q21.2,133809128,133949392,140264,-,-
BAC39_N20,2,2q21.2,133827039,133917694,90655,-,-
BAC241_O16,2,2q21.2,133938076,134044798,106722,-,-
BAC91_K21,2,2q21.2,134004809,134094047,89238,-,-
BAC208_K14,2,2q21.2,134004809,134080646,75837,-,-
BAC63_O18,2,2q21.2,134012072,134132347,120275,-,-
BAC31_I11,2,2q21.2,134013370,134165967,152597,-,-
BAC232_G23,2,2q21.2,134030306,134119038,88732,-,-
BAC23_N07,2,2q21.2,134179986,134272093,92107,-,-
BAC163_K17,2,2q21.2,134196537,134265226,68689,-,-
BAC211_L09,2,2q21.2,134287222,134449741,162519,-,-
BAC246_P14,2,2q21.2,134293644,134373794,80150,-,-
BAC56_K07,2,2q21.2,134312836,134493627,180791,-,-
BAC93_J18,2,2q21.2,134344906,134444503,99597,-,-
BAC158_H19,2,2q21.2,134430158,134526164,96006,-,-
BAC185_F05,2,2q21.2,134444709,134547091,102382,-,-
BAC153_E05,2,2q21.2,134450784,134565078,114294,-,-
BAC175_D10,2,2q21.2,134457748,134558152,100404,-,-
BAC106_B08,2,2q21.2,134555415,134680274,124859,-,-
BAC146_F04,2,2q21.2,134556857,134641859,85002,-,-
BAC232_K06,2,2q21.2,134582241,134673979,91738,-,-
BAC117_L21,2,2q21.2-2q21.3,134702633,134804414,101781,-,-
BAC238_G01,2,2q21.3,134822967,134934479,111512,-,-
BAC155_K24,2,2q21.3,134823556,134898597,75041,-,-
BAC74_G10,2,2q21.3,134845078,134943161,98083,-,-
BAC125_E01,2,2q21.3,134900770,135022960,122190,-,-
BAC146_H20,2,2q21.3,134917665,134993457,75792,-,-
BAC40_M02,2,2q21.3,134930165,135034356,104191,-,-
BAC142_I15,2,2q21.3,134973057,135090323,117266,-,-
BAC184_K22,2,2q21.3,134984781,135090206,105425,-,-
BAC220_B03,2,2q21.3,134993450,135085111,91661,-,-
BAC185_K11,2,2q21.3,135093068,135195218,102150,-,-
BAC161_B04,2,2q21.3,135113584,135183586,70002,-,-
BAC4_P16,2,2q21.3,135113584,135207734,94150,-,-
BAC145_K09,2,2q21.3,135208451,135301245,92794,-,-
BAC50_O24,2,2q21.3,135260503,135348950,88447,-,-
BAC95_A16,2,2q21.3,135289143,135408275,119132,-,-
BAC224_K09,2,2q21.3,135368920,135461589,92669,-,-
BAC128_P22,2,2q21.3,135380689,135514891,134202,-,-
BAC69_K02,2,2q21.3,135408414,135501283,92869,-,-
BAC8_J13,2,2q21.3,135408470,135514785,106315,-,-
BAC200_D18,2,2q21.3,135425285,135514891,89606,-,-
BAC39_D02,2,2q21.3,135461588,135564623,103035,-,-
BAC119_B13,2,2q21.3,135468199,135567934,99735,-,-
BAC238_G10,2,2q21.3,135498207,135586209,88002,-,-
BAC95_L05,2,2q21.3,135521899,135647876,125977,-,-
BAC74_A09,2,2q21.3,135541545,135638342,96797,-,-
BAC155_P11,2,2q21.3,135567928,135642411,74483,-,-
BAC121_G03,2,2q21.3,135739626,135827147,87521,-,-
BAC57_I17,2,2q21.3,135749699,135827148,77449,-,-
BAC141_D15,2,2q21.3,135845037,135946537,101500,-,-
BAC163_G09,2,2q21.3,135845092,135937308,92216,-,-
BAC242_N05,2,2q21.3,135858672,135946537,87865,-,-
BAC61_N17,2,2q21.3,135991267,136089516,98249,-,-
BAC160_H03,2,2q21.3,135991268,136065270,74002,-,-
BAC84_D14,2,2q21.3,136058813,136157993,99180,-,-
BAC66_F01,2,2q21.3,136070057,136181983,111926,-,-
BAC43_O11,2,2q21.3,136089526,136206747,117221,-,-
BAC123_E09,2,2q21.3,136158207,136296297,138090,-,-
BAC55_L01,2,2q21.3,136252789,136381763,128974,yes,-
BAC213_N14,2,2q21.3,136256362,136361322,104960,yes,-
BAC86_N03,2,2q21.3,136263021,136362931,99910,-,-
BAC26_A08,2,2q21.3,136282821,136381759,98938,-,-
BAC78_E06,2,2q21.3,136357155,136471128,113973,-,-
BAC172_J19,2,2q21.3,136391979,136471128,79149,-,-
BAC191_G24,2,2q21.3,136428733,136519959,91226,-,-
BAC49_J14,2,2q21.3-2q22.1,136528133,136664797,136664,-,-
BAC51_G18,2,2q21.3-2q22.1,136546790,136642147,95357,-,-
BAC81_C02,2,2q21.3-2q22.1,136580443,136740654,160211,-,-
BAC223_I13,2,2q21.3-2q22.1,136592622,136680045,87423,-,-
BAC61_A10,2,2q21.3-2q22.1,136598498,136693512,95014,-,-
BAC141_L01,2,2q22.1,136631381,136709692,78311,-,-
BAC176_B05,2,2q22.1,136634984,136717084,82100,-,-
BAC136_O08,2,2q22.1,136931808,137012128,80320,-,-
BAC149_G06,2,2q22.1,136952420,137071439,119019,-,-
BAC161_B02,2,2q22.1,136952743,137033483,80740,-,-
BAC140_K22,2,2q22.1,137046490,137142007,95517,-,-
BAC90_K22,2,2q22.1,137121023,137231019,109996,-,-
BAC51_O04,2,2q22.1,137261789,137420648,158859,-,-
BAC97_G16,2,2q22.1,137338611,137423327,84716,-,-
BAC176_P14,2,2q22.1,137486560,137575737,89177,-,-
BAC84_E04,2,2q22.1,137501003,137589657,88654,-,-
BAC34_H02,2,2q22.1,137613182,137703390,90208,-,-
BAC136_G17,2,2q22.1,137648326,137730529,82203,-,-
BAC118_E12,2,2q22.1,137757808,137854075,96267,-,-
BAC129_L10,2,2q22.1,137828955,137912676,83721,-,-
BAC82_B08,2,2q22.1,137867213,138029631,162418,-,-
BAC143_C23,2,2q22.1,137972588,138072799,100211,-,-
BAC96_F04,2,2q22.1,138099998,138200898,100900,-,-
BAC193_A12,2,2q22.1,138142499,138227822,85323,-,-
BAC150_G22,2,2q22.1,138284418,138371274,86856,-,-
BAC219_L15,2,2q22.1,138371475,138475177,103702,-,-
BAC80_H09,2,2q22.1,138387164,138465652,78488,-,-
BAC1_D09,2,2q22.1,138466072,138593390,127318,-,-
BAC117_C12,2,2q22.1,138479340,138590396,111056,-,-
BAC231_K23,2,2q22.1,138514659,138593095,78436,-,-
BAC122_L16,2,2q22.1,138593421,138671507,78086,-,-
BAC192_G14,2,2q22.1,138609726,138697028,87302,-,-
BAC120_K14,2,2q22.1,138671667,138757980,86313,-,-
BAC42_P05,2,2q22.1,138793107,138926075,132968,-,-
BAC43_A06,2,2q22.1,139026700,139136268,109568,-,-
BAC200_H16,2,2q22.1,139036321,139132206,95885,-,-
BAC84_B15,2,2q22.1,139042371,139127892,85521,-,-
BAC65_E04,2,2q22.1,139050509,139162711,112202,-,-
BAC195_L09,2,2q22.1,139056678,139125026,68348,-,-
BAC232_G12,2,2q22.1,139136460,139221268,84808,-,-
BAC97_E24,2,2q22.1,139267664,139404705,137041,-,-
BAC46_N19,2,2q22.1,139292566,139402336,109770,-,-
BAC252_L13,2,2q22.1,139331158,139415260,84102,-,-
BAC182_I15,2,2q22.1,139353333,139449659,96326,-,-
BAC81_C04,2,2q22.1,139404118,139544879,140761,-,-
BAC107_J16,2,2q22.1,139415792,139506336,90544,-,-
BAC109_C12,2,2q22.1,139431168,139537964,106796,-,-
BAC129_H22,2,2q22.1,139564813,139702127,137314,-,-
BAC82_K05,2,2q22.1,139778573,139874938,96365,-,-
BAC97_E11,2,2q22.1,139778575,139886145,107570,-,-
BAC241_G19,2,2q22.1,139935713,140021292,85579,-,-
BAC154_L04,2,2q22.1,139988045,140136201,148156,-,-
BAC102_F13,2,2q22.1,140136203,140306688,170485,-,-
BAC68_G10,2,2q22.1,140191889,140300934,109045,-,-
BAC123_G17,2,2q22.1,140276171,140361078,84907,-,-
BAC58_B17,2,2q22.1,140374519,140458654,84135,-,-
BAC83_L19,2,2q22.1,140430466,140519211,88745,-,-
BAC111_F12,2,2q22.1,140454791,140555530,100739,-,-
BAC64_M16,2,2q22.1,140571483,140663559,92076,-,-
BAC213_J20,2,2q22.1,140900262,140985960,85698,-,-
BAC80_L11,2,2q22.1,140913311,141000006,86695,-,-
BAC208_J22,2,2q22.1,140927745,140994837,67092,-,-
BAC104_E01,2,2q22.1,141000062,141088788,88726,-,-
BAC187_D01,2,2q22.1,141098521,141180517,81996,-,-
BAC70_H02,2,2q22.1,141514247,141608757,94510,-,-
BAC232_C09,2,2q22.1,141609155,141703596,94441,-,-
BAC144_B03,2,2q22.1,141703918,141715060,11142,-,-
BAC194_N03,2,2q22.1,141808928,141895567,86639,-,-
BAC248_K20,2,2q22.1,141908202,141998480,90278,-,-
BAC23_I03,2,2q22.1,142016219,142124509,108290,-,-
BAC67_D24,2,2q22.1-2q22.2,142359866,142480423,120557,-,-
BAC27_B01,2,2q22.1-2q22.2,142396352,142493897,97545,-,-
BAC152_B04,2,2q22.2,142597827,142675472,77645,-,-
BAC7_M08,2,2q22.2,142686236,142786125,99889,-,-
BAC34_M09,2,2q22.2,142702179,142811948,109769,-,-
BAC169_G22,2,2q22.2,142710415,142795635,85220,-,-
BAC68_L12,2,2q22.2,142812001,142946153,134152,-,-
BAC35_G18,2,2q22.2,143251699,143346408,94709,-,-
BAC236_H05,2,2q22.2,143304152,143404167,100015,-,-
BAC161_C05,2,2q22.2,143370601,143445858,75257,-,-
BAC180_M01,2,2q22.2,143557076,143640755,83679,-,-
BAC181_B01,2,2q22.2,143641005,143675786,34781,-,-
BAC220_E04,2,2q22.2,143650499,143760316,109817,-,-
BAC191_M02,2,2q22.2,144222945,144315885,92940,-,-
BAC190_P03,2,2q22.2,144242067,144321561,79494,-,-
BAC115_P13,2,2q22.2,144327973,144461927,133954,-,-
BAC86_K06,2,2q22.2,144444044,144538711,94667,-,-
BAC144_A12,2,2q22.2,144515784,144597825,82041,-,-
BAC172_M23,2,2q22.2,144531710,144620486,88776,-,-
BAC1_J04,2,2q22.2-2q22.3,144597819,144718949,121130,-,-
BAC142_H18,2,2q22.2-2q22.3,144675113,144779953,104840,-,-
BAC142_G18,2,2q22.2-2q22.3,144675144,144779953,104809,-,-
BAC249_C16,2,2q22.3,144744058,144830337,86279,-,-
BAC58_A20,2,2q22.3,144788941,144933193,144252,-,-
BAC160_I23,2,2q22.3,144830364,144952811,122447,-,-
BAC222_C21,2,2q22.3,144847683,144944586,96903,-,-
BAC252_A16,2,2q22.3,144992590,145107231,114641,-,-
BAC113_A06,2,2q22.3,144992590,145106864,114274,-,-
BAC243_H07,2,2q22.3,145025896,145106221,80325,-,-
BAC124_M15,2,2q22.3,145053921,145132856,78935,-,-
BAC221_B16,2,2q22.3,145065722,145152805,87083,-,-
BAC143_O13,2,2q22.3,145107226,145197209,89983,-,-
BAC97_G17,2,2q22.3,145312418,145433375,120957,-,-
BAC218_C18,2,2q22.3,145489028,145578434,89406,-,-
BAC228_P24,2,2q22.3,145492981,145586229,93248,-,-
BAC39_K05,2,2q22.3,145578444,145672528,94084,-,-
BAC169_G17,2,2q22.3,145622898,145697399,74501,-,-
BAC10_N04,2,2q22.3,145795511,145929582,134071,-,-
BAC196_F11,2,2q22.3,145850560,145935372,84812,-,-
BAC39_P16,2,2q22.3,145850567,146019167,168600,-,-
BAC248_C18,2,2q22.3,145881543,145975383,93840,-,-
BAC67_O18,2,2q22.3,145881543,145989067,107524,-,-
BAC1_H07,2,2q22.3,145937615,146034039,96424,-,-
BAC76_O09,2,2q22.3,145989066,146108715,119649,-,-
BAC142_A14,2,2q22.3,146071827,146082826,10999,-,-
BAC180_O19,2,2q22.3,146199384,146276724,77340,-,-
BAC153_J09,2,2q22.3,146300281,146323944,23663,-,-
BAC61_N08,2,2q22.3,146395637,146526128,130491,-,-
BAC95_O04,2,2q22.3,146398891,146508147,109256,-,-
BAC68_P03,2,2q22.3,146425017,146508057,83040,-,-
BAC227_A14,2,2q22.3,146889658,146951221,61563,-,-
BAC163_M07,2,2q22.3,146905786,147013694,107908,-,-
BAC101_C06,2,2q22.3,146959793,147074030,114237,-,-
BAC156_L01,2,2q22.3,147073924,147161560,87636,-,-
BAC55_A11,2,2q22.3,147094582,147211639,117057,-,-
BAC158_F13,2,2q22.3,147329502,147412055,82553,-,-
BAC158_I13,2,2q22.3,147329502,147412055,82553,-,-
BAC108_J15,2,2q22.3,147345305,147436567,91262,-,-
BAC11_O04,2,2q22.3,147392826,147501706,108880,-,-
BAC184_L03,2,2q22.3,147530618,147630991,100373,-,-
BAC80_P12,2,2q22.3,147761593,147853631,92038,-,-
BAC179_I01,2,2q22.3,147779519,147864879,85360,-,-
BAC150_J03,2,2q22.3,147846082,147930232,84150,-,-
BAC180_A06,2,2q22.3,147863547,147968428,104881,-,-
BAC17_G03,2,2q22.3,147996698,148104431,107733,-,-
BAC10_L15,2,2q22.3,148012518,148132971,120453,-,-
BAC122_F13,2,2q22.3,148077439,148174204,96765,-,-
BAC183_G19,2,2q22.3,148077439,148181520,104081,-,-
BAC178_L04,2,2q22.3,148078530,148188482,109952,-,-
BAC96_C17,2,2q22.3,148158703,148300427,141724,-,-
BAC250_H13,2,2q22.3,148167624,148280074,112450,-,-
BAC198_J18,2,2q22.3,148248065,148329946,81881,-,-
BAC132_L06,2,2q22.3-2q23.1,148383694,148444654,60960,-,-
BAC38_D24,2,2q23.1,148444760,148568399,123639,-,-
BAC82_J07,2,2q23.1,148453198,148572768,119570,-,-
BAC75_D13,2,2q23.1,148651078,148735279,84201,-,-
BAC228_L19,2,2q23.1,148709276,148788890,79614,-,-
BAC12_G11,2,2q23.1,148795460,148899719,104259,-,-
BAC162_F06,2,2q23.1,148811129,148903058,91929,-,-
BAC196_C13,2,2q23.1,148875249,148974812,99563,-,-
BAC88_A05,2,2q23.1,148909550,149057264,147714,-,-
BAC182_F14,2,2q23.1,148954215,149036253,82038,-,-
BAC249_H21,2,2q23.1,149061812,149151992,90180,-,-
BAC116_K18,2,2q23.1,149102250,149182677,80427,-,-
BAC132_N21,2,2q23.1,149142263,149254367,112104,-,-
BAC120_J23,2,2q23.1,149290283,149374609,84326,-,-
BAC76_L18,2,2q23.1-2q23.2,149525640,149610018,84378,-,-
BAC33_F23,2,2q23.1-2q23.2,149539525,149661486,121961,-,-
BAC37_D22,2,2q23.1-2q23.2,149543939,149634626,90687,-,-
BAC114_L19,2,2q23.2,149634731,149729973,95242,-,-
BAC122_D05,2,2q23.2,149659724,149809693,149969,-,-
BAC233_G17,2,2q23.2,149681674,149766984,85310,-,-
BAC32_D01,2,2q23.2,149701477,149853147,151670,-,-
BAC235_A14,2,2q23.2,149718155,149813141,94986,-,-
BAC120_N03,2,2q23.2,149728517,149826722,98205,-,-
BAC151_N04,2,2q23.2,149941557,150032002,90445,-,-
BAC157_P17,2,2q23.2,149944616,149959966,15350,-,-
BAC110_H11,2,2q23.2,149969900,150041035,71135,-,-
BAC146_B22,2,2q23.2,150052593,150127705,75112,-,-
BAC162_K17,2,2q23.2,150120766,150189793,69027,-,-
BAC168_C09,2,2q23.2,150120766,150197888,77122,-,-
BAC61_B16,2,2q23.2,150168509,150277692,109183,-,-
BAC219_L11,2,2q23.3,150357748,150451012,93264,-,-
BAC205_K13,2,2q23.3,150357748,150450712,92964,-,-
BAC68_M04,2,2q23.3,150369775,150480756,110981,-,-
BAC218_N16,2,2q23.3,150449573,150530060,80487,-,-
BAC37_C01,2,2q23.3,150451133,150537387,86254,-,-
BAC118_F22,2,2q23.3,150577069,150657702,80633,-,-
BAC252_F22,2,2q23.3,150588325,150756951,168626,-,-
BAC146_O02,2,2q23.3,150594130,150741661,147531,-,-
BAC150_I05,2,2q23.3,150646532,150741461,94929,-,-
BAC63_N19,2,2q23.3,150741463,150832845,91382,-,-
BAC182_B05,2,2q23.3,150856986,150942971,85985,-,-
BAC73_L16,2,2q23.3,150941768,151041425,99657,-,-
BAC236_I03,2,2q23.3,151006894,151123912,117018,-,-
BAC71_F14,2,2q23.3,151011070,151114987,103917,-,-
BAC123_I03,2,2q23.3,151019615,151128027,108412,-,-
BAC132_L04,2,2q23.3,151222903,151355024,132121,-,-
BAC59_H22,2,2q23.3,151225759,151314782,89023,-,-
BAC19_B18,2,2q23.3,151324379,151488250,163871,-,-
BAC242_F03,2,2q23.3,151333231,151408163,74932,-,-
BAC95_I05,2,2q23.3,151460320,151558796,98476,-,-
BAC243_E03,2,2q23.3,151472083,151538111,66028,-,-
BAC61_A22,2,2q23.3,151501029,151583806,82777,-,-
BAC119_G08,2,2q23.3,151525723,151625189,99466,-,-
BAC125_M02,2,2q23.3,151582617,151671380,88763,-,-
BAC119_P07,2,2q23.3,151608070,151709057,100987,-,-
BAC153_O03,2,2q23.3,151757998,151872667,114669,-,-
BAC180_C02,2,2q23.3,151894697,151976565,81868,-,-
BAC12_D19,2,2q23.3,151919574,151933068,13494,-,-
BAC157_H17,2,2q23.3,151926371,152020925,94554,-,-
BAC240_D11,2,2q23.3,151986917,152117481,130564,-,-
BAC82_G15,2,2q23.3,152038384,152175902,137518,-,-
BAC60_E24,2,2q23.3,152047444,152188736,141292,-,-
BAC220_J17,2,2q23.3,152050045,152156199,106154,-,-
BAC12_J08,2,2q23.3,152117488,152218834,101346,-,-
BAC160_E11,2,2q23.3,152207610,152302127,94517,-,-
BAC116_D10,2,2q23.3,152309556,152385676,76120,-,-
BAC37_A10,2,2q23.3,152311878,152442320,130442,-,-
BAC172_L15,2,2q23.3,152337447,152426602,89155,-,-
BAC122_D04,2,2q23.3,152338973,152357546,18573,-,-
BAC189_P18,2,2q23.3,152353664,152437753,84089,-,-
BAC148_K03,2,2q23.3,152471543,152557904,86361,-,-
BAC35_D03,2,2q23.3,152496214,152645645,149431,-,-
BAC250_F01,2,2q23.3,152536166,152620429,84263,-,-
BAC235_B19,2,2q23.3,152590086,152673598,83512,-,-
BAC4_N06,2,2q23.3,152592331,152758944,166613,-,-
BAC244_M08,2,2q23.3,152620424,152718645,98221,-,-
BAC74_M01,2,2q23.3,152629714,152760815,131101,-,-
BAC25_I09,2,2q23.3,152794104,152887589,93485,-,-
BAC71_F08,2,2q23.3,152798339,152887589,89250,-,-
BAC27_A08,2,2q23.3,152817360,152932992,115632,-,-
BAC46_J12,2,2q23.3,152925448,153050963,125515,-,-
BAC247_G14,2,2q23.3,153018683,153088517,69834,-,-
BAC44_M04,2,2q23.3,153053419,153193675,140256,-,-
BAC2_G24,2,2q23.3,153088696,153188375,99679,-,-
BAC165_L21,2,2q23.3,153179634,153269818,90184,-,-
BAC122_M21,2,2q23.3,153193701,153307862,114161,-,-
BAC76_C22,2,2q23.3,153193701,153314060,120359,-,-
BAC102_L23,2,2q23.3,153205395,153307862,102467,-,-
BAC211_C24,2,2q23.3,153367982,153462534,94552,-,-
BAC176_N23,2,2q23.3,153412190,153484142,71952,-,-
BAC128_O21,2,2q23.3,153432036,153517964,85928,-,-
BAC78_K06,2,2q23.3,153492294,153591421,99127,-,-
BAC60_P23,2,2q23.3,153708652,153801192,92540,-,-
BAC86_O09,2,2q23.3,153713253,153806873,93620,-,-
BAC162_O03,2,2q23.3,153794049,153893802,99753,-,-
BAC48_I11,2,2q23.3,153899624,154026866,127242,-,-
BAC182_P17,2,2q23.3,154051428,154128470,77042,-,-
BAC62_O11,2,2q23.3,154056395,154157573,101178,-,-
BAC200_N22,2,2q23.3,154063403,154149036,85633,-,-
BAC80_A06,2,2q23.3,154129892,154210524,80632,-,-
BAC53_H17,2,2q23.3,154130276,154210524,80248,-,-
BAC177_J24,2,2q23.3,154180681,154269319,88638,-,-
BAC177_H02,2,2q23.3,154180681,154269319,88638,-,-
BAC69_K12,2,2q23.3,154279432,154365877,86445,-,-
BAC111_P19,2,2q23.3,154287982,154397735,109753,-,-
BAC123_L09,2,2q23.3,154354147,154431786,77639,-,-
BAC115_C12,2,2q23.3,154499016,154592349,93333,-,-
BAC110_H04,2,2q24.1,154619576,154702975,83399,-,-
BAC57_O14,2,2q24.1,154782401,154895955,113554,-,-
BAC48_J15,2,2q24.1,154882425,154970882,88457,-,-
BAC12_A12,2,2q24.1,155046045,155154431,108386,-,-
BAC63_N22,2,2q24.1,155073054,155186017,112963,-,-
BAC181_F23,2,2q24.1,155140223,155239325,99102,-,-
BAC230_G07,2,2q24.1,155146783,155246697,99914,-,-
BAC172_N14,2,2q24.1,155245734,155329585,83851,-,-
BAC135_E19,2,2q24.1,155329578,155397007,67429,-,-
BAC91_L23,2,2q24.1,155432430,155515021,82591,-,-
BAC157_G03,2,2q24.1,155499493,155590456,90963,-,-
BAC213_N12,2,2q24.1,155849617,155944487,94870,-,-
BAC250_C03,2,2q24.1,156122695,156206183,83488,-,-
BAC90_D02,2,2q24.1,156382045,156482590,100545,-,-
BAC182_A07,2,2q24.1,156482771,156580873,98102,-,-
BAC68_M10,2,2q24.1,156724145,156815437,91292,-,-
BAC147_O22,2,2q24.1,156886120,156970435,84315,-,-
BAC86_C13,2,2q24.1,157007191,157051655,44464,-,-
BAC39_K24,2,2q24.1,157008371,157119059,110688,-,-
BAC105_D07,2,2q24.1,157068102,157155532,87430,-,-
BAC126_I01,2,2q24.1,157126255,157259651,133396,-,-
BAC218_L20,2,2q24.1,157308845,157384482,75637,-,-
BAC105_C06,2,2q24.1,157427728,157519955,92227,-,-
BAC28_A07,2,2q24.1,157449725,157529465,79740,-,-
BAC208_K17,2,2q24.1,157501342,157600245,98903,-,-
BAC159_L02,2,2q24.1,157654709,157746304,91595,-,-
BAC46_L11,2,2q24.1,157807139,157892575,85436,-,-
BAC104_G04,2,2q24.1,157814515,157935061,120546,-,-
BAC106_E18,2,2q24.1,157881464,157967158,85694,-,-
BAC27_B18,2,2q24.1,157964727,158077205,112478,-,-
BAC110_K08,2,2q24.1,158030913,158147628,116715,-,-
BAC237_O21,2,2q24.1,158030931,158143853,112922,-,-
BAC147_D07,2,2q24.1,158031218,158134765,103547,-,-
BAC120_A04,2,2q24.1,158109880,158206227,96347,-,-
BAC166_E12,2,2q24.1,158123811,158222532,98721,-,-
BAC51_P06,2,2q24.1,158147934,158259392,111458,-,-
BAC21_L02,2,2q24.1,158259503,158369121,109618,-,-
BAC144_L18,2,2q24.1,158265549,158354381,88832,-,-
BAC130_I17,2,2q24.1,158265549,158350021,84472,-,-
BAC50_F14,2,2q24.1,158314917,158404190,89273,-,-
BAC154_N07,2,2q24.1,158314917,158411991,97074,-,-
BAC103_B19,2,2q24.1,158442774,158526118,83344,-,-
BAC217_P10,2,2q24.1,158482442,158587988,105546,-,-
BAC36_E12,2,2q24.1,158482449,158582658,100209,-,-
BAC246_N21,2,2q24.1,158532245,158604535,72290,-,-
BAC65_C03,2,2q24.1,158556121,158638723,82602,-,-
BAC49_L01,2,2q24.1,158594571,158703123,108552,-,-
BAC109_C21,2,2q24.1,158691386,158779212,87826,-,-
BAC252_A04,2,2q24.1,158783784,158890468,106684,-,-
BAC224_D08,2,2q24.1,158808340,158890468,82128,-,-
BAC234_E17,2,2q24.1,158836898,158914688,77790,-,-
BAC199_P16,2,2q24.1,158873754,158951949,78195,-,-
BAC15_H09,2,2q24.1,158890461,158970128,79667,-,-
BAC63_G22,2,2q24.1,158890461,158982474,92013,-,-
BAC130_A14,2,2q24.1,158914682,159000140,85458,-,-
BAC58_J06,2,2q24.1,159104901,159211280,106379,-,-
BAC219_C16,2,2q24.1,159142346,159223913,81567,-,-
BAC252_K07,2,2q24.1,159214684,159323364,108680,-,-
BAC190_N01,2,2q24.1,159214689,159297242,82553,-,-
BAC151_N11,2,2q24.1,159221204,159327333,106129,-,-
BAC109_L03,2,2q24.1,159336613,159428428,91815,-,-
BAC104_C19,2,2q24.1,159385227,159493620,108393,-,-
BAC22_E19,2,2q24.1-2q24.2,159552439,159681972,129533,-,-
BAC170_C02,2,2q24.1-2q24.2,159599495,159690126,90631,-,-
BAC4_A20,2,2q24.2,159605322,159690126,84804,-,-
BAC191_J17,2,2q24.2,159618437,159695863,77426,-,-
BAC95_E02,2,2q24.2,159653338,159743345,90007,-,-
BAC125_P23,2,2q24.2,159654608,159780645,126037,-,-
BAC32_I16,2,2q24.2,159695902,159825107,129205,-,-
BAC49_N18,2,2q24.2,159719131,159839905,120774,-,-
BAC205_J11,2,2q24.2,159743614,159846435,102821,-,-
BAC232_E17,2,2q24.2,159756450,159860877,104427,-,-
BAC236_N21,2,2q24.2,159809159,159914918,105759,-,-
BAC28_L12,2,2q24.2,159889447,159977426,87979,-,-
BAC152_J03,2,2q24.2,159939244,160024873,85629,-,-
BAC39_K16,2,2q24.2,160002748,160114358,111610,-,-
BAC232_B20,2,2q24.2,160085669,160174912,89243,-,-
BAC143_A10,2,2q24.2,160092345,160156674,64329,-,-
BAC198_I05,2,2q24.2,160114754,160250048,135294,-,-
BAC171_A10,2,2q24.2,160175032,160264028,88996,-,-
BAC27_D21,2,2q24.2,160179080,160266937,87857,-,-
BAC12_O16,2,2q24.2,160455042,160542686,87644,-,-
BAC20_B05,2,2q24.2,160511889,160648730,136841,-,-
BAC8_L05,2,2q24.2,160574718,160665029,90311,-,-
BAC72_H05,2,2q24.2,160609716,160683065,73349,-,-
BAC17_B06,2,2q24.2,160643957,160806302,162345,-,-
BAC172_N07,2,2q24.2,160674207,160761179,86972,-,-
BAC101_D08,2,2q24.2,160716994,160813376,96382,-,-
BAC193_M04,2,2q24.2,160761516,160842259,80743,-,-
BAC39_F17,2,2q24.2,160773978,160868412,94434,-,-
BAC134_F15,2,2q24.2,160792749,160886272,93523,-,-
BAC175_D18,2,2q24.2,160873507,160959759,86252,-,-
BAC163_C13,2,2q24.2,160874639,160963749,89110,-,-
BAC247_G02,2,2q24.2,160875320,160963758,88438,-,-
BAC86_G23,2,2q24.2,160950488,161056182,105694,-,-
BAC42_C18,2,2q24.2,160955125,161074378,119253,-,-
BAC192_D03,2,2q24.2,160970158,161080303,110145,-,-
BAC50_J23,2,2q24.2,161080307,161174981,94674,-,-
BAC39_B15,2,2q24.2,161216375,161338173,121798,-,-
BAC55_B15,2,2q24.2,161351547,161458977,107430,-,-
BAC129_E21,2,2q24.2,161359869,161468167,108298,-,-
BAC188_C14,2,2q24.2,161427211,161545837,118626,-,-
BAC124_C02,2,2q24.2,161669213,161759479,90266,-,-
BAC137_N04,2,2q24.2,161703063,161816628,113565,-,-
BAC158_N17,2,2q24.2,161703066,161787950,84884,-,-
BAC175_J11,2,2q24.2,161728492,161811775,83283,-,-
BAC97_F17,2,2q24.2,161848770,161934709,85939,-,-
BAC16_C12,2,2q24.2,161868657,161983972,115315,-,-
BAC132_K02,2,2q24.2,161960604,162033314,72710,-,-
BAC154_B23,2,2q24.2,162078718,162161373,82655,-,-
BAC67_G18,2,2q24.2,162093339,162191594,98255,-,-
BAC14_M11,2,2q24.2,162094284,162209239,114955,-,-
BAC5_K21,2,2q24.2,162100498,162209508,109010,-,-
BAC102_K11,2,2q24.2,162141996,162221970,79974,-,-
BAC74_M18,2,2q24.2,162430348,162551474,121126,-,-
BAC57_C12,2,2q24.2,162502518,162618183,115665,-,-
BAC241_B02,2,2q24.2,162564598,162652939,88341,-,-
BAC115_O16,2,2q24.2,162580741,162690810,110069,-,-
BAC26_B14,2,2q24.2,162740038,162762137,22099,-,-
BAC151_I02,2,2q24.2,162756530,162855753,99223,-,-
BAC127_C15,2,2q24.2,162982599,163087004,104405,-,-
BAC193_I10,2,2q24.2,163009475,163084414,74939,-,-
BAC115_F19,2,2q24.2,163041932,163143240,101308,-,-
BAC5_J04,2,2q24.2,163053341,163143248,89907,-,-
BAC105_M14,2,2q24.2,163110400,163197462,87062,-,-
BAC188_I10,2,2q24.2,163113418,163207806,94388,-,-
BAC27_H03,2,2q24.2,163319775,163415158,95383,-,-
BAC175_A15,2,2q24.2,163443845,163456728,12883,-,-
BAC92_C05,2,2q24.3,163700261,163815624,115363,-,-
BAC10_H05,2,2q24.3,163708509,163801102,92593,-,-
BAC106_N18,2,2q24.3,163778260,163898706,120446,-,-
BAC224_C05,2,2q24.3,163821122,163912176,91054,-,-
BAC40_D01,2,2q24.3,163821122,163834728,13606,-,-
BAC27_O04,2,2q24.3,163822903,163910312,87409,-,-
BAC74_N02,2,2q24.3,163912186,164018311,106125,-,-
BAC226_H14,2,2q24.3,163922896,163987390,64494,-,-
BAC38_O08,2,2q24.3,163939103,164041920,102817,-,-
BAC240_G07,2,2q24.3,164066227,164156986,90759,-,-
BAC40_B03,2,2q24.3,164306609,164473156,166547,-,-
BAC1_H14,2,2q24.3,164365727,164473156,107429,-,-
BAC135_P06,2,2q24.3,164372982,164447439,74457,-,-
BAC162_C04,2,2q24.3,164412250,164494740,82490,-,-
BAC110_A05,2,2q24.3,164412350,164498022,85672,-,-
BAC135_C05,2,2q24.3,164442717,164530922,88205,-,-
BAC116_K04,2,2q24.3,164525718,164640930,115212,-,-
BAC150_M02,2,2q24.3,164580053,164682100,102047,-,-
BAC244_J08,2,2q24.3,164772378,164892950,120572,-,-
BAC224_P23,2,2q24.3,164772402,164856572,84170,-,-
BAC180_L17,2,2q24.3,164782300,164856572,74272,-,-
BAC137_G12,2,2q24.3,165002431,165094582,92151,-,-
BAC12_E19,2,2q24.3,165025149,165111358,86209,-,-
BAC187_C13,2,2q24.3,165135772,165226108,90336,-,-
BAC84_K05,2,2q24.3,165263502,165397038,133536,-,-
BAC77_L22,2,2q24.3,165365911,165448375,82464,-,-
BAC92_L09,2,2q24.3,165368562,165466418,97856,-,-
BAC198_G07,2,2q24.3,165368562,165483149,114587,-,-
BAC30_I23,2,2q24.3,165371474,165481337,109863,-,-
BAC22_E22,2,2q24.3,165397037,165525955,128918,-,-
BAC42_A07,2,2q24.3,165407238,165525955,118717,-,-
BAC57_L23,2,2q24.3,165417530,165555217,137687,-,-
BAC134_B18,2,2q24.3,165420590,165447456,26866,-,-
BAC52_G06,2,2q24.3,165433382,165549401,116019,-,-
BAC168_D17,2,2q24.3,165456864,165558976,102112,-,-
BAC235_K17,2,2q24.3,165496019,165583764,87745,-,-
BAC176_G08,2,2q24.3,165566857,165661774,94917,-,-
BAC190_L12,2,2q24.3,165739668,165874472,134804,-,-
BAC79_E12,2,2q24.3,165949636,166054346,104710,-,-
BAC27_L04,2,2q24.3,166143039,166233621,90582,-,-
BAC61_D16,2,2q24.3,166256359,166347133,90774,-,-
BAC40_N11,2,2q24.3,166259401,166363020,103619,-,-
BAC66_L22,2,2q24.3,166288893,166383719,94826,-,-
BAC210_C21,2,2q24.3,166477223,166577361,100138,-,-
BAC230_E02,2,2q24.3,166631150,166739877,108727,-,-
BAC105_B06,2,2q24.3,166737685,166819186,81501,-,-
BAC211_D14,2,2q24.3,166751505,166840667,89162,-,-
BAC246_K13,2,2q24.3,166843590,166922554,78964,-,-
BAC39_M11,2,2q24.3,166990223,167070207,79984,-,-
BAC59_E10,2,2q24.3,167042332,167123907,81575,-,-
BAC50_G24,2,2q24.3,167070362,167190681,120319,-,-
BAC46_E09,2,2q24.3,167133347,167232842,99495,-,-
BAC130_P17,2,2q24.3,167143774,167223926,80152,-,-
BAC151_G12,2,2q24.3,167240797,167331280,90483,-,-
BAC182_N12,2,2q24.3,167520589,167607597,87008,-,-
BAC170_F11,2,2q24.3,167539298,167633352,94054,-,-
BAC194_N15,2,2q24.3,167633488,167738725,105237,-,-
BAC187_N17,2,2q24.3,167775331,167860513,85182,-,-
BAC150_A22,2,2q24.3,167862269,167943283,81014,-,-
BAC169_E17,2,2q24.3,167909984,167991940,81956,-,-
BAC75_N21,2,2q24.3,167919122,168008976,89854,-,-
BAC192_K18,2,2q24.3,167931558,168011315,79757,-,-
BAC101_P16,2,2q24.3,167931558,168026940,95382,-,-
BAC124_P15,2,2q24.3,167963203,168068259,105056,-,-
BAC67_O12,2,2q24.3,168062975,168178752,115777,-,-
BAC92_J09,2,2q24.3,168070331,168166555,96224,-,-
BAC139_G14,2,2q24.3,168091462,168203172,111710,-,-
BAC178_B06,2,2q24.3,168138909,168223877,84968,-,-
BAC169_L08,2,2q24.3,168239277,168325001,85724,-,-
BAC96_A20,2,2q24.3,168297017,168314601,17584,-,-
BAC238_C17,2,2q24.3,168366763,168466023,99260,-,-
BAC171_D15,2,2q24.3,168366763,168470290,103527,-,-
BAC222_J24,2,2q24.3,168512733,168609237,96504,-,-
BAC43_N13,2,2q24.3,168520591,168626355,105764,-,-
BAC160_D12,2,2q24.3,168547586,168664281,116695,-,-
BAC163_E18,2,2q24.3,168780791,168870221,89430,-,-
BAC224_L03,2,2q24.3,168805609,168890411,84802,-,-
BAC101_D18,2,2q24.3,168844234,168962555,118321,-,-
BAC149_E08,2,2q24.3,168879132,168960510,81378,-,-
BAC238_C22,2,2q24.3,168888515,169005827,117312,-,-
BAC72_K05,2,2q24.3,168911768,168994892,83124,-,-
BAC158_O02,2,2q24.3,168911790,168993180,81390,-,-
BAC102_E10,2,2q24.3,168920799,169022478,101679,-,-
BAC62_L16,2,2q24.3,169087951,169281368,193417,-,-
BAC200_E23,2,2q24.3,169089950,169187593,97643,-,-
BAC25_A05,2,2q24.3,169199713,169330120,130407,-,-
BAC229_G12,2,2q24.3,169237626,169324979,87353,-,-
BAC243_L18,2,2q24.3,169281619,169391758,110139,-,-
BAC176_I07,2,2q24.3-2q31.1,169414691,169529656,114965,-,-
BAC160_H18,2,2q31.1,169501663,169598598,96935,-,-
BAC148_D19,2,2q31.1,169673152,169761921,88769,-,-
BAC83_M21,2,2q31.1,169675791,169765206,89415,-,-
BAC127_P05,2,2q31.1,169683654,169781483,97829,-,-
BAC69_M07,2,2q31.1,169754276,169843972,89696,-,-
BAC2_P11,2,2q31.1,169781642,169899871,118229,-,-
BAC211_I21,2,2q31.1,169811382,169899643,88261,-,-
BAC100_H16,2,2q31.1,169823408,169909482,86074,-,-
BAC168_B13,2,2q31.1,169843484,169937467,93983,-,-
BAC165_L13,2,2q31.1,169940712,170021313,80601,-,-
BAC83_H21,2,2q31.1,170078644,170222859,144215,yes,-
BAC160_L08,2,2q31.1,170117008,170199507,82499,-,-
BAC88_I21,2,2q31.1,170125083,170222682,97599,yes,-
BAC70_N20,2,2q31.1,170125083,170205266,80183,yes,-
BAC162_G08,2,2q31.1,170133837,170222704,88867,yes,-
BAC79_G12,2,2q31.1,170158585,170288186,129601,-,-
BAC158_G22,2,2q31.1,170182980,170275813,92833,-,-
BAC40_I05,2,2q31.1,170188184,170275816,87632,-,-
BAC113_J13,2,2q31.1,170365523,170456369,90846,-,-
BAC103_L15,2,2q31.1,170390973,170495775,104802,-,-
BAC197_F17,2,2q31.1,170456609,170541759,85150,-,-
BAC165_D13,2,2q31.1,170577519,170668681,91162,-,-
BAC129_C19,2,2q31.1,170623845,170707172,83327,-,-
BAC23_I04,2,2q31.1,170668842,170756459,87617,-,-
BAC221_G10,2,2q31.1,170943561,171051620,108059,-,-
BAC33_H22,2,2q31.1,170986513,171082267,95754,-,-
BAC64_H21,2,2q31.1,170986515,171102934,116419,-,-
BAC63_I01,2,2q31.1,171038602,171140590,101988,-,-
BAC220_H05,2,2q31.1,171100724,171177061,76337,-,-
BAC56_P03,2,2q31.1,171107873,171193533,85660,-,-
BAC90_K04,2,2q31.1,171191562,171303975,112413,-,-
BAC10_A21,2,2q31.1,171196125,171302039,105914,-,-
BAC65_P09,2,2q31.1,171198016,171283805,85789,-,-
BAC167_H13,2,2q31.1,171201947,171302039,100092,-,-
BAC58_P01,2,2q31.1,171201947,171317573,115626,-,-
BAC146_N13,2,2q31.1,171202495,171293631,91136,-,-
BAC152_J22,2,2q31.1,171335074,171440699,105625,-,-
BAC222_N07,2,2q31.1,171352195,171431298,79103,-,-
BAC126_H02,2,2q31.1,171365878,171505795,139917,-,-
BAC75_C06,2,2q31.1,171365938,171550901,184963,-,-
BAC95_C05,2,2q31.1,171396093,171496219,100126,-,-
BAC86_N08,2,2q31.1,171412642,171513070,100428,-,-
BAC51_J19,2,2q31.1,171431385,171512883,81498,-,-
BAC101_O19,2,2q31.1,171496214,171578558,82344,-,-
BAC227_P18,2,2q31.1,171513100,171578524,65424,-,-
BAC25_E19,2,2q31.1,171544761,171633325,88564,-,-
BAC2_M22,2,2q31.1,171545855,171698347,152492,-,-
BAC72_B15,2,2q31.1,171550898,171652701,101803,-,-
BAC13_O06,2,2q31.1,171816800,171912440,95640,-,-
BAC237_M07,2,2q31.1,171831282,171913429,82147,-,-
BAC126_J15,2,2q31.1,171885111,172002976,117865,-,-
BAC126_A22,2,2q31.1,171885111,172003002,117891,-,-
BAC189_A16,2,2q31.1,171885499,171998741,113242,-,-
BAC218_O08,2,2q31.1,171888709,171984943,96234,-,-
BAC53_A20,2,2q31.1,171919511,172006385,86874,-,-
BAC24_L07,2,2q31.1,171919516,172019638,100122,-,-
BAC249_L06,2,2q31.1,171919516,172017376,97860,-,-
BAC55_M14,2,2q31.1,171944795,172037426,92631,-,-
BAC15_G11,2,2q31.1,171998746,172011989,13243,-,-
BAC146_G04,2,2q31.1,172017391,172116463,99072,-,-
BAC66_J02,2,2q31.1,172023390,172192193,168803,-,-
BAC142_D06,2,2q31.1,172076272,172186666,110394,-,-
BAC142_C06,2,2q31.1,172076272,172186666,110394,-,-
BAC142_B05,2,2q31.1,172122582,172208407,85825,-,-
BAC42_E21,2,2q31.1,172132054,172251880,119826,-,-
BAC124_P12,2,2q31.1,172356553,172486760,130207,-,-
BAC181_O09,2,2q31.1,172375675,172457333,81658,-,-
BAC142_G02,2,2q31.1,172375676,172447998,72322,-,-
BAC153_H17,2,2q31.1,172422839,172513749,90910,-,-
BAC151_E15,2,2q31.1,172441855,172490654,48799,-,-
BAC36_H24,2,2q31.1,172444466,172490775,46309,-,-
BAC234_B02,2,2q31.1,172447993,172568020,120027,yes,-
BAC84_L09,2,2q31.1,172509172,172619826,110654,-,-
BAC66_G04,2,2q31.1,172535637,172630072,94435,-,-
BAC231_L07,2,2q31.1,172535805,172633390,97585,-,-
BAC126_E10,2,2q31.1,172535974,172634834,98860,-,-
BAC30_H06,2,2q31.1,172535974,172646464,110490,-,-
BAC101_I20,2,2q31.1,172549392,172631489,82097,-,-
BAC18_H10,2,2q31.1,172556965,172662344,105379,-,-
BAC117_H12,2,2q31.1,172619925,172724541,104616,-,-
BAC242_K17,2,2q31.1,172636335,172720887,84552,-,-
BAC38_G23,2,2q31.1,172665101,172766461,101360,-,-
BAC145_A09,2,2q31.1,172681347,172766605,85258,-,-
BAC100_B09,2,2q31.1,172743685,172855785,112100,-,-
BAC130_F19,2,2q31.1,172774963,172861053,86090,-,-
BAC142_J21,2,2q31.1,172807817,172913744,105927,-,-
BAC53_B19,2,2q31.1,172826384,172990939,164555,-,-
BAC58_F06,2,2q31.1,172878016,172990945,112929,-,-
BAC168_C15,2,2q31.1,172883801,172973200,89399,-,-
BAC101_N17,2,2q31.1,173125467,173222674,97207,-,-
BAC143_A14,2,2q31.1,173142703,173229517,86814,-,-
BAC150_E18,2,2q31.1,173196194,173285587,89393,-,-
BAC252_K22,2,2q31.1,173259605,173369670,110065,-,-
BAC108_N03,2,2q31.1,173259841,173369665,109824,-,-
BAC124_G07,2,2q31.1,173297469,173403205,105736,-,-
BAC56_I18,2,2q31.1,173300419,173397201,96782,-,-
BAC91_I18,2,2q31.1,173322410,173414523,92113,-,-
BAC119_N12,2,2q31.1,173413035,173564983,151948,-,-
BAC234_H15,2,2q31.1,173469726,173558224,88498,-,-
BAC128_I03,2,2q31.1,173558218,173663601,105383,-,-
BAC217_B14,2,2q31.1,173558218,173635000,76782,-,-
BAC237_B17,2,2q31.1,173561876,173643102,81226,-,-
BAC127_I20,2,2q31.1,173661587,173784415,122828,-,-
BAC40_L23,2,2q31.1,173687990,173795843,107853,-,-
BAC100_C19,2,2q31.1,173689765,173781209,91444,-,-
BAC175_A23,2,2q31.1,173723233,173809240,86007,-,-
BAC252_G16,2,2q31.1,173783007,173895080,112073,-,-
BAC95_M09,2,2q31.1,173805062,173906002,100940,-,-
BAC10_N16,2,2q31.1,173873013,173988131,115118,-,-
BAC42_H20,2,2q31.1,173910532,174036019,125487,-,-
BAC8_I13,2,2q31.1,173942806,174036022,93216,-,-
BAC73_O03,2,2q31.1,174033943,174128509,94566,-,-
BAC177_G11,2,2q31.1,174036017,174128530,92513,-,-
BAC37_D16,2,2q31.1,174048006,174221543,173537,-,-
BAC242_N03,2,2q31.1,174072553,174157000,84447,-,-
BAC54_I07,2,2q31.1,174102635,174228751,126116,-,-
BAC92_I22,2,2q31.1,174109082,174213547,104465,-,-
BAC107_F09,2,2q31.1,174420457,174501421,80964,-,-
BAC133_K15,2,2q31.1,174423825,174514865,91040,-,-
BAC193_J22,2,2q31.1,174426340,174501421,75081,-,-
BAC180_A07,2,2q31.1,174435531,174548100,112569,-,-
BAC211_E11,2,2q31.1,174464464,174549453,84989,-,-
BAC182_P24,2,2q31.1,174483732,174561790,78058,-,-
BAC96_E24,2,2q31.1,174598564,174722032,123468,-,-
BAC178_P19,2,2q31.1,174623382,174725033,101651,-,-
BAC196_A03,2,2q31.1,174631821,174725033,93212,-,-
BAC117_O08,2,2q31.1,174657131,174770116,112985,-,-
BAC191_B10,2,2q31.1,174716480,174797333,80853,-,-
BAC76_C06,2,2q31.1,174763495,174882309,118814,-,-
BAC191_F20,2,2q31.1,174814066,174897427,83361,-,-
BAC193_O17,2,2q31.1,174852306,174942551,90245,-,-
BAC13_D10,2,2q31.1,174916743,175046325,129582,-,-
BAC170_B11,2,2q31.1,174969016,175058573,89557,-,-
BAC227_B23,2,2q31.1,174971128,175073330,102202,-,-
BAC1_O16,2,2q31.1,174977270,175069150,91880,-,-
BAC238_B19,2,2q31.1,175154513,175240065,85552,-,-
BAC142_K20,2,2q31.1,175189542,175265979,76437,-,-
BAC160_F21,2,2q31.1,175189659,175270651,80992,-,-
BAC183_I22,2,2q31.1,175237687,175359870,122183,-,-
BAC106_D22,2,2q31.1,175268969,175405367,136398,-,-
BAC139_C06,2,2q31.1,175268969,175380347,111378,-,-
BAC125_M04,2,2q31.1,175325775,175439723,113948,-,-
BAC167_E19,2,2q31.1,175325776,175413884,88108,-,-
BAC227_P14,2,2q31.1,175405362,175496457,91095,-,-
BAC229_P09,2,2q31.1,175444700,175530079,85379,-,-
BAC56_M05,2,2q31.1,175473942,175595886,121944,-,-
BAC175_M20,2,2q31.1,175545151,175668501,123350,-,-
BAC189_N13,2,2q31.1,175545306,175645466,100160,-,-
BAC172_P14,2,2q31.1,175699287,175785608,86321,-,-
BAC173_K05,2,2q31.1,175763512,175846322,82810,-,-
BAC220_C06,2,2q31.1,175787615,175864027,76412,-,-
BAC123_N14,2,2q31.1,175856233,175941505,85272,-,-
BAC157_A17,2,2q31.1,175864998,175941055,76057,-,-
BAC96_O06,2,2q31.1,175913158,176014191,101033,-,-
BAC195_F04,2,2q31.1,175965549,176048133,82584,-,-
BAC90_O16,2,2q31.1,176133653,176234218,100565,-,-
BAC76_C16,2,2q31.1,176133711,176211986,78275,-,-
BAC166_K09,2,2q31.1,176174493,176241604,67111,-,-
BAC95_A17,2,2q31.1,176280000,176364742,84742,-,-
BAC167_C22,2,2q31.1,176360973,176446600,85627,-,-
BAC53_L14,2,2q31.1,176364782,176462077,97295,-,-
BAC102_A22,2,2q31.1,176444689,176531908,87219,-,-
BAC102_B17,2,2q31.1,176541216,176626362,85146,-,-
BAC210_L13,2,2q31.1,176567958,176690752,122794,-,-
BAC158_H09,2,2q31.1,176575862,176669198,93336,-,-
BAC34_F17,2,2q31.1,176602023,176707880,105857,-,-
BAC240_L16,2,2q31.1,176602023,176690784,88761,-,-
BAC17_C08,2,2q31.1,176817122,176928563,111441,-,-
BAC155_I04,2,2q31.1,176884245,177022936,138691,-,-
BAC147_P01,2,2q31.1,176964321,177069995,105674,-,-
BAC21_H04,2,2q31.1,176999798,177130512,130714,-,-
BAC82_I24,2,2q31.1,177055589,177145044,89455,-,-
BAC118_M16,2,2q31.1,177084235,177209693,125458,-,-
BAC194_L06,2,2q31.1,177096490,177189346,92856,-,-
BAC53_E04,2,2q31.1,177170759,177261410,90651,-,-
BAC24_A08,2,2q31.1,177172132,177331882,159750,-,-
BAC167_C05,2,2q31.1,177192080,177271441,79361,-,-
BAC194_I20,2,2q31.1,177310814,177395162,84348,-,-
BAC37_P23,2,2q31.1,177403484,177567948,164464,-,-
BAC189_M14,2,2q31.1,177458820,177549020,90200,-,-
BAC27_E01,2,2q31.1,177534085,177685859,151774,-,-
BAC139_E11,2,2q31.1,177578532,177652960,74428,-,-
BAC117_C20,2,2q31.1,177580289,177676958,96669,-,-
BAC183_I14,2,2q31.1,177607658,177696265,88607,-,-
BAC188_H20,2,2q31.2,177742034,177832649,90615,-,-
BAC192_K05,2,2q31.2,177742065,177832649,90584,-,-
BAC40_B15,2,2q31.2,177770188,177879663,109475,-,-
BAC249_P09,2,2q31.2,177919845,178092023,172178,-,-
BAC182_H09,2,2q31.2,177933804,178020860,87056,-,-
BAC66_I22,2,2q31.2,177934925,178018228,83303,-,-
BAC65_D16,2,2q31.2,177986406,178080259,93853,-,-
BAC199_D24,2,2q31.2,178016531,178110758,94227,-,-
BAC126_H20,2,2q31.2,178030952,178175932,144980,-,-
BAC126_P20,2,2q31.2,178030975,178175932,144957,-,-
BAC88_C13,2,2q31.2,178086678,178182471,95793,-,-
BAC30_C07,2,2q31.2,178087638,178166317,78679,-,-
BAC102_G18,2,2q31.2,178094842,178221550,126708,-,-
BAC38_C21,2,2q31.2,178180196,178286411,106215,-,-
BAC127_I04,2,2q31.2,178188913,178293847,104934,-,-
BAC59_E07,2,2q31.2,178221565,178317728,96163,-,-
BAC234_E05,2,2q31.2,178455825,178558286,102461,-,-
BAC83_J19,2,2q31.2,178526963,178617166,90203,-,-
BAC229_D17,2,2q31.2,178540575,178632389,91814,-,-
BAC119_D24,2,2q31.2,178545922,178666307,120385,-,-
BAC14_O13,2,2q31.2,178677583,178778487,100904,-,-
BAC74_E05,2,2q31.2,178683598,178764023,80425,-,-
BAC46_O09,2,2q31.2,178710106,178810858,100752,-,-
BAC140_L13,2,2q31.2,178722698,178778288,55590,-,-
BAC211_H23,2,2q31.2,178742560,178830130,87570,-,-
BAC191_F09,2,2q31.2,178844477,178926437,81960,-,-
BAC11_I15,2,2q31.2,178845526,178958954,113428,-,-
BAC75_J07,2,2q31.2,178853310,178973577,120267,-,-
BAC25_D15,2,2q31.2,178892459,179004714,112255,-,-
BAC219_M09,2,2q31.2,179109616,179200936,91320,-,-
BAC35_A14,2,2q31.2,179294375,179393632,99257,-,-
BAC183_D05,2,2q31.2,179449930,179557192,107262,-,-
BAC109_F01,2,2q31.2,179505842,179589513,83671,-,-
BAC247_L12,2,2q31.2,179542385,179640794,98409,-,-
BAC161_G20,2,2q31.2,179566869,179682518,115649,-,-
BAC12_F20,2,2q31.2,179589509,179677911,88402,-,-
BAC57_B19,2,2q31.2,179646816,179747914,101098,-,-
BAC213_I14,2,2q31.2,179649673,179730963,81290,-,-
BAC237_P01,2,2q31.2,179808448,179920051,111603,-,-
BAC36_I13,2,2q31.2,179808453,179898150,89697,-,-
BAC24_E24,2,2q31.2,180269908,180361019,91111,-,-
BAC104_O05,2,2q31.3,180431020,180533367,102347,-,-
BAC234_D07,2,2q31.3,180439540,180524622,85082,-,-
BAC151_M24,2,2q31.3,180479428,180595543,116115,-,-
BAC39_F03,2,2q31.3,180932059,181007284,75225,-,-
BAC198_P02,2,2q31.3,181021981,181104367,82386,-,-
BAC167_L03,2,2q31.3,181272036,181341846,69810,-,-
BAC145_J07,2,2q31.3,181328264,181429456,101192,-,-
BAC248_O08,2,2q31.3,181379287,181473687,94400,-,-
BAC125_I07,2,2q31.3,181379287,181484794,105507,-,-
BAC159_L08,2,2q31.3,181511842,181608563,96721,-,-
BAC184_M09,2,2q31.3,181604459,181691609,87150,-,-
BAC148_D14,2,2q31.3,181692796,181809040,116244,-,-
BAC228_G10,2,2q31.3,181914768,181995559,80791,-,-
BAC238_C12,2,2q31.3,182059861,182171648,111787,-,-
BAC79_D24,2,2q31.3,182089459,182186427,96968,-,-
BAC190_G05,2,2q31.3,182105600,182201964,96364,-,-
BAC96_L09,2,2q31.3,182180795,182266538,85743,-,-
BAC225_E03,2,2q31.3,182376324,182443045,66721,-,-
BAC44_B10,2,2q32.1,182841448,182951632,110184,-,-
BAC76_E03,2,2q32.1,182876653,182951630,74977,-,-
BAC189_L09,2,2q32.1,182884814,182983727,98913,-,-
BAC140_M07,2,2q32.1,183002746,183090859,88113,-,-
BAC73_N18,2,2q32.1,183032483,183151279,118796,-,-
BAC114_F17,2,2q32.1,183151248,183239580,88332,-,-
BAC171_E13,2,2q32.1,183174771,183270011,95240,-,-
BAC31_I08,2,2q32.1,183179620,183296942,117322,-,-
BAC115_H04,2,2q32.1,183436928,183522995,86067,-,-
BAC186_L23,2,2q32.1,183459317,183547832,88515,-,-
BAC26_G03,2,2q32.1,183548062,183696084,148022,-,-
BAC194_F04,2,2q32.1,183567296,183642759,75463,-,-
BAC181_A24,2,2q32.1,183579393,183642759,63366,-,-
BAC166_D06,2,2q32.1,183583950,183672512,88562,-,-
BAC232_I08,2,2q32.1,183597280,183667477,70197,-,-
BAC95_N21,2,2q32.1,183642028,183744730,102702,-,-
BAC125_F01,2,2q32.1,183683094,183798757,115663,-,-
BAC238_G16,2,2q32.1,183762180,183772769,10589,-,-
BAC66_D04,2,2q32.1,183798751,183902361,103610,-,-
BAC83_O03,2,2q32.1,183990670,184088587,97917,-,-
BAC151_G11,2,2q32.1,184161089,184245484,84395,-,-
BAC119_O18,2,2q32.1,184318988,184426151,107163,-,-
BAC137_C12,2,2q32.1,184363053,184515962,152909,-,-
BAC188_J21,2,2q32.1,184363069,184445716,82647,-,-
BAC157_F03,2,2q32.1,184453687,184525474,71787,-,-
BAC161_L10,2,2q32.1,184526688,184610194,83506,-,-
BAC125_F16,2,2q32.1,185036229,185122104,85875,-,-
BAC249_E12,2,2q32.1,185095627,185183171,87544,-,-
BAC106_N09,2,2q32.1,185373628,185480376,106748,-,-
BAC91_M20,2,2q32.1,185379087,185493622,114535,-,-
BAC227_K18,2,2q32.1,185721420,185784515,63095,-,-
BAC60_N08,2,2q32.1,185847161,185936843,89682,-,-
BAC223_K05,2,2q32.1,185881311,186025816,144505,-,-
BAC226_O02,2,2q32.1,185936294,186025816,89522,-,-
BAC233_B16,2,2q32.1,185941390,186025816,84426,-,-
BAC244_M24,2,2q32.1,185961491,186004204,42713,-,-
BAC76_D13,2,2q32.1,186207705,186290950,83245,-,-
BAC249_F06,2,2q32.1,186525971,186608875,82904,-,-
BAC60_N02,2,2q32.1,186741040,186801286,60246,-,-
BAC238_E10,2,2q32.1,186741040,186805187,64147,-,-
BAC244_B12,2,2q32.1,186741040,186831038,89998,-,-
BAC168_I04,2,2q32.1,187028925,187130843,101918,-,-
BAC179_B12,2,2q32.1,187078822,187175848,97026,-,-
BAC36_K19,2,2q32.1,187128410,187227304,98894,-,-
BAC64_O08,2,2q32.1,187218035,187299970,81935,-,-
BAC151_E08,2,2q32.1,187222503,187304715,82212,-,-
BAC249_P11,2,2q32.1,187319577,187418701,99124,-,-
BAC189_J20,2,2q32.1,187348413,187457731,109318,-,-
BAC114_B21,2,2q32.1,187397534,187492605,95071,-,-
BAC176_F01,2,2q32.1,187475291,187573998,98707,-,-
BAC240_O07,2,2q32.1,187503608,187586999,83391,-,-
BAC82_C20,2,2q32.1,187511936,187606046,94110,-,-
BAC176_E09,2,2q32.1,187568134,187648883,80749,-,-
BAC66_N11,2,2q32.1,188007946,188107518,99572,-,-
BAC171_F12,2,2q32.1,188109353,188217950,108597,-,-
BAC106_J02,2,2q32.1,188286055,188373941,87886,-,-
BAC55_E04,2,2q32.1,188437418,188526449,89031,-,-
BAC158_A11,2,2q32.1,188505888,188604038,98150,-,-
BAC158_N10,2,2q32.1,188505889,188604038,98149,-,-
BAC30_C02,2,2q32.1,188564271,188645343,81072,-,-
BAC243_G08,2,2q32.1,188645337,188777614,132277,-,-
BAC141_A11,2,2q32.1,188820974,188918331,97357,-,-
BAC70_A12,2,2q32.1,188831008,188918295,87287,-,-
BAC79_L21,2,2q32.1,188831021,188946517,115496,-,-
BAC223_O19,2,2q32.1,188835131,188946517,111386,-,-
BAC235_I04,2,2q32.1,188883446,188977600,94154,-,-
BAC143_D16,2,2q32.1,188971694,189069401,97707,-,-
BAC64_J09,2,2q32.1-2q32.2,189013235,189123858,110623,-,-
BAC185_K23,2,2q32.1-2q32.2,189082206,189195171,112965,-,-
BAC26_G21,2,2q32.2,189228620,189358962,130342,-,-
BAC71_K06,2,2q32.2,189269948,189363671,93723,-,-
BAC67_B09,2,2q32.2,189297177,189388812,91635,-,-
BAC68_L14,2,2q32.2,189450022,189536686,86664,-,-
BAC143_B03,2,2q32.2,189520655,189612270,91615,-,-
BAC108_L17,2,2q32.2,189615243,189708745,93502,-,-
BAC181_G11,2,2q32.2,189620400,189707774,87374,-,-
BAC59_K10,2,2q32.2,189708413,189813775,105362,-,-
BAC238_M11,2,2q32.2,189750316,189838972,88656,-,-
BAC27_E22,2,2q32.2,189893625,190038372,144747,-,-
BAC96_K17,2,2q32.2,189906357,190018755,112398,-,-
BAC96_G06,2,2q32.2,190043164,190135012,91848,-,-
BAC246_N22,2,2q32.2,190113293,190202295,89002,-,-
BAC39_P10,2,2q32.2,190131542,190312993,181451,-,-
BAC26_N15,2,2q32.2,190186226,190286369,100143,-,-
BAC183_O03,2,2q32.2,190190134,190296704,106570,-,-
BAC186_C14,2,2q32.2,190198147,190296704,98557,-,-
BAC71_I04,2,2q32.2,190202289,190348813,146524,-,-
BAC21_G20,2,2q32.2,190207572,190357332,149760,-,-
BAC89_E02,2,2q32.2,190207659,190322488,114829,-,-
BAC238_P23,2,2q32.2,190562432,190656717,94285,-,-
BAC235_C14,2,2q32.2,190672207,190747820,75613,-,-
BAC134_J01,2,2q32.2,190672207,190780516,108309,-,-
BAC63_A11,2,2q32.2,190683934,190787573,103639,-,-
BAC31_N07,2,2q32.2,190700179,190785906,85727,-,-
BAC133_L06,2,2q32.2,190735446,190808999,73553,-,-
BAC73_F02,2,2q32.2,190766862,190863647,96785,-,-
BAC187_G04,2,2q32.2,190780534,190874135,93601,-,-
BAC14_C14,2,2q32.2,190798880,190967585,168705,-,-
BAC169_K05,2,2q32.2,190822015,190913603,91588,-,-
BAC43_N04,2,2q32.2,190839249,190925093,85844,-,-
BAC36_E23,2,2q32.2,190874235,190988989,114754,-,-
BAC96_N16,2,2q32.2,190925090,191015762,90672,-,-
BAC219_K17,2,2q32.2,190935943,191044573,108630,-,-
BAC218_L16,2,2q32.2,190936225,191015790,79565,-,-
BAC100_D17,2,2q32.2,190966772,191044574,77802,-,-
BAC238_P01,2,2q32.2,190980085,191088309,108224,-,-
BAC108_I10,2,2q32.2,191081344,191172242,90898,-,-
BAC110_I12,2,2q32.2,191142841,191234850,92009,-,-
BAC148_C11,2,2q32.2,191162387,191235358,72971,-,-
BAC123_A10,2,2q32.2,191162387,191251709,89322,-,-
BAC49_P21,2,2q32.2,191274310,191360007,85697,-,-
BAC181_B03,2,2q32.2,191410233,191509464,99231,-,-
BAC53_P09,2,2q32.3,191601473,191699576,98103,-,-
BAC69_D21,2,2q32.3,191729393,191826860,97467,-,-
BAC195_E08,2,2q32.3,191739145,191846017,106872,-,-
BAC11_M08,2,2q32.3,191961866,192085640,123774,-,-
BAC123_J19,2,2q32.3,191976186,192071270,95084,-,-
BAC161_K02,2,2q32.3,191979432,192071270,91838,-,-
BAC14_M09,2,2q32.3,192000498,192076588,76090,-,-
BAC181_J23,2,2q32.3,192098495,192120382,21887,-,-
BAC170_N21,2,2q32.3,192140362,192207445,67083,-,-
BAC151_F20,2,2q32.3,192395731,192486834,91103,-,-
BAC34_K15,2,2q32.3,192788347,192861409,73062,-,-
BAC122_B02,2,2q32.3,192975232,193096757,121525,-,-
BAC112_H05,2,2q32.3,193042475,193155197,112722,-,-
BAC197_N16,2,2q32.3,193052841,193148761,95920,-,-
BAC136_M13,2,2q32.3,193070688,193155386,84698,-,-
BAC139_F24,2,2q32.3,193145282,193250432,105150,-,-
BAC103_L21,2,2q32.3,193234673,193322528,87855,-,-
BAC186_D03,2,2q32.3,193282844,193363927,81083,-,-
BAC78_E02,2,2q32.3,193294073,193382721,88648,-,-
BAC48_N13,2,2q32.3,193409287,193502399,93112,-,-
BAC20_F06,2,2q32.3,193871485,193964802,93317,-,-
BAC84_A02,2,2q32.3,193936253,194048049,111796,-,-
BAC148_P20,2,2q32.3,194004970,194091751,86781,-,-
BAC222_D07,2,2q32.3,194045697,194077291,31594,-,-
BAC227_B07,2,2q32.3,194063237,194143952,80715,-,-
BAC21_D02,2,2q32.3,194089960,194186294,96334,-,-
BAC120_A11,2,2q32.3,194122608,194264121,141513,-,-
BAC172_E12,2,2q32.3,194216233,194304456,88223,-,-
BAC84_J16,2,2q32.3,194408625,194500934,92309,-,-
BAC145_O09,2,2q32.3,194444073,194525679,81606,-,-
BAC51_B22,2,2q32.3,194445022,194525679,80657,-,-
BAC42_G08,2,2q32.3,194575018,194676244,101226,-,-
BAC41_K22,2,2q32.3,194692844,194796574,103730,-,-
BAC77_M01,2,2q32.3,194709842,194825606,115764,-,-
BAC80_C16,2,2q32.3,194741693,194827937,86244,-,-
BAC15_H16,2,2q32.3,194767294,194870733,103439,-,-
BAC124_I23,2,2q32.3,194769172,194870733,101561,-,-
BAC67_C15,2,2q32.3,194867887,195009159,141272,-,-
BAC228_N13,2,2q32.3,195128807,195157747,28940,-,-
BAC97_J16,2,2q32.3,195157144,195241212,84068,-,-
BAC185_M01,2,2q32.3,195393479,195490201,96722,-,-
BAC22_E16,2,2q32.3,195426188,195565248,139060,-,-
BAC32_A18,2,2q32.3,195437131,195571774,134643,-,-
BAC82_D11,2,2q32.3,195437357,195562423,125066,-,-
BAC131_M09,2,2q32.3,195609738,195704474,94736,-,-
BAC21_G02,2,2q32.3,195844125,195958377,114252,-,-
BAC124_P13,2,2q32.3,195951752,196059618,107866,-,-
BAC124_B18,2,2q32.3,195997710,196108115,110405,-,-
BAC131_A07,2,2q32.3,196019005,196116315,97310,-,-
BAC196_N02,2,2q32.3,196022019,196106141,84122,-,-
BAC239_O22,2,2q32.3,196166077,196268774,102697,-,-
BAC32_F04,2,2q32.3,196178929,196268768,89839,-,-
BAC11_B18,2,2q32.3,196264824,196366470,101646,-,-
BAC65_G23,2,2q32.3,196286045,196418420,132375,-,-
BAC240_D23,2,2q32.3,196471917,196571976,100059,-,-
BAC247_K05,2,2q32.3,196571973,196650129,78156,-,-
BAC31_L23,2,2q32.3,196658145,196766300,108155,-,-
BAC26_E01,2,2q32.3,196685473,196801567,116094,-,-
BAC80_K13,2,2q32.3,196767846,196851384,83538,-,-
BAC24_L01,2,2q32.3,196797441,196866941,69500,-,-
BAC71_B08,2,2q32.3,196860195,196948873,88678,-,-
BAC167_K10,2,2q32.3,196905393,196977399,72006,-,-
BAC200_K23,2,2q32.3-2q33.1,197026416,197122961,96545,-,-
BAC19_I03,2,2q32.3-2q33.1,197026618,197122961,96343,-,-
BAC235_A07,2,2q33.1,197123196,197225847,102651,-,-
BAC166_B22,2,2q33.1,197140870,197228385,87515,-,-
BAC83_L08,2,2q33.1,197196246,197282167,85921,-,-
BAC51_F22,2,2q33.1,197216335,197332955,116620,-,-
BAC127_O13,2,2q33.1,197319746,197407542,87796,-,-
BAC75_I08,2,2q33.1,197378353,197470841,92488,-,-
BAC184_I02,2,2q33.1,197473522,197553778,80256,-,-
BAC207_H19,2,2q33.1,197509915,197618044,108129,-,-
BAC181_O08,2,2q33.1,197531237,197655732,124495,-,-
BAC110_O17,2,2q33.1,197655727,197823995,168268,-,-
BAC60_M08,2,2q33.1,197679792,197813343,133551,-,-
BAC40_N14,2,2q33.1,197753874,197851209,97335,-,-
BAC59_D07,2,2q33.1,197775560,197969824,194264,-,-
BAC80_E09,2,2q33.1,197824061,197947736,123675,-,-
BAC30_C21,2,2q33.1,197834595,197931678,97083,-,-
BAC162_E23,2,2q33.1,197856775,197931683,74908,-,-
BAC145_H14,2,2q33.1,197858761,197931683,72922,-,-
BAC176_N04,2,2q33.1,197890913,197980895,89982,-,-
BAC69_O09,2,2q33.1,197941843,198045397,103554,-,-
BAC18_N05,2,2q33.1,198045448,198183721,138273,-,-
BAC190_J21,2,2q33.1,198052628,198125125,72497,-,-
BAC230_J07,2,2q33.1,198078061,198168554,90493,-,-
BAC125_E02,2,2q33.1,198086369,198203819,117450,-,-
BAC25_G08,2,2q33.1,198086384,198233206,146822,-,-
BAC5_H22,2,2q33.1,198308181,198429027,120846,-,-
BAC75_J02,2,2q33.1,198445753,198543682,97929,-,-
BAC1_K08,2,2q33.1,198475828,198583089,107261,-,-
BAC58_I19,2,2q33.1,198476018,198564659,88641,-,-
BAC166_M07,2,2q33.1,198483895,198556091,72196,-,-
BAC54_A01,2,2q33.1,198483943,198575658,91715,-,-
BAC240_G17,2,2q33.1,198556219,198653441,97222,-,-
BAC169_I18,2,2q33.1,198595826,198672634,76808,-,-
BAC32_F14,2,2q33.1,198693169,198795543,102374,-,-
BAC162_F04,2,2q33.1,198718698,198795543,76845,-,-
BAC93_D13,2,2q33.1,198937581,199057355,119774,-,-
BAC233_H04,2,2q33.1,198962491,199032184,69693,-,-
BAC237_J15,2,2q33.1,199236477,199351621,115144,-,-
BAC222_O13,2,2q33.1,199419843,199512811,92968,-,-
BAC165_G13,2,2q33.1,199662619,199747920,85301,-,-
BAC112_N06,2,2q33.1,199747915,199845489,97574,-,-
BAC177_K03,2,2q33.1,199897389,199988222,90833,-,-
BAC39_M07,2,2q33.1,199897389,200006981,109592,-,-
BAC204_P17,2,2q33.1,199911497,200005681,94184,-,-
BAC75_E04,2,2q33.1,199913808,199996997,83189,-,-
BAC163_F06,2,2q33.1,199921579,199996997,75418,-,-
BAC89_F10,2,2q33.1,199956670,200035167,78497,-,-
BAC184_C21,2,2q33.1,199968703,200077905,109202,-,-
BAC72_E02,2,2q33.1,199988244,200074440,86196,-,-
BAC144_B08,2,2q33.1,199996990,200077906,80916,-,-
BAC36_D15,2,2q33.1,200006976,200135431,128455,-,-
BAC57_A17,2,2q33.1,200023079,200156982,133903,-,-
BAC100_H10,2,2q33.1,200028292,200129138,100846,-,-
BAC178_P15,2,2q33.1,200062875,200144450,81575,-,-
BAC57_G01,2,2q33.1,200183199,200296726,113527,-,-
BAC196_C07,2,2q33.1,200309122,200392990,83868,-,-
BAC195_B20,2,2q33.1,200327270,200450008,122738,-,-
BAC221_D09,2,2q33.1,200419352,200511458,92106,-,-
BAC41_N24,2,2q33.1,200419374,200511464,92090,-,-
BAC157_F15,2,2q33.1,200480703,200569184,88481,-,-
BAC184_L15,2,2q33.1,200572570,200656137,83567,-,-
BAC1_L20,2,2q33.1,200612019,200727497,115478,-,-
BAC128_J11,2,2q33.1,200626214,200727497,101283,-,-
BAC224_P24,2,2q33.1,200694855,200777660,82805,-,-
BAC60_K20,2,2q33.1,200855681,200939787,84106,-,-
BAC95_A07,2,2q33.1,200882088,200966789,84701,-,-
BAC237_F01,2,2q33.1,200978899,201066040,87141,-,-
BAC132_P23,2,2q33.1,201195167,201277114,81947,-,-
BAC79_L07,2,2q33.1,201312476,201441045,128569,-,-
BAC96_F18,2,2q33.1,201370665,201557498,186833,-,-
BAC70_C15,2,2q33.1,201376623,201465823,89200,-,-
BAC151_P18,2,2q33.1,201391413,201486284,94871,-,-
BAC119_C24,2,2q33.1,201454701,201596642,141941,-,-
BAC25_K14,2,2q33.1,201465822,201551059,85237,-,-
BAC81_G03,2,2q33.1,201695671,201792363,96692,-,-
BAC75_K17,2,2q33.1,201699836,201850206,150370,-,-
BAC53_D07,2,2q33.1,201729045,201823093,94048,-,-
BAC230_K23,2,2q33.1,201749259,201860341,111082,-,-
BAC18_D09,2,2q33.1,201872227,201995017,122790,-,-
BAC73_P04,2,2q33.1,201922634,202016129,93495,-,-
BAC191_G22,2,2q33.1,202034639,202114499,79860,-,-
BAC36_E15,2,2q33.1,202151793,202263451,111658,-,-
BAC236_E05,2,2q33.1,202189335,202255204,65869,-,-
BAC175_A06,2,2q33.1,202245975,202381746,135771,-,-
BAC217_M17,2,2q33.1,202387482,202489159,101677,-,-
BAC149_M21,2,2q33.1,202396235,202499259,103024,-,-
BAC225_P17,2,2q33.1,202426350,202506966,80616,-,-
BAC106_M13,2,2q33.1,202489153,202578250,89097,-,-
BAC219_H20,2,2q33.1,202507053,202658737,151684,-,-
BAC144_A15,2,2q33.1,202526081,202640026,113945,-,-
BAC238_H04,2,2q33.1,202526081,202626027,99946,-,-
BAC148_D01,2,2q33.1,202563423,202668554,105131,-,-
BAC1_H05,2,2q33.1,202563440,202718524,155084,-,-
BAC19_M20,2,2q33.1,202614742,202701231,86489,-,-
BAC115_L19,2,2q33.1,202640020,202718493,78473,-,-
BAC39_A17,2,2q33.1,202693542,202809860,116318,-,-
BAC34_E15,2,2q33.1,202703595,202776740,73145,-,-
BAC203_F22,2,2q33.1,202765255,202850658,85403,-,-
BAC91_C15,2,2q33.1,202777063,202850272,73209,-,-
BAC184_J18,2,2q33.1,202778172,202872339,94167,-,-
BAC1_A16,2,2q33.1,202850988,202972238,121250,-,-
BAC77_H12,2,2q33.1,202895566,202994609,99043,-,-
BAC184_I11,2,2q33.1,202968607,203071891,103284,-,-
BAC40_J12,2,2q33.1,202968937,203143089,174152,-,-
BAC124_P02,2,2q33.1,203009520,203102567,93047,-,-
BAC243_M13,2,2q33.1,203021931,203133452,111521,-,-
BAC135_H06,2,2q33.1,203127778,203204919,77141,-,-
BAC134_C17,2,2q33.1,203133876,203219977,86101,-,-
BAC237_P16,2,2q33.1,203143302,203229269,85967,-,-
BAC3_D24,2,2q33.1,203168857,203323897,155040,-,-
BAC12_H21,2,2q33.1,203238216,203337029,98813,-,-
BAC21_I21,2,2q33.1,203345761,203459992,114231,-,-
BAC76_M22,2,2q33.1,203370132,203459992,89860,-,-
BAC48_P17,2,2q33.1-2q33.2,203467836,203582185,114349,-,-
BAC197_B05,2,2q33.2,203507125,203604263,97138,-,-
BAC235_J22,2,2q33.2,203590732,203684715,93983,-,-
BAC199_I18,2,2q33.2,203590732,203666812,76080,-,-
BAC146_N17,2,2q33.2,203618868,203702443,83575,-,-
BAC169_F10,2,2q33.2,203669163,203795749,126586,-,-
BAC51_P02,2,2q33.2,203716231,203795749,79518,-,-
BAC42_M07,2,2q33.2,203756736,203846916,90180,-,-
BAC49_B05,2,2q33.2,203789802,203950311,160509,-,-
BAC152_P15,2,2q33.2,203795743,203887133,91390,-,-
BAC150_B14,2,2q33.2,203847172,203917088,69916,-,-
BAC52_F12,2,2q33.2,203847172,203964788,117616,-,-
BAC155_D01,2,2q33.2,203847172,203950967,103795,-,-
BAC24_O05,2,2q33.2,203855023,203917124,62101,-,-
BAC229_C10,2,2q33.2,203870158,203950317,80159,-,-
BAC100_A22,2,2q33.2,203887629,203990507,102878,-,-
BAC100_M14,2,2q33.2,203887631,203979314,91683,-,-
BAC247_K06,2,2q33.2,203950327,204043733,93406,-,-
BAC128_I11,2,2q33.2,203980484,204064558,84074,-,-
BAC159_O01,2,2q33.2,203990590,204087933,97343,-,-
BAC24_C01,2,2q33.2,204064555,204165552,100997,-,-
BAC250_G21,2,2q33.2,204103480,204159906,56426,-,-
BAC61_O15,2,2q33.2,204125009,204227315,102306,-,-
BAC196_B06,2,2q33.2,204127106,204227319,100213,-,-
BAC4_F24,2,2q33.2,204152764,204250658,97894,-,-
BAC14_M16,2,2q33.2,204152764,204245346,92582,-,-
BAC236_A22,2,2q33.2,204250967,204347576,96609,-,-
BAC81_I14,2,2q33.2,204275989,204376812,100823,-,-
BAC235_A13,2,2q33.2,204376805,204462835,86030,-,-
BAC29_B13,2,2q33.2,204493237,204595752,102515,-,-
BAC177_E21,2,2q33.2,204505990,204610934,104944,-,-
BAC40_B09,2,2q33.2,204595746,204680602,84856,-,-
BAC25_K10,2,2q33.2,204610531,204764797,154266,-,-
BAC195_P02,2,2q33.2,204635342,204740068,104726,-,-
BAC185_C03,2,2q33.2,204671044,204747971,76927,-,-
BAC76_N18,2,2q33.2,204761817,204835683,73866,-,-
BAC122_H12,2,2q33.2,204811415,204903671,92256,-,-
BAC139_B09,2,2q33.2,204825163,204948176,123013,-,-
BAC78_P03,2,2q33.2,204849188,204984004,134816,-,-
BAC210_M05,2,2q33.2,204856875,204991009,134134,-,-
BAC151_D04,2,2q33.2,204896447,204991095,94648,-,-
BAC83_B09,2,2q33.2,204896447,204995485,99038,-,-
BAC148_A07,2,2q33.2,205044961,205120757,75796,-,-
BAC232_F09,2,2q33.2,205455689,205566421,110732,-,-
BAC96_A05,2,2q33.2-2q33.3,205505217,205619934,114717,-,-
BAC80_L13,2,2q33.2-2q33.3,205518413,205641950,123537,-,-
BAC128_A21,2,2q33.3,205696707,205793558,96851,-,-
BAC150_F06,2,2q33.3,205791383,205883688,92305,-,-
BAC181_H05,2,2q33.3,205978559,206056541,77982,-,-
BAC171_I08,2,2q33.3,206123455,206240511,117056,-,-
BAC11_G01,2,2q33.3,206135543,206214318,78775,-,-
BAC190_F07,2,2q33.3,206194206,206284818,90612,-,-
BAC36_B22,2,2q33.3,206275358,206360674,85316,-,-
BAC124_K11,2,2q33.3,206357288,206465271,107983,-,-
BAC130_D02,2,2q33.3,206399229,206478274,79045,-,-
BAC60_G05,2,2q33.3,206445124,206538483,93359,-,-
BAC204_J05,2,2q33.3,206465265,206557656,92391,-,-
BAC132_J10,2,2q33.3,206491589,206601167,109578,-,-
BAC42_M19,2,2q33.3,206612894,206692218,79324,-,-
BAC246_I01,2,2q33.3,206618145,206718641,100496,-,-
BAC137_H10,2,2q33.3,206678673,206766571,87898,-,-
BAC155_F20,2,2q33.3,206697149,206763553,66404,-,-
BAC219_L05,2,2q33.3,206697156,206755200,58044,-,-
BAC61_M24,2,2q33.3,206697172,206805805,108633,-,-
BAC191_K01,2,2q33.3,206755227,206884110,128883,-,-
BAC30_J18,2,2q33.3,206790749,206886435,95686,-,-
BAC205_C10,2,2q33.3,206809758,206895049,85291,-,-
BAC117_O17,2,2q33.3,206809784,206900674,90890,-,-
BAC233_K10,2,2q33.3,206819779,206908929,89150,-,-
BAC66_K11,2,2q33.3,206834976,206925394,90418,-,-
BAC175_L20,2,2q33.3,206855061,206951724,96663,-,-
BAC161_L03,2,2q33.3,206916971,207013676,96705,-,-
BAC106_A14,2,2q33.3,207037236,207127108,89872,-,-
BAC70_D01,2,2q33.3,207218026,207337789,119763,-,-
BAC200_O01,2,2q33.3,207540037,207660616,120579,-,-
BAC83_H14,2,2q33.3,207720966,207812244,91278,-,-
BAC238_N10,2,2q33.3,207742994,207848951,105957,-,-
BAC56_O13,2,2q33.3,207834436,207962209,127773,-,-
BAC84_P12,2,2q33.3,208033982,208147299,113317,-,-
BAC96_N20,2,2q33.3,208052707,208176510,123803,-,-
BAC192_J13,2,2q33.3,208136450,208215348,78898,-,-
BAC250_B20,2,2q33.3,208252477,208336841,84364,-,-
BAC139_I05,2,2q33.3,208327779,208388711,60932,-,-
BAC154_F12,2,2q33.3,208336889,208441236,104347,-,-
BAC135_P14,2,2q33.3,208349886,208468523,118637,-,-
BAC72_N12,2,2q33.3,208385951,208495371,109420,-,-
BAC59_K23,2,2q33.3,208388967,208493622,104655,-,-
BAC230_O06,2,2q33.3,208441256,208517644,76388,-,-
BAC31_F22,2,2q33.3,208442623,208534846,92223,-,-
BAC177_P21,2,2q33.3,208458586,208573934,115348,-,-
BAC161_A20,2,2q33.3,208460691,208550262,89571,-,-
BAC211_M09,2,2q33.3,208638788,208728326,89538,-,-
BAC225_D17,2,2q33.3,208675730,208743694,67964,-,-
BAC175_N24,2,2q33.3,208678640,208764007,85367,-,-
BAC60_B12,2,2q33.3,208780866,208954358,173492,-,-
BAC186_F13,2,2q33.3,208788722,208908897,120175,-,-
BAC88_E21,2,2q33.3,208817194,208917644,100450,-,-
BAC143_I17,2,2q33.3,208830369,208920284,89915,-,-
BAC65_E18,2,2q33.3,208875560,209013675,138115,-,-
BAC171_L04,2,2q33.3,208979957,209086068,106111,-,-
BAC68_G14,2,2q33.3,209013697,209097874,84177,-,-
BAC201_I09,2,2q33.3-2q34,209013793,209103560,89767,-,-
BAC197_I05,2,2q34,209306046,209395763,89717,-,-
BAC59_O23,2,2q34,209559519,209670339,110820,-,-
BAC58_C16,2,2q34,209632349,209725911,93562,-,-
BAC118_L06,2,2q34,210062044,210160231,98187,-,-
BAC51_G24,2,2q34,210227965,210321502,93537,-,-
BAC228_D06,2,2q34,210402585,210474897,72312,-,-
BAC59_O17,2,2q34,210407147,210507694,100547,-,-
BAC92_B08,2,2q34,210416229,210496953,80724,-,-
BAC198_P06,2,2q34,210677891,210755069,77178,-,-
BAC52_M13,2,2q34,210731686,210851550,119864,-,-
BAC53_J20,2,2q34,210791698,210876628,84930,-,-
BAC142_B20,2,2q34,210983784,211064918,81134,-,-
BAC153_I16,2,2q34,211011542,211100941,89399,-,-
BAC169_F14,2,2q34,211053779,211138906,85127,-,-
BAC237_E20,2,2q34,211172249,211264689,92440,-,-
BAC148_D05,2,2q34,211298282,211465149,166867,-,-
BAC76_B22,2,2q34,211327647,211440516,112869,-,-
BAC25_J17,2,2q34,211578045,211687042,108997,-,-
BAC46_K19,2,2q34,211716802,211845654,128852,-,-
BAC148_I03,2,2q34,211766125,211895700,129575,-,-
BAC160_P04,2,2q34,211781952,211884454,102502,-,-
BAC227_M24,2,2q34,211788763,211869768,81005,-,-
BAC195_B11,2,2q34,212013073,212118607,105534,-,-
BAC199_B18,2,2q34,212039333,212118119,78786,-,-
BAC56_B16,2,2q34,212086562,212200326,113764,-,-
BAC149_B21,2,2q34,212118601,212216504,97903,-,-
BAC82_K11,2,2q34,212217841,212344394,126553,-,-
BAC91_K23,2,2q34,212243098,212384792,141694,-,-
BAC231_H13,2,2q34,212319325,212431088,111763,-,-
BAC42_M08,2,2q34,212334820,212420512,85692,-,-
BAC5_J08,2,2q34,212355200,212417509,62309,-,-
BAC32_P02,2,2q34,212431386,212514115,82729,-,-
BAC59_I06,2,2q34,212512525,212623906,111381,-,-
BAC32_P19,2,2q34,212516246,212609821,93575,-,-
BAC40_D10,2,2q34,212671237,212788609,117372,-,-
BAC197_K20,2,2q34,213179476,213268428,88952,-,-
BAC247_H18,2,2q34,213329540,213412329,82789,-,-
BAC156_K09,2,2q34,213472534,213593503,120969,-,-
BAC30_N17,2,2q34,213518289,213630959,112670,-,-
BAC222_A14,2,2q34,213662063,213749024,86961,-,-
BAC171_A06,2,2q34,213761571,213862107,100536,-,-
BAC79_D19,2,2q34,213767981,213913220,145239,-,-
BAC125_F17,2,2q34,213922237,213998620,76383,-,-
BAC65_P17,2,2q34,214159818,214244155,84337,-,-
BAC177_F18,2,2q34,214264737,214317172,52435,-,-
BAC177_L08,2,2q34,214264737,214317172,52435,-,-
BAC162_M05,2,2q34,214294851,214380764,85913,-,-
BAC180_O11,2,2q34,214317424,214415144,97720,-,-
BAC199_I16,2,2q34,214394230,214518120,123890,-,-
BAC63_M02,2,2q34,214408136,214494764,86628,-,-
BAC167_N22,2,2q34,214409057,214545946,136889,-,-
BAC236_J21,2,2q34,214505404,214592721,87317,-,-
BAC188_D06,2,2q34,214505591,214615993,110402,-,-
BAC241_K10,2,2q34,214515559,214592649,77090,-,-
BAC142_I11,2,2q34,214674182,214751820,77638,-,-
BAC103_K09,2,2q34,214816312,214933357,117045,-,-
BAC83_H01,2,2q34,214992101,215094110,102009,-,-
BAC179_G21,2,2q34,215007279,215094135,86856,-,-
BAC84_H01,2,2q34-2q35,215063827,215164809,100982,-,-
BAC15_B16,2,2q34-2q35,215089367,215210873,121506,-,-
BAC242_G05,2,2q35,215125539,215211952,86413,-,-
BAC37_K14,2,2q35,215165184,215283890,118706,-,-
BAC195_L17,2,2q35,215260430,215352829,92399,-,-
BAC189_L05,2,2q35,215271018,215387289,116271,-,-
BAC230_C05,2,2q35,215354499,215443093,88594,-,-
BAC154_H01,2,2q35,215432637,215526744,94107,-,-
BAC39_H18,2,2q35,215560215,215636949,76734,-,-
BAC42_I04,2,2q35,215560215,215677163,116948,-,-
BAC125_J13,2,2q35,215595472,215755466,159994,-,-
BAC19_H07,2,2q35,215624198,215731658,107460,-,-
BAC128_N21,2,2q35,215677157,215775437,98280,-,-
BAC66_B01,2,2q35,215730482,215879480,148998,-,-
BAC147_P17,2,2q35,215812007,215928092,116085,-,-
BAC163_F16,2,2q35,215812010,215899916,87906,-,-
BAC26_P21,2,2q35,215827316,215899936,72620,-,-
BAC215_C19,2,2q35,215838436,215950399,111963,-,-
BAC140_N08,2,2q35,215861113,215939411,78298,-,-
BAC168_O13,2,2q35,215879477,215950430,70953,-,-
BAC21_A02,2,2q35,215950959,216044825,93866,-,-
BAC43_C14,2,2q35,215950959,216046784,95825,-,-
BAC219_G23,2,2q35,216044875,216142080,97205,-,-
BAC85_B07,2,2q35,216044878,216159701,114823,-,-
BAC69_P05,2,2q35,216052710,216142067,89357,-,-
BAC148_E13,2,2q35,216061440,216087432,25992,-,-
BAC34_F20,2,2q35,216146334,216185836,39502,-,-
BAC23_H06,2,2q35,216211585,216309449,97864,-,-
BAC243_M03,2,2q35,216345206,216447990,102784,-,-
BAC78_O22,2,2q35,216348123,216449355,101232,-,-
BAC228_I04,2,2q35,216384905,216491320,106415,-,-
BAC123_F02,2,2q35,216384942,216498691,113749,-,-
BAC170_F21,2,2q35,216387804,216468818,81014,-,-
BAC101_E15,2,2q35,216449968,216552120,102152,-,-
BAC40_J15,2,2q35,216548615,216660641,112026,-,-
BAC236_B08,2,2q35,216574548,216695535,120987,-,-
BAC57_N09,2,2q35,216605890,216694041,88151,-,-
BAC34_O03,2,2q35,216660635,216780636,120001,-,-
BAC177_L05,2,2q35,216780643,216896155,115512,-,-
BAC63_B03,2,2q35,216919629,217021614,101985,-,-
BAC218_J20,2,2q35,216932347,217012292,79945,-,-
BAC229_N01,2,2q35,216932457,217026837,94380,-,-
BAC50_L23,2,2q35,216987540,217123789,136249,-,-
BAC51_H17,2,2q35,216989161,217099453,110292,-,-
BAC186_M01,2,2q35,216989163,217082887,93724,-,-
BAC200_C23,2,2q35,217021819,217114943,93124,-,-
BAC22_B03,2,2q35,217031439,217124904,93465,-,-
BAC186_J09,2,2q35,217170139,217281879,111740,-,-
BAC223_M22,2,2q35,217202600,217299466,96866,-,-
BAC76_E13,2,2q35,217292160,217421360,129200,-,-
BAC57_E03,2,2q35,217301738,217461616,159878,-,-
BAC179_C12,2,2q35,217316797,217421360,104563,-,-
BAC175_C13,2,2q35,217330186,217450457,120271,-,-
BAC110_G02,2,2q35,217349096,217447911,98815,-,-
BAC65_H20,2,2q35,217363623,217456526,92903,-,-
BAC190_D15,2,2q35,217376385,217486566,110181,-,-
BAC79_D20,2,2q35,217472697,217556800,84103,-,-
BAC55_N16,2,2q35,217529958,217645520,115562,-,-
BAC230_O22,2,2q35,217532119,217643649,111530,-,-
BAC66_I20,2,2q35,217536860,217657781,120921,-,-
BAC162_N11,2,2q35,217801673,217896542,94869,-,-
BAC110_P14,2,2q35,217805212,217931148,125936,-,-
BAC60_C14,2,2q35,217840133,217958399,118266,-,-
BAC46_H16,2,2q35,217846012,217927569,81557,-,-
BAC102_N23,2,2q35,217953985,218082468,128483,-,-
BAC161_H17,2,2q35,218051068,218130991,79923,-,-
BAC144_L23,2,2q35,218067192,218165701,98509,-,-
BAC224_B05,2,2q35,218084587,218273647,189060,-,-
BAC188_B16,2,2q35,218165888,218264271,98383,-,-
BAC91_G19,2,2q35,218194766,218305228,110462,-,-
BAC237_B19,2,2q35,218274112,218345339,71227,-,-
BAC181_J10,2,2q35,218510088,218615367,105279,-,-
BAC36_D09,2,2q35,218528436,218652367,123931,-,-
BAC32_D10,2,2q35,218528446,218631061,102615,-,-
BAC132_O05,2,2q35,218557289,218647150,89861,-,-
BAC191_P08,2,2q35,218699827,218802624,102797,-,-
BAC90_B14,2,2q35,218701827,218799308,97481,-,-
BAC224_D21,2,2q35,218802845,218897396,94551,-,-
BAC192_I14,2,2q35,218827787,218897398,69611,-,-
BAC168_B16,2,2q35,218839752,218977026,137274,-,-
BAC236_H21,2,2q35,218869368,218977026,107658,-,-
BAC78_M08,2,2q35,218869368,219080107,210739,-,-
BAC160_J06,2,2q35,218880568,218996361,115793,-,-
BAC218_B18,2,2q35,218920300,219010968,90668,-,-
BAC103_J07,2,2q35,218924259,219039341,115082,-,-
BAC1_D06,2,2q35,218924294,219080107,155813,-,-
BAC227_F18,2,2q35,218929699,219031541,101842,-,-
BAC233_D08,2,2q35,218929699,219016691,86992,-,-
BAC63_C18,2,2q35,218929701,219031541,101840,-,-
BAC204_A09,2,2q35,218929919,219049113,119194,-,-
BAC238_H23,2,2q35,218965054,219080199,115145,-,-
BAC64_C19,2,2q35,219001251,219108318,107067,-,-
BAC187_N22,2,2q35,219001283,219106934,105651,-,-
BAC171_I21,2,2q35,219016950,219097429,80479,-,-
BAC157_A23,2,2q35,219016950,219108332,91382,-,-
BAC221_D01,2,2q35,219023074,219108332,85258,-,-
BAC65_I14,2,2q35,219042047,219164297,122250,-,-
BAC64_A12,2,2q35,219067491,219165400,97909,-,-
BAC83_J14,2,2q35,219110146,219213407,103261,-,-
BAC58_J09,2,2q35,219247120,219342000,94880,-,-
BAC149_G08,2,2q35,219248545,219373984,125439,-,-
BAC165_K13,2,2q35,219276020,219368230,92210,-,-
BAC167_E24,2,2q35,219365117,219464132,99015,-,-
BAC57_M03,2,2q35,219407637,219530365,122728,-,-
BAC147_C22,2,2q35,219447450,219528249,80799,-,-
BAC192_M17,2,2q35,219476882,219548619,71737,-,-
BAC244_G18,2,2q35,219513479,219621027,107548,-,-
BAC133_B18,2,2q35,219529093,219621027,91934,-,-
BAC140_E18,2,2q35,219529120,219625802,96682,-,-
BAC196_H06,2,2q35,219626921,219756126,129205,-,-
BAC196_G06,2,2q35,219626921,219756126,129205,-,-
BAC145_N16,2,2q35,219631498,219712472,80974,-,-
BAC80_N07,2,2q35,219668232,219785940,117708,-,-
BAC134_N09,2,2q35,219721096,219822516,101420,-,-
BAC154_L10,2,2q35,219805238,219909360,104122,-,-
BAC26_L11,2,2q35,219815298,219917622,102324,-,-
BAC57_M02,2,2q35,219842104,219966242,124138,-,-
BAC53_L08,2,2q35,219966264,220157125,190861,-,-
BAC196_C15,2,2q35,220041077,220162144,121067,-,-
BAC232_M13,2,2q35,220107797,220241353,133556,-,-
BAC234_F12,2,2q35,220126563,220234826,108263,-,-
BAC219_D02,2,2q35,220239283,220321960,82677,-,-
BAC151_I08,2,2q35,220278289,220344417,66128,-,-
BAC39_D09,2,2q35,220278313,220363167,84854,-,-
BAC95_B18,2,2q35,220302141,220409677,107536,-,-
BAC101_P10,2,2q35,220310927,220429730,118803,-,-
BAC84_H04,2,2q35,220321953,220413856,91903,-,-
BAC64_J06,2,2q35,220368964,220542198,173234,-,-
BAC48_H12,2,2q35,220429734,220508433,78699,-,-
BAC156_J02,2,2q35,220492976,220566208,73232,-,-
BAC74_D12,2,2q35,220588301,220695891,107590,-,-
BAC55_C10,2,2q35,220598614,220797373,198759,-,-
BAC64_B02,2,2q35,220612691,220766179,153488,-,-
BAC252_K04,2,2q35,220648740,220725493,76753,-,-
BAC169_H06,2,2q35,220678791,220766410,87619,-,-
BAC64_N24,2,2q35,220678791,220795187,116396,-,-
BAC192_F11,2,2q35,220683730,220774993,91263,-,-
BAC24_P08,2,2q35,220684616,220795187,110571,-,-
BAC97_A24,2,2q35,220725487,220836551,111064,-,-
BAC107_I08,2,2q35,221092589,221197911,105322,-,-
BAC175_D13,2,2q35,221122834,221197193,74359,-,-
BAC59_F19,2,2q35-2q36.1,221248221,221337024,88803,-,-
BAC116_D05,2,2q35-2q36.1,221276164,221378991,102827,-,-
BAC88_G02,2,2q36.1,221495060,221650520,155460,-,-
BAC81_I03,2,2q36.1,221589382,221678041,88659,-,-
BAC133_B02,2,2q36.1,221620216,221709113,88897,-,-
BAC250_A15,2,2q36.1,221647183,221726090,78907,-,-
BAC168_D22,2,2q36.1,221709203,221785645,76442,-,-
BAC117_H23,2,2q36.1,221718960,221806299,87339,-,-
BAC230_G15,2,2q36.1,221769108,221884547,115439,-,-
BAC24_E12,2,2q36.1,221776970,221910489,133519,-,-
BAC25_P05,2,2q36.1,221861323,221979355,118032,-,-
BAC172_I05,2,2q36.1,221916650,222001357,84707,-,-
BAC145_F23,2,2q36.1,222017335,222116404,99069,-,-
BAC81_J22,2,2q36.1,222116480,222278056,161576,-,-
BAC161_D01,2,2q36.1,222134429,222247930,113501,-,-
BAC247_D16,2,2q36.1,222142504,222235905,93401,-,-
BAC13_L06,2,2q36.1,222443289,222544032,100743,-,-
BAC133_O16,2,2q36.1,222450589,222637175,186586,-,-
BAC40_E06,2,2q36.1,222561180,222701324,140144,-,-
BAC156_L07,2,2q36.1,222591111,222683716,92605,-,-
BAC167_G15,2,2q36.1,222652983,222762849,109866,-,-
BAC197_K11,2,2q36.1,222671977,222761606,89629,-,-
BAC178_K01,2,2q36.1,222779807,222846670,66863,-,-
BAC33_F12,2,2q36.1,222847739,222923094,75355,-,-
BAC42_J09,2,2q36.1,222854510,222982034,127524,-,-
BAC159_J02,2,2q36.1,222905826,223007856,102030,-,-
BAC249_G18,2,2q36.1,222982275,223061705,79430,-,-
BAC168_O22,2,2q36.1,223101126,223176608,75482,-,-
BAC230_B15,2,2q36.1,223123514,223238947,115433,-,-
BAC53_B01,2,2q36.1,223216032,223316220,100188,-,-
BAC142_O03,2,2q36.1,223301516,223405457,103941,-,-
BAC234_E10,2,2q36.1,223316971,223393453,76482,-,-
BAC148_A10,2,2q36.1,223322553,223442183,119630,-,-
BAC116_P06,2,2q36.1,223393446,223495516,102070,-,-
BAC115_A17,2,2q36.1,223405454,223533189,127735,yes,-
BAC226_K01,2,2q36.1,223430553,223506555,76002,-,-
BAC57_J08,2,2q36.1,223465866,223587347,121481,-,-
BAC178_F16,2,2q36.1,223584100,223694888,110788,-,-
BAC240_H23,2,2q36.1,223760137,223871868,111731,-,-
BAC189_I20,2,2q36.1,223871862,223952165,80303,-,-
BAC10_A13,2,2q36.1,223888764,223990299,101535,-,-
BAC116_E18,2,2q36.1,223940407,224043079,102672,-,-
BAC89_J02,2,2q36.1,223981610,224066641,85031,-,-
BAC50_D08,2,2q36.1,224033443,224142431,108988,-,-
BAC189_M13,2,2q36.1,224033443,224140765,107322,-,-
BAC186_G02,2,2q36.1,224038324,224134495,96171,-,-
BAC64_M22,2,2q36.1,224053609,224184255,130646,-,-
BAC195_E03,2,2q36.1,224152259,224258687,106428,-,-
BAC182_N16,2,2q36.1,224184589,224303965,119376,-,-
BAC45_M09,2,2q36.1,224184598,224275989,91391,-,-
BAC33_H24,2,2q36.1,224276009,224436507,160498,-,-
BAC233_L13,2,2q36.1,224320577,224405636,85059,-,-
BAC68_G02,2,2q36.1,224355719,224464931,109212,-,-
BAC107_M16,2,2q36.1,224431527,224511003,79476,-,-
BAC75_P19,2,2q36.1,224436992,224576561,139569,-,-
BAC97_E08,2,2q36.1,224464998,224586947,121949,-,-
BAC160_G23,2,2q36.1,224470358,224567805,97447,-,-
BAC101_F20,2,2q36.1,224532532,224627694,95162,-,-
BAC22_F16,2,2q36.1,224532532,224620035,87503,-,-
BAC170_O22,2,2q36.1,224620099,224701979,81880,-,-
BAC191_B19,2,2q36.1,224659517,224742866,83349,-,-
BAC144_I15,2,2q36.1,224750713,224894232,143519,-,-
BAC238_L01,2,2q36.1,224750713,224873002,122289,-,-
BAC115_D08,2,2q36.1-2q36.2,224807081,224909404,102323,-,-
BAC39_M17,2,2q36.1-2q36.2,224808075,224938705,130630,-,-
BAC32_O20,2,2q36.1-2q36.2,224830578,224917176,86598,-,-
BAC183_B09,2,2q36.1-2q36.2,224850263,224933581,83318,-,-
BAC149_A05,2,2q36.1-2q36.2,224851707,224938709,87002,-,-
BAC236_B09,2,2q36.1-2q36.2,224867849,224952545,84696,-,-
BAC159_B12,2,2q36.1-2q36.2,224873010,224958505,85495,-,-
BAC189_E22,2,2q36.2,225143876,225237870,93994,-,-
BAC50_E16,2,2q36.2,225153179,225242648,89469,-,-
BAC106_N06,2,2q36.2,225156477,225242648,86171,-,-
BAC22_P20,2,2q36.2,225251455,225365880,114425,-,-
BAC59_H12,2,2q36.2,225278406,225361285,82879,-,-
BAC160_G20,2,2q36.2,225301043,225402319,101276,-,-
BAC162_E08,2,2q36.2,225361280,225433070,71790,-,-
BAC22_C13,2,2q36.2,225393109,225515012,121903,-,-
BAC31_A16,2,2q36.2,225522442,225605202,82760,-,-
BAC114_P19,2,2q36.2,225555293,225662817,107524,-,-
BAC224_N06,2,2q36.2,225594302,225691123,96821,-,-
BAC64_A15,2,2q36.2-2q36.3,225758497,225890523,132026,-,-
BAC39_D12,2,2q36.3,225871656,225949885,78229,-,-
BAC28_H16,2,2q36.3,226059182,226183975,124793,-,-
BAC78_B13,2,2q36.3,226059211,226195142,135931,-,-
BAC181_H20,2,2q36.3,226195133,226294823,99690,-,-
BAC67_L16,2,2q36.3,226209147,226294450,85303,-,-
BAC106_M09,2,2q36.3,226452207,226553931,101724,-,-
BAC105_A03,2,2q36.3,226815790,227020224,204434,-,-
BAC43_N20,2,2q36.3,226819157,226912566,93409,-,-
BAC188_H16,2,2q36.3,226830933,226921583,90650,-,-
BAC143_N18,2,2q36.3,226880945,226968554,87609,-,-
BAC26_F17,2,2q36.3,227152879,227276609,123730,-,-
BAC116_J09,2,2q36.3,227152881,227276609,123728,-,-
BAC149_B09,2,2q36.3,227197981,227286517,88536,-,-
BAC46_N08,2,2q36.3,227209353,227276609,67256,-,-
BAC228_P12,2,2q36.3,227330165,227416085,85920,-,-
BAC190_N15,2,2q36.3,227498957,227590532,91575,-,-
BAC248_C07,2,2q36.3,227535716,227630028,94312,-,-
BAC77_B03,2,2q36.3,227576851,227668422,91571,-,-
BAC80_L18,2,2q36.3,227668417,227795082,126665,-,-
BAC50_J17,2,2q36.3,227714786,227821516,106730,-,-
BAC249_N04,2,2q36.3,227722500,227795082,72582,-,-
BAC184_A19,2,2q36.3,227733204,227846148,112944,-,-
BAC10_H21,2,2q36.3,227779695,227902723,123028,-,-
BAC11_P05,2,2q36.3,227817031,227907338,90307,-,-
BAC203_O10,2,2q36.3,227821748,227906897,85149,-,-
BAC195_I06,2,2q36.3,227821772,227932448,110676,-,-
BAC65_P14,2,2q36.3,227837944,227849232,11288,-,-
BAC23_C24,2,2q36.3,227869632,227993658,124026,-,-
BAC61_H08,2,2q36.3,227907332,228051601,144269,-,-
BAC209_C15,2,2q36.3,228006505,228081318,74813,-,-
BAC105_N11,2,2q36.3,228008053,228100748,92695,-,-
BAC152_M24,2,2q36.3,228031459,228138317,106858,-,-
BAC41_H24,2,2q36.3,228100755,228186344,85589,-,-
BAC228_M06,2,2q36.3,228118219,228198966,80747,-,-
BAC183_F12,2,2q36.3,228262003,228353975,91972,-,-
BAC125_J04,2,2q36.3,228262003,228354645,92642,-,-
BAC196_G09,2,2q36.3,228275680,228353975,78295,-,-
BAC7_C23,2,2q36.3,228296260,228394282,98022,yes,-
BAC160_F20,2,2q36.3,228371738,228460446,88708,-,-
BAC234_I21,2,2q36.3,228423294,228520904,97610,-,-
BAC67_E07,2,2q36.3,228452488,228527961,75473,-,-
BAC230_O12,2,2q36.3,228456676,228553785,97109,-,-
BAC31_O11,2,2q36.3,228458244,228564340,106096,-,-
BAC38_N06,2,2q36.3,228473171,228579186,106015,-,-
BAC226_F18,2,2q36.3,228631200,228714268,83068,-,-
BAC71_O18,2,2q36.3,228632957,228799456,166499,-,-
BAC92_H16,2,2q36.3,228853168,228924419,71251,-,-
BAC158_B20,2,2q36.3,228924417,229013075,88658,-,-
BAC137_D03,2,2q36.3,228995321,229097719,102398,-,-
BAC12_B13,2,2q36.3,229046706,229158440,111734,-,-
BAC132_N11,2,2q36.3,229050755,229133686,82931,-,-
BAC124_K01,2,2q36.3,229102123,229195814,93691,-,-
BAC174_M16,2,2q36.3,229133710,229227709,93999,-,-
BAC177_K11,2,2q36.3,229227764,229318715,90951,-,-
BAC26_F01,2,2q36.3,229249728,229355593,105865,-,-
BAC63_O10,2,2q36.3,229519339,229627226,107887,-,-
BAC55_K23,2,2q36.3,229558469,229659700,101231,-,-
BAC85_P07,2,2q36.3,229660655,229759387,98732,-,-
BAC161_A03,2,2q36.3,229690203,229772024,81821,-,-
BAC197_A18,2,2q36.3,229699339,229800532,101193,-,-
BAC226_N17,2,2q36.3,229824928,229916406,91478,-,-
BAC230_K18,2,2q36.3,229865590,229958622,93032,-,-
BAC26_H23,2,2q36.3,229871180,230004374,133194,-,-
BAC145_B11,2,2q36.3,229974765,230055523,80758,-,-
BAC5_J24,2,2q36.3,229990710,230072699,81989,-,-
BAC144_J03,2,2q36.3,230023281,230102152,78871,-,-
BAC199_C18,2,2q36.3,230023281,230106854,83573,-,-
BAC59_B16,2,2q36.3,230152227,230243956,91729,-,-
BAC252_K11,2,2q36.3,230272835,230366490,93655,-,-
BAC59_I09,2,2q36.3,230305406,230400700,95294,-,-
BAC226_O18,2,2q36.3,230406811,230492374,85563,-,-
BAC48_O05,2,2q36.3,230462108,230540711,78603,-,-
BAC161_P18,2,2q36.3,230502550,230602852,100302,-,-
BAC92_E11,2,2q36.3,230510643,230639306,128663,-,-
BAC147_H03,2,2q36.3,230529426,230615742,86316,-,-
BAC55_I01,2,2q36.3,230531718,230648545,116827,-,-
BAC106_F05,2,2q36.3,230585997,230671952,85955,-,-
BAC169_A17,2,2q36.3,230613609,230689866,76257,-,-
BAC192_O12,2,2q36.3-2q37.1,230648822,230736335,87513,-,-
BAC14_F23,2,2q36.3-2q37.1,230672021,230801602,129581,-,-
BAC162_L08,2,2q37.1,230740815,230825058,84243,-,-
BAC109_D05,2,2q37.1,230766813,230858896,92083,-,-
BAC233_L14,2,2q37.1,230769152,230884654,115502,-,-
BAC92_I07,2,2q37.1,230858915,230958342,99427,-,-
BAC208_N06,2,2q37.1,230882482,230950664,68182,-,-
BAC176_J08,2,2q37.1,230884648,230976499,91851,-,-
BAC30_N18,2,2q37.1,230887464,230974797,87333,-,-
BAC161_N09,2,2q37.1,230896001,230974853,78852,-,-
BAC179_J21,2,2q37.1,230899373,230974866,75493,-,-
BAC60_P16,2,2q37.1,231043949,231132883,88934,-,-
BAC78_A22,2,2q37.1,231099740,231215419,115679,-,-
BAC73_O05,2,2q37.1,231130310,231231161,100851,-,-
BAC215_F21,2,2q37.1,231215414,231292939,77525,-,-
BAC246_N07,2,2q37.1,231270915,231360982,90067,-,-
BAC70_K09,2,2q37.1,231288059,231385444,97385,-,-
BAC91_J15,2,2q37.1,231293044,231410543,117499,-,-
BAC103_A10,2,2q37.1,231328038,231421331,93293,-,-
BAC27_N08,2,2q37.1,231432158,231576108,143950,-,-
BAC150_E08,2,2q37.1,231451891,231540750,88859,-,-
BAC41_I09,2,2q37.1,231658117,231745104,86987,-,-
BAC56_D15,2,2q37.1,231669090,231791295,122205,-,-
BAC237_P19,2,2q37.1,231704164,231795765,91601,-,-
BAC132_A17,2,2q37.1,231707626,231822235,114609,-,-
BAC48_N14,2,2q37.1,231707675,231797409,89734,-,-
BAC70_F09,2,2q37.1,231717967,231812383,94416,-,-
BAC230_N02,2,2q37.1,231766332,231852339,86007,-,-
BAC25_L21,2,2q37.1,231767300,231899154,131854,-,-
BAC70_F04,2,2q37.1,231906787,232040691,133904,-,-
BAC219_N16,2,2q37.1,231976489,232077728,101239,-,-
BAC184_P09,2,2q37.1,232016848,232105633,88785,-,-
BAC150_P16,2,2q37.1,232041210,232131502,90292,-,-
BAC50_L14,2,2q37.1,232061677,232194824,133147,-,-
BAC248_E07,2,2q37.1,232061721,232159029,97308,-,-
BAC231_C03,2,2q37.1,232077720,232159026,81306,-,-
BAC19_N12,2,2q37.1,232077968,232166514,88546,-,-
BAC109_P13,2,2q37.1,232118623,232216477,97854,-,-
BAC230_D07,2,2q37.1,232131640,232266564,134924,-,-
BAC90_O03,2,2q37.1,232146408,232266564,120156,-,-
BAC130_F12,2,2q37.1,232159023,232245513,86490,-,-
BAC173_L07,2,2q37.1,232170365,232270109,99744,-,-
BAC151_C06,2,2q37.1,232245507,232336582,91075,yes,-
BAC43_E13,2,2q37.1,232376577,232456086,79509,-,-
BAC5_E17,2,2q37.1,232424508,232540833,116325,yes,-
BAC127_M18,2,2q37.1,232454701,232546653,91952,yes,-
BAC115_I04,2,2q37.1,232454709,232567495,112786,yes,-
BAC33_K03,2,2q37.1,232481086,232567354,86268,yes,-
BAC10_E21,2,2q37.1,232541137,232675283,134146,-,-
BAC211_P21,2,2q37.1,232636694,232734272,97578,-,-
BAC101_F04,2,2q37.1,232655733,232784678,128945,-,-
BAC118_J20,2,2q37.1,232671327,232767480,96153,-,-
BAC179_K04,2,2q37.1,232698981,232808890,109909,-,-
BAC221_M03,2,2q37.1,232699000,232783695,84695,-,-
BAC218_O19,2,2q37.1,232710861,232832040,121179,-,-
BAC61_K22,2,2q37.1,232752133,232784712,32579,-,-
BAC226_K12,2,2q37.1,232808884,232948117,139233,-,-
BAC31_H04,2,2q37.1,232832043,232931842,99799,-,-
BAC33_G12,2,2q37.1,232843168,232931842,88674,-,-
BAC247_N18,2,2q37.1,232872997,232988591,115594,yes,-
BAC123_I06,2,2q37.1,232948121,233049792,101671,yes,-
BAC105_G11,2,2q37.1,233056769,233156875,100106,-,-
BAC243_F21,2,2q37.1,233166051,233245337,79286,-,-
BAC194_D12,2,2q37.1,233166051,233245337,79286,-,-
BAC22_I21,2,2q37.1,233166056,233257569,91513,-,-
BAC75_N17,2,2q37.1,233176518,233277157,100639,-,-
BAC82_G12,2,2q37.1,233245776,233344807,99031,-,-
BAC226_F23,2,2q37.1,233310885,233399575,88690,-,-
BAC226_H07,2,2q37.1,233344805,233434646,89841,-,-
BAC248_D18,2,2q37.1,233423093,233509655,86562,-,-
BAC124_D02,2,2q37.1,233425744,233547904,122160,-,-
BAC168_I09,2,2q37.1,233435872,233538521,102649,-,-
BAC168_N18,2,2q37.1,233444313,233563329,119016,-,-
BAC161_H22,2,2q37.1,233444339,233563284,118945,-,-
BAC48_H11,2,2q37.1,233590526,233691390,100864,-,-
BAC141_C21,2,2q37.1,233792272,233910480,118208,-,-
BAC246_J10,2,2q37.1,233799288,233922762,123474,-,-
BAC86_K03,2,2q37.1,233812105,233952989,140884,-,-
BAC33_J01,2,2q37.1,233816714,233901615,84901,-,-
BAC131_J06,2,2q37.1,233816801,233922762,105961,-,-
BAC18_B07,2,2q37.1,233835112,233920388,85276,-,-
BAC141_G02,2,2q37.1,233856961,233952989,96028,-,-
BAC28_B05,2,2q37.1,233880175,233991748,111573,-,-
BAC183_F02,2,2q37.1,233902107,233957133,55026,-,-
BAC84_O10,2,2q37.1,233918674,234003107,84433,-,-
BAC96_K09,2,2q37.1,233953232,234054928,101696,-,-
BAC252_J22,2,2q37.1,233957135,234077570,120435,-,-
BAC67_F01,2,2q37.1,233996140,234120093,123953,-,-
BAC104_G11,2,2q37.1,234035562,234187799,152237,-,-
BAC88_I08,2,2q37.1,234098904,234237635,138731,-,-
BAC66_J22,2,2q37.1,234170250,234295088,124838,-,-
BAC125_H05,2,2q37.1,234187806,234311977,124171,-,-
BAC167_C24,2,2q37.1,234381698,234467401,85703,-,-
BAC165_G23,2,2q37.1,234390609,234474010,83401,-,-
BAC96_K07,2,2q37.1,234390609,234494806,104197,-,-
BAC188_P20,2,2q37.1,234394552,234474010,79458,-,-
BAC132_M03,2,2q37.1,234403250,234483698,80448,-,-
BAC127_J22,2,2q37.1,234505187,234596257,91070,-,-
BAC26_B03,2,2q37.1,234508426,234633394,124968,-,-
BAC146_N15,2,2q37.1,234517486,234582668,65182,-,-
BAC80_O18,2,2q37.1,234527501,234619689,92188,-,-
BAC151_O10,2,2q37.1,234669184,234772477,103293,-,-
BAC12_M12,2,2q37.1,234681241,234787925,106684,-,-
BAC189_A11,2,2q37.1,234682267,234772477,90210,-,-
BAC71_P03,2,2q37.1,234729191,234849979,120788,-,-
BAC200_H05,2,2q37.1,234762776,234827639,64863,-,-
BAC89_I06,2,2q37.1,234772469,234870603,98134,-,-
BAC22_J12,2,2q37.1,234772476,234870603,98127,-,-
BAC141_J12,2,2q37.1,234780423,234880959,100536,-,-
BAC168_C22,2,2q37.1,234788016,234880959,92943,-,-
BAC80_A08,2,2q37.1,234877025,234973207,96182,-,-
BAC136_E05,2,2q37.1,234880146,234973172,93026,-,-
BAC14_C01,2,2q37.1,234884902,234985521,100619,-,-
BAC232_D06,2,2q37.1,234899652,235009878,110226,-,-
BAC186_L15,2,2q37.1,234912513,235005161,92648,-,-
BAC143_O19,2,2q37.1,234919760,235024497,104737,-,-
BAC144_M01,2,2q37.1,234942102,235030320,88218,-,-
BAC65_A09,2,2q37.1,235170190,235263741,93551,-,-
BAC124_B12,2,2q37.1-2q37.2,235216381,235325101,108720,-,-
BAC72_M15,2,2q37.1-2q37.2,235298446,235384360,85914,-,-
BAC39_J06,2,2q37.2,235445100,235527255,82155,-,-
BAC100_L11,2,2q37.2,235499644,235637366,137722,-,-
BAC116_P20,2,2q37.2,235527250,235632683,105433,-,-
BAC171_M19,2,2q37.2,235531090,235632691,101601,-,-
BAC88_K20,2,2q37.2,235531135,235632693,101558,-,-
BAC101_N22,2,2q37.2,235610375,235730386,120011,-,-
BAC219_N13,2,2q37.2,235756208,235844686,88478,-,-
BAC88_C09,2,2q37.2,235757806,235888131,130325,-,-
BAC226_J19,2,2q37.2,235859841,235962545,102704,-,-
BAC208_D09,2,2q37.2,235890416,235984907,94491,-,-
BAC110_M16,2,2q37.2,235952147,236044757,92610,-,-
BAC240_C11,2,2q37.2,235962875,236025605,62730,-,-
BAC197_J17,2,2q37.2,236007073,236103364,96291,-,-
BAC2_C18,2,2q37.2,236048450,236156308,107858,-,-
BAC168_G19,2,2q37.2,236057842,236140465,82623,-,-
BAC27_H10,2,2q37.2,236103359,236220205,116846,-,-
BAC182_A04,2,2q37.2,236107970,236219350,111380,-,-
BAC243_M04,2,2q37.2,236110972,236220208,109236,-,-
BAC172_O05,2,2q37.2,236127408,236220210,92802,-,-
BAC196_I20,2,2q37.2,236137286,236222672,85386,-,-
BAC26_E15,2,2q37.2,236137317,236293302,155985,-,-
BAC136_M21,2,2q37.2,236137464,236224567,87103,-,-
BAC109_E16,2,2q37.2,236139017,236293655,154638,-,-
BAC218_L12,2,2q37.2,236140458,236225582,85124,-,-
BAC220_M08,2,2q37.2,236220202,236330239,110037,-,-
BAC40_D08,2,2q37.2,236224786,236318425,93639,-,-
BAC131_K10,2,2q37.2,236288811,236362962,74151,-,-
BAC229_P12,2,2q37.2,236396386,236494168,97782,-,-
BAC64_K20,2,2q37.2,236421439,236522999,101560,-,-
BAC163_L14,2,2q37.2,236490079,236568760,78681,-,-
BAC90_D23,2,2q37.2,236518502,236604578,86076,-,-
BAC26_H22,2,2q37.2,236519009,236654950,135941,-,-
BAC81_C16,2,2q37.2,236530022,236707539,177517,-,-
BAC106_M15,2,2q37.2,236545940,236647863,101923,-,-
BAC169_H08,2,2q37.2,236554873,236647865,92992,-,-
BAC145_L17,2,2q37.2,236562988,236647731,84743,-,-
BAC228_P20,2,2q37.2,236568924,236662011,93087,-,-
BAC44_N16,2,2q37.2,236595495,236607215,11720,-,-
BAC155_L07,2,2q37.2,236601473,236682298,80825,-,-
BAC76_H24,2,2q37.2,236622916,236728801,105885,-,-
BAC37_P16,2,2q37.2,236653493,236736616,83123,-,-
BAC8_L07,2,2q37.2,236662016,236736624,74608,-,-
BAC158_J02,2,2q37.2,236769109,236838270,69161,-,-
BAC231_F07,2,2q37.2,236843137,236947540,104403,-,-
BAC222_P04,2,2q37.2,236843137,236947517,104380,-,-
BAC131_I15,2,2q37.2,236862772,236939829,77057,-,-
BAC107_P12,2,2q37.2-2q37.3,236922678,237038291,115613,-,-
BAC51_J04,2,2q37.3,237013528,237109794,96266,-,-
BAC141_D09,2,2q37.3,237037756,237118561,80805,-,-
BAC196_K18,2,2q37.3,237038543,237120961,82418,-,-
BAC25_D02,2,2q37.3,237127281,237283220,155939,-,-
BAC106_I09,2,2q37.3,237139314,237256801,117487,-,-
BAC15_M19,2,2q37.3,237174591,237253051,78460,-,-
BAC86_C11,2,2q37.3,237215053,237320303,105250,-,-
BAC233_P24,2,2q37.3,237225033,237320270,95237,-,-
BAC14_E04,2,2q37.3,237231119,237316081,84962,-,-
BAC70_L07,2,2q37.3,237231119,237308443,77324,-,-
BAC10_O19,2,2q37.3,237273542,237367342,93800,-,-
BAC151_J17,2,2q37.3,237301681,237389973,88292,-,-
BAC188_F18,2,2q37.3,237320297,237399686,79389,-,-
BAC51_C10,2,2q37.3,237354933,237461953,107020,-,-
BAC162_D03,2,2q37.3,237354935,237442677,87742,-,-
BAC58_C08,2,2q37.3,237389968,237477121,87153,-,-
BAC159_K03,2,2q37.3,237516876,237656746,139870,-,-
BAC8_I16,2,2q37.3,237674651,237766726,92075,-,-
BAC67_H02,2,2q37.3,237753491,237893976,140485,-,-
BAC184_I14,2,2q37.3,237766729,237871911,105182,-,-
BAC8_J05,2,2q37.3,237803366,237889166,85800,-,-
BAC19_P23,2,2q37.3,237827664,237935181,107517,-,-
BAC192_P23,2,2q37.3,237827850,237921284,93434,-,-
BAC46_J10,2,2q37.3,237871915,237974311,102396,-,-
BAC134_E24,2,2q37.3,237887776,237986741,98965,-,-
BAC152_B16,2,2q37.3,237887995,238008710,120715,-,-
BAC156_G21,2,2q37.3,237927715,238035190,107475,-,-
BAC79_O21,2,2q37.3,237927715,238044645,116930,-,-
BAC165_O05,2,2q37.3,237962957,238067962,105005,-,-
BAC131_H16,2,2q37.3,238055249,238163455,108206,-,-
BAC151_E07,2,2q37.3,238067977,238174605,106628,-,-
BAC50_F12,2,2q37.3,238078369,238196765,118396,-,-
BAC135_G05,2,2q37.3,238237820,238290305,52485,-,-
BAC218_C09,2,2q37.3,238267454,238373832,106378,-,-
BAC172_M10,2,2q37.3,238305917,238421535,115618,-,-
BAC141_I21,2,2q37.3,238334475,238431088,96613,-,-
BAC167_I06,2,2q37.3,238458132,238562444,104312,-,-
BAC142_A23,2,2q37.3,238497607,238585950,88343,-,-
BAC175_I09,2,2q37.3,238504954,238601400,96446,-,-
BAC96_M19,2,2q37.3,238518190,238641554,123364,-,-
BAC22_G13,2,2q37.3,238541635,238649159,107524,-,-
BAC179_B14,2,2q37.3,238559881,238662922,103041,-,-
BAC110_H02,2,2q37.3,238568156,238642574,74418,-,-
BAC229_M13,2,2q37.3,238602824,238727814,124990,-,-
BAC120_B20,2,2q37.3,238602824,238718829,116005,-,-
BAC223_C01,2,2q37.3,238603345,238743064,139719,-,-
BAC249_D20,2,2q37.3,238620239,238715939,95700,-,-
BAC232_K23,2,2q37.3,238735699,238854717,119018,-,-
BAC226_C24,2,2q37.3,238772621,238860001,87380,-,-
BAC157_F02,2,2q37.3,238783417,238915840,132423,-,-
BAC33_K13,2,2q37.3,238783417,238858161,74744,-,-
BAC43_C02,2,2q37.3,238788368,238919863,131495,-,-
BAC222_A18,2,2q37.3,238798975,238882518,83543,-,-
BAC110_M11,2,2q37.3,238845349,238964886,119537,-,-
BAC81_A08,2,2q37.3,238845349,239077465,232116,-,-
BAC60_L16,2,2q37.3,238860003,238975530,115527,-,-
BAC27_K08,2,2q37.3,238960813,239056469,95656,-,-
BAC128_F24,2,2q37.3,238965036,239077179,112143,-,-
BAC126_M15,2,2q37.3,238975806,239088768,112962,-,-
BAC56_J01,2,2q37.3,239130570,239265639,135069,-,-
BAC165_I16,2,2q37.3,239140003,239226205,86202,-,-
BAC210_G04,2,2q37.3,239142876,239218102,75226,-,-
BAC146_A08,2,2q37.3,239218378,239306812,88434,-,-
BAC226_C05,2,2q37.3,239218394,239298082,79688,-,-
BAC60_H15,2,2q37.3,239226199,239329644,103445,-,-
BAC152_K10,2,2q37.3,239310734,239398858,88124,-,-
BAC235_F14,2,2q37.3,239507332,239618040,110708,-,-
BAC156_H19,2,2q37.3,239513272,239628601,115329,-,-
BAC152_C04,2,2q37.3,239600200,239741421,141221,-,-
BAC1_N06,2,2q37.3,239618034,239755457,137423,-,-
BAC242_J17,2,2q37.3,239670876,239755457,84581,-,-
BAC235_J21,2,2q37.3,239739880,239828230,88350,-,-
BAC134_M10,2,2q37.3,239781083,239877590,96507,-,-
BAC58_N05,2,2q37.3,239787199,239949453,162254,-,-
BAC84_E14,2,2q37.3,239793311,239892418,99107,-,-
BAC217_M19,2,2q37.3,239794618,239892418,97800,-,-
BAC68_A04,2,2q37.3,239808587,239921650,113063,-,-
BAC21_P10,2,2q37.3,239938783,240151371,212588,-,-
BAC84_K11,2,2q37.3,239949663,240152953,203290,-,-
BAC81_F23,2,2q37.3,240002392,240151371,148979,-,-
BAC57_D13,2,2q37.3,240003956,240109923,105967,-,-
BAC49_H03,2,2q37.3,240003959,240109916,105957,-,-
BAC71_D09,2,2q37.3,240006633,240151371,144738,-,-
BAC155_G10,2,2q37.3,240012133,240087010,74877,-,-
BAC33_C12,2,2q37.3,240026018,240129616,103598,-,-
BAC169_P01,2,2q37.3,240029403,240109922,80519,-,-
BAC198_B02,2,2q37.3,240032174,240109923,77749,-,-
BAC2_G06,2,2q37.3,240047932,240152953,105021,-,-
BAC103_E18,2,2q37.3,240052949,240188841,135892,-,-
BAC102_J11,2,2q37.3,240195335,240289216,93881,-,-
BAC54_F08,2,2q37.3,240197102,240296579,99477,-,-
BAC217_M10,2,2q37.3,240201600,240313148,111548,-,-
BAC57_F10,2,2q37.3,240509443,240609038,99595,-,-
BAC80_C12,2,2q37.3,240515325,240632984,117659,-,-
BAC181_G14,2,2q37.3,240550837,240713837,163000,-,-
BAC184_B09,2,2q37.3,240581506,240670568,89062,-,-
BAC18_K16,2,2q37.3,240585276,240676600,91324,-,-
BAC168_E01,2,2q37.3,240609033,240722910,113877,-,-
BAC161_M12,2,2q37.3,240614782,240713841,99059,-,-
BAC31_G19,2,2q37.3,240620478,240723562,103084,-,-
BAC161_D20,2,2q37.3,240632982,240727787,94805,-,-
BAC14_C17,2,2q37.3,240710686,240826750,116064,-,-
BAC237_O17,2,2q37.3,240798202,240960240,162038,-,-
BAC135_P13,2,2q37.3,240916735,241007808,91073,-,-
BAC79_F07,2,2q37.3,240956446,241110046,153600,-,-
BAC39_P19,2,2q37.3,241003197,241049722,46525,-,-
BAC117_O05,2,2q37.3,241011760,241105950,94190,-,-
BAC78_O10,2,2q37.3,241136242,241255113,118871,-,-
BAC195_J14,2,2q37.3,241149671,241235542,85871,-,-
BAC247_H02,2,2q37.3,241186989,241308196,121207,-,-
BAC172_B04,2,2q37.3,241210714,241295797,85083,-,-
BAC132_D21,2,2q37.3,241242607,241343559,100952,-,-
BAC36_I17,2,2q37.3,241279204,241519239,240035,-,-
BAC244_K12,2,2q37.3,241308189,241413955,105766,-,-
BAC44_H10,2,2q37.3,241308197,241392409,84212,-,-
BAC117_C14,2,2q37.3,241343576,241540377,196801,-,-
BAC217_C02,2,2q37.3,241428321,241540377,112056,-,-
BAC218_A08,2,2q37.3,241434551,241519244,84693,-,-
BAC190_I02,2,2q37.3,241536057,241632473,96416,-,-
BAC117_F21,2,2q37.3,241536057,241642065,106008,-,-
BAC61_L11,2,2q37.3,241540425,241681587,141162,-,-
BAC200_B24,2,2q37.3,241540425,241630455,90030,-,-
BAC144_P03,2,2q37.3,241543557,241659056,115499,-,-
BAC243_H20,2,2q37.3,241555637,241659056,103419,-,-
BAC96_E05,2,2q37.3,241555647,241642065,86418,-,-
BAC55_H04,2,2q37.3,241569967,241681564,111597,-,-
BAC86_B03,2,2q37.3,241659049,241796361,137312,-,-
BAC217_P21,2,2q37.3,241684215,241784236,100021,-,-
BAC36_P08,2,2q37.3,241687496,241784238,96742,-,-
BAC38_I11,2,2q37.3,241698752,241812979,114227,-,-
BAC142_M07,2,2q37.3,241706320,241816185,109865,-,-
BAC21_M12,2,2q37.3,241722413,241816182,93769,-,-
BAC34_D07,2,2q37.3,241726237,241850377,124140,-,-
BAC161_M23,2,2q37.3,241728872,241850377,121505,-,-
BAC225_N17,2,2q37.3,241761732,241850377,88645,-,-
BAC185_M22,2,2q37.3,241768613,241902420,133807,-,-
BAC190_H21,2,2q37.3,241784237,241868351,84114,-,-
BAC177_G19,2,2q37.3,241816212,241938574,122362,-,-
BAC9_P14,2,2q37.3,241820136,241935722,115586,-,-
BAC39_M12,2,2q37.3,241850555,242020924,170369,-,-
BAC172_L04,2,2q37.3,241883532,242013294,129762,-,-
BAC66_D17,2,2q37.3,241935714,242071243,135529,-,-
BAC80_H05,2,2q37.3,241956148,242047480,91332,-,-
BAC59_F20,2,2q37.3,241956965,242072317,115352,-,-
BAC178_J05,2,2q37.3,241976289,242067150,90861,-,-
BAC78_A17,2,2q37.3,241986676,242071243,84567,-,-
BAC208_K05,2,2q37.3,242051942,242145068,93126,-,-
BAC135_I11,2,2q37.3,242067152,242170500,103348,yes,-
BAC235_A11,2,2q37.3,242069576,242145262,75686,-,-
BAC120_D21,2,2q37.3,242145415,242247170,101755,yes,-
BAC168_G14,2,2q37.3,242151643,242247170,95527,-,-
BAC59_H10,2,2q37.3,242151643,242265236,113593,-,-
BAC234_O12,2,2q37.3,242170798,242265238,94440,-,-
BAC152_I04,2,2q37.3,242170798,242266768,95970,-,-
BAC149_K09,2,2q37.3,242170798,242236682,65884,-,-
BAC54_I23,2,2q37.3,242182702,242271419,88717,-,-
BAC192_H20,2,2q37.3,242229705,242310787,81082,-,-
BAC41_M21,2,2q37.3,242236755,242333626,96871,-,-
BAC129_D12,2,2q37.3,242310851,242422500,111649,-,-
BAC40_D15,2,2q37.3,242328343,242422496,94153,-,-
BAC60_H12,2,2q37.3,242568993,242670154,101161,-,-
BAC237_N08,3,3p26.3,50935,135305,84370,-,-
BAC8_P14,3,3p26.3,55516,183128,127612,-,-
BAC66_D05,3,3p26.3,142209,224030,81821,-,-
BAC109_H06,3,3p26.3,175973,267672,91699,-,-
BAC120_G09,3,3p26.3,181004,339981,158977,-,-
BAC21_C22,3,3p26.3,187550,275110,87560,-,-
BAC124_P10,3,3p26.3,189425,320782,131357,-,-
BAC100_D03,3,3p26.3,211763,306607,94844,-,-
BAC45_F02,3,3p26.3,275103,339978,64875,-,-
BAC123_M04,3,3p26.3,338158,480133,141975,-,-
BAC183_H20,3,3p26.3,475608,558064,82456,-,-
BAC55_D06,3,3p26.3,766253,868783,102530,-,-
BAC139_N04,3,3p26.3,833491,895603,62112,-,-
BAC143_N15,3,3p26.3,940253,1009024,68771,-,-
BAC202_O06,3,3p26.3,1184380,1274802,90422,-,-
BAC217_L05,3,3p26.3,1197653,1275191,77538,-,-
BAC120_E13,3,3p26.3,1214884,1308685,93801,-,-
BAC221_O02,3,3p26.3,1337087,1405997,68910,-,-
BAC179_L14,3,3p26.3,1388978,1469953,80975,-,-
BAC62_B20,3,3p26.3,1431057,1554228,123171,-,-
BAC218_A16,3,3p26.3,1563726,1649095,85369,-,-
BAC131_F20,3,3p26.3,1844426,1937617,93191,-,-
BAC180_B14,3,3p26.3,1949732,2031140,81408,-,-
BAC229_M18,3,3p26.3,2045779,2124645,78866,-,-
BAC5_N24,3,3p26.3,2055869,2207753,151884,-,-
BAC136_I05,3,3p26.3,2167517,2251444,83927,-,-
BAC72_O16,3,3p26.3,2183406,2325036,141630,-,-
BAC124_K15,3,3p26.3,2355920,2482360,126440,-,-
BAC51_O14,3,3p26.3,2487917,2630950,143033,-,-
BAC88_N06,3,3p26.3,2561054,2653242,92188,-,-
BAC25_J16,3,3p26.3,2658471,2770464,111993,-,-
BAC53_M19,3,3p26.3,2688132,2784213,96081,-,-
BAC120_K07,3,3p26.3,2789790,2891660,101870,-,-
BAC234_A22,3,3p26.3,2807226,2892036,84810,-,-
BAC79_D23,3,3p26.3,2807229,2890795,83566,-,-
BAC213_J04,3,3p26.3,2923614,2999152,75538,-,-
BAC235_K07,3,3p26.3,3074968,3162693,87725,-,-
BAC52_B12,3,3p26.3,3076782,3155448,78666,-,-
BAC50_P20,3,3p26.3,3095059,3180939,85880,-,-
BAC184_K24,3,3p26.3,3159568,3255953,96385,-,-
BAC22_G24,3,3p26.3,3163839,3243428,79589,-,-
BAC209_L10,3,3p26.3,3243423,3321896,78473,-,-
BAC67_O21,3,3p26.3,3255964,3396490,140526,-,-
BAC83_J18,3,3p26.3,3277275,3396493,119218,-,-
BAC168_K14,3,3p26.3,3295659,3378672,83013,-,-
BAC169_I03,3,3p26.3,3396485,3474357,77872,-,-
BAC233_P07,3,3p26.2,3568671,3669768,101097,-,-
BAC150_L23,3,3p26.2,3652095,3755182,103087,-,-
BAC37_D14,3,3p26.2,3672289,3763703,91414,-,-
BAC168_O19,3,3p26.2,3795655,3922036,126381,-,-
BAC120_M02,3,3p26.2,3797134,3897524,100390,-,-
BAC185_I07,3,3p26.2,3820764,3907897,87133,-,-
BAC233_A20,3,3p26.2,3820771,3904668,83897,-,-
BAC139_C05,3,3p26.2,3955030,4047953,92923,-,-
BAC230_C10,3,3p26.2,4030784,4095000,64216,-,-
BAC66_O02,3,3p26.2,4069800,4160663,90863,-,-
BAC136_G01,3,3p26.2,4114517,4189022,74505,-,-
BAC136_G15,3,3p26.2,4183917,4273588,89671,-,-
BAC246_K01,3,3p26.2,4189016,4295389,106373,-,-
BAC73_C17,3,3p26.2,4282199,4391238,109039,-,-
BAC220_M18,3,3p26.2,4295237,4386466,91229,-,-
BAC143_P12,3,3p26.2,4303899,4418653,114754,-,-
BAC235_O09,3,3p26.2,4305071,4391119,86048,-,-
BAC26_C04,3,3p26.2,4380780,4467721,86941,-,-
BAC233_I17,3,3p26.2,4391232,4467721,76489,-,-
BAC143_M03,3,3p26.2,4418648,4498507,79859,-,-
BAC153_J17,3,3p26.2,4441878,4530072,88194,-,-
BAC2_I17,3,3p26.2,4522389,4625946,103557,-,-
BAC58_I13,3,3p26.2,4537974,4679694,141720,-,-
BAC125_N16,3,3p26.2,4637892,4736173,98281,-,-
BAC182_I07,3,3p26.2,4694433,4813649,119216,-,-
BAC196_P06,3,3p26.2,4766332,4851707,85375,-,-
BAC51_J13,3,3p26.2,4793543,4920694,127151,-,-
BAC217_E04,3,3p26.2,4801773,4889301,87528,-,-
BAC134_E17,3,3p26.2,4808598,4917334,108736,-,-
BAC25_N11,3,3p26.2,4869985,4952361,82376,-,-
BAC146_O09,3,3p26.2,4884066,4968355,84289,-,-
BAC165_F11,3,3p26.2,4888408,4968360,79952,-,-
BAC241_I21,3,3p26.2,4974829,5088658,113829,-,-
BAC60_N05,3,3p26.2,4983206,5094037,110831,-,-
BAC60_B08,3,3p26.2,5018353,5143097,124744,-,-
BAC91_B02,3,3p26.2,5046947,5161418,114471,-,-
BAC75_O02,3,3p26.2,5056706,5073604,16898,-,-
BAC123_P13,3,3p26.2,5056927,5168387,111460,-,-
BAC233_M09,3,3p26.2,5056927,5161387,104460,-,-
BAC139_B03,3,3p26.2,5070364,5167409,97045,-,-
BAC31_E20,3,3p26.2,5074147,5174094,99947,-,-
BAC186_N21,3,3p26.2,5074149,5185040,110891,-,-
BAC71_F04,3,3p26.2,5143103,5244636,101533,-,-
BAC120_I05,3,3p26.2,5174182,5249990,75808,-,-
BAC188_G24,3,3p26.2,5271190,5359699,88509,-,-
BAC237_G08,3,3p26.2,5303109,5393999,90890,-,-
BAC60_J13,3,3p26.2,5303111,5437580,134469,-,-
BAC183_O12,3,3p26.2,5359885,5440608,80723,-,-
BAC171_F02,3,3p26.2-3p26.1,5489563,5579191,89628,-,-
BAC91_F09,3,3p26.1,5543111,5633087,89976,-,-
BAC75_J18,3,3p26.1,5765134,5846887,81753,-,-
BAC179_M15,3,3p26.1,5860413,5959500,99087,-,-
BAC49_P08,3,3p26.1,5880502,5993803,113301,-,-
BAC103_C16,3,3p26.1,6219627,6311532,91905,-,-
BAC177_G12,3,3p26.1,6229230,6239962,10732,-,-
BAC71_O01,3,3p26.1,6263574,6394921,131347,-,-
BAC122_D07,3,3p26.1,6327760,6437346,109586,-,-
BAC35_E06,3,3p26.1,6460564,6554534,93970,-,-
BAC80_L22,3,3p26.1,6531655,6629565,97910,-,-
BAC243_H16,3,3p26.1,6579936,6679179,99243,-,-
BAC89_A04,3,3p26.1,6695172,6783176,88004,-,-
BAC84_G21,3,3p26.1,6796517,6924763,128246,-,-
BAC20_P04,3,3p26.1,6945353,7060644,115291,-,-
BAC96_D21,3,3p26.1,6949893,7053170,103277,-,-
BAC10_B09,3,3p26.1,6954512,7058969,104457,-,-
BAC224_G12,3,3p26.1,7192244,7301327,109083,-,-
BAC32_L17,3,3p26.1,7253407,7349670,96263,-,-
BAC16_E16,3,3p26.1,7413296,7518794,105498,-,-
BAC194_I18,3,3p26.1,7464200,7555275,91075,-,-
BAC78_H04,3,3p26.1,7491806,7575613,83807,-,-
BAC247_G08,3,3p26.1,7615576,7744339,128763,-,-
BAC197_B21,3,3p26.1,7619617,7724613,104996,-,-
BAC51_F01,3,3p26.1,7716464,7826216,109752,-,-
BAC61_E02,3,3p26.1,7799611,7901195,101584,-,-
BAC20_L23,3,3p26.1,7847258,7961952,114694,-,-
BAC249_D02,3,3p26.1,7884370,7968519,84149,-,-
BAC52_C21,3,3p26.1,7927330,8025934,98604,-,-
BAC243_E06,3,3p26.1,7944722,8066439,121717,-,-
BAC139_K12,3,3p26.1,8128009,8226832,98823,-,-
BAC97_I16,3,3p26.1,8149221,8226613,77392,-,-
BAC198_I01,3,3p26.1,8187075,8308233,121158,-,-
BAC158_H03,3,3p26.1,8251111,8346502,95391,-,-
BAC231_D11,3,3p26.1,8261446,8368462,107016,-,-
BAC125_P17,3,3p26.1,8315338,8401844,86506,-,-
BAC53_E07,3,3p26.1,8418867,8506964,88097,-,-
BAC154_G23,3,3p26.1,8485802,8637555,151753,-,-
BAC1_I03,3,3p26.1,8532756,8624357,91601,-,-
BAC234_O11,3,3p26.1,8552153,8641436,89283,-,-
BAC54_J24,3,3p26.1,8552210,8643395,91185,-,-
BAC244_F22,3,3p26.1,8574706,8669230,94524,-,-
BAC109_N22,3,3p26.1-3p25.3,8631874,8740365,108491,-,-
BAC226_P10,3,3p26.1-3p25.3,8648234,8796408,148174,-,-
BAC135_F17,3,3p26.1-3p25.3,8665275,8779237,113962,-,-
BAC238_G21,3,3p25.3,8800715,8885701,84986,-,-
BAC90_P06,3,3p25.3,8832625,8913625,81000,-,-
BAC96_E14,3,3p25.3,8909659,9015176,105517,-,-
BAC169_O13,3,3p25.3,8913747,9027691,113944,-,-
BAC123_I08,3,3p25.3,8918795,9010216,91421,-,-
BAC236_A19,3,3p25.3,8927810,9015678,87868,-,-
BAC169_I02,3,3p25.3,9128835,9230505,101670,-,-
BAC235_M24,3,3p25.3,9128835,9280698,151863,-,-
BAC132_L07,3,3p25.3,9128835,9230541,101706,-,-
BAC170_E17,3,3p25.3,9128866,9230541,101675,-,-
BAC29_A08,3,3p25.3,9144754,9230531,85777,-,-
BAC197_F07,3,3p25.3,9147272,9230541,83269,-,-
BAC143_L17,3,3p25.3,9163304,9230541,67237,-,-
BAC102_K13,3,3p25.3,9277671,9375699,98028,-,-
BAC187_N21,3,3p25.3,9364384,9451927,87543,-,-
BAC195_M04,3,3p25.3,9401305,9493137,91832,-,-
BAC40_M10,3,3p25.3,9547780,9719773,171993,-,-
BAC58_N17,3,3p25.3,9590972,9706942,115970,-,-
BAC62_H06,3,3p25.3,9590994,9706942,115948,-,-
BAC86_I15,3,3p25.3,9600703,9708525,107822,-,-
BAC218_G10,3,3p25.3,9606088,9694602,88514,-,-
BAC110_K15,3,3p25.3,9647854,9752633,104779,-,-
BAC243_L23,3,3p25.3,9785282,9871576,86294,-,-
BAC226_P11,3,3p25.3,9841113,9922621,81508,-,-
BAC199_C06,3,3p25.3,9870202,9948555,78353,-,-
BAC194_C07,3,3p25.3,9880174,9982100,101926,-,-
BAC184_M10,3,3p25.3,9880187,9980871,100684,-,-
BAC192_I08,3,3p25.3,9881324,9982100,100776,-,-
BAC95_O17,3,3p25.3,9900634,9986984,86350,-,-
BAC82_I08,3,3p25.3,9948931,10049588,100657,-,-
BAC231_A13,3,3p25.3,9980866,10071478,90612,-,-
BAC139_M09,3,3p25.3,10011960,10122077,110117,-,-
BAC247_N03,3,3p25.3,10048847,10127702,78855,-,-
BAC38_O16,3,3p25.3,10051667,10220134,168467,-,-
BAC167_M03,3,3p25.3,10063497,10168131,104634,-,-
BAC213_A01,3,3p25.3,10071835,10178164,106329,-,-
BAC233_E21,3,3p25.3,10089705,10200935,111230,-,-
BAC149_D02,3,3p25.3,10127698,10211509,83811,-,-
BAC131_H12,3,3p25.3,10146355,10221432,75077,-,-
BAC110_M06,3,3p25.3,10178265,10299252,120987,yes,-
BAC191_L13,3,3p25.3,10259400,10364277,104877,-,-
BAC25_E21,3,3p25.3,10259518,10364319,104801,-,-
BAC148_C06,3,3p25.3,10266576,10342903,76327,-,-
BAC129_N07,3,3p25.3,10277566,10364315,86749,-,-
BAC213_E19,3,3p25.3,10277680,10364313,86633,-,-
BAC55_O21,3,3p25.3,10279317,10364315,84998,-,-
BAC218_C11,3,3p25.3,10279332,10358432,79100,-,-
BAC70_K15,3,3p25.3,10536318,10635896,99578,-,-
BAC33_I20,3,3p25.3,10549701,10632314,82613,-,-
BAC101_A18,3,3p25.3,10585215,10672029,86814,-,-
BAC110_B16,3,3p25.3,10616091,10721389,105298,-,-
BAC29_G12,3,3p25.3,10624826,10719981,95155,-,-
BAC169_F19,3,3p25.3,10635889,10719979,84090,-,-
BAC80_M22,3,3p25.3,10717832,10872226,154394,-,-
BAC145_F24,3,3p25.3,10770560,10859774,89214,-,-
BAC67_P05,3,3p25.3,10786897,10886702,99805,-,-
BAC71_C08,3,3p25.3,10872242,11014709,142467,-,-
BAC44_J02,3,3p25.3,10872289,10970920,98631,-,-
BAC223_M01,3,3p25.3,10889548,10970916,81368,-,-
BAC132_B13,3,3p25.3,10923226,11011837,88611,-,-
BAC213_C05,3,3p25.3,10954986,11066561,111575,-,-
BAC32_A03,3,3p25.3,10998191,11081045,82854,-,-
BAC252_A20,3,3p25.3,11081415,11189780,108365,-,-
BAC179_B17,3,3p25.3,11107856,11200408,92552,-,-
BAC133_P10,3,3p25.3,11109904,11199368,89464,-,-
BAC148_G15,3,3p25.3,11113621,11215891,102270,-,-
BAC130_I09,3,3p25.3,11193322,11304459,111137,-,-
BAC149_D17,3,3p25.3,11200566,11281677,81111,-,-
BAC85_E18,3,3p25.3,11200566,11340470,139904,-,-
BAC84_F19,3,3p25.3,11215884,11316402,100518,-,-
BAC239_E22,3,3p25.3,11262225,11347031,84806,-,-
BAC102_C11,3,3p25.3,11357000,11481807,124807,-,-
BAC102_K02,3,3p25.2,11518861,11605928,87067,-,-
BAC156_G19,3,3p25.2,11519557,11654995,135438,-,-
BAC71_E05,3,3p25.2,11655264,11734238,78974,-,-
BAC90_E17,3,3p25.2,11666432,11834113,167681,-,-
BAC41_D09,3,3p25.2,11726466,11824091,97625,-,-
BAC222_F11,3,3p25.2,11729060,11824088,95028,-,-
BAC162_I24,3,3p25.2,11767583,11882711,115128,-,-
BAC115_B20,3,3p25.2,11835388,11952513,117125,-,-
BAC37_F02,3,3p25.2,11883256,11977065,93809,-,-
BAC185_C20,3,3p25.2,11912111,11999327,87216,-,-
BAC18_E02,3,3p25.2,11939684,12049880,110196,-,-
BAC97_M20,3,3p25.2,11951376,12071541,120165,-,-
BAC71_F12,3,3p25.2,11962206,12058895,96689,-,-
BAC247_N22,3,3p25.2,11962221,12046752,84531,-,-
BAC128_C20,3,3p25.2,12030895,12158717,127822,-,-
BAC51_M17,3,3p25.2,12116740,12217646,100906,-,-
BAC195_N02,3,3p25.2,12126891,12217646,90755,-,-
BAC171_F07,3,3p25.2,12130630,12217646,87016,-,-
BAC250_B10,3,3p25.2,12142379,12240066,97687,-,-
BAC26_O22,3,3p25.2,12200864,12296989,96125,-,-
BAC109_H15,3,3p25.2,12211249,12325916,114667,-,-
BAC108_K12,3,3p25.2-3p25.1,12310464,12457919,147455,-,-
BAC165_K17,3,3p25.2-3p25.1,12356410,12457919,101509,-,-
BAC79_I09,3,3p25.2-3p25.1,12383906,12481140,97234,-,-
BAC153_G10,3,3p25.1,12445690,12531838,86148,-,-
BAC218_B04,3,3p25.1,12457913,12535908,77995,-,-
BAC65_D24,3,3p25.1,12535902,12625327,89425,-,-
BAC55_I03,3,3p25.1,12608888,12709449,100561,-,-
BAC241_C12,3,3p25.1,12619580,12716494,96914,-,-
BAC73_N11,3,3p25.1,12660981,12752644,91663,-,-
BAC53_H11,3,3p25.1,12679305,12821194,141889,-,-
BAC10_N10,3,3p25.1,12741986,12920308,178322,-,-
BAC76_B12,3,3p25.1,12752710,12842907,90197,-,-
BAC224_O23,3,3p25.1,12765212,12852291,87079,-,-
BAC195_P17,3,3p25.1,12821185,12914822,93637,-,-
BAC119_L21,3,3p25.1,12834034,12914841,80807,-,-
BAC17_L19,3,3p25.1,12835695,12958393,122698,-,-
BAC252_M02,3,3p25.1,12893419,12998757,105338,-,-
BAC50_L20,3,3p25.1,12957170,13093194,136024,-,-
BAC224_D12,3,3p25.1,12967221,13093264,126043,-,-
BAC189_H09,3,3p25.1,12984903,13006346,21443,-,-
BAC219_B16,3,3p25.1,12984915,13104893,119978,-,-
BAC37_E11,3,3p25.1,13006391,13173030,166639,-,-
BAC113_I22,3,3p25.1,13047003,13206064,159061,-,-
BAC162_B12,3,3p25.1,13144140,13242751,98611,-,-
BAC28_D07,3,3p25.1,13206058,13321901,115843,-,-
BAC130_M06,3,3p25.1,13210143,13321901,111758,-,-
BAC94_O13,3,3p25.1,13212923,13338677,125754,-,-
BAC17_B08,3,3p25.1,13242767,13341109,98342,-,-
BAC86_E12,3,3p25.1,13246907,13337847,90940,-,-
BAC140_M09,3,3p25.1,13250863,13359607,108744,-,-
BAC237_C04,3,3p25.1,13259772,13341299,81527,-,-
BAC72_G10,3,3p25.1,13337841,13454796,116955,-,-
BAC78_J18,3,3p25.1,13352629,13442825,90196,-,-
BAC187_C07,3,3p25.1,13352637,13432934,80297,-,-
BAC185_N19,3,3p25.1,13374951,13463098,88147,-,-
BAC198_I21,3,3p25.1,13433027,13548868,115841,-,-
BAC211_N14,3,3p25.1,13480307,13562877,82570,-,-
BAC110_N12,3,3p25.1,13521558,13673826,152268,-,-
BAC121_B21,3,3p25.1,13616583,13749266,132683,-,-
BAC189_L01,3,3p25.1,13635218,13703920,68702,-,-
BAC141_I11,3,3p25.1,13654865,13749266,94401,-,-
BAC157_J02,3,3p25.1,13657949,13754058,96109,-,-
BAC48_D18,3,3p25.1,13754105,13844964,90859,-,-
BAC58_H17,3,3p25.1,13755725,13844915,89190,-,-
BAC205_P05,3,3p25.1,13858181,13936650,78469,-,-
BAC144_O09,3,3p25.1,13929830,14004010,74180,-,-
BAC129_E14,3,3p25.1,14013153,14105751,92598,-,-
BAC57_P06,3,3p25.1,14051507,14147609,96102,-,-
BAC219_P13,3,3p25.1,14160108,14245869,85761,-,-
BAC175_N23,3,3p25.1,14166804,14263040,96236,-,-
BAC43_G19,3,3p25.1,14166808,14263063,96255,-,-
BAC53_G24,3,3p25.1,14267341,14421212,153871,-,-
BAC39_O04,3,3p25.1,14294661,14421231,126570,-,-
BAC60_O05,3,3p25.1,14307569,14420339,112770,-,-
BAC90_N22,3,3p25.1,14320462,14450659,130197,-,-
BAC24_P04,3,3p25.1,14353189,14468962,115773,-,-
BAC69_F22,3,3p25.1,14365807,14479416,113609,-,-
BAC150_L12,3,3p25.1,14368562,14473070,104508,-,-
BAC44_F05,3,3p25.1,14368598,14505687,137089,-,-
BAC142_N07,3,3p25.1,14368620,14473074,104454,-,-
BAC150_M06,3,3p25.1,14411002,14505546,94544,-,-
BAC37_M12,3,3p25.1,14420359,14529098,108739,-,-
BAC147_C21,3,3p25.1,14424865,14543140,118275,-,-
BAC215_G03,3,3p25.1,14471923,14549820,77897,-,-
BAC124_D18,3,3p25.1,14480703,14577596,96893,-,-
BAC199_J16,3,3p25.1,14519489,14605225,85736,-,-
BAC186_O07,3,3p25.1,14530156,14614051,83895,-,-
BAC156_I17,3,3p25.1,14555293,14628441,73148,-,-
BAC14_C21,3,3p25.1,14555301,14641996,86695,-,-
BAC193_E17,3,3p25.1,14559486,14641218,81732,-,-
BAC29_N05,3,3p25.1,14577634,14664839,87205,-,-
BAC19_L12,3,3p25.1-3p24.3,14599157,14729442,130285,-,-
BAC250_B04,3,3p25.1-3p24.3,14601612,14703193,101581,-,-
BAC32_P07,3,3p25.1-3p24.3,14623934,14773584,149650,-,-
BAC160_J19,3,3p25.1-3p24.3,14664833,14741365,76532,-,-
BAC236_L12,3,3p24.3,14773576,14865255,91679,-,-
BAC52_L12,3,3p24.3,14842398,15004645,162247,-,-
BAC4_N24,3,3p24.3,14899424,15085732,186308,-,-
BAC163_D01,3,3p24.3,14949455,15046846,97391,-,-
BAC85_B18,3,3p24.3,15046839,15172221,125382,-,-
BAC38_F08,3,3p24.3,15063142,15173854,110712,-,-
BAC238_I10,3,3p24.3,15069696,15168663,98967,-,-
BAC219_C15,3,3p24.3,15106809,15186539,79730,-,-
BAC24_O03,3,3p24.3,15336131,15434759,98628,-,-
BAC69_C16,3,3p24.3,15365023,15482999,117976,-,-
BAC27_F08,3,3p24.3,15367900,15518114,150214,-,-
BAC103_M07,3,3p24.3,15387899,15482999,95100,-,-
BAC124_P20,3,3p24.3,15387900,15486277,98377,-,-
BAC217_H18,3,3p24.3,15398026,15483106,85080,-,-
BAC226_N03,3,3p24.3,15410377,15491098,80721,-,-
BAC34_H11,3,3p24.3,15644743,15719323,74580,-,-
BAC143_F12,3,3p24.3,15830189,15915296,85107,-,-
BAC75_A09,3,3p24.3,15919857,16024912,105055,-,-
BAC229_M06,3,3p24.3,15941211,16024697,83486,-,-
BAC103_M22,3,3p24.3,16024691,16181841,157150,-,-
BAC120_A02,3,3p24.3,16036769,16181913,145144,-,-
BAC60_P14,3,3p24.3,16042991,16154866,111875,-,-
BAC130_C16,3,3p24.3,16043524,16126203,82679,-,-
BAC249_L18,3,3p24.3,16043524,16181903,138379,-,-
BAC95_B06,3,3p24.3,16088488,16244619,156131,-,-
BAC224_I23,3,3p24.3,16100038,16184429,84391,-,-
BAC247_N04,3,3p24.3,16155011,16238281,83270,-,-
BAC77_H04,3,3p24.3,16192737,16305317,112580,-,-
BAC26_E04,3,3p24.3,16218012,16346335,128323,-,-
BAC217_J17,3,3p24.3,16235887,16329562,93675,-,-
BAC223_E10,3,3p24.3,16238277,16329902,91625,-,-
BAC137_I17,3,3p24.3,16262374,16353825,91451,-,-
BAC161_P02,3,3p24.3,16362634,16463418,100784,-,-
BAC182_K19,3,3p24.3,16383358,16460054,76696,-,-
BAC83_I01,3,3p24.3,16383358,16501152,117794,-,-
BAC49_B12,3,3p24.3,16383388,16501094,117706,-,-
BAC97_N09,3,3p24.3,16402005,16496702,94697,-,-
BAC128_O09,3,3p24.3,16405407,16496702,91295,-,-
BAC234_M20,3,3p24.3,16579343,16667832,88489,-,-
BAC132_L05,3,3p24.3,16626956,16721850,94894,-,-
BAC144_O21,3,3p24.3,16681369,16762094,80725,-,-
BAC76_A11,3,3p24.3,16749077,16843889,94812,-,-
BAC21_O07,3,3p24.3,16777056,16867343,90287,-,-
BAC225_B11,3,3p24.3,16940856,17019044,78188,-,-
BAC40_J19,3,3p24.3,16954713,17074815,120102,-,-
BAC78_I20,3,3p24.3,16968462,17046865,78403,-,-
BAC36_A05,3,3p24.3,17046886,17120040,73154,-,-
BAC1_J10,3,3p24.3,17084161,17210428,126267,-,-
BAC21_M08,3,3p24.3,17203436,17342369,138933,-,-
BAC57_D20,3,3p24.3,17210861,17307674,96813,-,-
BAC163_C20,3,3p24.3,17250379,17354118,103739,-,-
BAC249_E18,3,3p24.3,17521884,17622459,100575,-,-
BAC115_N10,3,3p24.3,17534170,17612733,78563,-,-
BAC27_I11,3,3p24.3,17573101,17622454,49353,-,-
BAC187_E24,3,3p24.3,17584713,17663736,79023,-,-
BAC153_H13,3,3p24.3,17682362,17770419,88057,-,-
BAC232_D02,3,3p24.3,17683615,17770437,86822,-,-
BAC127_O16,3,3p24.3,17730928,17846600,115672,-,-
BAC115_J07,3,3p24.3,17747674,17826545,78871,-,-
BAC5_C21,3,3p24.3,17757362,17835689,78327,-,-
BAC91_H23,3,3p24.3,17858227,17943532,85305,-,-
BAC69_M17,3,3p24.3,17934911,18052374,117463,-,-
BAC36_C16,3,3p24.3,18038025,18155514,117489,-,-
BAC169_M05,3,3p24.3,18182934,18265052,82118,-,-
BAC72_N14,3,3p24.3,18353334,18440002,86668,-,-
BAC95_G23,3,3p24.3,18596462,18690635,94173,-,-
BAC161_K15,3,3p24.3,18703860,18798707,94847,-,-
BAC105_A16,3,3p24.3,18747299,18880773,133474,-,-
BAC160_F18,3,3p24.3,18774343,18875042,100699,-,-
BAC173_A10,3,3p24.3,19043579,19138195,94616,-,-
BAC109_P07,3,3p24.3,19334788,19452211,117423,-,-
BAC217_N08,3,3p24.3,19473258,19557404,84146,-,-
BAC230_F08,3,3p24.3,19625383,19732582,107199,-,-
BAC170_P17,3,3p24.3,19662580,19756185,93605,-,-
BAC78_F06,3,3p24.3,19697975,19791140,93165,-,-
BAC72_D14,3,3p24.3,19806067,19873313,67246,-,-
BAC53_C07,3,3p24.3,19863252,20059821,196569,-,-
BAC188_K10,3,3p24.3,19912566,19986851,74285,-,-
BAC131_J18,3,3p24.3,19960540,20054325,93785,-,-
BAC88_P08,3,3p24.3,19988726,20086783,98057,-,-
BAC117_M02,3,3p24.3,19992363,20013294,20931,-,-
BAC65_F22,3,3p24.3,20092428,20183333,90905,-,-
BAC152_M07,3,3p24.3,20112842,20206829,93987,-,-
BAC230_H19,3,3p24.3,20119299,20202230,82931,-,-
BAC249_F08,3,3p24.3,20162332,20286244,123912,-,-
BAC225_E13,3,3p24.3,20229540,20297850,68310,-,-
BAC221_P10,3,3p24.3,20349592,20429120,79528,-,-
BAC1_E10,3,3p24.3,20621939,20703955,82016,-,-
BAC157_J08,3,3p24.3,20624062,20695450,71388,-,-
BAC36_H17,3,3p24.3,20806654,20894670,88016,-,-
BAC240_J07,3,3p24.3,20888579,20972842,84263,-,-
BAC226_J02,3,3p24.3,20973055,21095507,122452,-,-
BAC23_D13,3,3p24.3,21210170,21315084,104914,-,-
BAC220_D11,3,3p24.3,21402996,21483506,80510,-,-
BAC218_J12,3,3p24.3,21439144,21520748,81604,-,-
BAC20_I09,3,3p24.3,21495675,21589322,93647,-,-
BAC247_J07,3,3p24.3,21583860,21666384,82524,-,-
BAC18_J23,3,3p24.3,21767234,21845701,78467,-,-
BAC57_N11,3,3p24.3,21841787,21975203,133416,-,-
BAC239_B13,3,3p24.3,21918702,22007500,88798,-,-
BAC252_I05,3,3p24.3,21979026,22075746,96720,-,-
BAC127_H02,3,3p24.3,22137267,22245021,107754,-,-
BAC240_M01,3,3p24.3,22175455,22264810,89355,-,-
BAC128_N10,3,3p24.3,22322765,22422362,99597,-,-
BAC148_F14,3,3p24.3,22334941,22422364,87423,-,-
BAC46_C23,3,3p24.3,22391554,22475339,83785,-,-
BAC156_J06,3,3p24.3,22813481,22907005,93524,-,-
BAC250_M09,3,3p24.3,22907040,22998286,91246,-,-
BAC146_F06,3,3p24.3,22914049,22982074,68025,-,-
BAC2_K10,3,3p24.3,23141433,23240007,98574,-,-
BAC55_F21,3,3p24.3,23154347,23294358,140011,-,-
BAC21_J12,3,3p24.3,23165897,23244345,78448,-,-
BAC167_B06,3,3p24.3,23174021,23251204,77183,-,-
BAC154_I11,3,3p24.3,23294355,23356562,62207,-,-
BAC54_H20,3,3p24.3,23402826,23525371,122545,-,-
BAC240_D06,3,3p24.3,23451867,23525375,73508,-,-
BAC180_P17,3,3p24.3,23590624,23695406,104782,-,-
BAC232_O18,3,3p24.3,23593840,23680203,86363,-,-
BAC129_N12,3,3p24.3,23607650,23687752,80102,-,-
BAC221_E08,3,3p24.3,23651165,23736408,85243,-,-
BAC15_K13,3,3p24.3,23651165,23728588,77423,-,-
BAC128_K20,3,3p24.3,23694805,23792023,97218,-,-
BAC100_A05,3,3p24.3-3p24.2,23709450,23826757,117307,-,-
BAC14_L17,3,3p24.3-3p24.2,23716274,23941458,225184,-,-
BAC246_M08,3,3p24.3-3p24.2,23736403,23843936,107533,-,-
BAC106_K08,3,3p24.3-3p24.2,23787244,23864964,77720,-,-
BAC131_D24,3,3p24.2,23843931,23935288,91357,-,-
BAC193_D03,3,3p24.2,23986696,24055619,68923,-,-
BAC80_O21,3,3p24.2,24012115,24105390,93275,-,-
BAC238_J14,3,3p24.2,24074789,24189004,114215,-,-
BAC158_J12,3,3p24.2,24074789,24184835,110046,-,-
BAC157_E12,3,3p24.2,24193454,24290072,96618,-,-
BAC8_N05,3,3p24.2,24530877,24617575,86698,-,-
BAC90_O07,3,3p24.2,24587300,24705510,118210,-,-
BAC64_I03,3,3p24.2,24606142,24727209,121067,-,-
BAC181_L05,3,3p24.2,25075010,25146545,71535,-,-
BAC26_G01,3,3p24.2,25096334,25201727,105393,-,-
BAC191_C19,3,3p24.2,25112254,25206886,94632,-,-
BAC252_A17,3,3p24.2,25235772,25361295,125523,-,-
BAC181_L08,3,3p24.2,25306105,25392327,86222,-,-
BAC105_M03,3,3p24.2,25317902,25406766,88864,-,-
BAC136_N13,3,3p24.2,25395935,25530117,134182,-,-
BAC12_O03,3,3p24.2,25406806,25490107,83301,-,-
BAC194_E10,3,3p24.2,25415180,25498842,83662,-,-
BAC81_M05,3,3p24.2,25463730,25560886,97156,-,-
BAC158_C03,3,3p24.2,25484129,25595025,110896,-,-
BAC158_D03,3,3p24.2,25484150,25594972,110822,-,-
BAC15_B03,3,3p24.2,25484280,25629315,145035,-,-
BAC177_A20,3,3p24.2,25497358,25577182,79824,-,-
BAC83_J06,3,3p24.2,25500055,25595025,94970,-,-
BAC72_A18,3,3p24.2,25613926,25701297,87371,-,-
BAC218_H22,3,3p24.2,25642107,25726654,84547,-,-
BAC28_E16,3,3p24.2,25642107,25722662,80555,-,-
BAC117_P11,3,3p24.2,25713873,25816116,102243,-,-
BAC129_M03,3,3p24.2,25726702,25817461,90759,-,-
BAC242_F01,3,3p24.2,25757118,25860411,103293,-,-
BAC114_C20,3,3p24.2,25790807,25871608,80801,-,-
BAC127_F12,3,3p24.2,25965485,26084753,119268,-,-
BAC243_G22,3,3p24.2,25999595,26105521,105926,-,-
BAC180_E20,3,3p24.2,26100166,26192833,92667,-,-
BAC233_N15,3,3p24.2,26101186,26164795,63609,-,-
BAC109_A20,3,3p24.2,26277149,26357618,80469,-,-
BAC128_B09,3,3p24.2-3p24.1,26290190,26444544,154354,-,-
BAC120_N12,3,3p24.2,26297273,26394895,97622,-,-
BAC195_N03,3,3p24.2,26302860,26388404,85544,-,-
BAC115_G12,3,3p24.2-3p24.1,26316595,26403596,87001,-,-
BAC63_M06,3,3p24.2-3p24.1,26395306,26497350,102044,-,-
BAC147_M21,3,3p24.1,26562379,26644918,82539,-,-
BAC231_N19,3,3p24.1,26718334,26803252,84918,-,-
BAC214_O22,3,3p24.1,26824043,26867563,43520,-,-
BAC220_L07,3,3p24.1,26969797,27047682,77885,-,-
BAC233_I03,3,3p24.1,27076981,27169751,92770,-,-
BAC88_K13,3,3p24.1,27169832,27303594,133762,-,-
BAC197_J06,3,3p24.1,27284888,27381918,97030,-,-
BAC95_G18,3,3p24.1,27382983,27488181,105198,-,-
BAC42_L22,3,3p24.1,27386084,27541443,155359,-,-
BAC10_C15,3,3p24.1,27412612,27524553,111941,-,-
BAC169_D21,3,3p24.1,27607776,27676982,69206,-,-
BAC142_F19,3,3p24.1,27870846,27950340,79494,-,-
BAC195_G14,3,3p24.1,27907185,27983885,76700,-,-
BAC200_F05,3,3p24.1,27949344,28052535,103191,-,-
BAC168_K06,3,3p24.1,28024686,28127489,102803,-,-
BAC42_K19,3,3p24.1,28054721,28221102,166381,-,-
BAC161_B13,3,3p24.1,28104934,28185009,80075,-,-
BAC11_E16,3,3p24.1,28127482,28225047,97565,-,-
BAC123_N04,3,3p24.1,28301249,28470742,169493,-,-
BAC220_E08,3,3p24.1,28395940,28476449,80509,-,-
BAC136_K12,3,3p24.1,28401126,28479917,78791,-,-
BAC96_M08,3,3p24.1,28571811,28684147,112336,-,-
BAC197_C06,3,3p24.1,28651543,28745207,93664,-,-
BAC189_A05,3,3p24.1,28709955,28817820,107865,-,-
BAC28_C19,3,3p24.1,28786042,28877175,91133,-,-
BAC157_G23,3,3p24.1,28814912,28896682,81770,-,-
BAC163_A08,3,3p24.1,29030411,29088539,58128,-,-
BAC195_K07,3,3p24.1,29045327,29059576,14249,-,-
BAC243_P17,3,3p24.1,29046770,29129792,83022,-,-
BAC141_P14,3,3p24.1,29101168,29187697,86529,-,-
BAC25_O15,3,3p24.1,29115762,29206276,90514,-,-
BAC239_E08,3,3p24.1,29158502,29260743,102241,-,-
BAC116_M10,3,3p24.1,29367111,29472155,105044,-,-
BAC91_M13,3,3p24.1,29376580,29470628,94048,-,-
BAC57_O19,3,3p24.1,29503999,29639242,135243,-,-
BAC88_L14,3,3p24.1,29505377,29606103,100726,-,-
BAC60_B02,3,3p24.1,29606099,29717167,111068,-,-
BAC218_I18,3,3p24.1,29699589,29776747,77158,-,-
BAC66_P24,3,3p24.1,29771174,29887692,116518,-,-
BAC110_G03,3,3p24.1,29937576,30054026,116450,-,-
BAC24_P01,3,3p24.1,30437179,30580830,143651,-,-
BAC29_B21,3,3p24.1,30479700,30574914,95214,-,-
BAC7_M11,3,3p24.1,30506367,30628952,122585,-,-
BAC223_F16,3,3p24.1,30582928,30686752,103824,-,-
BAC100_D23,3,3p24.1-3p23,30740125,30841156,101031,-,-
BAC19_L21,3,3p23,30942803,31030024,87221,-,-
BAC63_K18,3,3p23,31015164,31110930,95766,-,-
BAC142_L15,3,3p23,31101657,31204750,103093,-,-
BAC62_K09,3,3p23,31101658,31177874,76216,-,-
BAC123_J09,3,3p23,31144191,31266278,122087,-,-
BAC75_H14,3,3p23,31204054,31309614,105560,-,-
BAC120_F05,3,3p23,31483964,31571865,87901,-,-
BAC18_A12,3,3p23,31487959,31582390,94431,-,-
BAC168_G06,3,3p23,31530389,31633225,102836,-,-
BAC238_K18,3,3p23,31530391,31630082,99691,-,-
BAC60_E23,3,3p23,31617733,31721164,103431,-,-
BAC61_I23,3,3p23,31650134,31781144,131010,-,-
BAC160_E14,3,3p23,31660913,31761282,100369,-,-
BAC178_B16,3,3p23,31660913,31738563,77650,-,-
BAC75_N09,3,3p23,31660917,31758622,97705,-,-
BAC29_B06,3,3p23,31765292,31895007,129715,-,-
BAC157_A12,3,3p23,31769701,31851250,81549,-,-
BAC81_F01,3,3p23,31794469,31896756,102287,-,-
BAC79_M23,3,3p23,31795470,31895037,99567,-,-
BAC78_N07,3,3p23,31795470,31929474,134004,-,-
BAC64_L08,3,3p23,31808360,31895074,86714,-,-
BAC66_A16,3,3p23,31822341,32003812,181471,-,-
BAC30_L23,3,3p23,31847624,31950331,102707,-,-
BAC23_N04,3,3p23,31965588,32099151,133563,-,-
BAC134_P16,3,3p23-3p22.3,32037331,32120400,83069,-,-
BAC39_E03,3,3p22.3,32117938,32202789,84851,-,-
BAC194_N10,3,3p22.3,32251702,32321391,69689,-,-
BAC37_C18,3,3p22.3,32303372,32407354,103982,-,-
BAC230_N16,3,3p22.3,32305917,32393420,87503,-,-
BAC219_P17,3,3p22.3,32324315,32419003,94688,-,-
BAC181_D08,3,3p22.3,32340072,32445779,105707,-,-
BAC56_L13,3,3p22.3,32482426,32599568,117142,-,-
BAC132_J02,3,3p22.3,32486552,32571740,85188,-,-
BAC198_K03,3,3p22.3,32486552,32566551,79999,-,-
BAC2_I14,3,3p22.3,32546413,32646590,100177,-,-
BAC235_L03,3,3p22.3,32551673,32665518,113845,-,-
BAC167_D03,3,3p22.3,32605891,32695504,89613,-,-
BAC196_O13,3,3p22.3,32789731,32880149,90418,-,-
BAC136_K16,3,3p22.3,32791662,32875636,83974,-,-
BAC223_M10,3,3p22.3,33076314,33219506,143192,-,-
BAC128_K23,3,3p22.3,33076894,33175284,98390,-,-
BAC177_A17,3,3p22.3,33168422,33252600,84178,-,-
BAC200_A03,3,3p22.3,33319831,33394879,75048,-,-
BAC232_J10,3,3p22.3,33424922,33543281,118359,-,-
BAC38_F13,3,3p22.3,33442762,33543281,100519,-,-
BAC146_N23,3,3p22.3,33448671,33543281,94610,-,-
BAC148_M13,3,3p22.3,33463141,33561433,98292,-,-
BAC178_B19,3,3p22.3,33561532,33637200,75668,-,-
BAC85_H09,3,3p22.3,33686977,33765724,78747,-,-
BAC192_I15,3,3p22.3,33691735,33764489,72754,-,-
BAC126_H04,3,3p22.3,33702871,33790262,87391,-,-
BAC41_C14,3,3p22.3,33741397,33826534,85137,-,-
BAC160_F10,3,3p22.3,33862383,33944086,81703,-,-
BAC49_A18,3,3p22.3,33893326,34054857,161531,-,-
BAC128_P12,3,3p22.3,34049097,34145587,96490,-,-
BAC38_E19,3,3p22.3,34059953,34205341,145388,-,-
BAC66_I08,3,3p22.3,34095729,34219324,123595,-,-
BAC157_B14,3,3p22.3,34106558,34204802,98244,-,-
BAC148_L01,3,3p22.3,34145581,34239784,94203,-,-
BAC171_H23,3,3p22.3,34160787,34241881,81094,-,-
BAC151_A18,3,3p22.3,34204924,34314232,109308,-,-
BAC89_A12,3,3p22.3,34266727,34362350,95623,-,-
BAC91_D11,3,3p22.3,34314238,34408776,94538,-,-
BAC236_H24,3,3p22.3,34594195,34678341,84146,-,-
BAC196_J11,3,3p22.3,34702177,34799618,97441,-,-
BAC186_K21,3,3p22.3,34732725,34817504,84779,-,-
BAC115_D06,3,3p22.3,35033634,35185835,152201,-,-
BAC63_N20,3,3p22.3,35053904,35179773,125869,-,-
BAC20_M14,3,3p22.3,35138231,35241718,103487,-,-
BAC30_F20,3,3p22.3,35141316,35226640,85324,-,-
BAC157_A22,3,3p22.3,35179784,35262917,83133,-,-
BAC74_J14,3,3p22.3,35203344,35307053,103709,-,-
BAC135_D05,3,3p22.3,35425495,35512301,86806,-,-
BAC143_H07,3,3p22.3,35614148,35704646,90498,-,-
BAC144_C11,3,3p22.3,35638825,35740337,101512,-,-
BAC51_C23,3,3p22.3,35747366,35866408,119042,-,-
BAC110_A11,3,3p22.3,35821491,35974346,152855,-,-
BAC165_P21,3,3p22.3,35875070,35958070,83000,-,-
BAC177_I22,3,3p22.3,35887631,35970501,82870,-,-
BAC66_M09,3,3p22.3,35888584,35919238,30654,-,-
BAC18_A18,3,3p22.3,36202106,36291297,89191,-,-
BAC90_N07,3,3p22.3,36217225,36312240,95015,-,-
BAC181_P08,3,3p22.3,36346286,36430858,84572,-,-
BAC163_H22,3,3p22.3,36439773,36499349,59576,-,-
BAC146_B13,3,3p22.2,36554466,36632514,78048,-,-
BAC80_F12,3,3p22.2,36617901,36714023,96122,-,-
BAC239_F06,3,3p22.2,36683324,36799642,116318,-,-
BAC42_B10,3,3p22.2,36813644,36941310,127666,-,-
BAC175_I18,3,3p22.2,36842165,36919225,77060,-,-
BAC32_L20,3,3p22.2,36923279,37035890,112611,-,-
BAC69_O05,3,3p22.2,36941308,37049970,108662,-,-
BAC36_O04,3,3p22.2,37080014,37187846,107832,-,-
BAC148_E01,3,3p22.2,37092299,37199384,107085,-,-
BAC97_E05,3,3p22.2,37193569,37310275,116706,-,-
BAC182_F19,3,3p22.2,37207350,37293648,86298,-,-
BAC153_A07,3,3p22.2,37207350,37297059,89709,-,-
BAC78_P01,3,3p22.2,37207350,37314112,106762,-,-
BAC92_M18,3,3p22.2,37207350,37324098,116748,-,-
BAC113_P01,3,3p22.2,37242929,37346695,103766,-,-
BAC100_L14,3,3p22.2,37255081,37335596,80515,-,-
BAC119_C03,3,3p22.2,37405894,37537361,131467,-,-
BAC213_J14,3,3p22.2,37413074,37520920,107846,-,-
BAC155_F12,3,3p22.2,37432514,37516487,83973,-,-
BAC44_B08,3,3p22.2,37432565,37524775,92210,-,-
BAC39_I05,3,3p22.2,37432566,37607660,175094,-,-
BAC46_M16,3,3p22.2,37433701,37541008,107307,-,-
BAC126_I13,3,3p22.2,37510414,37620666,110252,-,-
BAC85_G09,3,3p22.2,37510414,37610997,100583,-,-
BAC91_A15,3,3p22.2,37597199,37689881,92682,-,-
BAC37_C14,3,3p22.2,37607661,37720373,112712,-,-
BAC185_N12,3,3p22.2,37689902,37778842,88940,-,-
BAC148_M17,3,3p22.2,37707086,37834221,127135,-,-
BAC218_G16,3,3p22.2,37707100,37788403,81303,-,-
BAC23_D06,3,3p22.2,37718415,37831596,113181,-,-
BAC147_M04,3,3p22.2,37733653,37829210,95557,-,-
BAC168_M15,3,3p22.2,37753288,37906934,153646,-,-
BAC175_C09,3,3p22.2,37771682,37858523,86841,-,-
BAC165_C02,3,3p22.2,37789642,37880009,90367,-,-
BAC232_F03,3,3p22.2,37800286,37879977,79691,-,-
BAC179_O18,3,3p22.2,37985248,38078747,93499,-,-
BAC22_D23,3,3p22.2,37993254,38091022,97768,-,-
BAC154_C07,3,3p22.2,38094313,38170445,76132,-,-
BAC222_B21,3,3p22.2,38223010,38302050,79040,-,-
BAC81_K03,3,3p22.2,38258823,38380222,121399,-,-
BAC19_L07,3,3p22.2,38268919,38399347,130428,-,-
BAC166_A24,3,3p22.2,38296804,38381746,84942,-,-
BAC75_M03,3,3p22.2,38298353,38441076,142723,-,-
BAC34_P06,3,3p22.2,38302118,38383188,81070,-,-
BAC187_P13,3,3p22.2,38381811,38457070,75259,-,-
BAC115_O22,3,3p22.2,38383201,38509137,125936,-,-
BAC199_I06,3,3p22.2,38385717,38502161,116444,-,-
BAC186_K23,3,3p22.2,38471694,38582535,110841,-,-
BAC86_D08,3,3p22.2,38573871,38673077,99206,-,-
BAC61_B07,3,3p22.2,38598961,38745772,146811,-,-
BAC196_J21,3,3p22.2,38688888,38778035,89147,-,-
BAC184_E18,3,3p22.2,38719651,38816396,96745,-,-
BAC181_P05,3,3p22.2,38917542,38999086,81544,-,-
BAC248_A04,3,3p22.2,38917543,39011536,93993,-,-
BAC230_B05,3,3p22.2,38974241,39086538,112297,-,-
BAC68_N16,3,3p22.2,38974243,39104274,130031,-,-
BAC41_I05,3,3p22.2,38988463,39094529,106066,-,-
BAC109_D19,3,3p22.2,39057684,39162529,104845,-,-
BAC187_K18,3,3p22.2,39073032,39183839,110807,-,-
BAC109_L16,3,3p22.2,39150318,39286859,136541,-,-
BAC165_H03,3,3p22.2-3p22.1,39271069,39366788,95719,-,-
BAC136_E20,3,3p22.2-3p22.1,39286861,39375932,89071,-,-
BAC65_G18,3,3p22.1,39310834,39411734,100900,-,-
BAC92_F06,3,3p22.1,39415754,39509305,93551,-,-
BAC30_F22,3,3p22.1,39435569,39509307,73738,-,-
BAC202_D18,3,3p22.1,39440935,39519354,78419,-,-
BAC22_I02,3,3p22.1,39492862,39617545,124683,-,-
BAC20_A09,3,3p22.1,39562526,39635722,73196,-,-
BAC249_F05,3,3p22.1,39669418,39748244,78826,-,-
BAC188_B03,3,3p22.1,39794311,39879725,85414,-,-
BAC42_O18,3,3p22.1,39914341,40004268,89927,-,-
BAC81_C06,3,3p22.1,39914341,40004264,89923,-,-
BAC188_N14,3,3p22.1,39967878,40068210,100332,-,-
BAC230_C08,3,3p22.1,40173860,40258025,84165,-,-
BAC59_K06,3,3p22.1,40320878,40441451,120573,-,-
BAC150_J07,3,3p22.1,40324573,40413133,88560,-,-
BAC143_C12,3,3p22.1,40428908,40540259,111351,-,-
BAC62_K17,3,3p22.1,40439547,40548763,109216,-,-
BAC43_H12,3,3p22.1,40619372,40717790,98418,-,-
BAC18_K01,3,3p22.1,40627310,40716143,88833,-,-
BAC144_D15,3,3p22.1,40635967,40735090,99123,-,-
BAC69_O11,3,3p22.1,40767102,40873389,106287,-,-
BAC51_B08,3,3p22.1,40885882,40990882,105000,-,-
BAC51_B07,3,3p22.1,40953576,41068996,115420,-,-
BAC58_L18,3,3p22.1,40966686,41062630,95944,-,-
BAC175_P21,3,3p22.1,41020986,41113475,92489,-,-
BAC31_G14,3,3p22.1,41031833,41121275,89442,-,-
BAC1_J07,3,3p22.1,41041323,41175790,134467,-,-
BAC171_B21,3,3p22.1,41041323,41151990,110667,-,-
BAC22_C01,3,3p22.1,41060286,41151975,91689,-,-
BAC197_H13,3,3p22.1,41069001,41151990,82989,-,-
BAC158_O13,3,3p22.1,41101139,41195755,94616,-,-
BAC180_A18,3,3p22.1,41233863,41338483,104620,-,-
BAC220_H17,3,3p22.1,41260203,41348702,88499,-,-
BAC70_E14,3,3p22.1,41346778,41449533,102755,-,-
BAC178_F23,3,3p22.1,41348750,41438378,89628,-,-
BAC190_A03,3,3p22.1,41548475,41622668,74193,-,-
BAC86_G21,3,3p22.1,41683186,41809251,126065,-,-
BAC169_C18,3,3p22.1,41699476,41780328,80852,-,-
BAC51_E22,3,3p22.1,41728953,41831010,102057,-,-
BAC184_D05,3,3p22.1,41822395,41937000,114605,-,-
BAC25_A12,3,3p22.1,41831015,41936989,105974,-,-
BAC233_M19,3,3p22.1,41921225,42043539,122314,-,-
BAC96_A08,3,3p22.1,41921982,42015165,93183,-,-
BAC116_M16,3,3p22.1,41932528,42043020,110492,-,-
BAC145_J15,3,3p22.1,41942641,42031212,88571,-,-
BAC194_H04,3,3p22.1,41956569,42037542,80973,-,-
BAC57_B23,3,3p22.1,41988802,42097873,109071,-,-
BAC32_P17,3,3p22.1,42037598,42116715,79117,-,-
BAC96_D10,3,3p22.1,42043530,42160661,117131,-,-
BAC113_F12,3,3p22.1,42053891,42146002,92111,-,-
BAC24_P02,3,3p22.1,42101407,42216360,114953,-,-
BAC30_J15,3,3p22.1,42121887,42217033,95146,-,-
BAC218_K09,3,3p22.1,42154951,42251572,96621,-,-
BAC65_G05,3,3p22.1,42187932,42279714,91782,-,-
BAC101_A04,3,3p22.1,42216356,42304084,87728,-,-
BAC103_L09,3,3p22.1,42221766,42362096,140330,-,-
BAC8_N15,3,3p22.1,42288257,42372052,83795,-,-
BAC219_M22,3,3p22.1,42411491,42497092,85601,-,-
BAC157_H20,3,3p22.1,42411498,42505796,94298,-,-
BAC228_B03,3,3p22.1,42439747,42510109,70362,-,-
BAC167_F22,3,3p22.1,42460332,42556367,96035,-,-
BAC226_M10,3,3p22.1,42529518,42627781,98263,-,-
BAC236_F14,3,3p22.1,42541275,42630238,88963,-,-
BAC202_O08,3,3p22.1,42578969,42669168,90199,-,-
BAC241_M04,3,3p22.1,42630248,42742250,112002,-,-
BAC206_A14,3,3p22.1,42653710,42728086,74376,-,-
BAC208_J14,3,3p22.1,42707760,42801001,93241,-,-
BAC18_N19,3,3p22.1,42804660,42940808,136148,-,-
BAC149_M12,3,3p22.1,42818771,42906962,88191,-,-
BAC67_G08,3,3p22.1,42820674,42906960,86286,-,-
BAC144_O02,3,3p22.1,42824187,42906818,82631,-,-
BAC66_N17,3,3p22.1,42824187,42921281,97094,-,-
BAC236_O01,3,3p22.1,42826380,42906966,80586,-,-
BAC150_M16,3,3p22.1,43018529,43118882,100353,-,-
BAC19_E12,3,3p22.1,43146133,43238668,92535,-,-
BAC129_O08,3,3p22.1,43175854,43293665,117811,-,-
BAC49_D20,3,3p22.1,43175865,43271902,96037,-,-
BAC252_H11,3,3p22.1,43315439,43430746,115307,-,-
BAC89_E15,3,3p22.1,43332436,43444046,111610,-,-
BAC96_L15,3,3p22.1,43337445,43459783,122338,-,-
BAC8_I14,3,3p22.1,43490912,43581892,90980,-,-
BAC233_I14,3,3p22.1-3p21.33,43554445,43658335,103890,-,-
BAC28_N16,3,3p22.1-3p21.33,43581895,43699220,117325,-,-
BAC56_H02,3,3p22.1-3p21.33,43596920,43682673,85753,-,-
BAC152_E13,3,3p21.33,43608569,43712831,104262,-,-
BAC158_P16,3,3p21.33,43614535,43712481,97946,-,-
BAC8_M04,3,3p21.33,43715012,43881251,166239,-,-
BAC137_L21,3,3p21.33,43840706,43929768,89062,-,-
BAC150_J14,3,3p21.33,43877621,43971468,93847,-,-
BAC70_G14,3,3p21.33,43991193,44084333,93140,-,-
BAC57_M07,3,3p21.33,44040575,44137787,97212,-,-
BAC92_J22,3,3p21.33,44069339,44168086,98747,-,-
BAC64_F20,3,3p21.33,44084328,44205895,121567,-,-
BAC175_E10,3,3p21.33,44128597,44204190,75593,-,-
BAC226_N21,3,3p21.33,44137782,44216935,79153,-,-
BAC100_C09,3,3p21.33,44153089,44238660,85571,-,-
BAC17_A08,3,3p21.33,44196947,44237539,40592,-,-
BAC219_O10,3,3p21.33-3p21.32,44343572,44422447,78875,-,-
BAC37_P12,3,3p21.33-3p21.32,44379676,44508244,128568,-,-
BAC117_B02,3,3p21.32,44417713,44552981,135268,-,-
BAC68_E10,3,3p21.32,44422630,44487736,65106,-,-
BAC126_K07,3,3p21.32,44449638,44538137,88499,-,-
BAC240_M04,3,3p21.32,44538520,44637337,98817,-,-
BAC70_F17,3,3p21.32,44552988,44686154,133166,-,-
BAC236_O22,3,3p21.32,44560234,44647413,87179,-,-
BAC103_A19,3,3p21.32,44573522,44667481,93959,-,-
BAC155_D18,3,3p21.32,44581835,44667500,85665,-,-
BAC25_M15,3,3p21.32-3p21.31,44617707,44736290,118583,-,-
BAC46_P18,3,3p21.32-3p21.31,44621544,44736224,114680,-,-
BAC10_A03,3,3p21.32-3p21.31,44668555,44757968,89413,-,-
BAC75_C15,3,3p21.32-3p21.31,44670256,44762175,91919,-,-
BAC100_N14,3,3p21.32-3p21.31,44675320,44762178,86858,-,-
BAC49_M05,3,3p21.31,44740397,44835083,94686,-,-
BAC83_J01,3,3p21.31,44762171,44862447,100276,-,-
BAC167_E04,3,3p21.31,44762174,44849006,86832,-,-
BAC148_I02,3,3p21.31,44861074,44959619,98545,-,-
BAC230_M11,3,3p21.31,44953620,45051384,97764,-,-
BAC247_L15,3,3p21.31,44988410,45090278,101868,-,-
BAC27_O08,3,3p21.31,44995441,45088220,92779,-,-
BAC195_D11,3,3p21.31,45041225,45187265,146040,-,-
BAC43_A20,3,3p21.31,45041232,45165694,124462,-,-
BAC25_M03,3,3p21.31,45051377,45171468,120091,-,-
BAC82_A17,3,3p21.31,45053990,45177099,123109,-,-
BAC155_P01,3,3p21.31,45090272,45187235,96963,-,-
BAC109_M10,3,3p21.31,45096371,45187265,90894,-,-
BAC155_B19,3,3p21.31,45101066,45187265,86199,-,-
BAC237_A01,3,3p21.31,45115916,45223844,107928,-,-
BAC165_L19,3,3p21.31,45140445,45251126,110681,-,-
BAC223_H13,3,3p21.31,45147783,45251089,103306,-,-
BAC63_F09,3,3p21.31,45155881,45292845,136964,-,-
BAC84_I15,3,3p21.31,45165852,45269816,103964,-,-
BAC75_C21,3,3p21.31,45165854,45314621,148767,-,-
BAC97_N23,3,3p21.31,45171473,45269816,98343,-,-
BAC90_A03,3,3p21.31,45171489,45269294,97805,-,-
BAC176_B14,3,3p21.31,45187258,45269814,82556,-,-
BAC142_A08,3,3p21.31,45269807,45426061,156254,-,-
BAC25_L06,3,3p21.31,45294086,45426061,131975,-,-
BAC89_N01,3,3p21.31,45303031,45379288,76257,-,-
BAC149_I15,3,3p21.31,45316813,45390810,73997,-,-
BAC149_N11,3,3p21.31,45329748,45420078,90330,-,-
BAC179_J23,3,3p21.31,45338445,45421556,83111,-,-
BAC84_C10,3,3p21.31,45382633,45465593,82960,-,-
BAC180_D21,3,3p21.31,45391079,45484833,93754,-,-
BAC30_G03,3,3p21.31,45446793,45540017,93224,-,-
BAC190_M08,3,3p21.31,45513152,45595590,82438,-,-
BAC197_I11,3,3p21.31,45534072,45642804,108732,-,-
BAC60_N14,3,3p21.31,45563857,45719969,156112,-,-
BAC24_O10,3,3p21.31,45563912,45670403,106491,-,-
BAC45_M11,3,3p21.31,45593330,45687687,94357,-,-
BAC147_C06,3,3p21.31,45595658,45701357,105699,-,-
BAC240_J02,3,3p21.31,45606611,45701355,94744,-,-
BAC210_L03,3,3p21.31,45607158,45620534,13376,-,-
BAC86_B15,3,3p21.31,45620648,45720340,99692,-,-
BAC50_L10,3,3p21.31,45620651,45710472,89821,-,-
BAC57_G09,3,3p21.31,45624664,45701357,76693,-,-
BAC95_B07,3,3p21.31,45684463,45795435,110972,-,-
BAC130_G20,3,3p21.31,45739491,45833205,93714,-,-
BAC101_I18,3,3p21.31,45881867,45980572,98705,-,-
BAC101_M05,3,3p21.31,45889655,45984614,94959,-,-
BAC248_B20,3,3p21.31,45903380,45989898,86518,-,-
BAC243_E08,3,3p21.31,45904948,45985265,80317,-,-
BAC33_E13,3,3p21.31,45958367,46093042,134675,-,-
BAC106_I08,3,3p21.31,45958367,46082384,124017,-,-
BAC237_I08,3,3p21.31,46017433,46086080,68647,-,-
BAC110_F12,3,3p21.31,46141204,46260923,119719,-,-
BAC234_G04,3,3p21.31,46172835,46261996,89161,-,-
BAC139_O14,3,3p21.31,46251066,46339491,88425,-,-
BAC102_B04,3,3p21.31,46311416,46449242,137826,-,-
BAC186_G23,3,3p21.31,46389108,46492764,103656,-,-
BAC142_G24,3,3p21.31,46391124,46492592,101468,-,-
BAC142_H24,3,3p21.31,46391141,46492570,101429,-,-
BAC8_E05,3,3p21.31,46398581,46577091,178510,-,-
BAC127_L06,3,3p21.31,46401059,46497004,95945,-,-
BAC148_C21,3,3p21.31,46505833,46603080,97247,-,-
BAC236_N10,3,3p21.31,46534149,46645567,111418,-,-
BAC229_A09,3,3p21.31,46566327,46645588,79261,-,-
BAC143_O03,3,3p21.31,46582329,46662263,79934,-,-
BAC80_A05,3,3p21.31,46649491,46782675,133184,yes,-
BAC204_K05,3,3p21.31,46702321,46818823,116502,yes,-
BAC41_F16,3,3p21.31,46805712,46906563,100851,-,-
BAC61_E12,3,3p21.31,46943429,47083823,140394,-,-
BAC143_N11,3,3p21.31,46952403,47037072,84669,-,-
BAC104_K01,3,3p21.31,47183085,47279312,96227,-,-
BAC71_I18,3,3p21.31,47205204,47279827,74623,-,-
BAC169_O05,3,3p21.31,47247965,47353351,105386,-,-
BAC55_J13,3,3p21.31,47312089,47396302,84213,-,-
BAC126_K14,3,3p21.31,47331007,47415899,84892,-,-
BAC63_E09,3,3p21.31,47353375,47502242,148867,-,-
BAC40_P18,3,3p21.31,47404720,47496928,92208,-,-
BAC228_D09,3,3p21.31,47421956,47537281,115325,-,-
BAC246_D02,3,3p21.31,47430583,47506504,75921,-,-
BAC107_A18,3,3p21.31,47497116,47624059,126943,-,-
BAC67_C22,3,3p21.31,47518010,47603153,85143,-,-
BAC204_P15,3,3p21.31,47537502,47623949,86447,-,-
BAC152_E20,3,3p21.31,47564306,47676604,112298,-,-
BAC196_A11,3,3p21.31,47585367,47669853,84486,-,-
BAC109_K18,3,3p21.31,47598511,47682829,84318,-,-
BAC170_F15,3,3p21.31,47612716,47689267,76551,-,-
BAC244_G02,3,3p21.31,47646101,47729192,83091,-,-
BAC158_M20,3,3p21.31,47649554,47757344,107790,-,-
BAC192_G16,3,3p21.31,47651853,47729192,77339,-,-
BAC176_O04,3,3p21.31,47676600,47757344,80744,-,-
BAC249_F16,3,3p21.31,47683101,47789909,106808,-,-
BAC189_B20,3,3p21.31,47817935,47904810,86875,-,-
BAC58_N15,3,3p21.31,47831612,48009567,177955,-,-
BAC196_H01,3,3p21.31,47833609,47927859,94250,-,-
BAC65_O09,3,3p21.31,47833620,47939059,105439,-,-
BAC144_O08,3,3p21.31,47860923,47967185,106262,-,-
BAC76_M11,3,3p21.31,48088067,48211175,123108,-,-
BAC185_G08,3,3p21.31,48134843,48203733,68890,-,-
BAC199_K16,3,3p21.31,48150107,48238177,88070,-,-
BAC193_E19,3,3p21.31,48150107,48239281,89174,-,-
BAC188_E06,3,3p21.31,48241454,48323169,81715,-,-
BAC118_M09,3,3p21.31,48256930,48367894,110964,-,-
BAC67_D05,3,3p21.31,48286182,48470938,184756,-,-
BAC151_G10,3,3p21.31,48287771,48415932,128161,-,-
BAC189_N18,3,3p21.31,48290334,48367894,77560,-,-
BAC227_D05,3,3p21.31,48310595,48415080,104485,-,-
BAC180_N15,3,3p21.31,48331125,48432921,101796,-,-
BAC90_O13,3,3p21.31,48345739,48486856,141117,-,-
BAC101_E23,3,3p21.31,48380241,48473975,93734,-,-
BAC165_H05,3,3p21.31,48473969,48592123,118154,-,-
BAC172_H23,3,3p21.31,48542904,48636687,93783,-,-
BAC145_A04,3,3p21.31,48557842,48646372,88530,-,-
BAC246_E01,3,3p21.31,48592119,48682564,90445,-,-
BAC238_D19,3,3p21.31,48704976,48782991,78015,-,-
BAC22_O16,3,3p21.31,48708341,48795730,87389,-,-
BAC182_H14,3,3p21.31,48772645,48855193,82548,-,-
BAC143_I18,3,3p21.31,48772829,48852151,79322,-,-
BAC175_N18,3,3p21.31,48777081,48857806,80725,-,-
BAC129_B17,3,3p21.31,48803013,48893440,90427,-,-
BAC182_E08,3,3p21.31,48873723,48982214,108491,-,-
BAC247_I24,3,3p21.31,48873728,48965799,92071,-,-
BAC66_O07,3,3p21.31,48873748,48987412,113664,-,-
BAC147_C24,3,3p21.31,48883274,48962969,79695,-,-
BAC90_P14,3,3p21.31,48921685,49017211,95526,-,-
BAC129_N19,3,3p21.31,48941876,49032274,90398,-,-
BAC235_F22,3,3p21.31,48987425,49084968,97543,-,-
BAC196_F03,3,3p21.31,48987591,49080005,92414,-,-
BAC137_I15,3,3p21.31,49014477,49094979,80502,-,-
BAC92_G14,3,3p21.31,49017205,49104168,86963,-,-
BAC32_K18,3,3p21.31,49114630,49226814,112184,-,-
BAC144_A16,3,3p21.31,49130173,49228315,98142,-,-
BAC70_N01,3,3p21.31,49137344,49228163,90819,-,-
BAC111_L09,3,3p21.31,49169863,49319025,149162,-,-
BAC96_D11,3,3p21.31,49178294,49279148,100854,-,-
BAC84_K13,3,3p21.31,49239523,49363589,124066,-,-
BAC59_A21,3,3p21.31,49279143,49379615,100472,-,-
BAC151_D01,3,3p21.31,49322192,49425671,103479,-,-
BAC222_B09,3,3p21.31,49453786,49545297,91511,-,-
BAC50_F05,3,3p21.31,49469756,49634660,164904,-,-
BAC102_F11,3,3p21.31,49528570,49625013,96443,-,-
BAC105_A01,3,3p21.31,49570594,49684193,113599,-,-
BAC153_B17,3,3p21.31,49572513,49687769,115256,-,-
BAC246_K08,3,3p21.31,49700438,49782863,82425,-,-
BAC237_H06,3,3p21.31,49755120,49876660,121540,-,-
BAC218_B02,3,3p21.31,49784192,49871121,86929,-,-
BAC50_F06,3,3p21.31,49850798,49962567,111769,-,-
BAC191_F22,3,3p21.31,49872509,50025760,153251,-,-
BAC50_D20,3,3p21.31,49876655,49994310,117655,-,-
BAC200_O22,3,3p21.31,50025766,50126200,100434,-,-
BAC148_O01,3,3p21.31,50263876,50365383,101507,-,-
BAC70_O13,3,3p21.31,50273942,50363206,89264,-,-
BAC218_K17,3,3p21.31,50275627,50410321,134694,-,-
BAC232_N06,3,3p21.31,50275710,50410321,134611,-,-
BAC238_F22,3,3p21.31,50362374,50439206,76832,-,-
BAC51_K03,3,3p21.31,50362406,50499209,136803,-,-
BAC97_M11,3,3p21.31,50363192,50454528,91336,-,-
BAC143_F10,3,3p21.31,50365381,50437539,72158,-,-
BAC76_G01,3,3p21.31,50630412,50738909,108497,-,-
BAC179_H15,3,3p21.31,50922428,51002003,79575,-,-
BAC176_K05,3,3p21.31,51029935,51122950,93015,-,-
BAC36_N23,3,3p21.31,51114452,51215283,100831,-,-
BAC39_N15,3,3p21.31,51225687,51327341,101654,-,-
BAC80_H11,3,3p21.31,51228684,51351465,122781,-,-
BAC218_O06,3,3p21.31,51259452,51347708,88256,-,-
BAC114_I16,3,3p21.31-3p21.2,51368086,51450429,82343,-,-
BAC58_P05,3,3p21.2,51551301,51658758,107457,-,-
BAC240_H20,3,3p21.2,51572249,51649020,76771,-,-
BAC107_L01,3,3p21.2,51585279,51679329,94050,-,-
BAC49_P24,3,3p21.2-3p21.1,51600444,51703905,103461,-,-
BAC56_O11,3,3p21.2-3p21.1,51642891,51739113,96222,-,-
BAC70_L03,3,3p21.1,51814801,51919884,105083,-,-
BAC122_I15,3,3p21.1,51903913,52002123,98210,-,-
BAC185_A08,3,3p21.1,51915660,52005017,89357,-,-
BAC177_J17,3,3p21.1,51919875,52022171,102296,-,-
BAC20_B01,3,3p21.1,52058209,52191275,133066,-,-
BAC26_B02,3,3p21.1,52058866,52178571,119705,-,-
BAC148_J20,3,3p21.1,52082704,52190842,108138,-,-
BAC218_I07,3,3p21.1,52101169,52211122,109953,-,-
BAC242_I09,3,3p21.1,52103395,52178608,75213,-,-
BAC71_M08,3,3p21.1,52103437,52191309,87872,-,-
BAC224_D11,3,3p21.1,52119987,52221198,101211,-,-
BAC167_L17,3,3p21.1,52268478,52375621,107143,-,-
BAC56_O22,3,3p21.1,52269465,52348758,79293,-,-
BAC116_L19,3,3p21.1,52304392,52467792,163400,-,-
BAC222_M12,3,3p21.1,52335071,52440353,105282,-,-
BAC134_B23,3,3p21.1,52335072,52435028,99956,-,-
BAC144_L22,3,3p21.1,52344226,52440463,96237,-,-
BAC241_O06,3,3p21.1,52375733,52482863,107130,-,-
BAC234_B06,3,3p21.1,52478531,52562479,83948,-,-
BAC197_H20,3,3p21.1,52499829,52581963,82134,-,-
BAC157_E22,3,3p21.1,52552002,52642382,90380,-,-
BAC192_C21,3,3p21.1,52573096,52654562,81466,-,-
BAC119_N19,3,3p21.1,52581958,52700758,118800,-,-
BAC83_I09,3,3p21.1,52581958,52686183,104225,-,-
BAC90_B09,3,3p21.1,52728195,52846484,118289,-,-
BAC130_H14,3,3p21.1,52728896,52858518,129622,-,-
BAC154_N11,3,3p21.1,52768757,52858518,89761,-,-
BAC240_E03,3,3p21.1,52768770,52846487,77717,-,-
BAC194_F21,3,3p21.1,52771734,52892518,120784,-,-
BAC218_D18,3,3p21.1,52791357,52885422,94065,-,-
BAC183_O18,3,3p21.1,52822254,52918998,96744,-,-
BAC142_H03,3,3p21.1,52858512,52941307,82795,-,-
BAC175_B21,3,3p21.1,52914806,52996866,82060,-,-
BAC71_G09,3,3p21.1,52934762,53036446,101684,-,-
BAC103_N17,3,3p21.1,52975306,53109306,134000,-,-
BAC247_J01,3,3p21.1,52986702,53109105,122403,-,-
BAC232_H24,3,3p21.1,53007498,53116631,109133,-,-
BAC123_I05,3,3p21.1,53052493,53242476,189983,-,-
BAC69_J08,3,3p21.1,53160576,53280704,120128,-,-
BAC227_B09,3,3p21.1,53160595,53253941,93346,-,-
BAC238_M04,3,3p21.1,53167772,53242474,74702,-,-
BAC143_P10,3,3p21.1,53196748,53279649,82901,-,-
BAC89_L07,3,3p21.1,53240190,53357169,116979,-,-
BAC148_F23,3,3p21.1,53242548,53353249,110701,-,-
BAC185_J20,3,3p21.1,53244842,53357183,112341,-,-
BAC240_N01,3,3p21.1,53353260,53446371,93111,-,-
BAC226_K24,3,3p21.1,53357277,53446358,89081,-,-
BAC32_B17,3,3p21.1,53366958,53457598,90640,-,-
BAC142_P07,3,3p21.1,53454603,53562332,107729,-,-
BAC107_C08,3,3p21.1,53458806,53540943,82137,-,-
BAC107_C12,3,3p21.1,53458806,53540943,82137,-,-
BAC237_L14,3,3p21.1,53581485,53680046,98561,-,-
BAC196_F10,3,3p21.1,53608567,53720315,111748,-,-
BAC154_I01,3,3p21.1,53641139,53737563,96424,-,-
BAC192_C15,3,3p21.1,53643338,53737542,94204,-,-
BAC173_C05,3,3p21.1,53643338,53737993,94655,-,-
BAC143_P01,3,3p21.1,53682645,53826409,143764,-,-
BAC186_N05,3,3p21.1,53696599,53834500,137901,-,-
BAC62_G05,3,3p21.1,53721814,53800349,78535,-,-
BAC229_D03,3,3p21.1,53737558,53834798,97240,-,-
BAC56_G10,3,3p21.1,53737558,53845359,107801,-,-
BAC220_H15,3,3p21.1,53843773,53928216,84443,-,-
BAC19_N13,3,3p21.1,53932638,54022499,89861,-,-
BAC104_F23,3,3p21.1,54021515,54099941,78426,-,-
BAC24_F04,3,3p21.1,54061810,54225199,163389,-,-
BAC60_C17,3,3p21.1,54082672,54200114,117442,-,-
BAC129_K15,3,3p21.1,54116286,54198261,81975,-,-
BAC157_F09,3,3p21.1,54119010,54200114,81104,-,-
BAC50_O19,3,3p21.1,54303999,54388874,84875,-,-
BAC81_N07,3,3p21.1,54317219,54391066,73847,-,-
BAC31_M22,3,3p21.1-3p14.3,54324828,54418905,94077,-,-
BAC171_C21,3,3p21.1-3p14.3,54388872,54483682,94810,-,-
BAC168_O24,3,3p14.3,54438622,54549424,110802,-,-
BAC133_L04,3,3p14.3,54475735,54570538,94803,-,-
BAC194_G11,3,3p14.3,54477796,54590219,112423,-,-
BAC82_N23,3,3p14.3,54587733,54707982,120249,-,-
BAC250_E03,3,3p14.3,54587737,54695381,107644,-,-
BAC230_P10,3,3p14.3,54587807,54679157,91350,-,-
BAC221_O15,3,3p14.3,54617688,54714756,97068,-,-
BAC14_A05,3,3p14.3,54634363,54727179,92816,-,-
BAC78_N10,3,3p14.3,54689518,54840475,150957,-,-
BAC165_A13,3,3p14.3,54716785,54791762,74977,-,-
BAC27_O06,3,3p14.3,54768612,54894050,125438,-,-
BAC27_E14,3,3p14.3,54791863,54905107,113244,-,-
BAC152_G04,3,3p14.3,54793228,54894747,101519,-,-
BAC96_D23,3,3p14.3,54798672,54905486,106814,-,-
BAC244_B01,3,3p14.3,54821317,54918382,97065,-,-
BAC61_A05,3,3p14.3,54840498,54954718,114220,-,-
BAC113_O13,3,3p14.3,54851155,54968700,117545,-,-
BAC63_E13,3,3p14.3,54916909,55025500,108591,-,-
BAC199_C10,3,3p14.3,55081854,55170976,89122,-,-
BAC226_M05,3,3p14.3,55105320,55200595,95275,-,-
BAC142_A15,3,3p14.3,55154524,55246497,91973,-,-
BAC127_G02,3,3p14.3,55210128,55294394,84266,-,-
BAC233_M10,3,3p14.3,55257671,55333211,75540,-,-
BAC145_P09,3,3p14.3,55258048,55342886,84838,-,-
BAC218_L01,3,3p14.3,55359855,55435764,75909,-,-
BAC135_A11,3,3p14.3,55396157,55484588,88431,-,-
BAC250_G04,3,3p14.3,55435974,55545066,109092,-,-
BAC42_C07,3,3p14.3,55505959,55609817,103858,-,-
BAC135_A06,3,3p14.3,55590704,55673456,82752,-,-
BAC167_A08,3,3p14.3,55590712,55691344,100632,-,-
BAC53_O16,3,3p14.3,55590761,55695389,104628,-,-
BAC235_B05,3,3p14.3,55645714,55718513,72799,-,-
BAC242_E02,3,3p14.3,55700916,55804256,103340,-,-
BAC133_K11,3,3p14.3,55725097,55805926,80829,-,-
BAC117_E10,3,3p14.3,55804249,55914129,109880,-,-
BAC34_B07,3,3p14.3,56090350,56185335,94985,-,-
BAC34_A08,3,3p14.3,56090350,56185352,95002,-,-
BAC34_B08,3,3p14.3,56090350,56185334,94984,-,-
BAC61_F02,3,3p14.3,56130812,56232347,101535,-,-
BAC41_B24,3,3p14.3,56130815,56232370,101555,-,-
BAC75_A17,3,3p14.3,56266486,56372268,105782,-,-
BAC26_E02,3,3p14.3,56422540,56517808,95268,-,-
BAC26_F14,3,3p14.3,56478841,56567925,89084,-,-
BAC200_G04,3,3p14.3,56478851,56567930,89079,-,-
BAC10_A11,3,3p14.3,56503625,56623265,119640,-,-
BAC116_B13,3,3p14.3,56556581,56632835,76254,-,-
BAC127_B10,3,3p14.3,56632831,56728898,96067,-,-
BAC64_G04,3,3p14.3,56813876,56934682,120806,-,-
BAC124_D22,3,3p14.3,56835141,56979772,144631,-,-
BAC167_G07,3,3p14.3,56846943,56934682,87739,-,-
BAC189_B22,3,3p14.3,56849237,56924092,74855,-,-
BAC203_H09,3,3p14.3,56937288,57019959,82671,-,-
BAC142_E04,3,3p14.3,56944517,57033304,88787,-,-
BAC10_B12,3,3p14.3,56944517,57082264,137747,-,-
BAC193_I13,3,3p14.3,57019962,57110015,90053,-,-
BAC158_G19,3,3p14.3,57024094,57120468,96374,-,-
BAC162_L13,3,3p14.3,57028606,57120499,91893,-,-
BAC186_A23,3,3p14.3,57045215,57089941,44726,-,-
BAC86_B22,3,3p14.3,57068534,57199698,131164,-,-
BAC156_N07,3,3p14.3,57098269,57232218,133949,-,-
BAC214_K19,3,3p14.3,57153620,57231994,78374,-,-
BAC103_C13,3,3p14.3,57173272,57256897,83625,-,-
BAC250_K17,3,3p14.3,57232472,57321750,89278,-,-
BAC221_E16,3,3p14.3,57371920,57458445,86525,-,-
BAC71_K04,3,3p14.3,57449743,57541026,91283,-,-
BAC81_O16,3,3p14.3,57478356,57588472,110116,-,-
BAC165_N03,3,3p14.3,57478356,57555498,77142,-,-
BAC229_O17,3,3p14.3,57479564,57562472,82908,-,-
BAC119_C12,3,3p14.3,57618279,57707668,89389,-,-
BAC237_E23,3,3p14.3,57618282,57707672,89390,-,-
BAC99_J12,3,3p14.3,57620477,57733758,113281,-,-
BAC211_L16,3,3p14.3,57649403,57733402,83999,-,-
BAC234_P14,3,3p14.3,57733752,57816144,82392,-,-
BAC178_M17,3,3p14.3,57793217,57896733,103516,-,-
BAC37_H08,3,3p14.3,57797679,57885530,87851,-,-
BAC26_M04,3,3p14.3,57855676,57992655,136979,-,-
BAC70_L12,3,3p14.3,57889100,58043760,154660,-,-
BAC36_A07,3,3p14.3,57889100,58118650,229550,-,-
BAC196_M13,3,3p14.3,57903963,57984065,80102,-,-
BAC143_J08,3,3p14.3,57903966,58020606,116640,-,-
BAC95_H04,3,3p14.3,57914127,58010246,96119,-,-
BAC103_L11,3,3p14.3,58043764,58166842,123078,-,-
BAC140_O21,3,3p14.3,58049149,58114584,65435,-,-
BAC135_I08,3,3p14.3,58110064,58211824,101760,-,-
BAC120_H03,3,3p14.3,58110076,58254818,144742,-,-
BAC146_N22,3,3p14.3,58145825,58254777,108952,-,-
BAC217_C10,3,3p14.3,58185314,58285494,100180,-,-
BAC101_O04,3,3p14.3,58241749,58382914,141165,-,-
BAC147_N11,3,3p14.3,58254843,58353327,98484,-,-
BAC150_C12,3,3p14.3,58334332,58418155,83823,-,-
BAC169_N05,3,3p14.3-3p14.2,58486283,58584727,98444,-,-
BAC110_J02,3,3p14.3-3p14.2,58487177,58607509,120332,-,-
BAC62_O13,3,3p14.2,58581168,58677525,96357,-,-
BAC83_B02,3,3p14.2,58701770,58791946,90176,-,-
BAC139_E22,3,3p14.2,58713684,58796583,82899,-,-
BAC68_O15,3,3p14.2,58806580,58917414,110834,-,-
BAC37_M07,3,3p14.2,58837517,58996711,159194,-,-
BAC113_C08,3,3p14.2,59039924,59116168,76244,-,-
BAC133_A19,3,3p14.2,59066121,59186393,120272,-,-
BAC166_O20,3,3p14.2,59104687,59154010,49323,-,-
BAC162_L09,3,3p14.2,59109055,59220599,111544,-,-
BAC124_D17,3,3p14.2,59277103,59365904,88801,-,-
BAC191_M07,3,3p14.2,59329366,59384973,55607,-,-
BAC160_H02,3,3p14.2,59425746,59505886,80140,-,-
BAC142_C12,3,3p14.2,59425746,59530091,104345,-,-
BAC142_D12,3,3p14.2,59425746,59530091,104345,-,-
BAC219_O13,3,3p14.2,59505951,59621160,115209,-,-
BAC119_A12,3,3p14.2,59511325,59637464,126139,-,-
BAC24_K03,3,3p14.2,59552338,59674888,122550,-,-
BAC224_H13,3,3p14.2,59602239,59699533,97294,-,-
BAC163_E13,3,3p14.2,59637456,59720833,83377,-,-
BAC13_G22,3,3p14.2,59784748,59897671,112923,-,-
BAC165_E03,3,3p14.2,59792214,59928357,136143,-,-
BAC10_J24,3,3p14.2,59812605,59928356,115751,-,-
BAC125_A06,3,3p14.2,59996667,60098383,101716,-,-
BAC132_D23,3,3p14.2,60005818,60095721,89903,-,-
BAC145_G01,3,3p14.2,60106100,60203600,97500,-,-
BAC135_N15,3,3p14.2,60147721,60234380,86659,-,-
BAC149_O13,3,3p14.2,60278574,60370726,92152,-,-
BAC148_J08,3,3p14.2,60313290,60385290,72000,-,-
BAC107_H04,3,3p14.2,60506538,60606660,100122,-,-
BAC173_O05,3,3p14.2,60561309,60643813,82504,-,-
BAC76_P18,3,3p14.2,60608838,60757055,148217,-,-
BAC188_H03,3,3p14.2,60632147,60716332,84185,-,-
BAC218_B22,3,3p14.2,60642283,60757056,114773,-,-
BAC152_F11,3,3p14.2,60643809,60741982,98173,-,-
BAC37_P18,3,3p14.2,60651406,60741992,90586,-,-
BAC183_C12,3,3p14.2,60674845,60750489,75644,-,-
BAC170_L21,3,3p14.2,60837188,60925816,88628,-,-
BAC107_N03,3,3p14.2,60921148,60945052,23904,-,-
BAC55_B13,3,3p14.2,60930275,61015515,85240,-,-
BAC140_M16,3,3p14.2,61034347,61116696,82349,-,-
BAC179_E12,3,3p14.2,61112435,61208555,96120,-,-
BAC196_K14,3,3p14.2,61186660,61256434,69774,-,-
BAC119_D11,3,3p14.2,61224587,61330642,106055,-,-
BAC28_D05,3,3p14.2,61242050,61334878,92828,-,-
BAC40_M06,3,3p14.2,61259167,61404718,145551,-,-
BAC170_G16,3,3p14.2,61305550,61415867,110317,-,-
BAC22_G20,3,3p14.2,61335900,61449544,113644,-,-
BAC101_C24,3,3p14.2,61378377,61481819,103442,-,-
BAC247_G13,3,3p14.2,61475190,61621354,146164,-,-
BAC120_C15,3,3p14.2,61481921,61627131,145210,-,-
BAC143_E13,3,3p14.2,61490220,61627141,136921,-,-
BAC165_H13,3,3p14.2,61553769,61641768,87999,-,-
BAC101_F17,3,3p14.2,61553769,61639844,86075,-,-
BAC144_A13,3,3p14.2,61587829,61719675,131846,-,-
BAC51_M14,3,3p14.2,61627148,61724877,97729,-,-
BAC75_D14,3,3p14.2,61639914,61730721,90807,-,-
BAC198_B16,3,3p14.2,61639914,61733417,93503,-,-
BAC187_I07,3,3p14.2,61699507,61771162,71655,-,-
BAC120_F06,3,3p14.2,61733466,61856984,123518,-,-
BAC8_G11,3,3p14.2,61838389,61948021,109632,-,-
BAC88_E03,3,3p14.2,61881878,61968463,86585,-,-
BAC32_J05,3,3p14.2,61908227,62007803,99576,-,-
BAC82_L24,3,3p14.2,61915575,62006518,90943,-,-
BAC184_M15,3,3p14.2,62058817,62164752,105935,-,-
BAC220_B04,3,3p14.2,62143756,62217666,73910,-,-
BAC132_C02,3,3p14.2,62220229,62315101,94872,-,-
BAC33_A17,3,3p14.2,62244130,62313648,69518,-,-
BAC148_I06,3,3p14.2,62298854,62394789,95935,-,-
BAC90_O02,3,3p14.2,62317924,62416462,98538,-,-
BAC103_F06,3,3p14.2,62398546,62502148,103602,-,-
BAC131_L09,3,3p14.2,62419659,62511907,92248,-,-
BAC95_P08,3,3p14.2,62491440,62590472,99032,-,-
BAC187_P14,3,3p14.2,62513525,62602825,89300,-,-
BAC59_K17,3,3p14.2,62599631,62691256,91625,-,-
BAC113_P17,3,3p14.2,62622174,62705149,82975,-,-
BAC66_F02,3,3p14.2,62651562,62745046,93484,-,-
BAC78_J09,3,3p14.2,62651749,62741066,89317,-,-
BAC19_L19,3,3p14.2,62688151,62814672,126521,-,-
BAC1_F02,3,3p14.2,62728253,62827281,99028,-,-
BAC124_M03,3,3p14.2,62814896,62952120,137224,-,-
BAC197_M04,3,3p14.2,62849663,62946635,96972,-,-
BAC21_O21,3,3p14.2,62916479,63008365,91886,-,-
BAC86_M11,3,3p14.2,62916482,63025294,108812,-,-
BAC175_C14,3,3p14.2,62960866,63079770,118904,-,-
BAC73_M11,3,3p14.2,63273518,63424449,150931,-,-
BAC114_O20,3,3p14.2,63330938,63417761,86823,-,-
BAC215_C03,3,3p14.2,63415500,63439090,23590,-,-
BAC170_A12,3,3p14.2,63431328,63522072,90744,-,-
BAC24_I05,3,3p14.2,63575646,63685647,110001,-,-
BAC165_I05,3,3p14.1,63927977,64045090,117113,-,-
BAC34_P24,3,3p14.1,63928114,64042162,114048,-,-
BAC2_N03,3,3p14.1,63928122,64010399,82277,-,-
BAC38_P14,3,3p14.1,63936592,64040401,103809,-,-
BAC128_P03,3,3p14.1,63971812,64081339,109527,-,-
BAC67_O08,3,3p14.1,64040438,64153800,113362,-,-
BAC232_D14,3,3p14.1,64182298,64257662,75364,-,-
BAC26_G11,3,3p14.1,64185673,64296277,110604,-,-
BAC200_J04,3,3p14.1,64213041,64300983,87942,-,-
BAC17_L22,3,3p14.1,64281693,64415366,133673,-,-
BAC101_G04,3,3p14.1,64296525,64415562,119037,-,-
BAC31_I02,3,3p14.1,64296534,64406853,110319,-,-
BAC109_M19,3,3p14.1,64300976,64397877,96901,-,-
BAC36_H09,3,3p14.1,64356894,64456233,99339,-,-
BAC144_J07,3,3p14.1,64387938,64469262,81324,-,-
BAC100_A20,3,3p14.1,64406846,64498290,91444,-,-
BAC132_K11,3,3p14.1,64469257,64581263,112006,-,-
BAC190_F16,3,3p14.1,64498284,64581704,83420,-,-
BAC219_P20,3,3p14.1,64498577,64597925,99348,-,-
BAC197_K22,3,3p14.1,64500583,64602977,102394,-,-
BAC63_H12,3,3p14.1,64600491,64719599,119108,-,-
BAC25_C10,3,3p14.1,64609155,64702871,93716,-,-
BAC218_G14,3,3p14.1,64833966,64966784,132818,-,-
BAC62_P04,3,3p14.1,64871107,64968130,97023,-,-
BAC220_P15,3,3p14.1,64926905,65015798,88893,-,-
BAC190_J10,3,3p14.1,65008946,65081615,72669,-,-
BAC17_D15,3,3p14.1,65054362,65190288,135926,-,-
BAC127_J19,3,3p14.1,65060453,65180743,120290,-,-
BAC163_I09,3,3p14.1,65170113,65238531,68418,-,-
BAC134_I20,3,3p14.1,65196684,65291228,94544,-,-
BAC50_O20,3,3p14.1,65203596,65286280,82684,-,-
BAC59_C16,3,3p14.1,65239423,65360763,121340,-,-
BAC51_N12,3,3p14.1,65257922,65355224,97302,-,-
BAC244_A15,3,3p14.1,65286339,65357856,71517,-,-
BAC82_E13,3,3p14.1,65342149,65437349,95200,-,-
BAC42_J15,3,3p14.1,65405262,65556895,151633,-,-
BAC148_K06,3,3p14.1,65556125,65634811,78686,-,-
BAC42_B20,3,3p14.1,65565701,65658229,92528,-,-
BAC127_P02,3,3p14.1,65702515,65883905,181390,-,-
BAC44_M10,3,3p14.1,65793372,65883927,90555,-,-
BAC54_O11,3,3p14.1,65812172,65937559,125387,-,-
BAC132_K15,3,3p14.1,65840224,65951180,110956,-,-
BAC162_A19,3,3p14.1,65865629,65951180,85551,-,-
BAC191_F05,3,3p14.1,65877780,65930342,52562,-,-
BAC222_F10,3,3p14.1,65930348,66040271,109923,-,-
BAC127_O01,3,3p14.1,65931262,66072245,140983,-,-
BAC136_E24,3,3p14.1,65985054,66080138,95084,-,-
BAC77_J20,3,3p14.1,66467751,66566993,99242,-,-
BAC11_B10,3,3p14.1,66487285,66566949,79664,-,-
BAC243_D22,3,3p14.1,66516643,66601946,85303,-,-
BAC237_L16,3,3p14.1,66516643,66601946,85303,-,-
BAC144_B02,3,3p14.1,66533357,66619320,85963,-,-
BAC84_L08,3,3p14.1,66540148,66656671,116523,-,-
BAC124_D24,3,3p14.1,66558462,66629115,70653,-,-
BAC78_F16,3,3p14.1,66558474,66654886,96412,-,-
BAC28_N09,3,3p14.1,66602018,66762998,160980,-,-
BAC64_A14,3,3p14.1,66623842,66762998,139156,-,-
BAC90_N20,3,3p14.1,66623860,66714800,90940,-,-
BAC237_E22,3,3p14.1,66635488,66730270,94782,-,-
BAC21_B18,3,3p14.1,66656766,66743057,86291,-,-
BAC24_L23,3,3p14.1,66710927,66816304,105377,-,-
BAC195_O19,3,3p14.1,66726516,66816228,89712,-,-
BAC50_B01,3,3p14.1,66728344,66823124,94780,-,-
BAC210_G08,3,3p14.1,66820209,66904081,83872,-,-
BAC46_J14,3,3p14.1,66846896,66984284,137388,-,-
BAC156_P18,3,3p14.1,66888800,66985610,96810,-,-
BAC198_P17,3,3p14.1,66913074,66995975,82901,-,-
BAC86_E03,3,3p14.1,67073128,67178081,104953,-,-
BAC42_D20,3,3p14.1,67110689,67231381,120692,-,-
BAC229_J03,3,3p14.1,67167573,67246744,79171,-,-
BAC13_B01,3,3p14.1,67225453,67326166,100713,-,-
BAC121_A05,3,3p14.1,67263766,67368911,105145,-,-
BAC203_A02,3,3p14.1,67409432,67499998,90566,-,-
BAC20_L02,3,3p14.1,67559245,67689567,130322,-,-
BAC139_O16,3,3p14.1,67565921,67650411,84490,-,-
BAC183_J22,3,3p14.1,67720963,67838577,117614,-,-
BAC59_O15,3,3p14.1,67725246,67808304,83058,-,-
BAC234_M11,3,3p14.1,67725246,67814317,89071,-,-
BAC95_J11,3,3p14.1,67857301,67977957,120656,-,-
BAC100_J17,3,3p14.1,67977956,68065609,87653,-,-
BAC29_F05,3,3p14.1,67982045,68065609,83564,-,-
BAC31_F17,3,3p14.1,68116119,68200315,84196,-,-
BAC104_I14,3,3p14.1,68142185,68240275,98090,-,-
BAC189_O07,3,3p14.1,68155604,68245331,89727,-,-
BAC104_I22,3,3p14.1,68357739,68469857,112118,-,-
BAC27_A10,3,3p14.1,68490927,68605139,114212,-,-
BAC221_J03,3,3p14.1,68605134,68679635,74501,-,-
BAC22_I19,3,3p14.1,68657764,68800287,142523,-,-
BAC83_K22,3,3p14.1,68670803,68778131,107328,-,-
BAC26_E03,3,3p14.1,68724817,68881583,156766,-,-
BAC19_G19,3,3p14.1,68735901,68833092,97191,-,-
BAC93_D17,3,3p14.1,68803561,68965019,161458,-,-
BAC27_E04,3,3p14.1,69025614,69210093,184479,-,-
BAC58_O24,3,3p14.1,69036142,69137546,101404,-,-
BAC53_I20,3,3p14.1,69063529,69159520,95991,-,-
BAC113_K13,3,3p14.1,69137544,69210093,72549,-,-
BAC46_N16,3,3p14.1,69317400,69449548,132148,-,-
BAC150_K08,3,3p14.1,69325568,69410909,85341,-,-
BAC106_J12,3,3p14.1,69341046,69468050,127004,-,-
BAC40_B17,3,3p14.1,69401279,69541244,139965,-,-
BAC176_E05,3,3p14.1,69411160,69502507,91347,-,-
BAC145_E09,3,3p14.1,69510773,69595086,84313,-,-
BAC223_K18,3,3p14.1,69613830,69689995,76165,-,-
BAC132_B17,3,3p14.1,69640459,69746095,105636,-,-
BAC252_F19,3,3p14.1,69677296,69765575,88279,-,-
BAC41_M11,3,3p14.1,69708562,69825646,117084,-,-
BAC45_H18,3,3p14.1,69750284,69890373,140089,-,-
BAC102_N15,3,3p14.1,70121572,70216766,95194,-,-
BAC195_J11,3,3p14.1,70231482,70344800,113318,-,-
BAC190_F06,3,3p14.1,70344793,70431523,86730,-,-
BAC76_A17,3,3p14.1,70413228,70429631,16403,-,-
BAC2_J06,3,3p14.1,71009122,71098082,88960,-,-
BAC102_H20,3,3p14.1,71016783,71122850,106067,-,-
BAC56_J15,3,3p14.1,71033158,71130343,97185,-,-
BAC211_H15,3,3p14.1,71045285,71132142,86857,-,-
BAC95_D05,3,3p14.1,71245147,71334788,89641,-,-
BAC30_K01,3,3p14.1,71271029,71364371,93342,-,-
BAC176_N12,3,3p14.1,71272583,71390987,118404,-,-
BAC102_I04,3,3p14.1,71288309,71427444,139135,-,-
BAC18_L12,3,3p14.1,71321074,71404324,83250,-,-
BAC29_A12,3,3p14.1,71328945,71428649,99704,-,-
BAC73_J14,3,3p14.1,71334794,71454737,119943,-,-
BAC30_C11,3,3p14.1,71360823,71499338,138515,-,-
BAC20_A23,3,3p14.1,71374622,71478908,104286,-,-
BAC113_C05,3,3p14.1,71427449,71518582,91133,-,-
BAC191_E16,3,3p14.1,71497314,71570583,73269,-,-
BAC42_O04,3,3p14.1,71614228,71696356,82128,-,-
BAC49_P11,3,3p14.1,71626221,71729679,103458,-,-
BAC228_L05,3,3p14.1-3p13,71736430,71843231,106801,-,-
BAC224_O16,3,3p14.1-3p13,71798883,71865307,66424,-,-
BAC37_G21,3,3p13,71826887,71971564,144677,-,-
BAC79_E08,3,3p13,71915396,72021250,105854,-,-
BAC163_J23,3,3p13,71947314,72022943,75629,-,-
BAC214_H05,3,3p13,71961270,72073200,111930,-,-
BAC50_N08,3,3p13,71971395,72074827,103432,-,-
BAC219_D07,3,3p13,71977117,72063777,86660,-,-
BAC144_B06,3,3p13,72014395,72098745,84350,-,-
BAC40_L14,3,3p13,72020071,72107088,87017,-,-
BAC160_G19,3,3p13,72045064,72120577,75513,-,-
BAC126_G17,3,3p13,72081231,72184191,102960,-,-
BAC118_K15,3,3p13,72120879,72211867,90988,-,-
BAC241_E04,3,3p13,72174023,72269123,95100,-,-
BAC224_L09,3,3p13,72198351,72283194,84843,-,-
BAC248_F05,3,3p13,72215134,72327595,112461,-,-
BAC60_K17,3,3p13,72244859,72345799,100940,-,-
BAC244_L02,3,3p13,72250414,72351543,101129,-,-
BAC244_D01,3,3p13,72258790,72345799,87009,-,-
BAC137_E12,3,3p13,72275619,72392001,116382,-,-
BAC196_G01,3,3p13,72286925,72403135,116210,-,-
BAC30_L16,3,3p13,72310838,72397687,86849,-,-
BAC228_L10,3,3p13,72323784,72410305,86521,-,-
BAC83_P18,3,3p13,72403132,72493177,90045,-,-
BAC24_J11,3,3p13,72446903,72551466,104563,-,-
BAC208_B08,3,3p13,72513849,72614790,100941,-,-
BAC101_B23,3,3p13,72554540,72660674,106134,-,-
BAC221_F02,3,3p13,72652173,72738415,86242,-,-
BAC34_H23,3,3p13,72652183,72770827,118644,-,-
BAC234_D10,3,3p13,72665292,72751037,85745,-,-
BAC209_K17,3,3p13,72678201,72770432,92231,-,-
BAC132_O14,3,3p13,72722347,72828044,105697,-,-
BAC56_H12,3,3p13,72771234,72913604,142370,-,-
BAC41_F03,3,3p13,72773467,72865060,91593,-,-
BAC211_H03,3,3p13,72780888,72865095,84207,-,-
BAC243_F01,3,3p13,72830636,72898068,67432,-,-
BAC123_H09,3,3p13,72846982,72972401,125419,-,-
BAC147_D11,3,3p13,72855583,72977671,122088,-,-
BAC64_L02,3,3p13,72892451,73027764,135313,-,-
BAC170_J09,3,3p13,72935098,73010118,75020,-,-
BAC196_D21,3,3p13,72970357,73055255,84898,-,-
BAC52_B02,3,3p13,73009108,73123351,114243,-,-
BAC90_I19,3,3p13,73010128,73143642,133514,-,-
BAC83_N06,3,3p13,73014639,73161830,147191,-,-
BAC208_D14,3,3p13,73022344,73115486,93142,-,-
BAC247_A01,3,3p13,73030106,73112891,82785,-,-
BAC235_H24,3,3p13,73059350,73181576,122226,-,-
BAC70_L16,3,3p13,73059398,73230500,171102,-,-
BAC226_A17,3,3p13,73141481,73230538,89057,-,-
BAC199_J03,3,3p13,73143413,73244251,100838,-,-
BAC228_F06,3,3p13,73182770,73278808,96038,-,-
BAC119_J09,3,3p13,73183836,73334763,150927,-,-
BAC167_D08,3,3p13,73198635,73278765,80130,-,-
BAC148_I23,3,3p13,73213781,73289360,75579,-,-
BAC22_E05,3,3p13,73230532,73356801,126269,-,-
BAC40_C18,3,3p13,73245148,73362871,117723,-,-
BAC80_I03,3,3p13,73284929,73399182,114253,-,-
BAC57_P16,3,3p13,73362948,73469384,106436,-,-
BAC234_F05,3,3p13,73365751,73458407,92656,-,-
BAC181_O23,3,3p13,73365751,73469506,103755,-,-
BAC101_F08,3,3p13,73365751,73469506,103755,-,-
BAC66_O18,3,3p13,73386659,73489369,102710,-,-
BAC78_A14,3,3p13,73458424,73552364,93940,-,-
BAC181_D21,3,3p13,73470068,73578154,108086,-,-
BAC92_E21,3,3p13,73474340,73560500,86160,-,-
BAC148_A15,3,3p13,73489366,73597886,108520,-,-
BAC37_D02,3,3p13,73505220,73590453,85233,-,-
BAC109_J04,3,3p13,73590444,73734311,143867,-,-
BAC244_J10,3,3p13,73600500,73690628,90128,-,-
BAC114_B23,3,3p13,73635347,73736476,101129,-,-
BAC135_O11,3,3p13,73646572,73746099,99527,-,-
BAC169_P16,3,3p13,73653189,73736494,83305,-,-
BAC179_H02,3,3p13,73679661,73758613,78952,-,-
BAC64_E08,3,3p13,73690623,73774307,83684,-,-
BAC123_P14,3,3p13,73736484,73823755,87271,-,-
BAC247_J08,3,3p13,73867536,73986682,119146,-,-
BAC36_E18,3,3p13,73991570,74084698,93128,-,-
BAC125_G15,3,3p13,74049111,74155739,106628,-,-
BAC18_F16,3,3p13,74073774,74173257,99483,-,-
BAC137_J08,3,3p13,74086837,74173252,86415,-,-
BAC171_O20,3,3p13-3p12.3,74146890,74229983,83093,-,-
BAC38_I13,3,3p13-3p12.3,74178027,74253903,75876,yes,-
BAC71_A02,3,3p12.3,74202480,74213777,11297,-,-
BAC163_G16,3,3p12.3,74220987,74309986,88999,-,-
BAC172_L20,3,3p12.3,74328340,74416826,88486,-,-
BAC30_D19,3,3p12.3,74355553,74436102,80549,-,-
BAC78_G23,3,3p12.3,74416873,74547115,130242,-,-
BAC65_J02,3,3p12.3,74423797,74510733,86936,-,-
BAC125_F05,3,3p12.3,74700328,74816243,115915,-,-
BAC192_O20,3,3p12.3,74818616,74906420,87804,-,-
BAC19_A09,3,3p12.3,74833499,74937279,103780,-,-
BAC70_P03,3,3p12.3,74941501,75082627,141126,-,-
BAC235_M10,3,3p12.3,75147715,75228090,80375,-,-
BAC55_C18,3,3p12.3,75177225,75327273,150048,-,-
BAC252_K14,3,3p12.3,75413575,75538984,125409,-,-
BAC242_I10,3,3p12.3,75439077,75538689,99612,-,-
BAC23_K02,3,3p12.3,75455844,75549030,93186,-,-
BAC196_B19,3,3p12.3,75457781,75538987,81206,-,-
BAC118_A02,3,3p12.3,75482455,75614960,132505,-,-
BAC83_M07,3,3p12.3,75483724,75576172,92448,-,-
BAC228_F07,3,3p12.3,75492707,75576172,83465,-,-
BAC84_C05,3,3p12.3,75526335,75581657,55322,-,-
BAC81_I21,3,3p12.3,75592789,75689678,96889,-,-
BAC106_K16,3,3p12.3,75736636,75815223,78587,-,-
BAC92_I15,3,3p12.3,75773345,75901971,128626,-,-
BAC242_H18,3,3p12.3,75776025,75814507,38482,-,-
BAC107_P01,3,3p12.3,75808308,75949086,140778,-,-
BAC161_L16,3,3p12.3,75813665,75918516,104851,-,-
BAC139_B02,3,3p12.3,75872430,75886192,13762,-,-
BAC73_L08,3,3p12.3,76092283,76217243,124960,-,-
BAC151_C02,3,3p12.3,76221589,76292375,70786,-,-
BAC223_B07,3,3p12.3,76704504,76789200,84696,-,-
BAC61_H24,3,3p12.3,76735586,76857458,121872,-,-
BAC76_J06,3,3p12.3,76739164,76850081,110917,-,-
BAC68_A08,3,3p12.3,77145511,77229830,84319,-,-
BAC172_F05,3,3p12.3,77350259,77429424,79165,-,-
BAC114_M07,3,3p12.3,77357692,77465003,107311,-,-
BAC147_A08,3,3p12.3,77489529,77588183,98654,-,-
BAC153_P16,3,3p12.3,77577219,77660205,82986,-,-
BAC183_B22,3,3p12.3,77814368,77905275,90907,-,-
BAC166_D03,3,3p12.3,77870467,77977078,106611,-,-
BAC154_C23,3,3p12.3,77939048,78053714,114666,-,-
BAC25_E24,3,3p12.3,77939048,78083579,144531,-,-
BAC179_O23,3,3p12.3,78082053,78190891,108838,-,-
BAC153_H11,3,3p12.3,78181627,78194589,12962,-,-
BAC95_B19,3,3p12.3,78273244,78360951,87707,-,-
BAC101_E24,3,3p12.3,78312305,78399194,86889,-,-
BAC149_N21,3,3p12.3,78336281,78438439,102158,-,-
BAC153_C21,3,3p12.3,78341564,78438721,97157,-,-
BAC252_J15,3,3p12.3,78354891,78438441,83550,-,-
BAC161_A07,3,3p12.3,78453776,78552805,99029,-,-
BAC46_C13,3,3p12.3,78542077,78605843,63766,-,-
BAC7_A17,3,3p12.3,78548729,78734129,185400,-,-
BAC179_C01,3,3p12.3,78677370,78766037,88667,-,-
BAC226_E12,3,3p12.3,78678118,78766037,87919,-,-
BAC217_D21,3,3p12.3,78700935,78815679,114744,-,-
BAC248_N19,3,3p12.3,78718191,78803345,85154,-,-
BAC56_C15,3,3p12.3,78780010,78907516,127506,-,-
BAC49_K18,3,3p12.3,79007255,79126501,119246,-,-
BAC148_D07,3,3p12.3,79082376,79162231,79855,-,-
BAC40_O18,3,3p12.3,79211066,79349255,138189,-,-
BAC141_H15,3,3p12.3,79458826,79542986,84160,-,-
BAC157_M22,3,3p12.3,79461098,79542977,81879,-,-
BAC91_C18,3,3p12.3,79494894,79576514,81620,-,-
BAC240_J12,3,3p12.3,79497197,79576512,79315,-,-
BAC51_I10,3,3p12.3,79522271,79650133,127862,-,-
BAC243_G17,3,3p12.3,79647826,79730379,82553,-,-
BAC116_P14,3,3p12.3,79730569,79817140,86571,-,-
BAC163_M16,3,3p12.3,79844024,79921993,77969,-,-
BAC141_H02,3,3p12.3,79854137,79980089,125952,-,-
BAC59_J04,3,3p12.3,79906468,79987062,80594,-,-
BAC190_I14,3,3p12.3,80051688,80130816,79128,-,-
BAC105_G10,3,3p12.3,80177468,80268679,91211,-,-
BAC233_I08,3,3p12.3,80273978,80386632,112654,-,-
BAC26_O01,3,3p12.3,80331062,80512579,181517,-,-
BAC232_A19,3,3p12.3,80463465,80558144,94679,-,-
BAC86_G03,3,3p12.3,80730585,80910522,179937,-,-
BAC193_C02,3,3p12.3,80917780,80995361,77581,-,-
BAC12_G12,3,3p12.3,81402503,81490838,88335,-,-
BAC169_K02,3,3p12.3,81405042,81482430,77388,-,-
BAC92_D17,3,3p12.3,81505770,81588626,82856,-,-
BAC22_B24,3,3p12.3,81511251,81603705,92454,-,-
BAC236_M21,3,3p12.3,81610893,81703504,92611,-,-
BAC28_F03,3,3p12.3,81622802,81729912,107110,-,-
BAC110_O01,3,3p12.3,81629254,81713721,84467,-,-
BAC193_G08,3,3p12.3,81644708,81778254,133546,-,-
BAC37_N23,3,3p12.3-3p12.2,81745888,81855781,109893,-,-
BAC61_P12,3,3p12.3-3p12.2,81753023,81857615,104592,-,-
BAC79_K09,3,3p12.2,81827898,81910855,82957,-,-
BAC12_B15,3,3p12.2,81873115,82013749,140634,-,-
BAC162_P11,3,3p12.2,82022791,82111723,88932,-,-
BAC180_G19,3,3p12.2,82141570,82200500,58930,-,-
BAC62_I23,3,3p12.2,82448638,82600181,151543,-,-
BAC175_K06,3,3p12.2,82506940,82605099,98159,-,-
BAC63_L06,3,3p12.2,82544942,82642016,97074,-,-
BAC85_E14,3,3p12.2,82559316,82687188,127872,-,-
BAC161_E05,3,3p12.2,82602106,82728946,126840,-,-
BAC161_F01,3,3p12.2,82605096,82694761,89665,-,-
BAC61_F11,3,3p12.2,82694756,82797071,102315,-,-
BAC227_M03,3,3p12.2,82706728,82814584,107856,-,-
BAC235_G14,3,3p12.2,82718139,82793176,75037,-,-
BAC170_N22,3,3p12.2,82729075,82851218,122143,-,-
BAC237_B06,3,3p12.2,83221598,83315508,93910,-,-
BAC230_G19,3,3p12.2,83350103,83441132,91029,-,-
BAC132_A20,3,3p12.2,83377858,83491523,113665,-,-
BAC143_F16,3,3p12.2,83403916,83489484,85568,-,-
BAC129_K11,3,3p12.2,83521077,83638325,117248,-,-
BAC78_D01,3,3p12.2-3p12.1,83645503,83726701,81198,-,-
BAC126_G02,3,3p12.1,83786033,83902249,116216,-,-
BAC122_J14,3,3p12.1,83786064,83902249,116185,-,-
BAC165_D07,3,3p12.1,84054722,84138714,83992,-,-
BAC77_N18,3,3p12.1,84095025,84206471,111446,-,-
BAC234_C15,3,3p12.1,84126322,84211249,84927,-,-
BAC34_A09,3,3p12.1,84252279,84344268,91989,-,-
BAC239_G13,3,3p12.1,84346693,84452537,105844,-,-
BAC43_K09,3,3p12.1,84497683,84633948,136265,-,-
BAC222_K07,3,3p12.1,84609848,84701637,91789,-,-
BAC100_J10,3,3p12.1,84644215,84751972,107757,-,-
BAC246_L10,3,3p12.1,84682022,84767188,85166,-,-
BAC227_J16,3,3p12.1,84849281,84963094,113813,-,-
BAC167_D10,3,3p12.1,84912322,84998647,86325,-,-
BAC53_J03,3,3p12.1,85156175,85231711,75536,-,-
BAC150_K20,3,3p12.1,85156519,85291544,135025,-,-
BAC247_A14,3,3p12.1,85156731,85249060,92329,-,-
BAC25_A02,3,3p12.1,85203232,85291544,88312,-,-
BAC184_A23,3,3p12.1,85292546,85384746,92200,-,-
BAC144_C10,3,3p12.1,85306537,85377291,70754,-,-
BAC229_C11,3,3p12.1,85321431,85413633,92202,-,-
BAC233_P13,3,3p12.1,85473292,85555724,82432,-,-
BAC102_E23,3,3p12.1,85609865,85716578,106713,-,-
BAC95_K18,3,3p12.1,85610862,85685207,74345,-,-
BAC165_C06,3,3p12.1,85698816,85778026,79210,-,-
BAC150_F18,3,3p12.1,85723381,85814561,91180,-,-
BAC108_N22,3,3p12.1,85754883,85853534,98651,-,-
BAC227_I22,3,3p12.1,85799635,85871712,72077,-,-
BAC31_F06,3,3p12.1,86007432,86082490,75058,-,-
BAC160_B07,3,3p12.1,86038686,86125282,86596,-,-
BAC155_K01,3,3p12.1,86119882,86241001,121119,-,-
BAC144_K21,3,3p12.1,86208140,86322767,114627,-,-
BAC15_E21,3,3p12.1,86322759,86430167,107408,-,-
BAC30_D18,3,3p12.1,86511463,86601194,89731,-,-
BAC42_D09,3,3p12.1,86543143,86641501,98358,-,-
BAC16_C07,3,3p12.1,86584986,86719820,134834,-,-
BAC173_K10,3,3p12.1,86657517,86727091,69574,-,-
BAC57_G19,3,3p12.1,86687111,86778106,90995,-,-
BAC152_L02,3,3p12.1,86749642,86839984,90342,-,-
BAC233_N03,3,3p12.1,86791752,86904592,112840,-,-
BAC54_C23,3,3p12.1,86859566,86954981,95415,-,-
BAC79_H08,3,3p12.1-3p11.2,87134868,87246639,111771,-,-
BAC246_F03,3,3p12.1-3p11.2,87144089,87236105,92016,-,-
BAC189_J06,3,3p12.1-3p11.2,87184181,87292969,108788,-,-
BAC141_B18,3,3p11.2,87236100,87326614,90514,-,-
BAC130_C21,3,3p11.2,87269809,87378900,109091,-,-
BAC27_M21,3,3p11.2,87355270,87488588,133318,-,-
BAC192_A03,3,3p11.2,87457057,87545570,88513,-,-
BAC23_L11,3,3p11.2,87545564,87672575,127011,-,-
BAC41_D24,3,3p11.2,87663874,87789118,125244,-,-
BAC43_K13,3,3p11.2,87923765,88015395,91630,-,-
BAC50_G01,3,3p11.2,88095206,88199350,104144,-,-
BAC108_P08,3,3p11.2,88230462,88330164,99702,-,-
BAC173_G11,3,3p11.2,88326450,88400107,73657,-,-
BAC151_K04,3,3p11.2,88349614,88429720,80106,-,-
BAC152_N09,3,3p11.2,88378638,88466746,88108,-,-
BAC68_H12,3,3p11.2,88408383,88425328,16945,-,-
BAC92_B21,3,3p11.2,88622788,88717868,95080,-,-
BAC36_I15,3,3p11.2,88662014,88740821,78807,-,-
BAC228_D11,3,3p11.2,88666457,88738186,71729,-,-
BAC116_O15,3,3p11.2,88809129,88904896,95767,-,-
BAC108_F07,3,3p11.2,88868768,88882426,13658,-,-
BAC201_C11,3,3p11.2-3p11.1,89354828,89409880,55052,-,-
BAC21_B21,3,3p11.2-3p11.1,89365305,89489450,124145,-,-
BAC157_E24,3,3p11.1,89432482,89525054,92572,-,-
BAC199_M21,3,3p11.1,89490875,89578104,87229,-,-
BAC25_M13,3,3p11.1,89582157,89710326,128169,-,-
BAC213_L20,3,3p11.1,89604994,89702631,97637,-,-
BAC233_G04,3,3p11.1,89735867,89822223,86356,-,-
BAC247_E02,3,3p11.1,89829963,89917889,87926,-,-
BAC37_D18,3,3p11.1,89837313,89917889,80576,-,-
BAC197_J19,3,3p11.1,89856828,89945480,88652,-,-
BAC147_C05,3,3p11.1,90023858,90108744,84886,-,-
BAC238_C18,3,3p11.1,90038018,90114691,76673,-,-
BAC154_P08,3,3p11.1,90073299,90181189,107890,-,-
BAC89_O05,3,3q11.2,95033475,95159621,126146,-,-
BAC10_O20,3,3q11.2,95056805,95154901,98096,-,-
BAC208_N07,3,3q11.2,95101698,95120017,18319,-,-
BAC90_L18,3,3q11.2,95119931,95225424,105493,-,-
BAC172_J23,3,3q11.2,95161313,95283237,121924,-,-
BAC53_P14,3,3q11.2,95164011,95251900,87889,-,-
BAC167_D09,3,3q11.2,95187821,95283236,95415,-,-
BAC220_A18,3,3q11.2,95262124,95384196,122072,-,-
BAC246_N19,3,3q11.2,95359213,95450315,91102,-,-
BAC55_O01,3,3q11.2,95512399,95634227,121828,-,-
BAC64_K03,3,3q11.2,95536694,95622105,85411,-,-
BAC162_M23,3,3q11.2,95543985,95619926,75941,-,-
BAC101_O12,3,3q11.2,95543985,95634028,90043,-,-
BAC130_P09,3,3q11.2,95747588,95848250,100662,-,-
BAC78_A23,3,3q11.2,96166204,96313717,147513,-,-
BAC50_F23,3,3q11.2,96239640,96363048,123408,-,-
BAC222_P05,3,3q11.2,96502625,96550967,48342,-,-
BAC230_D20,3,3q11.2,96509696,96622778,113082,-,-
BAC17_O19,3,3q11.2,96738686,96886375,147689,-,-
BAC55_H22,3,3q11.2,96844679,96894262,49583,-,-
BAC151_C22,3,3q11.2,96998416,97095496,97080,-,-
BAC137_M21,3,3q11.2,97027629,97104517,76888,-,-
BAC200_I17,3,3q11.2,97151124,97229416,78292,-,-
BAC198_L21,3,3q11.2,97309937,97430351,120414,-,-
BAC54_H14,3,3q11.2,97323906,97431468,107562,-,-
BAC144_N21,3,3q11.2,97436086,97502078,65992,-,-
BAC14_F19,3,3q11.2,97504270,97615411,111141,-,-
BAC53_H18,3,3q11.2,97607364,97676895,69531,-,-
BAC156_P04,3,3q11.2,97654617,97789142,134525,-,-
BAC80_P08,3,3q11.2,97730102,97825077,94975,-,-
BAC227_N02,3,3q11.2,98026811,98113015,86204,-,-
BAC222_A16,3,3q11.2,98113033,98185929,72896,-,-
BAC219_O11,3,3q11.2,98324506,98403818,79312,-,-
BAC26_N10,3,3q11.2,98334399,98429645,95246,-,-
BAC247_P14,3,3q11.2,98397756,98523904,126148,-,-
BAC49_J20,3,3q11.2,98797871,98932260,134389,-,-
BAC80_M05,3,3q11.2,98856236,98976117,119881,-,-
BAC103_E23,3,3q11.2,98898563,99018698,120135,-,-
BAC218_N20,3,3q11.2,98909755,98998237,88482,-,-
BAC97_J18,3,3q11.2,99031927,99122469,90542,-,-
BAC36_M17,3,3q11.2,99211272,99224049,12777,-,-
BAC160_O06,3,3q11.2,99213438,99293946,80508,-,-
BAC26_C22,3,3q11.2,99218547,99379099,160552,yes,-
BAC186_J14,3,3q11.2,99297313,99392586,95273,yes,-
BAC132_L22,3,3q11.2,99358068,99436821,78753,yes,-
BAC224_G23,3,3q11.2,99499524,99581828,82304,-,-
BAC236_I06,3,3q11.2,99502500,99610012,107512,-,-
BAC193_G16,3,3q11.2,99520013,99590138,70125,-,-
BAC2_G16,3,3q11.2,99526578,99689096,162518,-,-
BAC90_K03,3,3q11.2,99624812,99714854,90042,-,-
BAC53_C12,3,3q11.2,99625126,99714854,89728,-,-
BAC35_I03,3,3q11.2,99644213,99742440,98227,-,-
BAC36_A02,3,3q11.2,99645094,99755633,110539,-,-
BAC131_I23,3,3q11.2-3q12.1,99714862,99830205,115343,-,-
BAC194_J20,3,3q12.1,99835758,99923996,88238,-,-
BAC44_E18,3,3q12.1,99966973,100051950,84977,-,-
BAC65_P04,3,3q12.1,100321291,100468409,147118,-,-
BAC55_E09,3,3q12.1,100452504,100578288,125784,-,-
BAC65_L16,3,3q12.1,100606151,100686399,80248,-,-
BAC62_C03,3,3q12.1,100682410,100766968,84558,-,-
BAC84_I19,3,3q12.1,100929314,101002573,73259,-,-
BAC150_G07,3,3q12.1,100941737,101025139,83402,-,-
BAC127_I11,3,3q12.1,100967133,101120604,153471,-,-
BAC82_C07,3,3q12.1,101019806,101199071,179265,-,-
BAC20_K19,3,3q12.1,101019806,101124387,104581,-,-
BAC119_G21,3,3q12.1,101052953,101162681,109728,-,-
BAC20_L19,3,3q12.1,101090653,101258773,168120,-,-
BAC72_H07,3,3q12.1,101090653,101221586,130933,-,-
BAC69_L01,3,3q12.1,101137930,101276959,139029,-,-
BAC82_G06,3,3q12.1,101144854,101362767,217913,-,-
BAC149_H06,3,3q12.1,101157886,101243762,85876,-,-
BAC249_A16,3,3q12.1,101162884,101257507,94623,-,-
BAC92_F22,3,3q12.1,101187829,101280424,92595,-,-
BAC179_C03,3,3q12.1,101216868,101299796,82928,-,-
BAC193_E12,3,3q12.1,101386165,101464596,78431,-,-
BAC36_J06,3,3q12.1-3q12.2,101464595,101572150,107555,-,-
BAC236_O15,3,3q12.2,101507425,101610036,102611,-,-
BAC67_H19,3,3q12.2,101760425,101837378,76953,-,-
BAC26_H15,3,3q12.2,101770893,101889285,118392,-,-
BAC101_C12,3,3q12.2,101814052,101895637,81585,-,-
BAC150_J01,3,3q12.2,101889280,101963801,74521,-,-
BAC31_B12,3,3q12.2,102150037,102262624,112587,-,-
BAC90_A11,3,3q12.2,102249995,102349214,99219,-,-
BAC165_I15,3,3q12.2,102269656,102379787,110131,-,-
BAC19_H16,3,3q12.2,102352736,102471100,118364,-,-
BAC172_K02,3,3q12.2,102359333,102455194,95861,-,-
BAC71_P12,3,3q12.3,102529215,102658868,129653,-,-
BAC182_M05,3,3q12.3,102586006,102660159,74153,-,-
BAC248_O11,3,3q12.3,102620739,102738597,117858,-,-
BAC37_A23,3,3q12.3,102653037,102728233,75196,-,-
BAC120_F14,3,3q12.3,102658520,102751868,93348,-,-
BAC11_H16,3,3q12.3,102658904,102746360,87456,-,-
BAC144_K20,3,3q12.3,102728226,102813745,85519,-,-
BAC149_P13,3,3q12.3,102728226,102813745,85519,-,-
BAC53_M15,3,3q12.3,102728231,102842959,114728,-,-
BAC64_B20,3,3q12.3,102769809,102887528,117719,-,-
BAC67_F06,3,3q12.3,102769812,102876687,106875,-,-
BAC114_B10,3,3q12.3,102773794,102872951,99157,-,-
BAC181_A07,3,3q12.3,102786915,102870826,83911,-,-
BAC182_G15,3,3q12.3,102787334,102876686,89352,-,-
BAC220_M02,3,3q12.3,102796755,102872763,76008,-,-
BAC83_L06,3,3q12.3,102818262,102959832,141570,-,-
BAC221_A21,3,3q12.3,102832056,102916082,84026,-,-
BAC221_K07,3,3q12.3,102893133,102978839,85706,-,-
BAC144_H05,3,3q12.3,102893133,102969715,76582,-,-
BAC152_F06,3,3q12.3,102893146,102970679,77533,-,-
BAC165_M11,3,3q12.3,102971580,103065393,93813,-,-
BAC89_F03,3,3q12.3,102979022,103065385,86363,-,-
BAC192_L09,3,3q12.3,103044143,103125664,81521,-,-
BAC173_H17,3,3q12.3,103078593,103169299,90706,-,-
BAC107_M04,3,3q12.3,103078593,103153251,74658,-,-
BAC81_K11,3,3q12.3,103102368,103211622,109254,-,-
BAC34_J08,3,3q12.3,103259228,103374918,115690,-,-
BAC20_P21,3,3q12.3,103365288,103487114,121826,-,-
BAC172_I16,3,3q12.3,103513928,103603932,90004,-,-
BAC176_F21,3,3q12.3,103624911,103710584,85673,-,-
BAC244_P21,3,3q12.3,103663188,103771603,108415,-,-
BAC118_P15,3,3q12.3,103752567,103922456,169889,-,-
BAC75_M22,3,3q12.3,103760714,103874470,113756,-,-
BAC119_N13,3,3q12.3,103785358,103874470,89112,-,-
BAC71_I17,3,3q12.3,103856054,103953252,97198,-,-
BAC119_H17,3,3q12.3,103975972,104092363,116391,-,-
BAC156_N11,3,3q12.3,104049632,104123479,73847,-,-
BAC122_G08,3,3q12.3,104098256,104176450,78194,-,-
BAC249_G16,3,3q12.3,104164460,104272166,107706,-,-
BAC54_G13,3,3q12.3,104180119,104262771,82652,-,-
BAC151_G21,3,3q12.3,104196924,104285607,88683,-,-
BAC45_E09,3,3q13.11,104605639,104686849,81210,-,-
BAC45_C07,3,3q13.11,104690113,104786325,96212,-,-
BAC219_I09,3,3q13.11,104692804,104795982,103178,-,-
BAC237_E13,3,3q13.11,104726228,104802235,76007,-,-
BAC91_K08,3,3q13.11,104786384,104900106,113722,-,-
BAC97_B20,3,3q13.11,104796141,104928528,132387,-,-
BAC145_I10,3,3q13.11,104954935,105063398,108463,-,-
BAC61_I22,3,3q13.11,105202946,105311052,108106,-,-
BAC66_P06,3,3q13.11,105323098,105410277,87179,-,-
BAC20_E21,3,3q13.11,105342336,105427068,84732,-,-
BAC248_L23,3,3q13.11,105456221,105527268,71047,-,-
BAC46_H12,3,3q13.11,105589021,105698866,109845,-,-
BAC158_O14,3,3q13.11,105910529,106031225,120696,-,-
BAC160_J23,3,3q13.11,105939967,106031536,91569,-,-
BAC68_B23,3,3q13.11,105989623,106079970,90347,-,-
BAC158_G23,3,3q13.11,106086793,106164900,78107,-,-
BAC166_E20,3,3q13.11,106253888,106341880,87992,-,-
BAC147_E21,3,3q13.11,106328243,106424393,96150,-,-
BAC63_K20,3,3q13.11,106424660,106506042,81382,-,-
BAC188_B06,3,3q13.11,106455988,106533681,77693,-,-
BAC43_O23,3,3q13.11,106782186,106884702,102516,-,-
BAC88_M18,3,3q13.11,106793633,106884828,91195,-,-
BAC71_C14,3,3q13.11,106835664,106948520,112856,-,-
BAC83_I10,3,3q13.11,106990241,107082145,91904,-,-
BAC192_B20,3,3q13.11,107508184,107580836,72652,-,-
BAC135_J21,3,3q13.11,107607999,107690982,82983,-,-
BAC19_F19,3,3q13.11,107619603,107709004,89401,-,-
BAC80_O06,3,3q13.11,107671791,107760378,88587,-,-
BAC153_P02,3,3q13.11,107679374,107787896,108522,-,-
BAC130_N08,3,3q13.12,107846040,107927564,81524,-,-
BAC71_E18,3,3q13.12,108008386,108162573,154187,-,-
BAC124_D14,3,3q13.12,108019627,108030061,10434,-,-
BAC26_G15,3,3q13.12,108020470,108151914,131444,-,-
BAC48_B03,3,3q13.12,108074777,108166589,91812,-,-
BAC241_H02,3,3q13.12,108216247,108323057,106810,-,-
BAC153_I03,3,3q13.12,108228895,108313747,84852,-,-
BAC147_H09,3,3q13.12,108431714,108519930,88216,-,-
BAC83_O09,3,3q13.12,108463989,108558465,94476,-,-
BAC130_C22,3,3q13.12,108555003,108640520,85517,-,-
BAC187_N01,3,3q13.12,108591895,108712671,120776,-,-
BAC147_M18,3,3q13.12,108621209,108711275,90066,-,-
BAC167_K19,3,3q13.12,108711700,108796822,85122,-,-
BAC189_J22,3,3q13.12,108718625,108798956,80331,-,-
BAC12_B14,3,3q13.12,108750741,108866626,115885,-,-
BAC147_F19,3,3q13.12,108814011,108930763,116752,-,-
BAC69_E09,3,3q13.12,108866617,108965037,98420,-,-
BAC143_L23,3,3q13.12,108866618,108942531,75913,-,-
BAC199_J24,3,3q13.12,108866855,108945909,79054,-,-
BAC150_J08,3,3q13.12,108929371,109037617,108246,-,-
BAC57_E10,3,3q13.12,108929371,109057572,128201,-,-
BAC154_O09,3,3q13.12,108988715,109084381,95666,-,-
BAC62_B24,3,3q13.12,109041571,109117807,76236,-,-
BAC17_P10,3,3q13.12,109118187,109177239,59052,-,-
BAC218_B12,3,3q13.12,109145822,109237918,92096,-,-
BAC12_J12,3,3q13.12,109149590,109240154,90564,-,-
BAC106_B02,3,3q13.12,109204756,109314149,109393,-,-
BAC152_C16,3,3q13.12,109209447,109346597,137150,-,-
BAC246_D17,3,3q13.12,109238123,109332852,94729,-,-
BAC156_L02,3,3q13.12,109273931,109424518,150587,-,-
BAC224_F21,3,3q13.12-3q13.13,109491411,109602948,111537,-,-
BAC63_B24,3,3q13.13,109512240,109602964,90724,-,-
BAC224_F12,3,3q13.13,109527024,109611472,84448,-,-
BAC183_E03,3,3q13.13,109541133,109647977,106844,-,-
BAC222_D18,3,3q13.13,109585179,109679454,94275,-,-
BAC192_M04,3,3q13.13,109624918,109715613,90695,-,-
BAC92_I03,3,3q13.13,109659701,109745070,85369,-,-
BAC158_E21,3,3q13.13,109868951,109969655,100704,-,-
BAC78_M18,3,3q13.13,109870498,109985127,114629,-,-
BAC42_M16,3,3q13.13,109939644,110045548,105904,-,-
BAC163_P06,3,3q13.13,109942888,110045516,102628,-,-
BAC128_C06,3,3q13.13,110051038,110182621,131583,-,-
BAC63_J14,3,3q13.13,110104488,110220598,116110,-,-
BAC58_J17,3,3q13.13,110246508,110377995,131487,-,-
BAC102_L10,3,3q13.13,110443257,110562642,119385,-,-
BAC55_P07,3,3q13.13,110452188,110634129,181941,-,-
BAC37_C07,3,3q13.13,110458516,110543679,85163,-,-
BAC186_I24,3,3q13.13,110460890,110543676,82786,-,-
BAC80_I17,3,3q13.13,110543699,110631840,88141,-,-
BAC83_G15,3,3q13.13,110689317,110798747,109430,-,-
BAC66_P09,3,3q13.13,110773374,110863033,89659,-,-
BAC10_G07,3,3q13.13,110798781,110870122,71341,-,-
BAC141_M22,3,3q13.13,110813073,110925636,112563,-,-
BAC171_L09,3,3q13.13,110834801,110915327,80526,-,-
BAC234_C02,3,3q13.13,110863026,110948323,85297,-,-
BAC170_L07,3,3q13.13,111031040,111127499,96459,-,-
BAC66_L04,3,3q13.13,111049707,111127499,77792,-,-
BAC151_K20,3,3q13.13,111124820,111231500,106680,-,-
BAC45_F07,3,3q13.13,111263663,111372096,108433,-,-
BAC34_O07,3,3q13.13,111385851,111493553,107702,-,-
BAC134_K23,3,3q13.13,111477623,111572198,94575,-,-
BAC27_P16,3,3q13.13,111493992,111581477,87485,-,-
BAC129_O11,3,3q13.13,111640087,111746895,106808,-,-
BAC153_D10,3,3q13.13,111695184,111795492,100308,-,-
BAC41_P17,3,3q13.13,111698296,111873670,175374,-,-
BAC72_F13,3,3q13.13,111717137,111800649,83512,-,-
BAC192_E07,3,3q13.13,111729735,111811606,81871,-,-
BAC149_N17,3,3q13.13,111802089,111886445,84356,-,-
BAC238_O15,3,3q13.13,111881084,112000941,119857,-,-
BAC229_O04,3,3q13.13,111919632,111999170,79538,-,-
BAC133_N20,3,3q13.13,112000939,112101897,100958,-,-
BAC97_D11,3,3q13.13,112013505,112146015,132510,-,-
BAC70_G18,3,3q13.13,112030792,112123529,92737,-,-
BAC33_G09,3,3q13.13,112211740,112310220,98480,-,-
BAC240_A09,3,3q13.13,112226479,112312182,85703,-,-
BAC197_B24,3,3q13.13,112236544,112326876,90332,-,-
BAC75_K14,3,3q13.13,112411064,112564357,153293,-,-
BAC141_C11,3,3q13.13,112424246,112531324,107078,-,-
BAC134_K10,3,3q13.13,112572677,112648018,75341,-,-
BAC33_N04,3,3q13.13,112662504,112760106,97602,-,-
BAC194_H23,3,3q13.2,112835720,112861346,25626,-,-
BAC203_G16,3,3q13.2,112873789,112944558,70769,-,-
BAC23_C02,3,3q13.2,112938163,113049063,110900,-,-
BAC51_P14,3,3q13.2,112944970,113080463,135493,-,-
BAC33_O08,3,3q13.2,113014390,113202910,188520,-,-
BAC194_L15,3,3q13.2,113198687,113281061,82374,-,-
BAC187_I10,3,3q13.2,113302925,113384143,81218,-,-
BAC149_M08,3,3q13.2,113549706,113621456,71750,-,-
BAC90_C01,3,3q13.2,113556042,113693796,137754,-,-
BAC155_G22,3,3q13.2,113605719,113686908,81189,-,-
BAC119_L20,3,3q13.2,113609728,113702752,93024,-,-
BAC96_B15,3,3q13.2,113693791,113806633,112842,-,-
BAC192_I11,3,3q13.2,113723641,113815387,91746,-,-
BAC59_H23,3,3q13.2,113878858,114036455,157597,-,-
BAC121_N21,3,3q13.2,114047965,114161559,113594,-,-
BAC118_O21,3,3q13.2,114048969,114158212,109243,-,-
BAC105_K11,3,3q13.2,114126307,114220028,93721,-,-
BAC22_C10,3,3q13.2,114438639,114559066,120427,-,-
BAC177_K17,3,3q13.2,114454075,114537671,83596,-,-
BAC180_E17,3,3q13.2,114455910,114569489,113579,-,-
BAC53_O20,3,3q13.2,114460272,114550007,89735,-,-
BAC49_I10,3,3q13.2,114508348,114627098,118750,-,-
BAC75_C10,3,3q13.2,114578031,114679761,101730,-,-
BAC77_F10,3,3q13.2,114610722,114700276,89554,-,-
BAC158_L07,3,3q13.2,114697621,114779187,81566,-,-
BAC8_J07,3,3q13.2,114730385,114828523,98138,-,-
BAC190_D02,3,3q13.2,114737859,114828523,90664,-,-
BAC81_H19,3,3q13.2,114738191,114850338,112147,-,-
BAC50_E15,3,3q13.2,114738191,114832838,94647,-,-
BAC161_I11,3,3q13.2,114747827,114834080,86253,-,-
BAC67_I14,3,3q13.2,114803352,114906017,102665,-,-
BAC129_B02,3,3q13.2,114836538,114919827,83289,-,-
BAC13_P22,3,3q13.2,114836564,114922339,85775,-,-
BAC119_L09,3,3q13.2-3q13.31,114975251,115107975,132724,-,-
BAC165_L06,3,3q13.31,115180693,115255819,75126,-,-
BAC64_C14,3,3q13.31,115212847,115311269,98422,-,-
BAC227_M01,3,3q13.31,115220720,115304117,83397,-,-
BAC31_K07,3,3q13.31,115256574,115353049,96475,-,-
BAC162_O04,3,3q13.31,115269321,115348810,79489,-,-
BAC40_G07,3,3q13.31,115270135,115363817,93682,-,-
BAC59_G23,3,3q13.31,115270145,115432290,162145,-,-
BAC35_D12,3,3q13.31,115312749,115415971,103222,-,-
BAC149_B06,3,3q13.31,115331980,115425923,93943,-,-
BAC227_B15,3,3q13.31,115515096,115601601,86505,-,-
BAC12_F05,3,3q13.31,115548241,115635014,86773,-,-
BAC122_A18,3,3q13.31,115622554,115752948,130394,-,-
BAC197_N17,3,3q13.31,115724496,115815998,91502,-,-
BAC28_P21,3,3q13.31,115724510,115817686,93176,-,-
BAC238_J23,3,3q13.31,115764187,115817790,53603,-,-
BAC137_M16,3,3q13.31,116068754,116164116,95362,-,-
BAC66_G19,3,3q13.31,116068754,116179547,110793,-,-
BAC252_B04,3,3q13.31,116433088,116538878,105790,-,-
BAC16_G14,3,3q13.31,116502747,116615123,112376,-,-
BAC153_C06,3,3q13.31,116737637,116857055,119418,-,-
BAC147_K07,3,3q13.31,116782159,116888594,106435,-,-
BAC16_O23,3,3q13.31,116807374,116938612,131238,-,-
BAC57_B02,3,3q13.31,116840998,116939402,98404,-,-
BAC244_C07,3,3q13.31,116841002,116931000,89998,-,-
BAC71_H02,3,3q13.31,116913050,117010028,96978,-,-
BAC155_H07,3,3q13.31,117077332,117183873,106541,-,-
BAC249_D09,3,3q13.31,117595648,117699408,103760,-,-
BAC86_H06,3,3q13.31,117624322,117715462,91140,-,-
BAC167_D05,3,3q13.31,117629256,117700409,71153,-,-
BAC217_A19,3,3q13.31,117852775,117957949,105174,-,-
BAC110_I05,3,3q13.31,118186473,118271773,85300,-,-
BAC67_E23,3,3q13.31,118196005,118313006,117001,-,-
BAC190_H07,3,3q13.31,118268907,118354711,85804,-,-
BAC109_G16,3,3q13.31,118391008,118513513,122505,-,-
BAC249_L07,3,3q13.31,118575235,118695173,119938,-,-
BAC130_B07,3,3q13.31-3q13.32,118709691,118808088,98397,-,-
BAC41_C01,3,3q13.31-3q13.32,118754799,118932096,177297,-,-
BAC165_I03,3,3q13.31-3q13.32,118790835,118861079,70244,-,-
BAC68_K16,3,3q13.32,118923099,119045842,122743,-,-
BAC64_F12,3,3q13.32,119003534,119115774,112240,-,-
BAC109_N19,3,3q13.32,119212870,119338655,125785,-,-
BAC223_M12,3,3q13.32,119237434,119316848,79414,-,-
BAC148_H11,3,3q13.32,119594240,119667817,73577,-,-
BAC163_E12,3,3q13.32,119696134,119854910,158776,-,-
BAC90_I12,3,3q13.32,119854905,119978412,123507,-,-
BAC142_E23,3,3q13.32,119861951,119918452,56501,-,-
BAC180_F09,3,3q13.32,119870540,120009515,138975,-,-
BAC48_J01,3,3q13.32,119892464,120057664,165200,-,-
BAC168_C08,3,3q13.32,119942511,120026640,84129,-,-
BAC248_G20,3,3q13.32,119942624,120026679,84055,-,-
BAC61_K04,3,3q13.32,119993631,120078015,84384,-,-
BAC148_C17,3,3q13.32,120019848,120111412,91564,-,-
BAC29_I15,3,3q13.32,120157991,120262220,104229,-,-
BAC65_J23,3,3q13.32,120199095,120297175,98080,-,-
BAC89_C08,3,3q13.32,120297185,120384795,87610,-,-
BAC202_M20,3,3q13.32,120333351,120413282,79931,-,-
BAC157_C01,3,3q13.32,120339269,120426536,87267,-,-
BAC88_A10,3,3q13.32,120363315,120494162,130847,-,-
BAC137_L17,3,3q13.32-3q13.33,120413289,120500938,87649,-,-
BAC224_I16,3,3q13.33,120551904,120650016,98112,-,-
BAC69_M12,3,3q13.33,120569435,120682776,113341,-,-
BAC2_N18,3,3q13.33,120602725,120692607,89882,-,-
BAC53_N05,3,3q13.33,120700652,120811141,110489,-,-
BAC188_H11,3,3q13.33,120815667,120910811,95144,-,-
BAC36_H20,3,3q13.33,120862261,120978413,116152,-,-
BAC1_C24,3,3q13.33,121015307,121113037,97730,-,-
BAC108_O06,3,3q13.33,121025907,121114087,88180,-,-
BAC118_P23,3,3q13.33,121119220,121232918,113698,-,-
BAC143_P19,3,3q13.33,121129609,121206676,77067,-,-
BAC219_E02,3,3q13.33,121129610,121209098,79488,-,-
BAC69_H21,3,3q13.33,121179874,121285550,105676,-,-
BAC191_O08,3,3q13.33,121211721,121297728,86007,-,-
BAC32_N22,3,3q13.33,121232936,121342817,109881,-,-
BAC218_K11,3,3q13.33,121347069,121436893,89824,-,-
BAC34_N22,3,3q13.33,121358664,121455115,96451,-,-
BAC119_A08,3,3q13.33,121467122,121551851,84729,-,-
BAC1_C13,3,3q13.33,121472099,121582527,110428,-,-
BAC236_F20,3,3q13.33,121473537,121550179,76642,-,-
BAC15_M11,3,3q13.33,121501361,121598632,97271,-,-
BAC61_G23,3,3q13.33,121516006,121611023,95017,-,-
BAC121_K22,3,3q13.33,121547042,121670647,123605,yes,-
BAC66_E23,3,3q13.33,121586268,121746803,160535,yes,-
BAC79_P07,3,3q13.33,121595442,121724807,129365,yes,-
BAC90_P01,3,3q13.33,121595445,121747281,151836,yes,-
BAC148_E04,3,3q13.33,121676578,121770683,94105,-,-
BAC36_J05,3,3q13.33,121705597,121805191,99594,-,-
BAC134_K16,3,3q13.33,121889348,121967390,78042,-,-
BAC169_L20,3,3q13.33,121974119,122066555,92436,-,-
BAC109_K11,3,3q13.33,121996953,122031342,34389,-,-
BAC201_M24,3,3q13.33,122057628,122138935,81307,-,-
BAC184_C19,3,3q13.33,122103458,122232342,128884,-,-
BAC89_H07,3,3q13.33,122354161,122456890,102729,-,-
BAC85_B01,3,3q13.33,122354161,122432258,78097,-,-
BAC53_F09,3,3q13.33,122535690,122628073,92383,-,-
BAC104_P09,3,3q13.33,122669029,122796366,127337,-,-
BAC247_N13,3,3q13.33,122700868,122774597,73729,-,-
BAC181_H06,3,3q13.33,122718436,122821914,103478,-,-
BAC145_B09,3,3q13.33,122782807,122863242,80435,-,-
BAC44_P16,3,3q13.33,122796366,122806826,10460,-,-
BAC179_G10,3,3q13.33,122804132,122889022,84890,-,-
BAC195_D08,3,3q13.33,122807716,122907037,99321,-,-
BAC230_G22,3,3q13.33,122822137,122902026,79889,-,-
BAC30_M07,3,3q13.33,122822175,122920869,98694,-,-
BAC97_C17,3,3q13.33,122857404,122974447,117043,-,-
BAC149_N19,3,3q13.33,122869709,122960969,91260,-,-
BAC104_I05,3,3q13.33,122889057,122976367,87310,-,-
BAC224_O11,3,3q13.33,122974521,123063898,89377,-,-
BAC54_G01,3,3q13.33,123027761,123126026,98265,-,-
BAC96_I24,3,3q13.33,123096272,123191176,94904,-,-
BAC147_F17,3,3q13.33,123108687,123192366,83679,-,-
BAC140_F14,3,3q13.33,123111360,123215490,104130,-,-
BAC109_A04,3,3q13.33,123125715,123258254,132539,-,-
BAC102_O01,3,3q13.33,123175913,123266489,90576,-,-
BAC218_J04,3,3q13.33,123215485,123375531,160046,-,-
BAC110_D08,3,3q13.33,123256931,123376502,119571,-,-
BAC100_I06,3,3q13.33-3q21.1,123338117,123441218,103101,-,-
BAC105_L01,3,3q13.33-3q21.1,123385470,123478071,92601,-,-
BAC21_G06,3,3q21.1,123451618,123555973,104355,-,-
BAC234_I03,3,3q21.1,123494104,123571209,77105,-,-
BAC37_M10,3,3q21.1,123572457,123684188,111731,-,-
BAC139_H22,3,3q21.1,123677880,123767049,89169,-,-
BAC84_B11,3,3q21.1,123694101,123796670,102569,-,-
BAC183_E12,3,3q21.1,123709308,123796670,87362,-,-
BAC228_F21,3,3q21.1,123768664,123916198,147534,-,-
BAC147_E20,3,3q21.1,123788757,123907853,119096,-,-
BAC181_O03,3,3q21.1,123788757,123876547,87790,-,-
BAC62_N14,3,3q21.1,123803333,123917624,114291,-,-
BAC23_O16,3,3q21.1,123853924,123976375,122451,-,-
BAC10_F17,3,3q21.1,123854467,123997663,143196,-,-
BAC4_D13,3,3q21.1,123958361,124106272,147911,-,-
BAC26_J03,3,3q21.1,124030542,124120390,89848,-,-
BAC84_H23,3,3q21.1,124077821,124170581,92760,-,-
BAC230_K17,3,3q21.1,124112924,124276113,163189,-,-
BAC146_A03,3,3q21.1,124127340,124233253,105913,-,-
BAC45_L06,3,3q21.1,124185284,124276103,90819,-,-
BAC173_M19,3,3q21.1,124187433,124276028,88595,-,-
BAC12_C21,3,3q21.1,124208126,124291361,83235,-,-
BAC136_O13,3,3q21.1,124279365,124428245,148880,-,-
BAC184_O11,3,3q21.1,124315009,124404782,89773,-,-
BAC1_C23,3,3q21.1,124405100,124513276,108176,-,-
BAC2_G17,3,3q21.1,124438373,124551358,112985,-,-
BAC141_G12,3,3q21.1,124479333,124559087,79754,-,-
BAC46_A20,3,3q21.1,124501302,124603531,102229,-,-
BAC46_I20,3,3q21.1,124507702,124638924,131222,-,-
BAC60_L02,3,3q21.1,124530922,124635201,104279,-,-
BAC34_F01,3,3q21.1,124531842,124639830,107988,-,-
BAC127_J07,3,3q21.1,124551370,124645601,94231,-,-
BAC135_E22,3,3q21.1,124661529,124777497,115968,-,-
BAC34_A11,3,3q21.1,124680107,124770258,90151,-,-
BAC44_N09,3,3q21.1,124722705,124819958,97253,-,-
BAC137_B02,3,3q21.1,124783501,124864481,80980,-,-
BAC149_P01,3,3q21.1,124838509,124920762,82253,-,-
BAC165_K14,3,3q21.1,124864486,124958870,94384,-,-
BAC193_C10,3,3q21.1,124887984,124971288,83304,-,-
BAC80_K07,3,3q21.1,124971464,125108784,137320,-,-
BAC26_M20,3,3q21.1,124987008,125101455,114447,-,-
BAC84_N21,3,3q21.1,125013386,125099674,86288,-,-
BAC183_C08,3,3q21.1,125016814,125108788,91974,-,-
BAC156_K21,3,3q21.1,125018589,125104123,85534,-,-
BAC217_D20,3,3q21.1,125019126,125101455,82329,-,-
BAC139_O15,3,3q21.1,125053651,125150636,96985,-,-
BAC185_E10,3,3q21.1,125064925,125140009,75084,-,-
BAC185_G01,3,3q21.1,125167239,125260102,92863,-,-
BAC19_O01,3,3q21.1,125185221,125309469,124248,-,-
BAC65_J14,3,3q21.1,125208437,125309503,101066,-,-
BAC194_F20,3,3q21.1,125281427,125374825,93398,-,-
BAC106_M21,3,3q21.1-3q21.2,125342579,125432345,89766,-,-
BAC150_A14,3,3q21.1-3q21.2,125354364,125448835,94471,-,-
BAC196_M02,3,3q21.1-3q21.2,125354817,125437680,82863,-,-
BAC146_J02,3,3q21.1-3q21.2,125371653,125457774,86121,-,-
BAC175_H17,3,3q21.1-3q21.2,125378163,125468705,90542,-,-
BAC217_C11,3,3q21.2,125401311,125484309,82998,-,-
BAC46_I04,3,3q21.2,125401343,125496860,95517,-,-
BAC20_N05,3,3q21.2,125437745,125532057,94312,-,-
BAC171_F05,3,3q21.2,125496872,125595355,98483,-,-
BAC221_E15,3,3q21.2,125641074,125750608,109534,-,-
BAC92_O05,3,3q21.2,125670073,125767585,97512,-,-
BAC160_C14,3,3q21.2,125744061,125822152,78091,-,-
BAC96_H20,3,3q21.2,125822165,125930215,108050,-,-
BAC66_A03,3,3q21.2,125829194,125948007,118813,-,-
BAC160_L14,3,3q21.2,125906099,126021820,115721,-,-
BAC8_E04,3,3q21.2,125930336,126035214,104878,-,-
BAC121_N23,3,3q21.2,125961941,126035214,73273,-,-
BAC88_D16,3,3q21.2,125961941,126085748,123807,-,-
BAC187_B13,3,3q21.2,125962180,126042584,80404,-,-
BAC201_G05,3,3q21.2,126011602,126096584,84982,-,-
BAC22_H18,3,3q21.2,126059167,126146299,87132,-,-
BAC194_P05,3,3q21.2,126107176,126200701,93525,-,-
BAC181_A10,3,3q21.2,126135229,126213771,78542,-,-
BAC142_P13,3,3q21.2,126135229,126202616,67387,-,-
BAC108_M16,3,3q21.2,126135563,126255810,120247,-,-
BAC75_B17,3,3q21.2,126162780,126241056,78276,-,-
BAC176_K15,3,3q21.2,126241052,126331677,90625,-,-
BAC157_P01,3,3q21.2,126258143,126338665,80522,-,-
BAC125_G19,3,3q21.2,126281492,126385487,103995,-,-
BAC74_G22,3,3q21.2,126308568,126385487,76919,-,-
BAC197_B03,3,3q21.2,126318446,126416648,98202,-,-
BAC82_M18,3,3q21.2,126320516,126407375,86859,-,-
BAC24_D13,3,3q21.2,126320769,126422365,101596,-,-
BAC185_C11,3,3q21.2,126334233,126407375,73142,-,-
BAC109_G19,3,3q21.2,126504967,126593817,88850,-,-
BAC200_D11,3,3q21.2,126545268,126637164,91896,-,-
BAC83_K07,3,3q21.2,126578730,126683702,104972,-,-
BAC241_J20,3,3q21.2,126578730,126663186,84456,-,-
BAC39_L20,3,3q21.2,126657017,126743767,86750,-,-
BAC106_P18,3,3q21.2,126708390,126820497,112107,-,-
BAC163_H06,3,3q21.2,126709116,126785735,76619,-,-
BAC158_A16,3,3q21.2,126736512,126797748,61236,-,-
BAC171_O22,3,3q21.2,126804501,126905471,100970,-,-
BAC61_B04,3,3q21.2,126888375,127047697,159322,yes,-
BAC84_N19,3,3q21.2,126908057,126980943,72886,yes,-
BAC120_D02,3,3q21.2,126921548,127074939,153391,yes,-
BAC8_P10,3,3q21.2,126944192,127088801,144609,-,-
BAC134_H08,3,3q21.2,126959659,127047697,88038,-,-
BAC171_J03,3,3q21.2,126961023,127031859,70836,-,-
BAC248_B14,3,3q21.2,126977702,127066434,88732,-,-
BAC17_D23,3,3q21.2,126994303,127088801,94498,-,-
BAC33_I22,3,3q21.2,127031893,127187967,156074,-,-
BAC104_N01,3,3q21.2,127055131,127164374,109243,-,-
BAC224_P05,3,3q21.2,127075153,127133878,58725,-,-
BAC130_E19,3,3q21.2,127075153,127152343,77190,-,-
BAC224_J18,3,3q21.2,127197624,127296340,98716,-,-
BAC170_E12,3,3q21.2,127221587,127302525,80938,-,-
BAC160_M22,3,3q21.2,127281419,127391782,110363,-,-
BAC71_M19,3,3q21.2,127296334,127398347,102013,-,-
BAC81_J10,3,3q21.2,127296486,127391813,95327,-,-
BAC126_M04,3,3q21.2,127302520,127407629,105109,-,-
BAC125_K13,3,3q21.2,127302524,127407629,105105,-,-
BAC237_G20,3,3q21.2,127306624,127446052,139428,-,-
BAC36_A22,3,3q21.2,127409197,127507429,98232,-,-
BAC178_C22,3,3q21.2,127467692,127556095,88403,-,-
BAC100_F24,3,3q21.2,127560653,127642254,81601,-,-
BAC11_C11,3,3q21.2,127578107,127697232,119125,-,-
BAC140_N20,3,3q21.2-3q21.3,127664373,127756687,92314,-,-
BAC178_B03,3,3q21.3,127704584,127792191,87607,-,-
BAC196_A08,3,3q21.3,127756680,127860398,103718,-,-
BAC148_P08,3,3q21.3,127802989,127906845,103856,-,-
BAC24_D03,3,3q21.3,127855622,127953387,97765,-,-
BAC121_L19,3,3q21.3,127860392,127992043,131651,-,-
BAC149_H13,3,3q21.3,127885018,127992043,107025,-,-
BAC159_G07,3,3q21.3,127953381,128097651,144270,-,-
BAC76_L19,3,3q21.3,127953395,128077822,124427,-,-
BAC59_C24,3,3q21.3,127991615,128223448,231833,-,-
BAC24_P10,3,3q21.3,127992215,128151888,159673,-,-
BAC241_M05,3,3q21.3,128032930,128134859,101929,-,-
BAC32_L15,3,3q21.3,128049019,128152349,103330,-,-
BAC49_C22,3,3q21.3,128057808,128152407,94599,-,-
BAC145_H04,3,3q21.3,128126552,128258120,131568,-,-
BAC68_H20,3,3q21.3,128151883,128252811,100928,-,-
BAC107_M07,3,3q21.3,128151883,128317918,166035,-,-
BAC189_N24,3,3q21.3,128152358,128244532,92174,-,-
BAC113_F08,3,3q21.3,128152358,128258448,106090,-,-
BAC163_I16,3,3q21.3,128179063,128323696,144633,-,-
BAC40_P02,3,3q21.3,128372701,128453444,80743,-,-
BAC79_F24,3,3q21.3,128413934,128529898,115964,-,-
BAC122_B14,3,3q21.3,128509807,128659730,149923,-,-
BAC20_D24,3,3q21.3,128524805,128653334,128529,-,-
BAC181_F09,3,3q21.3,128529894,128651612,121718,-,-
BAC162_J03,3,3q21.3,128595298,128697125,101827,-,-
BAC153_B09,3,3q21.3,128651628,128776107,124479,-,-
BAC57_G18,3,3q21.3,128659723,128750286,90563,-,-
BAC223_K16,3,3q21.3,128659761,128751086,91325,-,-
BAC20_I19,3,3q21.3,128751317,128850982,99665,-,-
BAC162_I21,3,3q21.3,128916001,129026649,110648,-,-
BAC51_P04,3,3q21.3,128935294,129104754,169460,-,-
BAC71_M15,3,3q21.3,128997926,129078327,80401,-,-
BAC110_I15,3,3q21.3,129057951,129145186,87235,-,-
BAC186_E17,3,3q21.3,129146433,129234558,88125,-,-
BAC25_F21,3,3q21.3,129158250,129247989,89739,-,-
BAC34_H22,3,3q21.3,129175341,129330326,154985,-,-
BAC69_H23,3,3q21.3,129175602,129288970,113368,-,-
BAC199_H11,3,3q21.3,129251079,129330302,79223,-,-
BAC193_C12,3,3q21.3,129255235,129403356,148121,-,-
BAC86_F18,3,3q21.3,129255238,129378209,122971,-,-
BAC32_O05,3,3q21.3,129261097,129480184,219087,-,-
BAC244_L16,3,3q21.3,129288965,129378343,89378,-,-
BAC161_F10,3,3q21.3,129288967,129369011,80044,-,-
BAC135_B13,3,3q21.3,129315779,129394432,78653,-,-
BAC24_A17,3,3q21.3,129321354,129521092,199738,-,-
BAC223_H03,3,3q21.3,129323445,129394432,70987,-,-
BAC14_C15,3,3q21.3,129365061,129509721,144660,-,-
BAC12_N11,3,3q21.3,129378545,129491737,113192,-,-
BAC145_N22,3,3q21.3,129378945,129457447,78502,-,-
BAC184_C04,3,3q21.3,129405368,129508713,103345,-,-
BAC176_E11,3,3q21.3,129428253,129509729,81476,-,-
BAC169_A09,3,3q21.3,129441948,129531212,89264,-,-
BAC151_H06,3,3q21.3,129471710,129549449,77739,-,-
BAC57_N10,3,3q21.3,129487616,129600604,112988,-,-
BAC32_L04,3,3q21.3,129515895,129616607,100712,-,-
BAC142_E11,3,3q21.3,129564034,129648203,84169,-,-
BAC169_J13,3,3q21.3,129607184,129698621,91437,-,-
BAC214_G08,3,3q21.3,129708237,129817103,108866,-,-
BAC220_O04,3,3q21.3,129739938,129800655,60717,-,-
BAC247_N24,3,3q21.3,129739940,129839439,99499,-,-
BAC192_H12,3,3q21.3,129860494,129943897,83403,-,-
BAC30_K24,3,3q21.3,129932778,130073974,141196,-,-
BAC161_K18,3,3q21.3,129963000,130056248,93248,-,-
BAC89_N03,3,3q21.3,130015393,130112278,96885,-,-
BAC247_C06,3,3q21.3,130025239,130111298,86059,-,-
BAC100_N13,3,3q21.3,130033088,130115053,81965,-,-
BAC61_O14,3,3q21.3,130033089,130143818,110729,-,-
BAC37_O11,3,3q21.3,130057268,130196159,138891,-,-
BAC92_C14,3,3q21.3,130111317,130218727,107410,-,-
BAC184_F09,3,3q21.3,130133629,130233035,99406,-,-
BAC172_P21,3,3q21.3,130138550,130227480,88930,-,-
BAC30_P10,3,3q21.3,130191353,130320087,128734,-,-
BAC191_B15,3,3q21.3,130196654,130285392,88738,-,-
BAC41_F20,3,3q21.3,130196654,130288891,92237,-,-
BAC37_F06,3,3q21.3,130216312,130324601,108289,-,-
BAC92_J13,3,3q21.3,130233189,130365456,132267,-,-
BAC22_F06,3,3q21.3,130324612,130427224,102612,-,-
BAC135_C04,3,3q21.3,130325045,130448299,123254,-,-
BAC118_I17,3,3q21.3,130329787,130435201,105414,-,-
BAC27_P07,3,3q21.3,130329814,130433500,103686,-,-
BAC58_C02,3,3q21.3,130387447,130485883,98436,-,-
BAC52_I21,3,3q21.3,130727753,130829757,102004,-,-
BAC17_F12,3,3q21.3,130728637,130829538,100901,-,-
BAC50_H13,3,3q21.3,130757234,130866114,108880,-,-
BAC220_L03,3,3q21.3,130763354,130851627,88273,-,-
BAC135_D10,3,3q21.3,130881482,130982986,101504,-,-
BAC43_K24,3,3q21.3,130881482,130970649,89167,-,-
BAC82_G19,3,3q21.3,130881486,130970426,88940,-,-
BAC77_E13,3,3q21.3,130983022,131068425,85403,-,-
BAC116_M01,3,3q21.3,131029555,131118153,88598,-,-
BAC39_K03,3,3q21.3,131099654,131218467,118813,-,-
BAC123_M20,3,3q21.3,131147358,131250092,102734,yes,-
BAC196_J15,3,3q21.3,131176778,131304461,127683,yes,-
BAC108_P21,3,3q21.3,131213308,131304461,91153,yes,-
BAC10_O11,3,3q21.3,131214960,131311174,96214,-,-
BAC153_B14,3,3q21.3,131230269,131311176,80907,yes,-
BAC100_M08,3,3q21.3,131249652,131377095,127443,-,-
BAC217_C23,3,3q21.3,131250152,131345930,95778,-,-
BAC235_M09,3,3q21.3,131250152,131329951,79799,-,-
BAC35_E02,3,3q21.3,131260195,131381131,120936,-,-
BAC230_K04,3,3q21.3,131311197,131393120,81923,-,-
BAC190_L02,3,3q22.1,131536069,131640625,104556,-,-
BAC183_I16,3,3q22.1,131571019,131652077,81058,-,-
BAC67_B12,3,3q22.1,131578214,131659912,81698,-,-
BAC52_O16,3,3q22.1,131750879,131882815,131936,yes,-
BAC177_E03,3,3q22.1,131837298,131928154,90856,-,-
BAC57_E20,3,3q22.1,131992236,132102560,110324,-,-
BAC249_O09,3,3q22.1,132029523,132115588,86065,-,-
BAC45_J01,3,3q22.1,132034430,132172441,138011,-,-
BAC199_I04,3,3q22.1,132121708,132203963,82255,-,-
BAC109_H18,3,3q22.1,132206667,132350278,143611,-,-
BAC27_K11,3,3q22.1,132274411,132363805,89394,-,-
BAC55_E12,3,3q22.1,132319877,132401032,81155,-,-
BAC180_M24,3,3q22.1,132322313,132400290,77977,-,-
BAC149_M15,3,3q22.1,132494713,132588076,93363,-,-
BAC172_E04,3,3q22.1,132588068,132663425,75357,-,-
BAC171_J11,3,3q22.1,132609480,132693332,83852,-,-
BAC144_D20,3,3q22.1,132797097,132880337,83240,-,-
BAC228_B21,3,3q22.1,132845623,132950734,105111,-,-
BAC219_P08,3,3q22.1,133011225,133100971,89746,-,-
BAC96_B16,3,3q22.1,133268452,133408662,140210,-,-
BAC29_C24,3,3q22.1,133292946,133411737,118791,-,-
BAC129_H20,3,3q22.1,133301028,133392261,91233,-,-
BAC45_A17,3,3q22.1,133301028,133376737,75709,-,-
BAC83_G08,3,3q22.1,133301028,133380453,79425,-,-
BAC59_C08,3,3q22.1,133400645,133488572,87927,-,-
BAC199_J09,3,3q22.1,133459896,133551665,91769,-,-
BAC231_N07,3,3q22.1,133471195,133551113,79918,-,-
BAC252_D08,3,3q22.1,133532561,133625518,92957,-,-
BAC189_N03,3,3q22.1,133540721,133618657,77936,-,-
BAC8_D08,3,3q22.1,133543230,133659828,116598,-,-
BAC220_J23,3,3q22.1,133583792,133659835,76043,-,-
BAC186_J03,3,3q22.1,133644257,133725255,80998,-,-
BAC77_I04,3,3q22.1,133775760,133854875,79115,-,-
BAC156_C10,3,3q22.1,133834979,133925716,90737,-,-
BAC208_M16,3,3q22.1,133848108,133925716,77608,-,-
BAC123_B08,3,3q22.1,133954753,134062312,107559,-,-
BAC55_L17,3,3q22.1,133976391,134110832,134441,-,-
BAC150_A06,3,3q22.1,134055335,134163695,108360,-,-
BAC24_J18,3,3q22.1,134112579,134211941,99362,-,-
BAC116_J14,3,3q22.1,134347048,134443683,96635,-,-
BAC121_J07,3,3q22.1,134513046,134594656,81610,-,-
BAC1_G06,3,3q22.1,134555516,134643332,87816,-,-
BAC195_O15,3,3q22.1,134568032,134648513,80481,-,-
BAC226_G02,3,3q22.1,134568990,134647408,78418,-,-
BAC26_I10,3,3q22.1,134656448,134824360,167912,-,-
BAC68_B05,3,3q22.1,134672466,134756647,84181,-,-
BAC90_F17,3,3q22.1,134687847,134792762,104915,-,-
BAC88_F11,3,3q22.1,134688276,134815107,126831,-,-
BAC129_F04,3,3q22.1,134721891,134786136,64245,-,-
BAC78_B06,3,3q22.1,134848203,134945926,97723,-,-
BAC57_D23,3,3q22.1,134886560,134995877,109317,-,-
BAC156_P13,3,3q22.1,134902692,135001895,99203,-,-
BAC227_K06,3,3q22.1,134991028,135081992,90964,-,-
BAC75_H18,3,3q22.1,135024275,135133047,108772,-,-
BAC41_F13,3,3q22.1,135056316,135151259,94943,-,-
BAC240_M06,3,3q22.1,135117456,135133049,15593,-,-
BAC222_M18,3,3q22.1,135153637,135236196,82559,-,-
BAC234_G07,3,3q22.1,135197860,135276790,78930,-,-
BAC55_O19,3,3q22.1,135199466,135309753,110287,-,-
BAC205_P15,3,3q22.1,135213381,135301140,87759,-,-
BAC132_L01,3,3q22.1,135319635,135477774,158139,-,-
BAC39_J23,3,3q22.1,135319635,135473148,153513,-,-
BAC173_K19,3,3q22.1,135436107,135523484,87377,-,-
BAC107_D18,3,3q22.1,135453881,135555415,101534,-,-
BAC167_D11,3,3q22.1,135459885,135555437,95552,-,-
BAC130_C15,3,3q22.1,135473150,135548019,74869,-,-
BAC70_E16,3,3q22.1,135494941,135596787,101846,-,-
BAC27_N17,3,3q22.1,135496911,135635101,138190,-,-
BAC88_H18,3,3q22.1,135548023,135677321,129298,-,-
BAC186_N17,3,3q22.1,135551307,135641047,89740,-,-
BAC106_H05,3,3q22.1,135555657,135656329,100672,-,-
BAC229_H14,3,3q22.1,135596830,135684133,87303,-,-
BAC120_L10,3,3q22.1-3q22.2,135616702,135754177,137475,-,-
BAC179_O09,3,3q22.1-3q22.2,135641627,135721533,79906,-,-
BAC193_K06,3,3q22.1-3q22.2,135687696,135765405,77709,-,-
BAC153_I18,3,3q22.2,135701374,135810050,108676,-,-
BAC30_N13,3,3q22.2,135717449,135809980,92531,-,-
BAC106_F17,3,3q22.2,135766292,135857966,91674,-,-
BAC195_D17,3,3q22.2,135904849,136021305,116456,-,-
BAC228_J19,3,3q22.2,135968774,136037509,68735,-,-
BAC135_B20,3,3q22.2,136108892,136218516,109624,-,-
BAC143_K10,3,3q22.2,136110957,136214335,103378,-,-
BAC40_N20,3,3q22.2,136130171,136260562,130391,-,-
BAC234_I14,3,3q22.2,136148638,136271298,122660,-,-
BAC132_L24,3,3q22.2,136185148,136260562,75414,-,-
BAC31_K19,3,3q22.2,136260575,136395836,135261,-,-
BAC196_O07,3,3q22.2,136271291,136355836,84545,-,-
BAC65_J19,3,3q22.2,136271291,136362164,90873,-,-
BAC23_A06,3,3q22.2,136272569,136399641,127072,-,-
BAC26_P08,3,3q22.2,136286323,136372987,86664,-,-
BAC45_B03,3,3q22.2,136292336,136381711,89375,-,-
BAC66_L24,3,3q22.2,136338038,136425041,87003,-,-
BAC194_N08,3,3q22.2,136343088,136437187,94099,-,-
BAC58_N16,3,3q22.2,136343088,136465439,122351,-,-
BAC64_P13,3,3q22.2,136372990,136498368,125378,-,-
BAC170_A10,3,3q22.2,136386698,136498367,111669,-,-
BAC66_N16,3,3q22.2,136395870,136502141,106271,-,-
BAC194_L02,3,3q22.2,136398754,136423351,24597,-,-
BAC243_H18,3,3q22.2,136546861,136631674,84813,-,-
BAC244_A14,3,3q22.2,136869115,136952350,83235,-,-
BAC26_G19,3,3q22.2,137011013,137113830,102817,-,-
BAC117_P21,3,3q22.2,137043984,137133371,89387,-,-
BAC226_E08,3,3q22.2-3q22.3,137305642,137409340,103698,-,-
BAC10_K03,3,3q22.2-3q22.3,137328901,137437692,108791,-,-
BAC60_G17,3,3q22.2-3q22.3,137381032,137511333,130301,-,-
BAC192_O18,3,3q22.2-3q22.3,137392457,137487997,95540,-,-
BAC75_H20,3,3q22.2-3q22.3,137392465,137487979,95514,-,-
BAC27_M18,3,3q22.3,137439728,137548125,108397,yes,-
BAC165_M02,3,3q22.3,137439728,137525339,85611,-,-
BAC188_B01,3,3q22.3,137452355,137557589,105234,-,-
BAC66_H12,3,3q22.3,137467376,137548066,80690,-,-
BAC81_E08,3,3q22.3,137553104,137638749,85645,-,-
BAC160_A05,3,3q22.3,137574250,137590634,16384,-,-
BAC95_F04,3,3q22.3,137729476,137841508,112032,-,-
BAC50_J08,3,3q22.3,137743120,137837066,93946,-,-
BAC59_L16,3,3q22.3,137774377,137877712,103335,-,-
BAC15_E19,3,3q22.3,137779101,137874054,94953,-,-
BAC96_E06,3,3q22.3,137795569,137896458,100889,-,-
BAC43_I17,3,3q22.3,137826519,137948030,121511,-,-
BAC243_L05,3,3q22.3,137838279,137942708,104429,-,-
BAC118_I23,3,3q22.3,137975936,138118645,142709,-,-
BAC162_O18,3,3q22.3,137994233,138089939,95706,-,-
BAC178_A20,3,3q22.3,138034098,138112408,78310,-,-
BAC75_O21,3,3q22.3,138034098,138118676,84578,-,-
BAC131_N21,3,3q22.3,138034098,138198281,164183,-,-
BAC69_I03,3,3q22.3,138041713,138126333,84620,-,-
BAC133_C23,3,3q22.3,138176572,138269827,93255,-,-
BAC179_I18,3,3q22.3,138180688,138269833,89145,-,-
BAC50_C16,3,3q22.3,138184562,138298707,114145,-,-
BAC162_C09,3,3q22.3,138303140,138421730,118590,-,-
BAC49_K17,3,3q22.3,138364606,138466937,102331,-,-
BAC230_E08,3,3q22.3,138388527,138493213,104686,-,-
BAC64_H06,3,3q22.3,138535372,138632807,97435,-,-
BAC56_J19,3,3q22.3,138679051,138794745,115694,-,-
BAC200_M24,3,3q22.3,138686951,138798258,111307,-,-
BAC23_F10,3,3q22.3,138701424,138815247,113823,-,-
BAC244_I12,3,3q22.3,138728551,138840812,112261,-,-
BAC127_B19,3,3q22.3,138799530,138937674,138144,-,-
BAC20_K16,3,3q22.3,138831794,138937675,105881,-,-
BAC128_C03,3,3q22.3,138840807,138940520,99713,-,-
BAC226_J23,3,3q22.3,138953586,139067350,113764,-,-
BAC237_M11,3,3q22.3,138963565,139067350,103785,-,-
BAC11_C08,3,3q22.3,138966486,139057269,90783,-,-
BAC160_K08,3,3q22.3,138973500,139056589,83089,-,-
BAC21_K10,3,3q22.3,139178766,139273256,94490,-,-
BAC41_B23,3,3q22.3,139217783,139310873,93090,-,-
BAC199_P20,3,3q22.3,139273253,139386548,113295,-,-
BAC11_N09,3,3q22.3,139273276,139420138,146862,-,-
BAC214_C16,3,3q22.3,139310195,139386618,76423,-,-
BAC198_N08,3,3q22.3,139330974,139442170,111196,-,-
BAC108_E08,3,3q22.3,139330974,139440738,109764,-,-
BAC80_B03,3,3q22.3,139346743,139460947,114204,-,-
BAC27_G11,3,3q22.3,139363686,139460962,97276,-,-
BAC184_F05,3,3q22.3,139442194,139534568,92374,-,-
BAC240_M10,3,3q22.3,139460956,139551685,90729,-,-
BAC161_B07,3,3q22.3,139534633,139621060,86427,-,-
BAC230_M12,3,3q22.3,139578748,139676125,97377,-,-
BAC88_L04,3,3q22.3,139588636,139682063,93427,-,-
BAC107_H16,3,3q22.3,139621074,139761212,140138,-,-
BAC226_K23,3,3q22.3,139645995,139727682,81687,-,-
BAC66_K15,3,3q22.3,139682054,139761212,79158,-,-
BAC168_A08,3,3q22.3,139752800,139843983,91183,-,-
BAC181_I09,3,3q22.3,139782876,139867869,84993,-,-
BAC6_L23,3,3q22.3,139782876,139867869,84993,-,-
BAC173_B17,3,3q22.3,139807108,139890743,83635,-,-
BAC180_H21,3,3q22.3,139834340,139932709,98369,-,-
BAC62_B07,3,3q22.3,139895985,139969279,73294,-,-
BAC147_O23,3,3q22.3,139932799,140020511,87712,-,-
BAC182_N21,3,3q22.3,139932799,140015533,82734,-,-
BAC24_A13,3,3q22.3,139979549,140092702,113153,-,-
BAC199_B11,3,3q22.3,140003119,140096770,93651,-,-
BAC111_J16,3,3q22.3,140003119,140092702,89583,-,-
BAC199_L08,3,3q22.3,140008247,140096770,88523,-,-
BAC90_L16,3,3q22.3,140008247,140096771,88524,-,-
BAC19_N07,3,3q22.3,140020514,140156931,136417,-,-
BAC31_A22,3,3q22.3,140092815,140184878,92063,-,-
BAC229_F03,3,3q22.3,140101138,140218272,117134,-,-
BAC179_I20,3,3q22.3,140114433,140220046,105613,-,-
BAC212_L17,3,3q22.3,140244223,140322977,78754,-,-
BAC162_I06,3,3q22.3-3q23,140313968,140414844,100876,-,-
BAC242_O10,3,3q22.3,140314625,140382198,67573,-,-
BAC92_N18,3,3q22.3-3q23,140339225,140426041,86816,-,-
BAC246_C09,3,3q22.3-3q23,140347486,140417153,69667,-,-
BAC183_O08,3,3q22.3-3q23,140372796,140506691,133895,-,-
BAC120_G01,3,3q22.3-3q23,140385292,140497284,111992,-,-
BAC186_B02,3,3q23,140446560,140546773,100213,-,-
BAC53_A16,3,3q23,140488442,140585165,96723,-,-
BAC92_P03,3,3q23,140517034,140627049,110015,-,-
BAC195_I22,3,3q23,140585180,140674457,89277,-,-
BAC80_C22,3,3q23,140615937,140723337,107400,-,-
BAC90_G20,3,3q23,140630426,140749387,118961,-,-
BAC97_H16,3,3q23,140634009,140749387,115378,-,-
BAC162_A05,3,3q23,140762905,140842710,79805,-,-
BAC211_N10,3,3q23,140813211,140910554,97343,-,-
BAC61_P23,3,3q23,140914391,141006240,91849,-,-
BAC186_K05,3,3q23,140929318,140945940,16622,-,-
BAC192_O19,3,3q23,140938013,141006191,68178,-,-
BAC155_F24,3,3q23,140938013,141006258,68245,-,-
BAC45_P02,3,3q23,140940241,141021714,81473,-,-
BAC177_G04,3,3q23,141041252,141161285,120033,-,-
BAC61_G01,3,3q23,141055464,141147779,92315,-,-
BAC233_B07,3,3q23,141083783,141181842,98059,-,-
BAC179_D08,3,3q23,141147835,141251793,103958,-,-
BAC36_F01,3,3q23,141251387,141337882,86495,-,-
BAC171_P13,3,3q23,141265013,141353011,87998,-,-
BAC145_L12,3,3q23,141424600,141495009,70409,-,-
BAC26_A10,3,3q23,141424600,141579939,155339,-,-
BAC193_L05,3,3q23,141449297,141545174,95877,-,-
BAC146_B05,3,3q23,141485375,141565291,79916,-,-
BAC56_G09,3,3q23,141494604,141589321,94717,-,-
BAC177_P13,3,3q23,141528266,141646527,118261,-,-
BAC78_I10,3,3q23,141579939,141672088,92149,-,-
BAC123_E14,3,3q23,141590031,141695674,105643,-,-
BAC235_B15,3,3q23,141596687,141690956,94269,-,-
BAC16_G17,3,3q23,141615495,141714816,99321,-,-
BAC1_H06,3,3q23,141740184,141827436,87252,-,-
BAC184_B10,3,3q23,141820128,141905995,85867,-,-
BAC139_E24,3,3q23,141914549,141989757,75208,-,-
BAC132_C01,3,3q23,141930559,142058268,127709,-,-
BAC48_M03,3,3q23,141940761,142062434,121673,-,-
BAC86_H23,3,3q23,142069765,142154978,85213,-,-
BAC150_M21,3,3q23,142170820,142247292,76472,-,-
BAC26_H20,3,3q23,142189595,142280069,90474,-,-
BAC65_H23,3,3q23,142254017,142345952,91935,-,-
BAC147_P11,3,3q23,142341126,142440597,99471,-,-
BAC88_G09,3,3q23,142466887,142567724,100837,-,-
BAC49_O01,3,3q23,142553701,142644525,90824,-,-
BAC145_F07,3,3q23,142561905,142687374,125469,-,-
BAC95_I21,3,3q23,142575224,142642564,67340,-,-
BAC155_H02,3,3q23,142589782,142693925,104143,-,-
BAC198_E19,3,3q23,142593748,142680043,86295,-,-
BAC97_G05,3,3q23,142599110,142687378,88268,-,-
BAC28_K03,3,3q23,142643621,142724176,80555,-,-
BAC1_C04,3,3q23,142687373,142784308,96935,-,-
BAC38_E05,3,3q23,142700732,142845658,144926,-,-
BAC147_B07,3,3q23,142716242,142853929,137687,-,-
BAC7_C04,3,3q23,142724172,142815479,91307,-,-
BAC118_H21,3,3q23,142892803,142992663,99860,-,-
BAC20_P02,3,3q23,142923685,143017997,94312,-,-
BAC38_L24,3,3q23,142926304,143014973,88669,-,-
BAC118_F24,3,3q23,142969329,143064942,95613,-,-
BAC46_D06,3,3q23,142976068,143064351,88283,-,-
BAC219_D05,3,3q23,142979651,143066427,86776,-,-
BAC244_J16,3,3q23,142994578,143104877,110299,-,-
BAC37_D24,3,3q23,143033577,143152526,118949,-,-
BAC161_M04,3,3q23,143094933,143190836,95903,-,-
BAC195_K11,3,3q23,143123370,143205073,81703,-,-
BAC200_C22,3,3q23,143162451,143254336,91885,-,-
BAC65_A03,3,3q23,143162451,143259464,97013,-,-
BAC24_B13,3,3q23,143174065,143255719,81654,-,-
BAC152_M18,3,3q23,143303341,143382445,79104,-,-
BAC10_G02,3,3q23,143365479,143439403,73924,-,-
BAC191_A04,3,3q23,143366588,143472679,106091,-,-
BAC116_E24,3,3q23,143382439,143480415,97976,-,-
BAC165_A10,3,3q23,143382458,143490298,107840,-,-
BAC81_L13,3,3q23,143490290,143579583,89293,-,-
BAC10_A10,3,3q23,143495387,143624528,129141,-,-
BAC220_B20,3,3q23,143616755,143700179,83424,-,-
BAC123_D20,3,3q23,143709356,143811396,102040,-,-
BAC115_P11,3,3q23,143731381,143817430,86049,-,-
BAC175_G04,3,3q23,143788717,143886849,98132,-,-
BAC152_A06,3,3q23,143811390,143909131,97741,-,-
BAC86_A09,3,3q23,143932389,144034099,101710,-,-
BAC122_B20,3,3q23,144053953,144159978,106025,-,-
BAC86_P17,3,3q23,144055887,144202329,146442,-,-
BAC129_C01,3,3q23,144067009,144202329,135320,-,-
BAC154_H23,3,3q23,144068212,144159978,91766,-,-
BAC88_J23,3,3q23,144108140,144192914,84774,-,-
BAC161_K20,3,3q23-3q24,144334548,144415372,80824,-,-
BAC123_I17,3,3q24,144502518,144595778,93260,-,-
BAC22_L22,3,3q24,144526858,144647409,120551,-,-
BAC135_O12,3,3q24,144554096,144636572,82476,-,-
BAC43_F03,3,3q24,144554096,144636569,82473,-,-
BAC55_C14,3,3q24,144620289,144719738,99449,-,-
BAC82_J19,3,3q24,144685203,144797715,112512,-,-
BAC63_H06,3,3q24,144728780,144805116,76336,-,-
BAC218_L08,3,3q24,144801572,144892550,90978,-,-
BAC31_D23,3,3q24,144865761,144965591,99830,-,-
BAC69_N06,3,3q24,144886316,145000046,113730,-,-
BAC58_C12,3,3q24,144951864,145052275,100411,-,-
BAC177_D16,3,3q24,145060305,145148767,88462,-,-
BAC12_K12,3,3q24,145254754,145336133,81379,-,-
BAC40_A05,3,3q24,145285755,145379747,93992,-,-
BAC161_E19,3,3q24,145445193,145532582,87389,-,-
BAC157_H09,3,3q24,145938430,146017268,78838,-,-
BAC172_K08,3,3q24,145942474,146014867,72393,-,-
BAC125_E06,3,3q24,145948375,146069096,120721,-,-
BAC227_J09,3,3q24,146276479,146362286,85807,-,-
BAC129_C06,3,3q24,146354789,146468945,114156,-,-
BAC68_L18,3,3q24,146416198,146523160,106962,-,-
BAC23_N18,3,3q24,146594507,146684924,90417,-,-
BAC157_I20,3,3q24,146948835,147066189,117354,-,-
BAC91_M09,3,3q24,147122154,147203573,81419,-,-
BAC81_L05,3,3q24,147485941,147576213,90272,-,-
BAC228_J17,3,3q24,147493174,147566937,73763,-,-
BAC90_G01,3,3q24,147558429,147661449,103020,-,-
BAC244_D02,3,3q24,147589199,147681354,92155,-,-
BAC180_K08,3,3q24,147701111,147786743,85632,-,-
BAC40_J14,3,3q24,147891288,148060287,168999,-,-
BAC40_N17,3,3q24,147978560,148084372,105812,-,-
BAC118_D01,3,3q24,148342827,148440301,97474,-,-
BAC172_J14,3,3q24,148360073,148463474,103401,-,-
BAC168_G04,3,3q24,148525900,148639469,113569,-,-
BAC144_P16,3,3q24,148560574,148639637,79063,-,-
BAC143_B07,3,3q24,148636894,148650934,14040,-,-
BAC78_A07,3,3q24,148639096,148783869,144773,-,-
BAC248_H08,3,3q24,148818701,148887141,68440,-,-
BAC162_F10,3,3q24,148872526,148966193,93667,-,-
BAC110_I06,3,3q24,148893159,149007946,114787,-,-
BAC61_M07,3,3q24,148953828,149077273,123445,-,-
BAC246_H08,3,3q24,148987782,149077273,89491,-,-
BAC90_D07,3,3q24,149077267,149188443,111176,-,-
BAC41_G22,3,3q24,149081986,149172288,90302,-,-
BAC123_F16,3,3q24,149209063,149317238,108175,-,-
BAC181_K07,3,3q24,149345935,149471054,125119,-,-
BAC28_B23,3,3q24,149490838,149586215,95377,-,-
BAC96_N09,3,3q24,149682423,149787765,105342,-,-
BAC221_L10,3,3q24,149850283,149942757,92474,-,-
BAC148_A03,3,3q24,149871063,149960984,89921,-,-
BAC44_I09,3,3q24,150042238,150164133,121895,-,-
BAC46_D09,3,3q24,150074764,150162328,87564,-,-
BAC161_E03,3,3q24,150123313,150214804,91491,-,-
BAC232_C12,3,3q24,150247446,150342813,95367,-,-
BAC168_P09,3,3q24,150264818,150358308,93490,-,-
BAC79_J11,3,3q24-3q25.1,150377290,150471528,94238,-,-
BAC107_E16,3,3q25.1,150487926,150582729,94803,-,-
BAC96_N15,3,3q25.1,150559974,150667372,107398,-,-
BAC224_I06,3,3q25.1,150582722,150715287,132565,yes,-
BAC175_E16,3,3q25.1,150636492,150723351,86859,yes,-
BAC41_N13,3,3q25.1,150659135,150754210,95075,yes,-
BAC217_B24,3,3q25.1,150668130,150754788,86658,yes,-
BAC232_E23,3,3q25.1,150747252,150843546,96294,-,-
BAC69_I09,3,3q25.1,150754814,150854151,99337,-,-
BAC83_L22,3,3q25.1,150760527,150861565,101038,-,-
BAC242_K16,3,3q25.1,150772054,150854151,82097,-,-
BAC80_B19,3,3q25.1,150773164,150880122,106958,-,-
BAC140_L15,3,3q25.1,150773326,150788281,14955,-,-
BAC69_E23,3,3q25.1,150881542,150950196,68654,-,-
BAC101_G02,3,3q25.1,150989272,151083366,94094,-,-
BAC104_H22,3,3q25.1,151103078,151198979,95901,-,-
BAC113_G04,3,3q25.1,151109324,151268289,158965,-,-
BAC204_A13,3,3q25.1,151109770,151188589,78819,-,-
BAC160_I10,3,3q25.1,151131939,151236762,104823,-,-
BAC40_G05,3,3q25.1,151131950,151243121,111171,-,-
BAC31_F15,3,3q25.1,151142980,151258901,115921,-,-
BAC147_O13,3,3q25.1,151166903,151266537,99634,-,-
BAC82_H09,3,3q25.1,151192111,151331763,139652,-,-
BAC230_A21,3,3q25.1,151426906,151519104,92198,-,-
BAC185_G18,3,3q25.1,151473938,151555551,81613,-,-
BAC244_I21,3,3q25.1,151686250,151761193,74943,-,-
BAC181_A14,3,3q25.1,151697565,151806565,109000,-,-
BAC96_G23,3,3q25.1,151757357,151872043,114686,-,-
BAC119_E11,3,3q25.1,151763885,151857450,93565,-,-
BAC41_D21,3,3q25.1,151784670,151907166,122496,-,-
BAC242_I04,3,3q25.1,151806643,151907166,100523,-,-
BAC122_E19,3,3q25.1,151806643,151907158,100515,-,-
BAC89_N09,3,3q25.1,151841091,151925354,84263,-,-
BAC71_C01,3,3q25.1,151878804,151966737,87933,-,-
BAC167_P15,3,3q25.1,151878821,151957179,78358,-,-
BAC67_M19,3,3q25.1,151893443,151988391,94948,-,-
BAC177_K10,3,3q25.1,151913433,152059741,146308,-,-
BAC132_F04,3,3q25.1,151988616,152100971,112355,-,-
BAC78_F02,3,3q25.1,152223962,152309962,86000,-,-
BAC137_B20,3,3q25.1,152302760,152389148,86388,-,-
BAC82_J01,3,3q25.1,152309956,152411845,101889,-,-
BAC153_M07,3,3q25.1,152321029,152401700,80671,-,-
BAC122_P11,3,3q25.1,152328147,152506253,178106,-,-
BAC97_H13,3,3q25.1,152336950,152431762,94812,-,-
BAC170_O16,3,3q25.1,152411974,152501776,89802,-,-
BAC133_H24,3,3q25.1,152434757,152591801,157044,-,-
BAC180_O09,3,3q25.1,152463068,152553945,90877,-,-
BAC85_J03,3,3q25.1,152469315,152584270,114955,-,-
BAC193_K05,3,3q25.1,152516901,152581079,64178,-,-
BAC173_E14,3,3q25.1,152587709,152660518,72809,-,-
BAC125_E04,3,3q25.1,152775586,152862850,87264,-,-
BAC24_H07,3,3q25.1,152871320,152952598,81278,-,-
BAC244_C13,3,3q25.1,152875988,152987793,111805,-,-
BAC165_H10,3,3q25.1,152979994,153052678,72684,-,-
BAC147_K14,3,3q25.1,152993587,153071424,77837,-,-
BAC46_B12,3,3q25.1,153122770,153209744,86974,-,-
BAC88_N18,3,3q25.1,153160640,153261495,100855,-,-
BAC237_L24,3,3q25.1,153187356,153270534,83178,-,-
BAC240_E05,3,3q25.1,153187357,153270540,83183,-,-
BAC86_P19,3,3q25.1,153209767,153294967,85200,-,-
BAC235_J10,3,3q25.1,153315937,153389352,73415,-,-
BAC122_K01,3,3q25.1,153394226,153478178,83952,-,-
BAC63_B05,3,3q25.1-3q25.2,153492762,153585419,92657,-,-
BAC87_M24,3,3q25.2,153573845,153602886,29041,-,-
BAC24_D22,3,3q25.2,153640427,153731508,91081,-,-
BAC192_G15,3,3q25.2,153684813,153771771,86958,-,-
BAC124_B02,3,3q25.2,153697789,153851030,153241,-,-
BAC146_E07,3,3q25.2,153785258,153877641,92383,-,-
BAC248_O01,3,3q25.2,153788027,153884388,96361,-,-
BAC160_H01,3,3q25.2,153903395,154003063,99668,-,-
BAC55_O06,3,3q25.2,153962156,154083731,121575,-,-
BAC118_F15,3,3q25.2,153992504,154094259,101755,-,-
BAC140_C08,3,3q25.2,154032126,154141554,109428,-,-
BAC168_A09,3,3q25.2,154148701,154252290,103589,-,-
BAC48_L09,3,3q25.2,154199338,154287387,88049,-,-
BAC78_M13,3,3q25.2,154224946,154313961,89015,-,-
BAC242_E16,3,3q25.2,154275648,154356120,80472,-,-
BAC236_J14,3,3q25.2,154279506,154350376,70870,-,-
BAC113_H16,3,3q25.2,154279506,154408401,128895,-,-
BAC131_D08,3,3q25.2,154405219,154473564,68345,-,-
BAC186_H13,3,3q25.2,154578210,154675166,96956,-,-
BAC247_O07,3,3q25.2,154728151,154804735,76584,-,-
BAC176_J21,3,3q25.2,154947809,155003476,55667,-,-
BAC75_E06,3,3q25.2,154978288,155065944,87656,-,-
BAC117_N21,3,3q25.2,155045054,155065968,20914,-,-
BAC222_F22,3,3q25.2,155394349,155482753,88404,-,-
BAC168_F20,3,3q25.2,155464545,155554369,89824,-,-
BAC124_O09,3,3q25.2,155466838,155554369,87531,-,-
BAC30_P22,3,3q25.2,155466838,155599805,132967,-,-
BAC25_B02,3,3q25.2,155482795,155584970,102175,-,-
BAC200_E01,3,3q25.2,155482797,155584527,101730,-,-
BAC101_N18,3,3q25.2,155567132,155656887,89755,-,-
BAC228_I08,3,3q25.2,155636433,155715450,79017,-,-
BAC131_H02,3,3q25.2,155666227,155751511,85284,-,-
BAC196_A16,3,3q25.2,155754842,155851426,96584,-,-
BAC101_O13,3,3q25.2,155764648,155893823,129175,-,-
BAC20_P22,3,3q25.2,155764700,155859222,94522,-,-
BAC25_B12,3,3q25.2,155893857,156025258,131401,-,-
BAC130_D03,3,3q25.2,155907369,155979185,71816,-,-
BAC128_G24,3,3q25.2,155966437,156090378,123941,-,-
BAC224_A11,3,3q25.2,156146853,156263212,116359,-,-
BAC237_D03,3,3q25.2,156146995,156232064,85069,-,-
BAC134_P23,3,3q25.2,156171937,156268477,96540,-,-
BAC173_F07,3,3q25.2-3q25.31,156280173,156393341,113168,-,-
BAC198_M13,3,3q25.31,156504182,156601164,96982,-,-
BAC124_L16,3,3q25.31,156549158,156664873,115715,-,-
BAC81_L14,3,3q25.31,156601158,156736221,135063,-,-
BAC167_H18,3,3q25.31,156706998,156794229,87231,-,-
BAC134_O03,3,3q25.31,156711097,156804417,93320,-,-
BAC151_I19,3,3q25.31,156727796,156809348,81552,-,-
BAC233_M14,3,3q25.31,156749869,156852507,102638,-,-
BAC112_J04,3,3q25.31,156785191,156900251,115060,-,-
BAC67_O19,3,3q25.31,156809345,156900251,90906,-,-
BAC116_C03,3,3q25.31,156809354,156905764,96410,-,-
BAC242_C14,3,3q25.31,156836893,156918047,81154,-,-
BAC183_E08,3,3q25.31,156874610,156966460,91850,-,-
BAC41_P23,3,3q25.31,156912543,157025745,113202,-,-
BAC102_P14,3,3q25.31,156918085,157113941,195856,-,-
BAC84_G19,3,3q25.31,156921193,157019114,97921,-,-
BAC144_N10,3,3q25.31,156952773,157033734,80961,-,-
BAC41_J23,3,3q25.31,157141531,157233199,91668,-,-
BAC218_L11,3,3q25.31,157165073,157276713,111640,-,-
BAC131_H13,3,3q25.31,157174725,157285590,110865,-,-
BAC252_M15,3,3q25.31,157196024,157288884,92860,-,-
BAC128_N01,3,3q25.31,157209485,157288414,78929,-,-
BAC113_A10,3,3q25.31,157253450,157382349,128899,-,-
BAC52_G14,3,3q25.31,157262662,157367716,105054,-,-
BAC186_G20,3,3q25.31,157293266,157376875,83609,-,-
BAC129_A02,3,3q25.31,157293266,157382349,89083,-,-
BAC176_H06,3,3q25.31,157330284,157427166,96882,-,-
BAC45_G01,3,3q25.31,157368177,157449241,81064,-,-
BAC153_P18,3,3q25.31,157382341,157450624,68283,-,-
BAC103_A02,3,3q25.31,157382351,157476938,94587,-,-
BAC96_H14,3,3q25.31,157388769,157481822,93053,-,-
BAC195_H10,3,3q25.31,157427215,157512089,84874,-,-
BAC219_J11,3,3q25.31,157524303,157637944,113641,-,-
BAC46_K17,3,3q25.31,157547119,157643740,96621,-,-
BAC240_N17,3,3q25.31,157566984,157655379,88395,-,-
BAC248_F03,3,3q25.31,157574925,157660794,85869,-,-
BAC165_B17,3,3q25.31,157708126,157806467,98341,-,-
BAC151_O23,3,3q25.31,157708126,157846154,138028,-,-
BAC240_I01,3,3q25.31,157720349,157832557,112208,-,-
BAC80_C07,3,3q25.31,157720363,157855587,135224,-,-
BAC29_N19,3,3q25.31,157739944,157866849,126905,-,-
BAC63_O09,3,3q25.31,157846190,157925655,79465,-,-
BAC143_C06,3,3q25.31,157859391,157942775,83384,-,-
BAC123_E18,3,3q25.31,157929916,158036888,106972,-,-
BAC46_C10,3,3q25.31,157991581,158075998,84417,-,-
BAC134_B08,3,3q25.31-3q25.32,158030811,158114337,83526,-,-
BAC247_A10,3,3q25.32,158234547,158314271,79724,-,-
BAC237_A12,3,3q25.32,158238761,158325040,86279,-,-
BAC64_P12,3,3q25.32,158300454,158393883,93429,-,-
BAC131_H11,3,3q25.32,158300993,158404707,103714,-,-
BAC120_H14,3,3q25.32,158300993,158404951,103958,-,-
BAC120_I12,3,3q25.32,158369482,158466526,97044,-,-
BAC22_K22,3,3q25.32,158457615,158544300,86685,-,-
BAC134_O11,3,3q25.32,158592466,158686272,93806,-,-
BAC106_P15,3,3q25.32,158593229,158734443,141214,-,-
BAC95_I13,3,3q25.32,158593684,158686031,92347,-,-
BAC184_K15,3,3q25.32,158601242,158686453,85211,-,-
BAC63_E23,3,3q25.32,158728197,158817002,88805,-,-
BAC34_E07,3,3q25.32,158816008,158919417,103409,-,-
BAC141_G16,3,3q25.32,158816997,158901122,84125,-,-
BAC170_I08,3,3q25.32,158852313,159020978,168665,-,-
BAC89_F04,3,3q25.32,158860854,158958433,97579,-,-
BAC66_K04,3,3q25.32,158879154,158961726,82572,-,-
BAC161_K01,3,3q25.32,158928833,159020691,91858,-,-
BAC152_G14,3,3q25.32,159001372,159077448,76076,-,-
BAC190_F14,3,3q25.32,159041957,159128003,86046,-,-
BAC252_O09,3,3q25.32,159059464,159150292,90828,-,-
BAC128_E09,3,3q25.32,159083611,159172965,89354,-,-
BAC6_P13,3,3q25.32,159141736,159235975,94239,-,-
BAC165_N14,3,3q25.32,159247414,159330310,82896,-,-
BAC24_K02,3,3q25.32,159280917,159423034,142117,-,-
BAC218_N03,3,3q25.32,159300445,159397356,96911,-,-
BAC1_B13,3,3q25.32,159341404,159471139,129735,-,-
BAC133_O03,3,3q25.32,159369420,159470610,101190,-,-
BAC234_K01,3,3q25.32,159376409,159456917,80508,-,-
BAC244_I15,3,3q25.32,159423027,159492388,69361,-,-
BAC2_K04,3,3q25.32-3q25.33,159859333,159979440,120107,yes,-
BAC110_H12,3,3q25.32-3q25.33,159859333,159961891,102558,yes,-
BAC228_I10,3,3q25.32-3q25.33,159892263,159943519,51256,yes,-
BAC153_K15,3,3q25.32-3q25.33,159895222,159977944,82722,yes,-
BAC72_K11,3,3q25.33,159915491,160010836,95345,-,-
BAC165_D23,3,3q25.33,160005960,160095582,89622,-,-
BAC197_G11,3,3q25.33,160010121,160103295,93174,-,-
BAC136_O10,3,3q25.33,160014497,160087363,72866,-,-
BAC123_A21,3,3q25.33,160014497,160155346,140849,-,-
BAC188_A20,3,3q25.33,160190325,160302902,112577,-,-
BAC186_O04,3,3q25.33,160275835,160372624,96789,-,-
BAC123_C05,3,3q25.33,160308144,160434004,125860,-,-
BAC42_I22,3,3q25.33,160454418,160548212,93794,-,-
BAC23_M23,3,3q25.33,160576423,160708324,131901,-,-
BAC8_G12,3,3q25.33,160585718,160695371,109653,-,-
BAC222_G17,3,3q25.33,160600536,160688044,87508,-,-
BAC235_P23,3,3q25.33,160635659,160727161,91502,-,-
BAC220_B11,3,3q25.33,160716599,160800960,84361,-,-
BAC248_B12,3,3q25.33,160774398,160859675,85277,-,-
BAC70_N13,3,3q25.33,160825797,160937043,111246,-,-
BAC160_B19,3,3q25.33,160892341,160997413,105072,-,-
BAC135_L10,3,3q25.33,160914372,161004090,89718,-,-
BAC59_C19,3,3q25.33,160914741,161013614,98873,-,-
BAC107_P06,3,3q25.33,160932092,161032987,100895,-,-
BAC67_H10,3,3q25.33,161089653,161175100,85447,-,-
BAC106_O15,3,3q25.33-3q26.1,161090714,161236562,145848,-,-
BAC196_B02,3,3q25.33-3q26.1,161158300,161297205,138905,-,-
BAC10_A17,3,3q26.1,161206268,161316172,109904,-,-
BAC139_F12,3,3q26.1,161238680,161316811,78131,-,-
BAC90_P24,3,3q26.1,161240376,161350904,110528,-,-
BAC109_O01,3,3q26.1,161307919,161421515,113596,-,-
BAC149_G20,3,3q26.1,161316907,161421522,104615,-,-
BAC71_O05,3,3q26.1,161370606,161490891,120285,-,-
BAC80_K04,3,3q26.1,161388000,161490895,102895,-,-
BAC189_B23,3,3q26.1,161478684,161567142,88458,-,-
BAC27_D22,3,3q26.1,161499503,161602717,103214,-,-
BAC42_N21,3,3q26.1,161563151,161694830,131679,-,-
BAC183_C04,3,3q26.1,161582005,161664342,82337,-,-
BAC133_I18,3,3q26.1,161708005,161817139,109134,-,-
BAC102_I05,3,3q26.1,161735930,161849221,113291,-,-
BAC171_B09,3,3q26.1,161796401,161893750,97349,-,-
BAC128_P08,3,3q26.1,161804764,161938200,133436,-,-
BAC228_N14,3,3q26.1,161910059,162006983,96924,-,-
BAC50_C09,3,3q26.1,161966492,162049228,82736,-,-
BAC11_P03,3,3q26.1,161991863,162123713,131850,-,-
BAC222_B10,3,3q26.1,162098060,162250380,152320,-,-
BAC100_N07,3,3q26.1,162240451,162350552,110101,-,-
BAC180_D20,3,3q26.1,162269426,162350551,81125,-,-
BAC113_C09,3,3q26.1,162270787,162350541,79754,-,-
BAC107_J07,3,3q26.1,162476775,162575573,98798,-,-
BAC74_I15,3,3q26.1,162541936,162650570,108634,-,-
BAC230_K22,3,3q26.1,162750106,162849440,99334,-,-
BAC168_O18,3,3q26.1,162797509,162863413,65904,-,-
BAC10_P13,3,3q26.1,163175825,163273105,97280,-,-
BAC66_M16,3,3q26.1,163248305,163364596,116291,-,-
BAC46_F18,3,3q26.1,163257804,163319274,61470,-,-
BAC97_G04,3,3q26.1,163499160,163601013,101853,-,-
BAC26_B10,3,3q26.1,163499232,163594719,95487,-,-
BAC235_B17,3,3q26.1,163715686,163795575,79889,-,-
BAC141_E09,3,3q26.1,163908244,164111911,203667,-,-
BAC61_F08,3,3q26.1,164180885,164292231,111346,-,-
BAC64_D13,3,3q26.1,164187583,164296748,109165,-,-
BAC51_H11,3,3q26.1,164215049,164255001,39952,-,-
BAC217_N19,3,3q26.1,164264056,164354929,90873,-,-
BAC184_N04,3,3q26.1,164264056,164374223,110167,-,-
BAC90_F15,3,3q26.1,164332668,164431080,98412,-,-
BAC106_J21,3,3q26.1,164410698,164593653,182955,-,-
BAC88_D24,3,3q26.1,164528583,164622193,93610,-,-
BAC45_F15,3,3q26.1,164557842,164713046,155204,-,-
BAC45_A13,3,3q26.1,164664491,164778567,114076,-,-
BAC200_P18,3,3q26.1,164841789,164925604,83815,-,-
BAC70_O11,3,3q26.1,164860328,165024512,164184,-,-
BAC147_L03,3,3q26.1,164915250,164989493,74243,-,-
BAC102_N09,3,3q26.1,165392439,165491340,98901,-,-
BAC143_D19,3,3q26.1,165410819,165495663,84844,-,-
BAC186_C16,3,3q26.1,165495658,165583779,88121,-,-
BAC184_I15,3,3q26.1,165606216,165680710,74494,-,-
BAC184_O01,3,3q26.1,165705272,165799454,94182,-,-
BAC108_P11,3,3q26.1,166299635,166461620,161985,-,-
BAC78_F01,3,3q26.1,166393190,166534885,141695,-,-
BAC104_G03,3,3q26.1,166418904,166509406,90502,-,-
BAC102_C04,3,3q26.1,166492621,166580410,87789,-,-
BAC230_E23,3,3q26.1,166538468,166629028,90560,-,-
BAC78_I23,3,3q26.1,166642019,166779535,137516,-,-
BAC194_J24,3,3q26.1,166766642,166856994,90352,-,-
BAC114_C08,3,3q26.1,166795718,166882205,86487,-,-
BAC152_G03,3,3q26.1,166802201,166879308,77107,-,-
BAC178_B02,3,3q26.1,166890224,166993653,103429,-,-
BAC58_K16,3,3q26.1,166898432,167025178,126746,-,-
BAC183_D11,3,3q26.1,166902345,166994532,92187,-,-
BAC182_C05,3,3q26.1,167355580,167435991,80411,-,-
BAC88_G16,3,3q26.1,167519206,167607587,88381,-,-
BAC125_O19,3,3q26.1,167653180,167750793,97613,-,-
BAC230_B09,3,3q26.1,167796421,167904712,108291,-,-
BAC30_O18,3,3q26.1,168273638,168377083,103445,-,-
BAC5_E23,3,3q26.1,168303504,168391444,87940,-,-
BAC83_F01,3,3q26.1,168375149,168454747,79598,-,-
BAC127_M15,3,3q26.1,168567235,168668791,101556,-,-
BAC189_O05,3,3q26.1,168605142,168697744,92602,-,-
BAC29_H18,3,3q26.1,168753426,168848219,94793,-,-
BAC33_L15,3,3q26.1,168780160,168873047,92887,-,-
BAC113_G11,3,3q26.1,168829335,168926464,97129,-,-
BAC68_O13,3,3q26.1,168909136,168987932,78796,-,-
BAC120_P09,3,3q26.1,168940142,169033768,93626,-,-
BAC247_H22,3,3q26.1,168973724,169055966,82242,-,-
BAC183_P18,3,3q26.1,169013503,169119794,106291,-,-
BAC86_I03,3,3q26.1,169051532,169153258,101726,-,-
BAC96_B14,3,3q26.1-3q26.2,169177219,169330660,153441,-,-
BAC117_J05,3,3q26.2,169325347,169427435,102088,-,-
BAC63_A10,3,3q26.2,169377007,169500905,123898,-,-
BAC78_P09,3,3q26.2,169427431,169531432,104001,-,-
BAC91_D20,3,3q26.2,169552143,169629500,77357,-,-
BAC71_N17,3,3q26.2,169700117,169807890,107773,-,-
BAC130_K24,3,3q26.2,169785737,169862186,76449,-,-
BAC236_G07,3,3q26.2,169963564,170051929,88365,-,-
BAC196_E21,3,3q26.2,170197566,170284264,86698,-,-
BAC61_M02,3,3q26.2,170262202,170373830,111628,-,-
BAC215_M07,3,3q26.2,170262221,170348192,85971,-,-
BAC28_H10,3,3q26.2,170795385,170899946,104561,-,-
BAC97_L20,3,3q26.2,170800101,170899951,99850,-,-
BAC31_F16,3,3q26.2,170818539,170844139,25600,-,-
BAC218_M07,3,3q26.2,170899944,170997086,97142,-,-
BAC70_K04,3,3q26.2,170964575,171046204,81629,-,-
BAC113_I18,3,3q26.2,171009817,171093399,83582,-,-
BAC124_M10,3,3q26.2,171108687,171283910,175223,-,-
BAC73_L04,3,3q26.2,171119887,171220334,100447,-,-
BAC143_K08,3,3q26.2,171195725,171284043,88318,-,-
BAC1_J17,3,3q26.2,171196412,171284053,87641,-,-
BAC150_K10,3,3q26.2,171206222,171330840,124618,-,-
BAC27_O14,3,3q26.2,171206589,171336383,129794,-,-
BAC30_F02,3,3q26.2,171250559,171324798,74239,-,-
BAC217_O22,3,3q26.2,171285352,171373319,87967,-,-
BAC120_C21,3,3q26.2,171372073,171465264,93191,-,-
BAC55_J17,3,3q26.2,171470041,171568517,98476,-,-
BAC42_P02,3,3q26.2,171559753,171675766,116013,-,-
BAC84_F20,3,3q26.2,171571396,171660263,88867,-,-
BAC5_K24,3,3q26.2,171571396,171682510,111114,-,-
BAC176_E22,3,3q26.2,171650497,171780210,129713,-,-
BAC33_N11,3,3q26.2,171682688,171769868,87180,-,-
BAC243_I04,3,3q26.2,171787873,171882297,94424,-,-
BAC176_M04,3,3q26.2,171787875,171869491,81616,-,-
BAC39_P09,3,3q26.2,171787878,171874180,86302,-,-
BAC43_A05,3,3q26.2,171815431,171912589,97158,-,-
BAC248_D19,3,3q26.2,171821505,171905974,84469,-,-
BAC105_C02,3,3q26.2,171834024,171905966,71942,-,-
BAC114_B17,3,3q26.2,171918415,172004273,85858,-,-
BAC104_L10,3,3q26.2,171962213,172078887,116674,-,-
BAC170_F03,3,3q26.2,172004679,172100211,95532,-,-
BAC133_E03,3,3q26.2,172056017,172150045,94028,-,-
BAC135_J09,3,3q26.2,172105981,172203345,97364,-,-
BAC150_L18,3,3q26.2,172196294,172298779,102485,-,-
BAC17_P06,3,3q26.2,172228600,172347847,119247,-,-
BAC192_G07,3,3q26.2,172228602,172320550,91948,-,-
BAC158_C23,3,3q26.2,172279358,172360768,81410,-,-
BAC158_D23,3,3q26.2,172279358,172360768,81410,-,-
BAC68_P02,3,3q26.2,172421808,172489290,67482,-,-
BAC22_P07,3,3q26.31,172582207,172664097,81890,-,-
BAC67_M13,3,3q26.31,172887487,172995808,108321,-,-
BAC181_I13,3,3q26.31,172887519,173012322,124803,-,-
BAC53_H07,3,3q26.31,172901330,173002748,101418,-,-
BAC57_E08,3,3q26.31,173012320,173139901,127581,-,-
BAC155_P14,3,3q26.31,173075951,173161868,85917,-,-
BAC154_N21,3,3q26.31,173193828,173315204,121376,-,-
BAC75_H06,3,3q26.31,173347326,173457223,109897,-,-
BAC182_O03,3,3q26.31,173386600,173492313,105713,-,-
BAC178_F02,3,3q26.31,173395949,173492313,96364,-,-
BAC226_J20,3,3q26.31,173395949,173494476,98527,-,-
BAC176_P09,3,3q26.31,173395949,173482817,86868,-,-
BAC220_B02,3,3q26.31,173482835,173572755,89920,-,-
BAC30_L12,3,3q26.31,173497019,173641635,144616,-,-
BAC143_K18,3,3q26.31,173497022,173603213,106191,-,-
BAC129_B12,3,3q26.31,173672649,173755646,82997,-,-
BAC85_A15,3,3q26.31,173697251,173790739,93488,-,-
BAC25_N04,3,3q26.31,173697251,173813421,116170,-,-
BAC131_E17,3,3q26.31,173755638,173834514,78876,-,-
BAC165_F23,3,3q26.31,173857747,173950554,92807,-,-
BAC156_A17,3,3q26.31,173857749,173962664,104915,-,-
BAC163_L01,3,3q26.31,173865844,173970374,104530,-,-
BAC205_D11,3,3q26.31,173866656,173961882,95226,-,-
BAC215_P06,3,3q26.31,173880317,173958724,78407,-,-
BAC18_C12,3,3q26.31,173963913,174062121,98208,-,-
BAC218_P20,3,3q26.31,174055415,174152502,97087,-,-
BAC45_K15,3,3q26.31,174085504,174184215,98711,-,-
BAC219_J15,3,3q26.31,174184493,174290815,106322,-,-
BAC80_I13,3,3q26.31,174261000,174355273,94273,-,-
BAC235_H18,3,3q26.31,174387070,174468458,81388,-,-
BAC46_F17,3,3q26.31,174393966,174509351,115385,-,-
BAC22_F08,3,3q26.31,174468475,174575267,106792,-,-
BAC229_C17,3,3q26.31,174541979,174585566,43587,-,-
BAC88_E23,3,3q26.31,174593338,174691953,98615,-,-
BAC183_D22,3,3q26.31,174744299,174828613,84314,-,-
BAC124_K13,3,3q26.31,174806816,174891529,84713,-,-
BAC199_G16,3,3q26.31,174806818,174898509,91691,-,-
BAC129_M02,3,3q26.31,174806818,174917612,110794,-,-
BAC235_D03,3,3q26.31,174966199,175054230,88031,-,-
BAC108_P16,3,3q26.31,174975546,175063618,88072,-,-
BAC172_C17,3,3q26.31,174983195,175107622,124427,-,-
BAC91_A03,3,3q26.31,175035118,175130493,95375,-,-
BAC24_M15,3,3q26.31,175168354,175273132,104778,-,-
BAC249_I10,3,3q26.31,175333041,175420053,87012,-,-
BAC101_D11,3,3q26.31,175423887,175549757,125870,-,-
BAC104_G24,3,3q26.31,175452056,175560604,108548,-,-
BAC126_D05,3,3q26.31,175519915,175605788,85873,-,-
BAC126_N15,3,3q26.31,175519915,175605788,85873,-,-
BAC65_H17,3,3q26.31,175661086,175788661,127575,-,-
BAC12_C02,3,3q26.31,175711837,175797492,85655,-,-
BAC200_B12,3,3q26.31,175771572,175860343,88771,-,-
BAC165_O11,3,3q26.31,175934492,176042453,107961,-,-
BAC157_H19,3,3q26.31,175935461,176028323,92862,-,-
BAC197_G08,3,3q26.31,175942047,176028325,86278,-,-
BAC236_B03,3,3q26.31,175942050,176022168,80118,-,-
BAC44_M03,3,3q26.31,175947066,176029292,82226,-,-
BAC144_N16,3,3q26.31,176246222,176355164,108942,-,-
BAC53_L23,3,3q26.31,176443918,176549629,105711,-,-
BAC69_H17,3,3q26.31,176500639,176576074,75435,-,-
BAC45_O03,3,3q26.32,177341218,177429071,87853,-,-
BAC161_K07,3,3q26.32,177404940,177475931,70991,-,-
BAC2_C23,3,3q26.32,177411823,177507200,95377,-,-
BAC201_C01,3,3q26.32,177471492,177578275,106783,-,-
BAC106_D18,3,3q26.32,177539890,177646334,106444,-,-
BAC182_I02,3,3q26.32,177646328,177738956,92628,-,-
BAC59_B06,3,3q26.32,177711724,177834535,122811,-,-
BAC105_J10,3,3q26.32,177821686,177920664,98978,-,-
BAC125_P14,3,3q26.32,177833732,177920746,87014,-,-
BAC145_B10,3,3q26.32,177936851,178063133,126282,-,-
BAC227_F13,3,3q26.32,178028160,178120475,92315,-,-
BAC62_P20,3,3q26.32,178129019,178264543,135524,-,-
BAC68_I11,3,3q26.32,178264576,178365690,101114,-,-
BAC120_A03,3,3q26.32,178396268,178557748,161480,-,-
BAC90_H12,3,3q26.32,178415838,178528800,112962,-,-
BAC11_K08,3,3q26.32,178416164,178523218,107054,-,-
BAC125_D17,3,3q26.32,178421113,178523228,102115,-,-
BAC234_N10,3,3q26.32,178467946,178583068,115122,-,-
BAC140_L14,3,3q26.32,178507138,178598408,91270,-,-
BAC149_F09,3,3q26.32,178574584,178678021,103437,-,-
BAC42_K04,3,3q26.32,178583077,178693857,110780,-,-
BAC226_P19,3,3q26.32,178648213,178761129,112916,-,-
BAC21_G14,3,3q26.32,178675667,178807298,131631,-,-
BAC228_E17,3,3q26.32,178678310,178778103,99793,-,-
BAC5_H02,3,3q26.32,178678310,178761129,82819,-,-
BAC158_N07,3,3q26.32,178693866,178774388,80522,-,-
BAC33_C11,3,3q26.32,178739493,178840191,100698,-,-
BAC227_B20,3,3q26.32,178798997,178889691,90694,-,-
BAC217_J01,3,3q26.32,178799348,178880965,81617,-,-
BAC75_C19,3,3q26.32,178895379,178985798,90419,-,-
BAC163_B07,3,3q26.32,178932458,179016084,83626,-,-
BAC46_D22,3,3q26.32,179035233,179222294,187061,-,-
BAC180_J03,3,3q26.32,179052224,179160340,108116,-,-
BAC190_O07,3,3q26.32,179083654,179158125,74471,-,-
BAC1_N14,3,3q26.32,179102388,179229429,127041,-,-
BAC167_D15,3,3q26.32,179462829,179546904,84075,-,-
BAC124_B06,3,3q26.32,179696512,179793617,97105,-,-
BAC6_D21,3,3q26.32,179723997,179830119,106122,-,-
BAC55_P18,3,3q26.32,179849997,179945329,95332,-,-
BAC182_B04,3,3q26.32,179881396,179957316,75920,-,-
BAC40_I13,3,3q26.32,179942462,180043718,101256,-,-
BAC157_D22,3,3q26.32,180124707,180235839,111132,-,-
BAC65_F16,3,3q26.32,180124710,180213620,88910,-,-
BAC1_K19,3,3q26.32,180191181,180296291,105110,-,-
BAC117_L12,3,3q26.32,180191203,180283076,91873,-,-
BAC183_H22,3,3q26.32,180204249,180283076,78827,-,-
BAC23_D14,3,3q26.32,180213656,180300485,86829,-,-
BAC167_G12,3,3q26.32,180214363,180290865,76502,-,-
BAC10_C06,3,3q26.32,180217584,180300485,82901,-,-
BAC86_D03,3,3q26.32,180253902,180379268,125366,-,-
BAC246_B01,3,3q26.32,180290855,180379268,88413,-,-
BAC160_F19,3,3q26.32,180297256,180395817,98561,-,-
BAC26_P14,3,3q26.32,180310944,180415064,104120,-,-
BAC211_A05,3,3q26.32,180350220,180457597,107377,-,-
BAC127_C12,3,3q26.32,180364026,180457596,93570,-,-
BAC240_H06,3,3q26.32,180452843,180552459,99616,-,-
BAC78_C12,3,3q26.32,180454438,180595358,140920,-,-
BAC136_C24,3,3q26.32-3q26.33,180490271,180601540,111269,-,-
BAC80_I19,3,3q26.32,180533993,180595358,61365,-,-
BAC77_N10,3,3q26.32-3q26.33,180595383,180694007,98624,-,-
BAC184_E23,3,3q26.33,180624938,180716988,92050,-,-
BAC146_M16,3,3q26.33,180653970,180736013,82043,-,-
BAC178_H09,3,3q26.33,180711185,180781146,69961,-,-
BAC151_K17,3,3q26.33,180738362,180861943,123581,-,-
BAC99_O01,3,3q26.33,180805719,180901061,95342,-,-
BAC225_I07,3,3q26.33,180833720,180907154,73434,-,-
BAC110_A16,3,3q26.33,180917302,181000692,83390,-,-
BAC76_L05,3,3q26.33,180919317,181032428,113111,-,-
BAC152_N15,3,3q26.33,180927178,181060033,132855,-,-
BAC242_H08,3,3q26.33,180940374,181039172,98798,-,-
BAC114_C19,3,3q26.33,180940374,181032419,92045,-,-
BAC150_K06,3,3q26.33,180947884,181026972,79088,-,-
BAC102_B16,3,3q26.33,180981945,181093236,111291,-,-
BAC129_O10,3,3q26.33,181039185,181132739,93554,-,-
BAC150_F01,3,3q26.33,181093246,181198181,104935,-,-
BAC101_B13,3,3q26.33,181139986,181223969,83983,-,-
BAC180_N12,3,3q26.33,181202804,181308613,105809,-,-
BAC60_K14,3,3q26.33,181308606,181407272,98666,-,-
BAC246_H04,3,3q26.33,181474565,181561457,86892,-,-
BAC97_E02,3,3q26.33,181743099,181887630,144531,-,-
BAC41_N22,3,3q26.33,181747688,181864151,116463,-,-
BAC59_J20,3,3q26.33,181792631,181887630,94999,-,-
BAC151_M03,3,3q26.33,181861462,181961408,99946,-,-
BAC160_B03,3,3q26.33,181920252,182045095,124843,-,-
BAC7_M24,3,3q26.33,181929197,182062084,132887,-,-
BAC51_K07,3,3q26.33,181929405,182048967,119562,-,-
BAC143_D22,3,3q26.33,181942922,182048971,106049,-,-
BAC140_O22,3,3q26.33,182007060,182099414,92354,-,-
BAC86_G09,3,3q26.33,182099291,182179337,80046,-,-
BAC232_G04,3,3q26.33,182118793,182203221,84428,-,-
BAC236_G17,3,3q26.33,182265329,182368543,103214,-,-
BAC97_P11,3,3q26.33,182265329,182368543,103214,-,-
BAC73_J17,3,3q26.33,182269339,182370200,100861,-,-
BAC44_P12,3,3q26.33,182335650,182435066,99416,-,-
BAC30_O24,3,3q26.33,182397106,182552453,155347,-,-
BAC127_J20,3,3q26.33,182482614,182584686,102072,-,-
BAC125_P13,3,3q26.33,182626379,182730567,104188,-,-
BAC36_E10,3,3q26.33,182626389,182765296,138907,-,-
BAC102_H02,3,3q26.33,182732671,182842825,110154,-,-
BAC39_F18,3,3q26.33,182854217,182987515,133298,-,-
BAC80_G17,3,3q26.33,182948765,183105745,156980,-,-
BAC14_E17,3,3q26.33,182987646,183115784,128138,-,-
BAC134_B21,3,3q26.33,182988724,183071055,82331,-,-
BAC179_B11,3,3q26.33,182993699,183105716,112017,-,-
BAC172_G16,3,3q26.33,183004554,183149442,144888,-,-
BAC135_L11,3,3q26.33,183004554,183105745,101191,-,-
BAC161_P21,3,3q26.33,183019991,183118401,98410,-,-
BAC60_A12,3,3q26.33,183072543,183149449,76906,-,-
BAC231_I11,3,3q26.33,183131798,183227849,96051,-,-
BAC16_G20,3,3q26.33,183206263,183311808,105545,-,-
BAC197_H14,3,3q26.33,183221670,183323535,101865,-,-
BAC143_L12,3,3q26.33,183221670,183294204,72534,-,-
BAC154_P07,3,3q26.33,183258861,183368691,109830,-,-
BAC66_L14,3,3q26.33,183368866,183455489,86623,-,-
BAC190_E18,3,3q26.33,183407997,183483772,75775,-,-
BAC25_O09,3,3q26.33,183407997,183500865,92868,-,-
BAC160_D09,3,3q26.33,183573043,183654950,81907,-,-
BAC226_O14,3,3q26.33,183593532,183679273,85741,-,-
BAC244_D14,3,3q26.33,183628336,183714278,85942,-,-
BAC77_J18,3,3q26.33,183954085,184069226,115141,-,-
BAC41_K15,3,3q26.33,183960395,184076685,116290,-,-
BAC23_E20,3,3q26.33,183981754,184067117,85363,-,-
BAC10_G12,3,3q26.33,184093729,184185485,91756,-,-
BAC227_I01,3,3q26.33,184097784,184196281,98497,-,-
BAC226_M20,3,3q26.33-3q27.1,184147087,184250799,103712,-,-
BAC198_J06,3,3q26.33-3q27.1,184147087,184254286,107199,-,-
BAC88_K01,3,3q26.33-3q27.1,184160903,184243818,82915,-,-
BAC34_N01,3,3q26.33-3q27.1,184185495,184278088,92593,-,-
BAC183_B08,3,3q27.1,184321062,184416528,95466,-,-
BAC233_P20,3,3q27.1,184326070,184421624,95554,-,-
BAC20_O15,3,3q27.1,184344009,184438636,94627,-,-
BAC236_N23,3,3q27.1,184357354,184438653,81299,-,-
BAC125_J07,3,3q27.1,184376081,184553627,177546,-,-
BAC248_I10,3,3q27.1,184386482,184504290,117808,-,-
BAC176_G15,3,3q27.1,184399312,184487337,88025,-,-
BAC67_E17,3,3q27.1,184502664,184597864,95200,-,-
BAC58_A14,3,3q27.1,184510315,184610462,100147,-,-
BAC91_C02,3,3q27.1,184516846,184609706,92860,-,-
BAC76_C09,3,3q27.1,184521367,184601814,80447,-,-
BAC55_M09,3,3q27.1,184521439,184628174,106735,-,-
BAC149_O22,3,3q27.1,184532678,184610460,77782,-,-
BAC231_K13,3,3q27.1,184575782,184678599,102817,-,-
BAC68_A07,3,3q27.1,184575783,184683289,107506,-,-
BAC69_O12,3,3q27.1,184575786,184710189,134403,-,-
BAC170_B03,3,3q27.1,184610468,184715771,105303,-,-
BAC232_M03,3,3q27.1,184634013,184694501,60488,-,-
BAC227_H21,3,3q27.1,184805116,184830074,24958,-,-
BAC9_D02,3,3q27.1,185040852,185148058,107206,-,-
BAC128_H07,3,3q27.1,185040852,185160701,119849,-,-
BAC69_L15,3,3q27.1,185048447,185177898,129451,-,-
BAC106_A02,3,3q27.1,185048744,185207937,159193,-,-
BAC124_F11,3,3q27.1,185093518,185179826,86308,-,-
BAC37_K04,3,3q27.1,185097402,185195890,98488,-,-
BAC233_J15,3,3q27.1,185279805,185391086,111281,-,-
BAC230_E19,3,3q27.1,185297430,185385052,87622,-,-
BAC124_C13,3,3q27.1,185349218,185483215,133997,-,-
BAC22_I14,3,3q27.1,185349218,185469519,120301,-,-
BAC144_B04,3,3q27.1,185380161,185465594,85433,-,-
BAC173_O15,3,3q27.1,185496075,185634993,138918,-,-
BAC41_N08,3,3q27.1,185516376,185683078,166702,-,-
BAC40_A23,3,3q27.1,185529540,185636640,107100,-,-
BAC53_C14,3,3q27.1,185554091,185648354,94263,-,-
BAC194_J15,3,3q27.1,185567987,185683664,115677,-,-
BAC208_H18,3,3q27.1,185640253,185749988,109735,-,-
BAC75_C05,3,3q27.1,185669898,185763679,93781,-,-
BAC125_E17,3,3q27.1,185751208,185855482,104274,-,-
BAC165_A21,3,3q27.1,185751288,185855485,104197,-,-
BAC57_N04,3,3q27.1,185815033,185926984,111951,-,-
BAC96_D02,3,3q27.1,185829168,185926987,97819,-,-
BAC51_P21,3,3q27.1,185829224,185926983,97759,-,-
BAC141_G06,3,3q27.1,185834770,185926987,92217,-,-
BAC8_G18,3,3q27.1,185874124,185965586,91462,-,-
BAC102_M04,3,3q27.2,186018107,186121268,103161,-,-
BAC37_F07,3,3q27.2,186043611,186183784,140173,-,-
BAC18_N16,3,3q27.2,186069301,186191885,122584,-,-
BAC95_F10,3,3q27.2,186158905,186258866,99961,-,-
BAC244_B21,3,3q27.2,186216032,186308530,92498,-,-
BAC46_B08,3,3q27.2,186223059,186308561,85502,-,-
BAC186_L08,3,3q27.2,186225637,186340358,114721,-,-
BAC97_C12,3,3q27.2,186285109,186392741,107632,-,-
BAC91_N09,3,3q27.2,186408255,186491928,83673,-,-
BAC173_M09,3,3q27.2,186458133,186570497,112364,-,-
BAC119_P08,3,3q27.2,186479416,186575142,95726,-,-
BAC95_I14,3,3q27.2,186479416,186567865,88449,-,-
BAC75_D23,3,3q27.2,186502074,186602809,100735,-,-
BAC128_F09,3,3q27.2,186573662,186647142,73480,-,-
BAC189_N12,3,3q27.2,186637684,186737670,99986,-,-
BAC136_N17,3,3q27.2,186745592,186825347,79755,-,-
BAC6_F19,3,3q27.2,186756445,186866828,110383,-,-
BAC150_E07,3,3q27.2,186774424,186840357,65933,-,-
BAC152_N14,3,3q27.2,186806801,186913419,106618,-,-
BAC162_M24,3,3q27.2,186849014,186954799,105785,-,-
BAC197_H12,3,3q27.2,186849191,186955897,106706,-,-
BAC39_K12,3,3q27.2,186913613,187025434,111821,-,-
BAC50_L21,3,3q27.2,186963978,187075052,111074,-,-
BAC50_G07,3,3q27.2,187057496,187195352,137856,-,-
BAC153_E07,3,3q27.2,187107663,187238852,131189,-,-
BAC18_K10,3,3q27.2,187136214,187232026,95812,-,-
BAC180_G01,3,3q27.2,187159073,187238525,79452,-,-
BAC156_E20,3,3q27.2,187159073,187248012,88939,-,-
BAC213_L16,3,3q27.2,187159074,187238413,79339,-,-
BAC66_A14,3,3q27.2,187159075,187238524,79449,-,-
BAC186_M03,3,3q27.2,187180299,187302309,122010,-,-
BAC182_N13,3,3q27.2,187195383,187302309,106926,-,-
BAC36_N19,3,3q27.2,187248391,187394849,146458,-,-
BAC35_O07,3,3q27.2,187287618,187387578,99960,-,-
BAC110_A04,3,3q27.2,187389963,187497304,107341,-,-
BAC198_L06,3,3q27.2-3q27.3,187399179,187523127,123948,-,-
BAC26_J18,3,3q27.3,187559288,187691202,131914,-,-
BAC33_G16,3,3q27.3,187566938,187674284,107346,-,-
BAC82_H03,3,3q27.3,187567106,187699367,132261,-,-
BAC185_L18,3,3q27.3,187583221,187672720,89499,-,-
BAC130_P20,3,3q27.3,187612580,187742124,129544,-,-
BAC65_A20,3,3q27.3,187617418,187720720,103302,-,-
BAC242_O15,3,3q27.3,187632374,187720720,88346,-,-
BAC24_P22,3,3q27.3,187717425,187826134,108709,-,-
BAC199_G22,3,3q27.3,187718135,187803546,85411,-,-
BAC176_E02,3,3q27.3,187766539,187847639,81100,-,-
BAC130_L20,3,3q27.3,187785402,187861027,75625,yes,-
BAC225_B17,3,3q27.3,187791719,187888666,96947,yes,-
BAC95_I15,3,3q27.3,187801039,187922600,121561,-,-
BAC115_J16,3,3q27.3,187876086,187984458,108372,-,-
BAC38_L07,3,3q27.3,187879032,187984982,105950,-,-
BAC168_P11,3,3q27.3,187900995,188003119,102124,-,-
BAC145_L04,3,3q27.3,187933090,188042356,109266,-,-
BAC63_D07,3,3q27.3,188014256,188122461,108205,yes,-
BAC190_J16,3,3q27.3,188014256,188109394,95138,yes,-
BAC67_L22,3,3q27.3,188014256,188138554,124298,yes,-
BAC118_J15,3,3q27.3,188079829,188181804,101975,-,-
BAC75_O24,3,3q27.3,188099496,188207949,108453,-,-
BAC50_E10,3,3q27.3,188200717,188306623,105906,-,-
BAC97_O04,3,3q27.3,188202656,188306628,103972,-,-
BAC155_J08,3,3q27.3,188241237,188332021,90784,-,-
BAC55_E24,3,3q27.3,188324630,188434015,109385,-,-
BAC149_J19,3,3q27.3,188389102,188482374,93272,-,-
BAC182_O06,3,3q27.3,188432204,188513949,81745,-,-
BAC187_G13,3,3q27.3,188432238,188493996,61758,-,-
BAC177_A04,3,3q27.3,188432505,188520576,88071,-,-
BAC171_A21,3,3q27.3,188658156,188673979,15823,-,-
BAC242_P11,3,3q27.3,188691564,188791009,99445,-,-
BAC61_O22,3,3q27.3,188738102,188833524,95422,-,-
BAC195_F06,3,3q27.3,188804881,188884743,79862,-,-
BAC150_N16,3,3q27.3,188846679,188931367,84688,-,-
BAC52_O17,3,3q27.3,188901503,189009115,107612,-,-
BAC198_F19,3,3q27.3,188921030,189008237,87207,-,-
BAC242_N01,3,3q27.3,189010850,189142802,131952,-,-
BAC195_D14,3,3q27.3,189092446,189173372,80926,-,-
BAC122_C01,3,3q27.3,189145261,189237343,92082,-,-
BAC241_N07,3,3q27.3,189154793,189251623,96830,-,-
BAC150_H06,3,3q27.3,189193516,189272834,79318,-,-
BAC131_D02,3,3q27.3,189246243,189326421,80178,-,-
BAC154_L22,3,3q27.3-3q28,189300019,189400457,100438,-,-
BAC76_L15,3,3q28,189496037,189597650,101613,-,-
BAC53_B10,3,3q28,189503340,189597650,94310,-,-
BAC105_L06,3,3q28,189731017,189835792,104775,-,-
BAC9_O24,3,3q28,190015537,190151275,135738,-,-
BAC144_N20,3,3q28,190060460,190165623,105163,-,-
BAC4_P12,3,3q28,190145671,190240260,94589,-,-
BAC12_E13,3,3q28,190178117,190264467,86350,-,-
BAC122_E04,3,3q28,190195579,190303211,107632,-,-
BAC123_E15,3,3q28,190195594,190290980,95386,-,-
BAC209_D05,3,3q28,190296062,190386349,90287,-,-
BAC186_F17,3,3q28,190305763,190393957,88194,-,-
BAC218_G09,3,3q28,190410616,190493211,82595,-,-
BAC74_E06,3,3q28,190590902,190689684,98782,-,-
BAC221_I16,3,3q28,190623189,190709632,86443,-,-
BAC183_F21,3,3q28,190809348,190959098,149750,-,-
BAC81_P07,3,3q28,190914027,190999116,85089,-,-
BAC151_P05,3,3q28,191000983,191088209,87226,-,-
BAC156_O07,3,3q28,191059276,191157903,98627,-,-
BAC50_K22,3,3q28,191167052,191287467,120415,-,-
BAC155_K02,3,3q28,191168083,191255309,87226,-,-
BAC117_E08,3,3q28,191302345,191398590,96245,-,-
BAC34_I10,3,3q28,191364785,191495143,130358,-,-
BAC230_C21,3,3q28,191580757,191658939,78182,-,-
BAC128_O22,3,3q28,191607243,191695417,88174,-,-
BAC151_K06,3,3q28,191650090,191772225,122135,-,-
BAC186_O09,3,3q28,191662145,191748811,86666,-,-
BAC154_M03,3,3q28,191752355,191825632,73277,-,-
BAC252_H04,3,3q28,191900104,192005104,105000,-,-
BAC86_C18,3,3q28,191949866,192048000,98134,-,-
BAC121_M20,3,3q28,192019759,192128339,108580,-,-
BAC115_P18,3,3q28,192210621,192292875,82254,-,-
BAC188_L23,3,3q28,192266843,192356460,89617,-,-
BAC29_L24,3,3q28,192288356,192393056,104700,-,-
BAC17_P12,3,3q28,192340128,192492928,152800,-,-
BAC69_M20,3,3q28,192354038,192393056,39018,-,-
BAC235_M11,3,3q28,192584827,192692665,107838,-,-
BAC134_B14,3,3q28,192596824,192679728,82904,-,-
BAC27_L09,3,3q28,192725678,192864192,138514,-,-
BAC31_I16,3,3q28,192804456,192903926,99470,-,-
BAC181_E05,3,3q28,192822507,192917358,94851,-,-
BAC55_N20,3,3q28,192853555,193010720,157165,-,-
BAC73_F16,3,3q28,192939579,193038748,99169,-,-
BAC162_K13,3,3q28,192980457,193125710,145253,-,-
BAC66_M24,3,3q28,193118688,193219647,100959,-,-
BAC12_G10,3,3q28,193189800,193288672,98872,-,-
BAC2_L17,3,3q28,193222632,193313380,90748,-,-
BAC25_O10,3,3q28,193259366,193364301,104935,-,-
BAC143_F11,3,3q28,193396282,193508167,111885,-,-
BAC230_K11,3,3q28,193431409,193538606,107197,-,-
BAC173_O07,3,3q28,193504928,193613804,108876,-,-
BAC15_B02,3,3q28-3q29,193621180,193825482,204302,-,-
BAC40_H11,3,3q28,193635052,193730910,95858,-,-
BAC139_E04,3,3q28,193645968,193723600,77632,-,-
BAC127_J16,3,3q28,193651445,193730910,79465,-,-
BAC102_P07,3,3q28-3q29,193721202,193820714,99512,-,-
BAC80_J17,3,3q29,193813638,193905161,91523,-,-
BAC33_E08,3,3q29,193864479,193962336,97857,-,-
BAC56_H16,3,3q29,193880237,194041389,161152,-,-
BAC80_C10,3,3q29,193888420,194012184,123764,-,-
BAC100_O05,3,3q29,193909640,194012079,102439,-,-
BAC157_G07,3,3q29,193978348,194075215,96867,-,-
BAC178_N03,3,3q29,193990005,194082125,92120,-,-
BAC77_F18,3,3q29,194054615,194189298,134683,-,-
BAC25_J24,3,3q29,194134108,194261692,127584,-,-
BAC62_B01,3,3q29,194171206,194272739,101533,-,-
BAC65_L18,3,3q29,194228165,194329396,101231,-,-
BAC86_A21,3,3q29,194341089,194449805,108716,-,-
BAC2_J17,3,3q29,194467376,194577596,110220,-,-
BAC10_C02,3,3q29,194472183,194583903,111720,-,-
BAC153_L17,3,3q29,194508153,194587584,79431,-,-
BAC155_L23,3,3q29,194517607,194602599,84992,-,-
BAC247_A02,3,3q29,194577780,194701684,123904,-,-
BAC141_D10,3,3q29,194663007,194752338,89331,-,-
BAC30_G01,3,3q29,194802539,194925838,123299,-,-
BAC57_F09,3,3q29,194802556,194880640,78084,-,-
BAC95_L18,3,3q29,194821287,194911755,90468,-,-
BAC110_N18,3,3q29,194911749,195036695,124946,-,-
BAC240_C18,3,3q29,195132866,195225322,92456,-,-
BAC48_E13,3,3q29,195222783,195361558,138775,-,-
BAC127_E22,3,3q29,195242913,195361572,118659,-,-
BAC250_O08,3,3q29,195250478,195348074,97596,-,-
BAC113_O06,3,3q29,195255429,195357921,102492,-,-
BAC181_K19,3,3q29,195268559,195355144,86585,-,-
BAC117_P24,3,3q29,195282012,195374554,92542,-,-
BAC124_F10,3,3q29,195286172,195393581,107409,-,-
BAC235_M16,3,3q29,195299638,195395729,96091,-,-
BAC128_O11,3,3q29,195307651,195403654,96003,-,-
BAC150_C14,3,3q29,195340301,195456752,116451,-,-
BAC162_K23,3,3q29,195393594,195485361,91767,-,-
BAC200_B08,3,3q29,195436468,195508480,72012,-,-
BAC143_B11,3,3q29,195442611,195511577,68966,-,-
BAC243_L15,3,3q29,195574199,195660216,86017,-,-
BAC24_F17,3,3q29,195594412,195722124,127712,-,-
BAC136_N07,3,3q29,195679215,195758003,78788,-,-
BAC64_P02,3,3q29,195741665,195827202,85537,-,-
BAC61_O10,3,3q29,195757996,195873850,115854,-,-
BAC234_O15,3,3q29,195771137,195865335,94198,-,-
BAC136_K15,3,3q29,195799373,195897809,98436,-,-
BAC180_N22,3,3q29,195861313,195943321,82008,-,-
BAC175_O11,3,3q29,195861313,195983494,122181,-,-
BAC176_D14,3,3q29,195875782,196020367,144585,-,-
BAC33_F02,3,3q29,195875782,195983472,107690,-,-
BAC143_K22,3,3q29,195885129,196032532,147403,-,-
BAC61_L15,3,3q29,195889588,195998206,108618,-,-
BAC195_A20,3,3q29,195916844,196046629,129785,-,-
BAC68_K23,3,3q29,195916844,196025489,108645,-,-
BAC249_P03,3,3q29,195926148,196025514,99366,-,-
BAC155_J03,3,3q29,195926148,196043736,117588,-,-
BAC38_N17,3,3q29,195983500,196108666,125166,-,-
BAC193_I17,3,3q29,196025509,196159765,134256,-,-
BAC30_L07,3,3q29,196032526,196113715,81189,-,-
BAC180_E06,3,3q29,196043733,196159765,116032,-,-
BAC103_O06,3,3q29,196117595,196192539,74944,-,-
BAC190_G02,3,3q29,196155431,196275651,120220,-,-
BAC18_L10,3,3q29,196184967,196293339,108372,-,-
BAC219_C24,3,3q29,196204373,196288017,83644,-,-
BAC20_K11,3,3q29,196244712,196349988,105276,-,-
BAC133_D18,3,3q29,196339090,196450238,111148,-,-
BAC106_H09,3,3q29,196509706,196612360,102654,-,-
BAC108_J04,3,3q29,196555117,196708999,153882,-,-
BAC32_D22,3,3q29,196900840,197006078,105238,yes,-
BAC65_A18,3,3q29,196943713,197105277,161564,yes,-
BAC239_D07,3,3q29,196951239,197055520,104281,yes,-
BAC52_K24,3,3q29,196962733,197029566,66833,-,-
BAC153_K02,3,3q29,197006133,197100581,94448,-,-
BAC116_A06,3,3q29,197011909,197100539,88630,-,-
BAC61_K20,3,3q29,197029563,197178036,148473,yes,-
BAC108_B10,3,3q29,197150535,197249771,99236,-,-
BAC67_L12,3,3q29,197256567,197343572,87005,yes,-
BAC171_N01,3,3q29,197282881,197367539,84658,-,-
BAC250_L12,3,3q29,197284348,197382421,98073,-,-
BAC33_F06,3,3q29,197343566,197462739,119173,-,-
BAC114_G13,3,3q29,197343577,197463910,120333,-,-
BAC70_B13,3,3q29,197405808,197535401,129593,yes,-
BAC246_F08,3,3q29,197405841,197484454,78613,-,-
BAC236_L16,3,3q29,197483942,197600928,116986,-,-
BAC80_I10,3,3q29,197500362,197619786,119424,-,-
BAC72_C16,3,3q29,197500364,197592238,91874,-,-
BAC86_K19,3,3q29,197592246,197714042,121796,-,-
BAC147_O21,3,3q29,197654468,197742220,87752,-,-
BAC151_D06,3,3q29,197896654,198002039,105385,-,-
BAC78_C08,3,3q29,197896654,198018239,121585,-,-
BAC68_O05,3,3q29,197974717,198076937,102220,-,-
BAC168_H14,3,3q29,197991243,198076937,85694,-,-
BAC38_N24,3,3q29,198011756,198112280,100524,-,-
BAC90_A04,3,3q29,198035357,198119019,83662,-,-
BAC43_B22,3,3q29,198100833,198209536,108703,-,-
BAC80_C21,3,3q29,198107748,198247158,139410,-,-
BAC200_P16,3,3q29,198135384,198239524,104140,-,-
BAC232_I05,3,3q29,198166212,198271923,105711,-,-
BAC144_K05,3,3q29,198166212,198271957,105745,-,-
BAC61_J06,3,3q29,198169046,198311559,142513,-,-
BAC13_M18,3,3q29,198196969,198278698,81729,-,-
BAC188_L15,3,3q29,198198678,198278702,80024,-,-
BAC96_F21,3,3q29,198206824,198301571,94747,-,-
BAC243_N21,3,3q29,198209531,198286451,76920,-,-
BAC20_B02,3,3q29,198209531,198312275,102744,-,-
BAC106_L20,3,3q29,198209531,198298255,88724,-,-
BAC116_L18,3,3q29,198215525,198368338,152813,-,-
BAC113_D16,3,3q29,198278843,198381070,102227,-,-
BAC217_F22,3,3q29,198291149,198367495,76346,-,-
BAC61_C19,3,3q29,198298764,198397794,99030,-,-
BAC96_L18,3,3q29,198312276,198426441,114165,-,-
BAC248_B24,3,3q29,198367494,198468357,100863,-,-
BAC46_A08,3,3q29,198505368,198587577,82209,-,-
BAC151_N22,3,3q29,198661185,198745270,84085,-,-
BAC100_M19,3,3q29,198783468,198916687,133219,yes,-
BAC117_K10,3,3q29,198807063,198821922,14859,-,-
BAC42_D18,3,3q29,198807066,198914983,107917,yes,-
BAC96_C05,3,3q29,198809276,198903661,94385,yes,-
BAC10_K02,3,3q29,198835713,198994490,158777,yes,-
BAC2_M18,3,3q29,198883607,199000378,116771,-,-
BAC193_A08,3,3q29,198892770,199000378,107608,-,-
BAC38_G04,3,3q29,198915052,199034049,118997,-,-
BAC106_H10,3,3q29,198952662,199068296,115634,-,-
BAC65_G07,3,3q29,199025859,199117246,91387,-,-
BAC169_F06,3,3q29,199034410,199128149,93739,-,-
BAC231_G21,3,3q29,199034412,199117246,82834,-,-
BAC148_D09,3,3q29,199040877,199143499,102622,-,-
BAC86_E07,3,3q29,199103521,199273394,169873,-,-
BAC175_M13,3,3q29,199103521,199199495,95974,-,-
BAC158_N24,3,3q29,199110536,199199493,88957,-,-
BAC242_M10,3,3q29,199114628,199236064,121436,-,-
BAC77_M13,3,3q29,199122684,199214811,92127,-,-
BAC215_D18,3,3q29,199149284,199277020,127736,-,-
BAC31_I14,3,3q29,199150801,199260267,109466,-,-
BAC123_K14,3,3q29,199177271,199276964,99693,-,-
BAC15_G19,3,3q29,199190300,199276259,85959,-,-
BAC239_I11,3,3q29,199335175,199408112,72937,-,-
BAC50_K23,4,4p16.3,76938,155601,78663,-,-
BAC144_G07,4,4p16.3,120269,201660,81391,-,-
BAC187_A19,4,4p16.3,143476,226109,82633,-,-
BAC236_H02,4,4p16.3,237841,326390,88549,-,-
BAC2_C14,4,4p16.3,265859,373463,107604,-,-
BAC145_F13,4,4p16.3,271023,373463,102440,-,-
BAC48_C13,4,4p16.3,273532,297699,24167,-,-
BAC14_I01,4,4p16.3,322250,427471,105221,-,-
BAC89_N06,4,4p16.3,324876,409818,84942,-,-
BAC69_O06,4,4p16.3,326886,459571,132685,-,-
BAC1_D10,4,4p16.3,337751,355331,17580,-,-
BAC221_P22,4,4p16.3,357263,438783,81520,-,-
BAC8_J14,4,4p16.3,438791,523364,84573,-,-
BAC156_E11,4,4p16.3,493843,556992,63149,-,-
BAC1_J03,4,4p16.3,608763,753740,144977,-,-
BAC34_F03,4,4p16.3,660964,773295,112331,-,-
BAC240_P22,4,4p16.3,773396,881329,107933,-,-
BAC8_K18,4,4p16.3,779016,908849,129833,-,-
BAC201_E04,4,4p16.3,976187,1075810,99623,-,-
BAC246_J21,4,4p16.3,1036502,1137794,101292,-,-
BAC120_B11,4,4p16.3,1100225,1204654,104429,-,-
BAC186_J20,4,4p16.3,1294240,1401335,107095,yes,-
BAC139_D23,4,4p16.3,1310708,1392504,81796,yes,-
BAC34_I14,4,4p16.3,1310813,1401335,90522,yes,-
BAC249_I06,4,4p16.3,1510304,1625102,114798,-,-
BAC59_G04,4,4p16.3,1510304,1625097,114793,-,-
BAC193_C03,4,4p16.3,1524911,1618068,93157,-,-
BAC144_P04,4,4p16.3,1535599,1625717,90118,-,-
BAC57_K06,4,4p16.3,1546711,1625097,78386,-,-
BAC51_J17,4,4p16.3,1546726,1670821,124095,-,-
BAC161_D24,4,4p16.3,1588394,1674759,86365,-,-
BAC120_F12,4,4p16.3,1612243,1711927,99684,-,-
BAC147_K18,4,4p16.3,1618063,1784070,166007,-,-
BAC54_K17,4,4p16.3,1618063,1708818,90755,-,-
BAC246_B02,4,4p16.3,1674896,1757610,82714,-,-
BAC95_G12,4,4p16.3,1679054,1757614,78560,-,-
BAC50_H08,4,4p16.3,1784731,1916874,132143,-,-
BAC67_I12,4,4p16.3,1873050,1980658,107608,-,-
BAC100_E03,4,4p16.3,1878656,1996081,117425,-,-
BAC1_F06,4,4p16.3,1890838,1985011,94173,-,-
BAC135_O20,4,4p16.3,1932272,2020557,88285,-,-
BAC51_F19,4,4p16.3,1980684,2082559,101875,-,-
BAC153_J14,4,4p16.3,2049082,2129247,80165,-,-
BAC88_O15,4,4p16.3,2060807,2158573,97766,-,-
BAC115_O12,4,4p16.3,2078850,2189254,110404,-,-
BAC180_N19,4,4p16.3,2091788,2189240,97452,-,-
BAC104_E06,4,4p16.3,2091789,2183829,92040,-,-
BAC106_G23,4,4p16.3,2106891,2183831,76940,-,-
BAC67_A15,4,4p16.3,2129372,2212265,82893,-,-
BAC205_J02,4,4p16.3,2129436,2276215,146779,-,-
BAC84_I10,4,4p16.3,2158788,2278750,119962,-,-
BAC248_G23,4,4p16.3,2212315,2292444,80129,-,-
BAC10_B17,4,4p16.3,2276209,2371405,95196,-,-
BAC243_G05,4,4p16.3,2278743,2362484,83741,-,-
BAC44_F18,4,4p16.3,2278778,2356321,77543,-,-
BAC70_K18,4,4p16.3,2316771,2457146,140375,-,-
BAC28_C01,4,4p16.3,2355849,2467771,111922,-,-
BAC197_P06,4,4p16.3,2374259,2457146,82887,-,-
BAC76_G11,4,4p16.3,2394901,2513982,119081,-,-
BAC178_E16,4,4p16.3,2394901,2461339,66438,-,-
BAC66_L23,4,4p16.3,2424065,2536698,112633,-,-
BAC168_P10,4,4p16.3,2604233,2729030,124797,-,-
BAC67_E02,4,4p16.3,2604233,2692837,88604,-,-
BAC158_J15,4,4p16.3,2629408,2718630,89222,-,-
BAC94_N09,4,4p16.3,2721970,2847843,125873,-,-
BAC65_E06,4,4p16.3,2729114,2855543,126429,-,-
BAC163_J20,4,4p16.3,2729144,2810076,80932,-,-
BAC69_H12,4,4p16.3,2771476,2865383,93907,-,-
BAC57_G03,4,4p16.3,2813539,2911080,97541,-,-
BAC223_D21,4,4p16.3,2872716,2952636,79920,-,-
BAC2_A11,4,4p16.3,2907077,3032189,125112,-,-
BAC14_E23,4,4p16.3,2933088,3032198,99110,-,-
BAC104_D06,4,4p16.3,2933101,3009900,76799,-,-
BAC75_B05,4,4p16.3,2964568,3072186,107618,-,-
BAC1_K04,4,4p16.3,2966412,3072186,105774,-,-
BAC45_D08,4,4p16.3-4p16.2,2989616,3128594,138978,-,-
BAC22_I03,4,4p16.3,3015473,3097318,81845,-,-
BAC150_H14,4,4p16.3-4p16.2,3097579,3182851,85272,-,-
BAC236_H20,4,4p16.2,3107748,3212733,104985,-,-
BAC194_P13,4,4p16.2,3112879,3196864,83985,-,-
BAC7_A05,4,4p16.2,3137237,3157111,19874,-,-
BAC137_D17,4,4p16.2,3137258,3215830,78572,-,-
BAC120_J05,4,4p16.2,3213190,3323218,110028,-,-
BAC180_H03,4,4p16.2,3258950,3336254,77304,-,-
BAC45_D09,4,4p16.2,3277674,3411531,133857,-,-
BAC186_K08,4,4p16.2,3323240,3424173,100933,-,-
BAC157_K14,4,4p16.2,3335371,3443630,108259,-,-
BAC217_L15,4,4p16.2,3443476,3544053,100577,-,-
BAC250_L02,4,4p16.2,3463555,3593124,129569,-,-
BAC183_F04,4,4p16.2,3631697,3731121,99424,-,-
BAC153_N19,4,4p16.2,3849965,4043457,193492,-,-
BAC156_J13,4,4p16.2,3990293,4128721,138428,-,-
BAC91_M11,4,4p16.2,3995996,4075927,79931,-,-
BAC182_J05,4,4p16.2,4000636,4090709,90073,-,-
BAC10_L09,4,4p16.2,4055252,4206950,151698,yes,-
BAC125_D23,4,4p16.2,4068477,4150895,82418,-,-
BAC133_O19,4,4p16.2,4081743,4243043,161300,yes,-
BAC187_D04,4,4p16.2,4081849,4163110,81261,-,-
BAC153_A14,4,4p16.2,4085974,4235656,149682,yes,-
BAC28_B07,4,4p16.2,4090806,4229148,138342,yes,-
BAC75_L18,4,4p16.2,4103484,4230802,127318,yes,-
BAC179_A19,4,4p16.2,4170795,4316054,145259,yes,-
BAC180_J19,4,4p16.2,4170798,4278531,107733,yes,-
BAC62_M11,4,4p16.2,4235649,4320502,84853,-,-
BAC62_P24,4,4p16.2,4235654,4351640,115986,-,-
BAC204_O01,4,4p16.2,4236030,4328980,92950,-,-
BAC140_A20,4,4p16.2,4277832,4401416,123584,-,-
BAC152_F04,4,4p16.2,4351681,4410806,59125,-,-
BAC152_L09,4,4p16.2,4471526,4559627,88101,-,-
BAC124_E20,4,4p16.2,4474509,4565358,90849,-,-
BAC118_J22,4,4p16.2,4497472,4674797,177325,-,-
BAC121_F08,4,4p16.2,4542693,4692838,150145,-,-
BAC70_K06,4,4p16.2,4585743,4680024,94281,-,-
BAC196_A10,4,4p16.2,4593520,4722287,128767,-,-
BAC123_C23,4,4p16.2,4593521,4723969,130448,-,-
BAC234_O14,4,4p16.2,4623519,4710181,86662,-,-
BAC18_H04,4,4p16.2,4694245,4792621,98376,-,-
BAC189_N09,4,4p16.2,4747262,4831919,84657,-,-
BAC134_J15,4,4p16.2,4845798,4951103,105305,-,-
BAC218_F11,4,4p16.2,4890719,5019671,128952,-,-
BAC110_P07,4,4p16.2,4931841,5016571,84730,-,-
BAC238_H02,4,4p16.2,4984923,5067496,82573,-,-
BAC173_I12,4,4p16.2,5019666,5147898,128232,-,-
BAC153_L06,4,4p16.2,5073582,5187014,113432,-,-
BAC22_F10,4,4p16.2-4p16.1,5113532,5225311,111779,-,-
BAC70_F10,4,4p16.2-4p16.1,5187166,5278338,91172,-,-
BAC115_C08,4,4p16.1,5218131,5382851,164720,-,-
BAC142_C22,4,4p16.1,5246096,5337173,91077,-,-
BAC46_C17,4,4p16.1,5250424,5347766,97342,-,-
BAC179_N11,4,4p16.1,5441354,5552756,111402,-,-
BAC63_K22,4,4p16.1,5455712,5584361,128649,-,-
BAC102_M13,4,4p16.1,5468243,5584361,116118,-,-
BAC176_M11,4,4p16.1,5508767,5591733,82966,-,-
BAC107_I14,4,4p16.1,5584409,5669711,85302,-,-
BAC186_F21,4,4p16.1,5593545,5686079,92534,-,-
BAC237_L12,4,4p16.1,5641541,5741058,99517,-,-
BAC11_I16,4,4p16.1,5686073,5788602,102529,-,-
BAC244_O04,4,4p16.1,5691859,5787105,95246,-,-
BAC131_B01,4,4p16.1,5738868,5798839,59971,-,-
BAC21_H06,4,4p16.1,5798866,5929609,130743,-,-
BAC146_K06,4,4p16.1,5827359,5929363,102004,-,-
BAC76_D02,4,4p16.1,5865044,5951136,86092,-,-
BAC105_F19,4,4p16.1,5867918,5990721,122803,-,-
BAC215_K20,4,4p16.1,5891572,5978019,86447,-,-
BAC133_K21,4,4p16.1,5957829,6049367,91538,-,-
BAC177_E19,4,4p16.1,6063830,6153507,89677,-,-
BAC246_B15,4,4p16.1,6063855,6167532,103677,-,-
BAC116_K12,4,4p16.1,6068265,6153520,85255,-,-
BAC56_J18,4,4p16.1,6195902,6284701,88799,-,-
BAC192_G10,4,4p16.1,6197668,6284690,87022,-,-
BAC178_E21,4,4p16.1,6211928,6304419,92491,-,-
BAC84_D19,4,4p16.1,6233476,6348566,115090,-,-
BAC234_A01,4,4p16.1,6280101,6360597,80496,-,-
BAC32_O03,4,4p16.1,6280132,6423803,143671,-,-
BAC230_M06,4,4p16.1,6302685,6439689,137004,-,-
BAC48_L16,4,4p16.1,6313124,6495577,182453,-,-
BAC18_F03,4,4p16.1,6340528,6458735,118207,-,-
BAC236_J13,4,4p16.1,6439874,6519356,79482,-,-
BAC112_M04,4,4p16.1,6439874,6519339,79465,-,-
BAC200_E03,4,4p16.1,6440482,6519356,78874,-,-
BAC186_N24,4,4p16.1,6451901,6602855,150954,-,-
BAC51_P07,4,4p16.1,6620664,6747055,126391,-,-
BAC130_E08,4,4p16.1,6646960,6756846,109886,-,-
BAC165_L08,4,4p16.1,6657452,6756846,99394,-,-
BAC158_J23,4,4p16.1,6666558,6795924,129366,-,-
BAC166_P12,4,4p16.1,6747047,6863231,116184,-,-
BAC153_M05,4,4p16.1,6762823,6883356,120533,-,-
BAC243_N10,4,4p16.1,7015850,7113497,97647,-,-
BAC243_A03,4,4p16.1,7022052,7109647,87595,-,-
BAC83_G09,4,4p16.1,7025204,7163408,138204,-,-
BAC53_H05,4,4p16.1,7113550,7273628,160078,-,-
BAC113_I06,4,4p16.1,7137236,7251044,113808,-,-
BAC229_E03,4,4p16.1,7163412,7236107,72695,-,-
BAC188_L16,4,4p16.1,7163413,7276500,113087,-,-
BAC152_N12,4,4p16.1,7247516,7323721,76205,-,-
BAC50_O16,4,4p16.1,7254277,7365235,110958,-,-
BAC182_B15,4,4p16.1,7266186,7365236,99050,-,-
BAC134_E11,4,4p16.1,7323715,7414484,90769,-,-
BAC27_E02,4,4p16.1,7557349,7646906,89557,-,-
BAC79_P09,4,4p16.1,7561352,7652864,91512,-,-
BAC123_F19,4,4p16.1,7564448,7651322,86874,-,-
BAC52_O10,4,4p16.1,7564491,7671967,107476,-,-
BAC44_I15,4,4p16.1,7620943,7790391,169448,-,-
BAC240_N15,4,4p16.1,7671970,7790493,118523,-,-
BAC177_L17,4,4p16.1,7683331,7783902,100571,-,-
BAC234_M07,4,4p16.1,7698315,7790493,92178,-,-
BAC60_H08,4,4p16.1,7720688,7861517,140829,-,-
BAC171_O17,4,4p16.1,7720944,7821065,100121,-,-
BAC179_G14,4,4p16.1,7746301,7829772,83471,-,-
BAC67_M14,4,4p16.1,7924479,8042810,118331,-,-
BAC193_F20,4,4p16.1,7961477,8059698,98221,-,-
BAC233_A08,4,4p16.1,7977651,8080873,103222,-,-
BAC220_L09,4,4p16.1,7998663,8080858,82195,-,-
BAC169_B20,4,4p16.1,7998665,8088920,90255,-,-
BAC169_C04,4,4p16.1,8061757,8156520,94763,-,-
BAC119_M20,4,4p16.1,8137793,8218185,80392,-,-
BAC139_O21,4,4p16.1,8137818,8253785,115967,-,-
BAC32_H18,4,4p16.1,8150723,8284306,133583,-,-
BAC177_M06,4,4p16.1,8181815,8284310,102495,-,-
BAC247_F22,4,4p16.1,8188093,8273596,85503,-,-
BAC142_F10,4,4p16.1,8300423,8383430,83007,-,-
BAC96_L02,4,4p16.1,8319702,8405009,85307,-,-
BAC102_N07,4,4p16.1,8351617,8451448,99831,-,-
BAC44_P17,4,4p16.1,8373152,8481198,108046,-,-
BAC184_H18,4,4p16.1,8415974,8548257,132283,-,-
BAC45_D11,4,4p16.1,8418040,8505861,87821,-,-
BAC57_P19,4,4p16.1,8468257,8557313,89056,-,-
BAC181_E16,4,4p16.1,8481217,8566774,85557,-,-
BAC81_N09,4,4p16.1,8548258,8642853,94595,yes,-
BAC18_L08,4,4p16.1,8556347,8642819,86472,yes,-
BAC92_M06,4,4p16.1,8601491,8723327,121836,yes,-
BAC218_G19,4,4p16.1,8630175,8732317,102142,-,-
BAC178_N15,4,4p16.1,8651697,8726961,75264,-,-
BAC162_L18,4,4p16.1,8655789,8723389,67600,-,-
BAC177_B02,4,4p16.1,8668049,8721521,53472,-,-
BAC144_D06,4,4p16.1,8668049,8723389,55340,-,-
BAC221_F21,4,4p16.1,8668102,8778332,110230,-,-
BAC25_P03,4,4p16.1,8934138,9031944,97806,yes,-
BAC51_N15,4,4p16.1,8936187,8984196,48009,yes,-
BAC226_H02,4,4p16.1,8969909,8984930,15021,-,-
BAC199_J21,4,4p16.1,8979400,9097543,118143,yes,-
BAC64_F03,4,4p16.1,8984191,9106188,121997,yes,-
BAC145_N09,4,4p16.1,8985180,9097543,112363,yes,-
BAC188_E04,4,4p16.1,9043704,9168924,125220,yes,-
BAC102_F12,4,4p16.1,9075688,9168673,92985,yes,-
BAC221_D04,4,4p16.1,9106227,9203098,96871,yes,-
BAC150_B07,4,4p16.1,9155553,9269916,114363,-,-
BAC23_N23,4,4p16.1,9168919,9269909,100990,-,-
BAC82_L03,4,4p16.1,9168931,9269812,100881,-,-
BAC237_L10,4,4p16.1,9282724,9356268,73544,-,-
BAC32_F21,4,4p16.1,9285558,9390449,104891,yes,-
BAC172_N15,4,4p16.1,9313287,9431183,117896,yes,-
BAC246_J12,4,4p16.1,9332953,9447622,114669,yes,-
BAC50_J01,4,4p16.1,9401502,9502849,101347,-,-
BAC206_O20,4,4p16.1,9410869,9533038,122169,-,-
BAC139_E10,4,4p16.1,9414651,9510643,95992,-,-
BAC161_I04,4,4p16.1,9454473,9559210,104737,-,-
BAC197_B04,4,4p16.1,9500625,9588834,88209,-,-
BAC185_H03,4,4p16.1,9605885,9685903,80018,-,-
BAC27_H04,4,4p16.1,9611426,9639633,28207,-,-
BAC141_M06,4,4p16.1,9646841,9766532,119691,-,-
BAC88_B05,4,4p16.1,9646841,9761562,114721,-,-
BAC161_G22,4,4p16.1,9651464,9728787,77323,-,-
BAC194_L10,4,4p16.1,9718625,9807301,88676,-,-
BAC229_F01,4,4p16.1,9732965,9804484,71519,-,-
BAC130_N17,4,4p16.1,9755846,9832532,76686,-,-
BAC116_E01,4,4p16.1,9783517,9867623,84106,-,-
BAC222_K06,4,4p16.1,9807296,9879587,72291,-,-
BAC78_O19,4,4p16.1,9867618,9957072,89454,-,-
BAC197_D23,4,4p16.1,9928941,10022930,93989,-,-
BAC175_L10,4,4p16.1,9928941,10018779,89838,-,-
BAC55_J02,4,4p16.1,10001819,10142809,140990,-,-
BAC175_F16,4,4p16.1,10064790,10150207,85417,-,-
BAC29_B11,4,4p16.1,10067000,10199514,132514,-,-
BAC217_A17,4,4p16.1,10112995,10215920,102925,-,-
BAC36_P24,4,4p16.1,10146099,10239856,93757,-,-
BAC10_A14,4,4p16.1,10239862,10393493,153631,-,-
BAC108_F09,4,4p16.1,10259497,10361842,102345,-,-
BAC240_O05,4,4p16.1,10264481,10362181,97700,-,-
BAC172_A19,4,4p16.1,10264797,10352517,87720,-,-
BAC232_D09,4,4p16.1,10357701,10471733,114032,-,-
BAC155_P03,4,4p16.1,10381288,10445524,64236,-,-
BAC56_O18,4,4p16.1,10455178,10552773,97595,-,-
BAC92_B01,4,4p16.1,10561167,10693475,132308,-,-
BAC162_F18,4,4p16.1,10581956,10690737,108781,-,-
BAC242_I18,4,4p16.1,10633894,10727916,94022,-,-
BAC38_E03,4,4p16.1,10727942,10898987,171045,-,-
BAC92_M22,4,4p16.1-4p15.33,10781268,10900254,118986,-,-
BAC76_M21,4,4p16.1-4p15.33,10781272,10900011,118739,-,-
BAC144_G09,4,4p16.1-4p15.33,10887778,10991840,104062,-,-
BAC154_M20,4,4p15.33,10951808,11022222,70414,-,-
BAC217_E02,4,4p15.33,11080278,11208527,128249,-,-
BAC221_F03,4,4p15.33,11103910,11185949,82039,-,-
BAC1_K10,4,4p15.33,11243025,11358808,115783,-,-
BAC137_K21,4,4p15.33,11425263,11539315,114052,-,-
BAC18_K24,4,4p15.33,11488872,11606611,117739,-,-
BAC46_O16,4,4p15.33,11506213,11596043,89830,-,-
BAC39_B24,4,4p15.33,11506213,11606611,100398,-,-
BAC131_E21,4,4p15.33,11542064,11634248,92184,-,-
BAC22_C11,4,4p15.33,11547560,11661552,113992,-,-
BAC27_M10,4,4p15.33,11587159,11695119,107960,-,-
BAC150_B11,4,4p15.33,11606912,11683882,76970,-,-
BAC199_A18,4,4p15.33,11988108,12091361,103253,-,-
BAC234_M12,4,4p15.33,12037081,12117797,80716,-,-
BAC117_D22,4,4p15.33,12044981,12133750,88769,-,-
BAC235_C13,4,4p15.33,12138669,12252821,114152,-,-
BAC200_B16,4,4p15.33,12152850,12234261,81411,-,-
BAC153_A09,4,4p15.33,12379732,12471602,91870,-,-
BAC150_C07,4,4p15.33,12400085,12484917,84832,-,-
BAC240_N13,4,4p15.33,12580929,12717671,136742,-,-
BAC149_M11,4,4p15.33,12590438,12667140,76702,-,-
BAC186_B14,4,4p15.33,12675713,12789868,114155,-,-
BAC41_E09,4,4p15.33,12734789,12855084,120295,-,-
BAC168_J12,4,4p15.33,12761738,12834549,72811,-,-
BAC186_I18,4,4p15.33,12855362,12938930,83568,-,-
BAC77_P03,4,4p15.33,12955565,13037039,81474,-,-
BAC97_F02,4,4p15.33,13047349,13136704,89355,-,-
BAC135_K23,4,4p15.33,13113510,13214499,100989,-,-
BAC100_B07,4,4p15.33,13146864,13256405,109541,-,-
BAC60_J02,4,4p15.33,13153976,13253674,99698,-,-
BAC217_G23,4,4p15.33,13361192,13456821,95629,-,-
BAC126_C20,4,4p15.33,13753621,13882428,128807,-,-
BAC6_B11,4,4p15.33,13842462,13951833,109371,-,-
BAC154_J09,4,4p15.33,14157934,14238946,81012,-,-
BAC158_K01,4,4p15.33,14182178,14261228,79050,-,-
BAC83_H23,4,4p15.33,14196995,14302569,105574,-,-
BAC61_C12,4,4p15.33,14347327,14477157,129830,-,-
BAC53_H09,4,4p15.33,14402373,14487768,85395,-,-
BAC144_C04,4,4p15.33,14605692,14733207,127515,-,-
BAC247_J21,4,4p15.33,14664318,14764498,100180,-,-
BAC60_L21,4,4p15.33,14760306,14841611,81305,-,-
BAC252_F12,4,4p15.33,14788382,14807057,18675,-,-
BAC57_C13,4,4p15.33,14869754,14955723,85969,-,-
BAC179_D04,4,4p15.33,14872197,14961943,89746,-,-
BAC178_F03,4,4p15.33,15007706,15078483,70777,-,-
BAC70_F19,4,4p15.33,15020052,15119998,99946,-,-
BAC234_M18,4,4p15.33,15047764,15151290,103526,-,-
BAC250_P19,4,4p15.33-4p15.32,15228865,15346200,117335,-,-
BAC60_D17,4,4p15.33-4p15.32,15228865,15319212,90347,-,-
BAC153_L12,4,4p15.33-4p15.32,15262380,15358336,95956,-,-
BAC16_O20,4,4p15.33-4p15.32,15280777,15376583,95806,-,-
BAC26_L07,4,4p15.32,15319207,15518538,199331,-,-
BAC143_B01,4,4p15.32,15398663,15493267,94604,-,-
BAC52_C24,4,4p15.32,15432719,15595306,162587,-,-
BAC244_H13,4,4p15.32,15433181,15516942,83761,-,-
BAC129_C23,4,4p15.32,15439958,15518589,78631,-,-
BAC43_L06,4,4p15.32,15493261,15639578,146317,-,-
BAC163_N19,4,4p15.32,15516934,15618206,101272,-,-
BAC193_J21,4,4p15.32,15520676,15633867,113191,-,-
BAC31_E07,4,4p15.32,15520676,15659197,138521,-,-
BAC186_P06,4,4p15.32,15540466,15625371,84905,-,-
BAC62_J12,4,4p15.32,15557767,15615136,57369,-,-
BAC72_A08,4,4p15.32,15564474,15670843,106369,-,-
BAC235_D13,4,4p15.32,15613779,15727890,114111,-,-
BAC211_C12,4,4p15.32,15625604,15731741,106137,-,-
BAC211_D12,4,4p15.32,15625626,15731741,106115,-,-
BAC46_A14,4,4p15.32,15633866,15772522,138656,-,-
BAC144_I10,4,4p15.32,15638505,15727134,88629,-,-
BAC25_L02,4,4p15.32,15865787,15938284,72497,-,-
BAC75_P10,4,4p15.32,15942287,16085286,142999,-,-
BAC102_L06,4,4p15.32,16021510,16139728,118218,-,-
BAC57_H01,4,4p15.32,16021510,16166163,144653,-,-
BAC234_B10,4,4p15.32,16056368,16140313,83945,-,-
BAC152_K08,4,4p15.32,16094759,16167095,72336,-,-
BAC78_M20,4,4p15.32,16140309,16240521,100212,-,-
BAC177_L20,4,4p15.32,16178424,16257993,79569,-,-
BAC106_A21,4,4p15.32,16233286,16338963,105677,-,-
BAC244_N08,4,4p15.32,16381978,16488075,106097,-,-
BAC31_L10,4,4p15.32,16381978,16475624,93646,-,-
BAC68_G23,4,4p15.32,16444993,16544963,99970,-,-
BAC117_C17,4,4p15.32,16488773,16562912,74139,-,-
BAC134_P15,4,4p15.32,16506911,16593146,86235,-,-
BAC134_L09,4,4p15.32,16721940,16832229,110289,-,-
BAC133_K02,4,4p15.32,16803469,16976426,172957,-,-
BAC75_N19,4,4p15.32,16832379,16957985,125606,-,-
BAC86_K10,4,4p15.32,16935067,17017250,82183,-,-
BAC42_H21,4,4p15.32,16990404,17126747,136343,-,-
BAC181_K23,4,4p15.32,16992783,17133523,140740,-,-
BAC115_L12,4,4p15.32,17016133,17150353,134220,-,-
BAC158_O12,4,4p15.32,17079689,17189839,110150,-,-
BAC101_D05,4,4p15.32,17188900,17306498,117598,-,-
BAC135_G09,4,4p15.32,17189835,17292607,102772,-,-
BAC106_C03,4,4p15.32,17218015,17372740,154725,-,-
BAC193_F03,4,4p15.32,17225451,17308361,82910,-,-
BAC60_C07,4,4p15.32,17259938,17372540,112602,-,-
BAC239_I06,4,4p15.32,17269435,17372540,103105,-,-
BAC240_L12,4,4p15.32,17376161,17453603,77442,-,-
BAC167_K18,4,4p15.32,17380758,17486106,105348,-,-
BAC179_N05,4,4p15.32,17422734,17537680,114946,-,-
BAC78_K07,4,4p15.32,17559356,17664097,104741,-,-
BAC109_E10,4,4p15.32,17744858,17881336,136478,-,-
BAC66_C23,4,4p15.32,17995694,18104924,109230,-,-
BAC66_E10,4,4p15.32,18033376,18119753,86377,-,-
BAC1_M07,4,4p15.32,18087194,18192861,105667,-,-
BAC217_C12,4,4p15.32,18119828,18217974,98146,-,-
BAC163_E20,4,4p15.32,18264379,18359121,94742,-,-
BAC91_G12,4,4p15.32,18278150,18404860,126710,-,-
BAC52_P23,4,4p15.31,18639651,18783362,143711,-,-
BAC140_B08,4,4p15.31,18708104,18805672,97568,-,-
BAC44_P15,4,4p15.31,18752072,18909912,157840,-,-
BAC151_A11,4,4p15.31,18849281,18929829,80548,-,-
BAC134_A24,4,4p15.31,19052255,19179363,127108,-,-
BAC19_H01,4,4p15.31,19125315,19223104,97789,-,-
BAC45_K08,4,4p15.31,19167450,19261120,93670,-,-
BAC70_N04,4,4p15.31,19179357,19302415,123058,-,-
BAC7_B11,4,4p15.31,19397373,19481730,84357,-,-
BAC172_I03,4,4p15.31,19485416,19589901,104485,-,-
BAC179_K13,4,4p15.31,19525237,19539628,14391,-,-
BAC52_J21,4,4p15.31,19692898,19798035,105137,-,-
BAC22_I24,4,4p15.31,19697153,19826739,129586,-,-
BAC178_A13,4,4p15.31,20057173,20134562,77389,-,-
BAC96_J16,4,4p15.31,20091573,20202126,110553,yes,-
BAC51_B23,4,4p15.31,20185529,20312341,126812,-,-
BAC53_B21,4,4p15.31,20331842,20423240,91398,-,-
BAC2_J13,4,4p15.31,20351203,20441060,89857,-,-
BAC187_E01,4,4p15.31,20364789,20441056,76267,-,-
BAC23_D09,4,4p15.31,20423234,20510489,87255,-,-
BAC84_B16,4,4p15.31,20434947,20520950,86003,-,-
BAC25_I22,4,4p15.31,20490543,20595110,104567,-,-
BAC233_K21,4,4p15.31,20721089,20842562,121473,-,-
BAC180_C04,4,4p15.31,20726933,20824392,97459,-,-
BAC102_B19,4,4p15.31,20804013,20910617,106604,-,-
BAC57_K24,4,4p15.31,20821122,20910617,89495,-,-
BAC68_C14,4,4p15.31,20894601,20999685,105084,-,-
BAC153_L11,4,4p15.31,20910611,20999684,89073,-,-
BAC131_C17,4,4p15.31,20951508,21055140,103632,-,-
BAC120_K10,4,4p15.31,20956333,21051858,95525,-,-
BAC230_A12,4,4p15.31,20999789,21110051,110262,-,-
BAC229_P11,4,4p15.31,21044194,21153149,108955,-,-
BAC22_F19,4,4p15.31,21076378,21179853,103475,-,-
BAC119_E18,4,4p15.31,21248630,21363066,114436,-,-
BAC76_F17,4,4p15.31,21272872,21365901,93029,-,-
BAC196_D15,4,4p15.31,21274411,21356398,81987,-,-
BAC120_P24,4,4p15.31,21390328,21489857,99529,-,-
BAC152_M10,4,4p15.31,21432245,21519924,87679,-,-
BAC75_C01,4,4p15.31,21517723,21672992,155269,-,-
BAC151_P21,4,4p15.31,21563450,21644555,81105,-,-
BAC123_C13,4,4p15.31,21798328,21897341,99013,-,-
BAC240_L17,4,4p15.31,21842504,21926836,84332,-,-
BAC205_M18,4,4p15.31,21897511,21989226,91715,-,-
BAC243_K11,4,4p15.31,21918980,22002785,83805,-,-
BAC227_I23,4,4p15.31,21950291,22031381,81090,-,-
BAC55_B19,4,4p15.31,22024563,22169365,144802,-,-
BAC64_B11,4,4p15.31,22111715,22198959,87244,-,-
BAC222_B15,4,4p15.31,22135100,22255482,120382,-,-
BAC248_J10,4,4p15.31,22349662,22438589,88927,-,-
BAC133_N12,4,4p15.31,22376115,22461659,85544,-,-
BAC154_M02,4,4p15.31,22450006,22557107,107101,-,-
BAC19_P19,4,4p15.31,22450006,22552922,102916,-,-
BAC244_I02,4,4p15.31,22450006,22552931,102925,-,-
BAC38_L20,4,4p15.31,22561010,22663577,102567,-,-
BAC18_F06,4,4p15.31,22636158,22742148,105990,-,-
BAC51_N13,4,4p15.31,22695586,22796851,101265,-,-
BAC83_F12,4,4p15.31,22748466,22856997,108531,-,-
BAC100_K08,4,4p15.31,22757547,22857000,99453,-,-
BAC148_I10,4,4p15.31,22757547,22856867,99320,-,-
BAC102_I12,4,4p15.31,22802544,22902429,99885,-,-
BAC54_E03,4,4p15.31,22970415,23064244,93829,-,-
BAC228_H22,4,4p15.2,23122518,23211515,88997,-,-
BAC120_N23,4,4p15.2,23295527,23381308,85781,-,-
BAC130_H16,4,4p15.2,23335106,23457313,122207,-,-
BAC151_C20,4,4p15.2,23348229,23426205,77976,-,-
BAC161_H01,4,4p15.2,23414739,23475540,60801,-,-
BAC54_K11,4,4p15.2,23466835,23569387,102552,-,-
BAC26_C10,4,4p15.2,23475540,23578343,102803,-,-
BAC52_P18,4,4p15.2,23522794,23659461,136667,-,-
BAC80_H21,4,4p15.2,23576117,23702317,126200,-,-
BAC189_O20,4,4p15.2,23620565,23702320,81755,-,-
BAC69_F20,4,4p15.2,23646607,23734607,88000,-,-
BAC21_I15,4,4p15.2,23689436,23798705,109269,-,-
BAC117_L17,4,4p15.2,23702312,23798321,96009,-,-
BAC248_D04,4,4p15.2,23773330,23876553,103223,-,-
BAC41_D13,4,4p15.2,23776669,23914788,138119,-,-
BAC186_M18,4,4p15.2,23794072,23874881,80809,-,-
BAC84_M13,4,4p15.2,23802621,23908503,105882,-,-
BAC36_E19,4,4p15.2,23918261,24009890,91629,-,-
BAC44_L01,4,4p15.2,23923670,24019685,96015,-,-
BAC45_B05,4,4p15.2,23925760,24033349,107589,-,-
BAC147_G03,4,4p15.2,23951955,24061029,109074,-,-
BAC130_E24,4,4p15.2,24040200,24121857,81657,-,-
BAC165_B24,4,4p15.2,24113020,24233696,120676,-,-
BAC114_K16,4,4p15.2,24144505,24241353,96848,-,-
BAC136_P07,4,4p15.2,24155472,24251372,95900,-,-
BAC244_A13,4,4p15.2,24192753,24272095,79342,-,-
BAC14_E11,4,4p15.2,24251545,24335701,84156,-,-
BAC95_K03,4,4p15.2,24272090,24365915,93825,-,-
BAC163_I19,4,4p15.2,24328712,24418878,90166,-,-
BAC37_H07,4,4p15.2,24379115,24527507,148392,-,-
BAC173_H05,4,4p15.2,24379317,24478938,99621,-,-
BAC82_N14,4,4p15.2,24403741,24493920,90179,-,-
BAC147_C20,4,4p15.2,24405178,24493712,88534,-,-
BAC149_B03,4,4p15.2,24501095,24584955,83860,-,-
BAC131_B07,4,4p15.2,24506965,24621639,114674,-,-
BAC8_L16,4,4p15.2,24537821,24635685,97864,-,-
BAC226_H17,4,4p15.2,24621853,24714497,92644,-,-
BAC64_B05,4,4p15.2,24722037,24821323,99286,-,-
BAC175_E05,4,4p15.2,24733427,24825999,92572,-,-
BAC230_F17,4,4p15.2,24837394,24936756,99362,-,-
BAC65_A16,4,4p15.2,24840617,24928424,87807,-,-
BAC155_H20,4,4p15.2,24962384,25050952,88568,-,-
BAC153_A01,4,4p15.2,24990748,25093013,102265,-,-
BAC134_C05,4,4p15.2,25003686,25088287,84601,-,-
BAC229_G15,4,4p15.2,25028710,25111306,82596,-,-
BAC143_I05,4,4p15.2,25178221,25278575,100354,-,-
BAC188_A17,4,4p15.2,25182677,25293371,110694,-,-
BAC236_D06,4,4p15.2,25269936,25380958,111022,-,-
BAC157_K21,4,4p15.2,25278568,25380958,102390,-,-
BAC118_H05,4,4p15.2,25293417,25384657,91240,-,-
BAC144_P20,4,4p15.2,25411669,25555230,143561,-,-
BAC90_G22,4,4p15.2,25412547,25553632,141085,-,-
BAC130_K04,4,4p15.2,25465597,25566505,100908,-,-
BAC156_E18,4,4p15.2,25642459,25722219,79760,-,-
BAC155_B22,4,4p15.2,25655975,25741230,85255,-,-
BAC61_D03,4,4p15.2,25656007,25804432,148425,-,-
BAC63_I18,4,4p15.2,25668464,25765474,97010,-,-
BAC232_K15,4,4p15.2,25668464,25754354,85890,-,-
BAC182_D03,4,4p15.2,25685609,25773649,88040,-,-
BAC110_M13,4,4p15.2,25779802,25916254,136452,-,-
BAC234_C17,4,4p15.2,25804424,25897192,92768,-,-
BAC181_M10,4,4p15.2,25828028,25932814,104786,-,-
BAC106_E11,4,4p15.2,25879003,26003486,124483,-,-
BAC178_P22,4,4p15.2,25902315,26001922,99607,-,-
BAC232_N20,4,4p15.2,25932877,26038070,105193,-,-
BAC119_O08,4,4p15.2,26038723,26152932,114209,-,-
BAC46_J24,4,4p15.2,26040229,26146282,106053,-,-
BAC186_B21,4,4p15.2,26207655,26313832,106177,-,-
BAC35_N01,4,4p15.2,26207718,26333516,125798,-,-
BAC222_N09,4,4p15.2,26344205,26433008,88803,-,-
BAC105_A14,4,4p15.2,26508252,26585193,76941,-,-
BAC48_M04,4,4p15.2,26601256,26688589,87333,-,-
BAC80_E10,4,4p15.2,26608404,26722015,113611,-,-
BAC188_N04,4,4p15.2,26610785,26711056,100271,-,-
BAC193_I22,4,4p15.2,26792184,26877124,84940,-,-
BAC27_F17,4,4p15.2,26795646,26885520,89874,-,-
BAC6_L03,4,4p15.2,26877399,26998491,121092,-,-
BAC139_J15,4,4p15.2,26883928,26969030,85102,-,-
BAC55_O14,4,4p15.2,26980408,27120686,140278,-,-
BAC233_I05,4,4p15.2,27030085,27124898,94813,-,-
BAC152_I22,4,4p15.2,27215727,27296275,80548,-,-
BAC106_E17,4,4p15.2,27250698,27334591,83893,-,-
BAC81_A15,4,4p15.2,27362083,27479823,117740,-,-
BAC192_L03,4,4p15.2,27424812,27523314,98502,-,-
BAC46_P15,4,4p15.2,27570280,27669272,98992,-,-
BAC53_P16,4,4p15.2,27689459,27773925,84466,-,-
BAC161_C15,4,4p15.2,27739674,27821709,82035,-,-
BAC227_G08,4,4p15.2,27774005,27871776,97771,-,-
BAC31_E23,4,4p15.2-4p15.1,27862164,27962476,100312,-,-
BAC151_M06,4,4p15.1,28058051,28175610,117559,-,-
BAC169_D14,4,4p15.1,28071916,28155560,83644,-,-
BAC97_K16,4,4p15.1,28280587,28398944,118357,-,-
BAC142_O02,4,4p15.1,28311164,28395724,84560,-,-
BAC183_O11,4,4p15.1,28657976,28758970,100994,-,-
BAC176_F06,4,4p15.1,28657979,28758970,100991,-,-
BAC249_A18,4,4p15.1,28884127,28965375,81248,-,-
BAC157_F04,4,4p15.1,28965368,29043519,78151,-,-
BAC89_P15,4,4p15.1,29278344,29429869,151525,-,-
BAC118_E06,4,4p15.1,29641869,29738098,96229,-,-
BAC82_O16,4,4p15.1,29788723,29913718,124995,-,-
BAC137_K24,4,4p15.1,29834092,29913718,79626,-,-
BAC119_M10,4,4p15.1,29961339,30093505,132166,-,-
BAC32_N23,4,4p15.1,30149134,30256406,107272,-,-
BAC101_F13,4,4p15.1,30222588,30364294,141706,-,-
BAC86_A02,4,4p15.1,30286819,30364339,77520,-,-
BAC156_K23,4,4p15.1,30428665,30513402,84737,-,-
BAC242_C02,4,4p15.1,30467674,30567705,100031,-,-
BAC9_H02,4,4p15.1,30568232,30655492,87260,-,-
BAC58_K14,4,4p15.1,30715367,30821792,106425,-,-
BAC60_K12,4,4p15.1,30731178,30929223,198045,-,-
BAC231_J07,4,4p15.1,30929216,31006628,77412,-,-
BAC229_I05,4,4p15.1,30942060,31026997,84937,-,-
BAC133_J01,4,4p15.1,31076365,31158383,82018,-,-
BAC80_J21,4,4p15.1,31212830,31326850,114020,-,-
BAC119_M08,4,4p15.1,31217842,31301801,83959,-,-
BAC128_J23,4,4p15.1,31591832,31717768,125936,-,-
BAC18_J02,4,4p15.1,31648628,31742933,94305,-,-
BAC234_A08,4,4p15.1,31780219,31871068,90849,-,-
BAC12_K01,4,4p15.1,31848694,31940282,91588,-,-
BAC4_C24,4,4p15.1,31865950,31958884,92934,-,-
BAC121_B15,4,4p15.1,31912213,31997433,85220,-,-
BAC195_H15,4,4p15.1,32055671,32122422,66751,-,-
BAC65_E10,4,4p15.1,32122413,32221375,98962,-,-
BAC244_C14,4,4p15.1,32218613,32319238,100625,-,-
BAC104_L06,4,4p15.1,32281354,32367569,86215,-,-
BAC151_K07,4,4p15.1,32283368,32400718,117350,-,-
BAC158_B13,4,4p15.1,32461079,32582881,121802,-,-
BAC56_N19,4,4p15.1,32549435,32639685,90250,-,-
BAC89_O15,4,4p15.1,32580203,32665516,85313,-,-
BAC142_B16,4,4p15.1,32599832,32708596,108764,-,-
BAC248_L01,4,4p15.1,32628104,32721088,92984,-,-
BAC139_B15,4,4p15.1,32796272,32880022,83750,-,-
BAC33_O10,4,4p15.1,32991468,33091325,99857,-,-
BAC128_P07,4,4p15.1,33054574,33152668,98094,-,-
BAC78_C24,4,4p15.1,33091048,33188782,97734,-,-
BAC135_P19,4,4p15.1,33332658,33407569,74911,-,-
BAC243_P14,4,4p15.1,33356161,33431884,75723,-,-
BAC167_A12,4,4p15.1,33428969,33516558,87589,-,-
BAC101_B04,4,4p15.1,33511937,33626059,114122,-,-
BAC225_F15,4,4p15.1,33592835,33672443,79608,-,-
BAC168_C07,4,4p15.1,33672438,33761089,88651,-,-
BAC227_G22,4,4p15.1,33732757,33827462,94705,-,-
BAC56_I16,4,4p15.1,33827634,33952118,124484,-,-
BAC140_H11,4,4p15.1,33861717,33949928,88211,-,-
BAC54_O13,4,4p15.1,33864427,33948283,83856,-,-
BAC172_H08,4,4p15.1,33953165,34039045,85880,-,-
BAC199_O10,4,4p15.1,34095535,34183816,88281,-,-
BAC120_O09,4,4p15.1,34211451,34346903,135452,-,-
BAC91_P24,4,4p15.1,34390239,34477462,87223,-,-
BAC230_I19,4,4p15.1,34435037,34519333,84296,-,-
BAC82_L21,4,4p15.1,34449974,34535072,85098,-,-
BAC72_M14,4,4p15.1,34474659,34596659,122000,-,-
BAC96_P13,4,4p15.1,34535077,34689057,153980,-,-
BAC74_B20,4,4p15.1,34590153,34694767,104614,-,-
BAC27_A21,4,4p15.1,34598736,34718932,120196,-,-
BAC181_I17,4,4p15.1,34614360,34732339,117979,-,-
BAC122_A13,4,4p15.1,34638324,34732320,93996,-,-
BAC78_G07,4,4p15.1,34682707,34818967,136260,-,-
BAC178_A24,4,4p15.1,34713234,34860024,146790,-,-
BAC84_O14,4,4p15.1,35041280,35128540,87260,-,-
BAC127_O08,4,4p15.1,35179075,35278421,99346,-,-
BAC8_I02,4,4p15.1,35208833,35349652,140819,-,-
BAC36_H07,4,4p15.1,35223381,35354802,131421,-,-
BAC247_E09,4,4p15.1,35241675,35321447,79772,-,-
BAC21_G12,4,4p15.1,35250326,35351260,100934,-,-
BAC140_M08,4,4p15.1-4p14,35404866,35518123,113257,-,-
BAC120_F04,4,4p14,35520265,35602888,82623,-,-
BAC189_G01,4,4p14,35566021,35660170,94149,-,-
BAC178_L01,4,4p14,35566780,35667241,100461,-,-
BAC67_G11,4,4p14,35864009,35974785,110776,-,-
BAC51_K06,4,4p14,35875872,35974785,98913,-,-
BAC116_M08,4,4p14,35880832,36023311,142479,-,-
BAC147_A01,4,4p14,35960340,36049912,89572,-,-
BAC79_K21,4,4p14,35990138,36114377,124239,-,-
BAC169_F11,4,4p14,36055854,36127094,71240,-,-
BAC175_K04,4,4p14,36114484,36199327,84843,-,-
BAC41_K05,4,4p14,36221643,36323193,101550,-,-
BAC179_P17,4,4p14,36221643,36313539,91896,-,-
BAC185_D22,4,4p14,36231601,36317803,86202,-,-
BAC163_C08,4,4p14,36496721,36581794,85073,-,-
BAC233_A17,4,4p14,36592902,36696742,103840,-,-
BAC149_F16,4,4p14,36596880,36698724,101844,-,-
BAC22_A08,4,4p14,36717527,36835809,118282,-,-
BAC20_M01,4,4p14,36824450,36925030,100580,-,-
BAC186_O03,4,4p14,36864281,36939095,74814,-,-
BAC176_N05,4,4p14,36894684,36974201,79517,-,-
BAC71_G05,4,4p14,36939107,37016011,76904,-,-
BAC59_D02,4,4p14,36944463,37102545,158082,-,-
BAC160_F05,4,4p14,37060022,37137322,77300,-,-
BAC62_D08,4,4p14,37121136,37215761,94625,-,-
BAC60_N18,4,4p14,37137338,37227636,90298,-,-
BAC140_N10,4,4p14,37143830,37283150,139320,-,-
BAC226_M16,4,4p14,37147409,37253609,106200,-,-
BAC83_D18,4,4p14,37179912,37307821,127909,-,-
BAC146_I01,4,4p14,37179912,37266329,86417,-,-
BAC247_F06,4,4p14,37211155,37307821,96666,-,-
BAC152_D01,4,4p14,37218413,37298109,79696,-,-
BAC167_E21,4,4p14,37227629,37319090,91461,-,-
BAC125_D04,4,4p14,37266323,37368211,101888,-,-
BAC147_G08,4,4p14,37283290,37444075,160785,-,-
BAC145_B19,4,4p14,37317550,37440932,123382,-,-
BAC150_E23,4,4p14,37342855,37427046,84191,-,-
BAC97_C24,4,4p14,37368219,37466423,98204,-,-
BAC103_D05,4,4p14,37404163,37535320,131157,-,-
BAC36_C12,4,4p14,37405048,37508536,103488,-,-
BAC234_P03,4,4p14,37427036,37518177,91141,-,-
BAC68_J17,4,4p14,37460373,37555421,95048,-,-
BAC180_D24,4,4p14,37501968,37583248,81280,-,-
BAC20_I21,4,4p14,37546478,37654423,107945,-,-
BAC167_F12,4,4p14,37555485,37661500,106015,-,-
BAC32_B21,4,4p14,37559874,37648602,88728,-,-
BAC86_B14,4,4p14,37675217,37810818,135601,-,-
BAC230_N22,4,4p14,37695586,37774743,79157,-,-
BAC101_F09,4,4p14,37695782,37810818,115036,-,-
BAC117_A19,4,4p14,37704108,37810818,106710,-,-
BAC84_I22,4,4p14,37812240,37935874,123634,-,-
BAC96_I17,4,4p14,37830416,37912049,81633,-,-
BAC32_N19,4,4p14,37874041,37965020,90979,-,-
BAC180_E21,4,4p14,37880955,37960398,79443,-,-
BAC29_J01,4,4p14,37881058,37972371,91313,-,-
BAC224_N23,4,4p14,37971132,38073515,102383,-,-
BAC140_F16,4,4p14,37998614,38073515,74901,-,-
BAC213_P03,4,4p14,38059840,38207383,147543,-,-
BAC235_C15,4,4p14,38265271,38397826,132555,-,-
BAC117_L13,4,4p14,38438090,38532402,94312,-,-
BAC161_L12,4,4p14,38458990,38547471,88481,-,-
BAC61_J07,4,4p14,38532661,38676932,144271,-,-
BAC144_E15,4,4p14,38567384,38676932,109548,-,-
BAC217_A15,4,4p14,38574826,38654810,79984,-,-
BAC122_D20,4,4p14,38577202,38687793,110591,-,-
BAC27_I02,4,4p14,38577207,38679020,101813,-,-
BAC242_N13,4,4p14,38619260,38712100,92840,-,-
BAC117_N22,4,4p14,38626882,38716099,89217,-,-
BAC144_I06,4,4p14,38656706,38758997,102291,-,-
BAC180_J04,4,4p14,38677150,38780255,103105,-,-
BAC101_A06,4,4p14,38754429,38847065,92636,-,-
BAC95_N22,4,4p14,38812074,38928154,116080,-,-
BAC197_G10,4,4p14,38816869,38905936,89067,-,-
BAC148_F22,4,4p14,38816869,38905936,89067,-,-
BAC26_K04,4,4p14,38897161,38983976,86815,-,-
BAC97_O11,4,4p14,38939377,39013699,74322,-,-
BAC52_D18,4,4p14,38985200,39203141,217941,-,-
BAC58_L12,4,4p14,39020051,39144415,124364,-,-
BAC185_G15,4,4p14,39133817,39217074,83257,-,-
BAC72_K10,4,4p14,39203229,39318075,114846,-,-
BAC131_B08,4,4p14,39313358,39409412,96054,-,-
BAC201_I21,4,4p14,39318190,39414802,96612,-,-
BAC236_H18,4,4p14,39324663,39409670,85007,-,-
BAC243_A01,4,4p14,39480369,39602468,122099,-,-
BAC55_L10,4,4p14,39496666,39570927,74261,-,-
BAC185_M11,4,4p14,39511328,39612378,101050,-,-
BAC175_M12,4,4p14,39512389,39600767,88378,-,-
BAC97_J07,4,4p14,39571129,39642288,71159,-,-
BAC185_L08,4,4p14,39572135,39647844,75709,-,-
BAC243_K18,4,4p14,39683961,39783987,100026,-,-
BAC53_B06,4,4p14,39703384,39789069,85685,-,-
BAC49_J18,4,4p14,39705999,39788142,82143,-,-
BAC162_A18,4,4p14,39706024,39808494,102470,-,-
BAC148_I12,4,4p14,39706182,39797098,90916,-,-
BAC238_F04,4,4p14,39794004,39873290,79286,-,-
BAC236_L11,4,4p14,40002795,40085308,82513,-,-
BAC193_C11,4,4p14,40002797,40078769,75972,-,-
BAC250_G12,4,4p14,40064228,40152318,88090,-,-
BAC177_L10,4,4p14,40085448,40173667,88219,-,-
BAC177_F16,4,4p14,40085448,40173471,88023,-,-
BAC68_P15,4,4p14,40101753,40198923,97170,-,-
BAC67_N09,4,4p14,40175135,40278194,103059,-,-
BAC34_K06,4,4p14,40198564,40375877,177313,-,-
BAC154_F09,4,4p14,40218664,40313127,94463,-,-
BAC222_N08,4,4p14,40282172,40388509,106337,-,-
BAC53_C13,4,4p14,40305385,40387923,82538,-,-
BAC55_O18,4,4p14,40305387,40438892,133505,-,-
BAC132_C05,4,4p14,40313286,40375875,62589,-,-
BAC142_K21,4,4p14,40375867,40481091,105224,-,-
BAC51_G09,4,4p14,40438901,40551241,112340,-,-
BAC193_P11,4,4p14,40458273,40525891,67618,-,-
BAC135_K12,4,4p14,40486947,40597133,110186,-,-
BAC119_F10,4,4p14,40489597,40620876,131279,-,-
BAC238_P13,4,4p14,40633854,40725158,91304,-,-
BAC73_M12,4,4p14,40638594,40773136,134542,-,-
BAC126_M03,4,4p14,40694897,40751556,56659,-,-
BAC97_I23,4,4p13,40916158,41006936,90778,-,-
BAC57_H22,4,4p13,40955082,41047582,92500,-,-
BAC105_F02,4,4p13,41003417,41102451,99034,-,-
BAC46_D15,4,4p13,41003463,41102407,98944,-,-
BAC140_J24,4,4p13,41080541,41096459,15918,-,-
BAC168_G16,4,4p13,41168124,41247512,79388,-,-
BAC218_J22,4,4p13,41212905,41298284,85379,-,-
BAC176_H19,4,4p13,41251423,41375483,124060,-,-
BAC68_O19,4,4p13,41292867,41404193,111326,-,-
BAC11_D18,4,4p13,41322879,41438877,115998,-,-
BAC182_H07,4,4p13,41341620,41435844,94224,-,-
BAC186_C02,4,4p13,41342195,41449102,106907,yes,-
BAC36_B17,4,4p13,41354980,41451010,96030,-,-
BAC116_O24,4,4p13,41354981,41465087,110106,yes,-
BAC152_P05,4,4p13,41469047,41556551,87504,-,-
BAC39_L01,4,4p13,41530242,41635852,105610,-,-
BAC50_B10,4,4p13,41587651,41704903,117252,-,-
BAC219_L18,4,4p13,41594918,41689656,94738,-,-
BAC109_G21,4,4p13,41615313,41704779,89466,-,-
BAC137_E11,4,4p13,41694690,41792919,98229,-,-
BAC239_A16,4,4p13,41769124,41866233,97109,-,-
BAC118_O01,4,4p13,41777807,41870492,92685,-,-
BAC252_D05,4,4p13,41796972,41870482,73510,-,-
BAC121_C17,4,4p13,41825823,41984092,158269,-,-
BAC124_A05,4,4p13,41845463,41936682,91219,-,-
BAC73_B08,4,4p13,41857105,42022584,165479,-,-
BAC237_H17,4,4p13,41861268,41984469,123201,-,-
BAC81_E13,4,4p13,41945582,42108737,163155,-,-
BAC115_M04,4,4p13,41988990,42137962,148972,-,-
BAC156_P06,4,4p13,41999746,42108735,108989,-,-
BAC134_B17,4,4p13,42007462,42112497,105035,-,-
BAC228_H02,4,4p13,42033554,42138005,104451,-,-
BAC80_P15,4,4p13,42055000,42142160,87160,-,-
BAC246_L09,4,4p13,42055000,42137962,82962,-,-
BAC177_J09,4,4p13,42149237,42230390,81153,-,-
BAC150_G18,4,4p13,42242331,42332893,90562,-,-
BAC252_L18,4,4p13,42305753,42445687,139934,-,-
BAC170_D20,4,4p13,42382610,42453382,70772,-,-
BAC241_J02,4,4p13,42499545,42622991,123446,-,-
BAC203_F01,4,4p13,42550393,42624970,74577,-,-
BAC117_L07,4,4p13,42651619,42733842,82223,-,-
BAC28_P23,4,4p13,42776154,42799304,23150,-,-
BAC233_M02,4,4p13,42776990,42866814,89824,-,-
BAC38_H08,4,4p13,42966566,43076982,110416,-,-
BAC116_O03,4,4p13,43476059,43549637,73578,-,-
BAC55_F16,4,4p13,43490628,43587355,96727,-,-
BAC61_E19,4,4p13,43549759,43644758,94999,-,-
BAC32_D13,4,4p13,43601414,43615866,14452,-,-
BAC90_H17,4,4p13,43735654,43840906,105252,-,-
BAC35_D07,4,4p13,43823817,43931758,107941,-,-
BAC32_D18,4,4p13,43861421,43963072,101651,-,-
BAC51_N02,4,4p13,43898506,43984886,86380,-,-
BAC117_H16,4,4p13,43964956,44074629,109673,-,-
BAC105_N06,4,4p13,44190991,44281075,90084,-,-
BAC171_I24,4,4p13,44328109,44401817,73708,-,-
BAC78_O11,4,4p13,44333251,44456718,123467,-,-
BAC176_B21,4,4p13,44424547,44507754,83207,-,-
BAC228_E23,4,4p13,44483141,44567490,84349,-,-
BAC66_M17,4,4p13,44483141,44576728,93587,-,-
BAC40_L24,4,4p13,44507757,44636636,128879,-,-
BAC79_B19,4,4p13,44558695,44612772,54077,-,-
BAC129_N04,4,4p13,44660291,44742890,82599,-,-
BAC161_L13,4,4p13,44672903,44752818,79915,-,-
BAC25_A07,4,4p13,44729831,44833519,103688,-,-
BAC190_C12,4,4p13,44953284,45050950,97666,-,-
BAC186_D05,4,4p13,45068262,45135654,67392,-,-
BAC119_D14,4,4p13,45125280,45205917,80637,-,-
BAC71_H16,4,4p13,45206355,45387413,181058,-,-
BAC51_E10,4,4p13,45336223,45456499,120276,-,-
BAC238_A18,4,4p13,45421542,45503033,81491,-,-
BAC116_L05,4,4p13,45456602,45574794,118192,-,-
BAC89_J17,4,4p13,45465089,45588771,123682,-,-
BAC168_J10,4,4p12,45757179,45853712,96533,-,-
BAC134_F05,4,4p12,45913500,45958346,44846,-,-
BAC49_H19,4,4p12,45913564,45990683,77119,-,-
BAC168_O10,4,4p12,45952233,46036319,84086,-,-
BAC90_C17,4,4p12,46022042,46129909,107867,-,-
BAC134_A17,4,4p12,46102921,46192053,89132,-,-
BAC234_E11,4,4p12,46516441,46618902,102461,-,-
BAC73_H19,4,4p12,46516541,46685443,168902,-,-
BAC90_C09,4,4p12,46685438,46790104,104666,-,-
BAC197_J18,4,4p12,46689078,46816704,127626,-,-
BAC113_C01,4,4p12,46926969,47061102,134133,-,-
BAC54_E18,4,4p12,46970145,47061099,90954,-,-
BAC130_M14,4,4p12,47070880,47195883,125003,-,-
BAC38_N05,4,4p12,47112609,47195883,83274,-,-
BAC193_J01,4,4p12,47189029,47285211,96182,-,-
BAC38_F04,4,4p12,47296287,47407092,110805,-,-
BAC12_G22,4,4p12,47333050,47544240,211190,-,-
BAC157_B16,4,4p12,47412681,47499517,86836,-,-
BAC58_P19,4,4p12,47551794,47725369,173575,-,-
BAC137_E17,4,4p12,47587196,47663223,76027,-,-
BAC127_G07,4,4p12,47616175,47731629,115454,-,-
BAC215_I24,4,4p12,47655889,47758381,102492,-,-
BAC74_O17,4,4p12,47663217,47755121,91904,-,-
BAC33_M04,4,4p12,47736780,47836029,99249,-,-
BAC132_N02,4,4p12,47752992,47857923,104931,-,-
BAC184_K08,4,4p12,47772624,47842775,70151,-,-
BAC166_J12,4,4p12,47892731,47999064,106333,-,-
BAC128_B06,4,4p12,47920774,48012838,92064,-,-
BAC168_H04,4,4p12,47921602,48055097,133495,-,-
BAC250_I20,4,4p12,47932556,48032417,99861,-,-
BAC33_K09,4,4p12,48012869,48105304,92435,-,-
BAC44_B14,4,4p12,48012922,48170660,157738,-,-
BAC115_L22,4,4p12,48050179,48161428,111249,-,-
BAC177_J12,4,4p12,48068237,48161807,93570,-,-
BAC102_G08,4,4p12,48150595,48249718,99123,-,-
BAC149_H04,4,4p12,48159648,48261203,101555,-,-
BAC53_D17,4,4p12,48288915,48374525,85610,-,-
BAC41_K21,4,4p12,48426898,48549072,122174,-,-
BAC63_K03,4,4p12,48433712,48538626,104914,-,-
BAC248_G06,4,4p12,48465988,48551973,85985,-,-
BAC50_O23,4,4p12,48483118,48611172,128054,-,-
BAC21_G24,4,4p12,48541552,48670278,128726,-,-
BAC157_L01,4,4p12-4p11,48669779,48758967,89188,-,-
BAC153_L07,4,4p11,48776378,48873428,97050,-,-
BAC199_L10,4,4p11,48953956,48980009,26053,-,-
BAC168_B09,4,4p11,48953957,48992570,38613,-,-
BAC142_O14,4,4p11,49190755,49221791,31036,-,-
BAC124_A01,4,4p11,49190755,49259924,69169,-,-
BAC53_M22,4,4p11,49190769,49238848,48079,-,-
BAC217_A16,4,4p11,49190771,49238848,48077,-,-
BAC195_C10,4,4p11,49195976,49221791,25815,-,-
BAC20_M17,4,4p11,49197417,49238847,41430,-,-
BAC91_N17,4,4q12,52434756,52519424,84668,-,-
BAC95_E08,4,4q12,52449039,52535449,86410,-,-
BAC132_J13,4,4q12,52558079,52652988,94909,-,-
BAC63_H11,4,4q12,52615508,52712699,97191,-,-
BAC183_A05,4,4q12,52626203,52712728,86525,-,-
BAC140_G09,4,4q12,52811801,52905350,93549,-,-
BAC116_I05,4,4q12,52850892,52968808,117916,-,-
BAC16_G07,4,4q12,52853426,52983291,129865,-,-
BAC233_G02,4,4q12,52876405,52958439,82034,-,-
BAC186_A11,4,4q12,52998470,53086871,88401,-,-
BAC187_A20,4,4q12,53065071,53157732,92661,-,-
BAC158_E17,4,4q12,53065962,53161084,95122,-,-
BAC195_I02,4,4q12,53071861,53218934,147073,-,-
BAC44_K07,4,4q12,53091484,53208525,117041,-,-
BAC191_O16,4,4q12,53120478,53210256,89778,-,-
BAC91_F21,4,4q12,53130389,53261863,131474,-,-
BAC105_N02,4,4q12,53240347,53344266,103919,-,-
BAC178_I22,4,4q12,53262513,53342584,80071,-,-
BAC193_L17,4,4q12,53428229,53534736,106507,-,-
BAC55_C21,4,4q12,53504215,53594956,90741,-,-
BAC55_C17,4,4q12,53609806,53722345,112539,-,-
BAC237_P20,4,4q12,53636447,53715232,78785,-,-
BAC111_N15,4,4q12,53712596,53802991,90395,-,-
BAC146_J10,4,4q12,53783280,53884031,100751,-,-
BAC192_G05,4,4q12,53788984,53877616,88632,-,-
BAC129_N22,4,4q12,53910575,53995804,85229,-,-
BAC25_D13,4,4q12,53944260,54057846,113586,-,-
BAC101_L17,4,4q12,53944304,54177594,233290,-,-
BAC131_P21,4,4q12,53967302,54056796,89494,-,-
BAC8_N03,4,4q12,54016303,54122852,106549,-,-
BAC102_A24,4,4q12,54062539,54150196,87657,-,-
BAC158_J21,4,4q12,54165173,54239661,74488,-,-
BAC142_B24,4,4q12,54176699,54274553,97854,-,-
BAC220_P22,4,4q12,54275761,54349794,74033,-,-
BAC189_K07,4,4q12,54339222,54438505,99283,-,-
BAC234_D19,4,4q12,54339223,54416896,77673,-,-
BAC240_F01,4,4q12,54416890,54498813,81923,-,-
BAC110_F09,4,4q12,54426527,54525688,99161,-,-
BAC42_P11,4,4q12,54496200,54600181,103981,-,-
BAC32_N14,4,4q12,54522534,54544468,21934,-,-
BAC135_C09,4,4q12,54596380,54674876,78496,-,-
BAC244_M22,4,4q12,54600710,54686783,86073,-,-
BAC120_M11,4,4q12,54606382,54715444,109062,-,-
BAC103_P11,4,4q12,54632161,54715444,83283,-,-
BAC121_N05,4,4q12,54669384,54822367,152983,-,-
BAC192_D05,4,4q12,54773744,54872416,98672,-,-
BAC165_H02,4,4q12,54774470,54872416,97946,-,-
BAC160_P01,4,4q12,54777161,54861352,84191,-,-
BAC119_I12,4,4q12,54777161,54900050,122889,-,-
BAC146_D16,4,4q12,54779599,54873608,94009,-,-
BAC71_C06,4,4q12,54789556,54938012,148456,-,-
BAC215_N02,4,4q12,54892879,54982626,89747,-,-
BAC36_K14,4,4q12,54938483,55032007,93524,-,-
BAC109_I04,4,4q12,54939972,54963922,23950,-,-
BAC161_B24,4,4q12,54939988,55025658,85670,-,-
BAC217_E11,4,4q12,55088737,55178458,89721,-,-
BAC125_D21,4,4q12,55092230,55205469,113239,-,-
BAC187_I24,4,4q12,55149599,55236888,87289,-,-
BAC144_A04,4,4q12,55178453,55285679,107226,-,-
BAC134_L17,4,4q12,55285719,55368769,83050,-,-
BAC237_P04,4,4q12,55299107,55380982,81875,-,-
BAC75_E10,4,4q12,55299107,55393089,93982,-,-
BAC117_E07,4,4q12,55357848,55475652,117804,-,-
BAC124_E23,4,4q12,55369486,55501931,132445,-,-
BAC27_D06,4,4q12,55377793,55389484,11691,-,-
BAC31_J09,4,4q12,55382560,55533889,151329,-,-
BAC24_J16,4,4q12,55393100,55500834,107734,-,-
BAC250_A16,4,4q12,55408259,55506170,97911,-,-
BAC144_B15,4,4q12,55527055,55683052,155997,-,-
BAC109_A02,4,4q12,55564261,55677877,113616,-,-
BAC75_G11,4,4q12,55627668,55723416,95748,-,-
BAC58_P16,4,4q12,55701570,55807988,106418,-,-
BAC193_E03,4,4q12,55723449,55807989,84540,-,-
BAC200_O04,4,4q12,55733452,55768189,34737,-,-
BAC226_O16,4,4q12,55830487,55955424,124937,-,-
BAC26_F02,4,4q12,55847577,56006264,158687,-,-
BAC150_P07,4,4q12,55885501,55999065,113564,-,-
BAC40_G12,4,4q12,55885506,55990142,104636,-,-
BAC217_N21,4,4q12,55916951,55999829,82878,-,-
BAC211_F18,4,4q12,55999873,56058135,58262,-,-
BAC92_B13,4,4q12,56006256,56105976,99720,-,-
BAC230_D04,4,4q12,56006533,56091155,84622,-,-
BAC75_K06,4,4q12,56058146,56165797,107651,-,-
BAC109_G15,4,4q12,56067863,56165458,97595,-,-
BAC106_J07,4,4q12,56083769,56213557,129788,-,-
BAC78_K08,4,4q12,56083769,56200639,116870,-,-
BAC79_J14,4,4q12,56096988,56193783,96795,-,-
BAC160_K02,4,4q12,56104242,56196159,91917,-,-
BAC227_J19,4,4q12,56110854,56214685,103831,-,-
BAC243_E16,4,4q12,56300180,56406448,106268,-,-
BAC24_B14,4,4q12,56319362,56433747,114385,-,-
BAC25_A17,4,4q12,56320371,56428344,107973,-,-
BAC123_D19,4,4q12,56348096,56454438,106342,-,-
BAC187_K22,4,4q12,56412748,56524668,111920,-,-
BAC243_M21,4,4q12,56437447,56518839,81392,-,-
BAC67_G19,4,4q12,56518833,56588539,69706,-,-
BAC156_G17,4,4q12,56525327,56615725,90398,-,-
BAC157_D08,4,4q12,56637719,56717434,79715,-,-
BAC43_C04,4,4q12,56841387,56923109,81722,-,-
BAC45_E07,4,4q12,56847821,56934888,87067,-,-
BAC211_I09,4,4q12,56847912,56959711,111799,-,-
BAC32_F13,4,4q12,56927452,57030170,102718,-,-
BAC61_I03,4,4q12,56938748,57022839,84091,-,-
BAC10_J03,4,4q12,56950533,57047968,97435,-,-
BAC40_J05,4,4q12,56950541,57087122,136581,-,-
BAC120_A07,4,4q12,56967076,57097477,130401,-,-
BAC50_E12,4,4q12,56981849,57097478,115629,-,-
BAC102_I11,4,4q12,56984148,57084662,100514,-,-
BAC81_K05,4,4q12,57003573,57114912,111339,-,-
BAC160_K17,4,4q12,57024644,57130050,105406,-,-
BAC162_K06,4,4q12,57060998,57161593,100595,-,-
BAC71_G10,4,4q12,57084657,57186866,102209,-,-
BAC118_J09,4,4q12,57087117,57242488,155371,-,-
BAC157_O21,4,4q12,57090897,57175895,84998,-,-
BAC60_E07,4,4q12,57256332,57408261,151929,-,-
BAC143_M23,4,4q12,57277499,57362754,85255,-,-
BAC106_D03,4,4q12,57325003,57408261,83258,-,-
BAC87_M15,4,4q12,57325322,57438682,113360,-,-
BAC27_E16,4,4q12,57342842,57435547,92705,-,-
BAC1_N12,4,4q12,57342845,57509416,166571,-,-
BAC67_I20,4,4q12,57470854,57556420,85566,-,-
BAC88_O23,4,4q12,57509410,57631794,122384,-,-
BAC214_M06,4,4q12,57515465,57602250,86785,-,-
BAC105_O13,4,4q12,57643802,57748829,105027,-,-
BAC61_D14,4,4q12,57688583,57775433,86850,-,-
BAC49_F16,4,4q12,57728352,57817313,88961,-,-
BAC95_H15,4,4q12,57730896,57844192,113296,-,-
BAC162_N22,4,4q12,57919725,58002854,83129,-,-
BAC142_K12,4,4q12,58077260,58168167,90907,-,-
BAC142_J12,4,4q12,58077260,58168167,90907,-,-
BAC134_I13,4,4q12,58103060,58292186,189126,-,-
BAC146_M04,4,4q12,58229381,58327389,98008,-,-
BAC76_E19,4,4q12,58292180,58385115,92935,-,-
BAC108_H05,4,4q12,58325644,58449610,123966,-,-
BAC95_A09,4,4q12,58724030,58805836,81806,-,-
BAC59_H06,4,4q12,58894742,59007304,112562,-,-
BAC64_D15,4,4q12,58952914,59040344,87430,-,-
BAC189_J19,4,4q12,59001826,59105110,103284,-,-
BAC169_P04,4,4q12-4q13.1,59161531,59249646,88115,-,-
BAC29_I21,4,4q12-4q13.1,59184438,59264873,80435,-,-
BAC89_P05,4,4q12-4q13.1,59198302,59308290,109988,-,-
BAC162_I03,4,4q13.1,59266127,59382175,116048,-,-
BAC127_B16,4,4q13.1,59583784,59686203,102419,-,-
BAC226_F01,4,4q13.1,59592227,59721352,129125,-,-
BAC63_I15,4,4q13.1,60005219,60093984,88765,-,-
BAC74_L14,4,4q13.1,60061036,60160009,98973,-,-
BAC237_P08,4,4q13.1,60093153,60208318,115165,-,-
BAC211_O10,4,4q13.1,60117347,60195919,78572,-,-
BAC135_O10,4,4q13.1,60160341,60249875,89534,-,-
BAC82_B14,4,4q13.1,60233491,60354693,121202,-,-
BAC134_G23,4,4q13.1,60314879,60398760,83881,-,-
BAC133_O09,4,4q13.1,60351410,60447024,95614,-,-
BAC195_J19,4,4q13.1,60468389,60536045,67656,-,-
BAC13_I02,4,4q13.1,60582216,60689425,107209,-,-
BAC84_F08,4,4q13.1,60663444,60781136,117692,-,-
BAC53_B14,4,4q13.1,60684191,60781193,97002,-,-
BAC165_L09,4,4q13.1,60737501,60817326,79825,-,-
BAC22_E12,4,4q13.1,60780701,60872042,91341,-,-
BAC228_N23,4,4q13.1,60796252,60893358,97106,-,-
BAC181_C13,4,4q13.1,61393174,61486774,93600,-,-
BAC234_I23,4,4q13.1,61547159,61645513,98354,-,-
BAC64_I13,4,4q13.1,61588146,61686764,98618,-,-
BAC51_I07,4,4q13.1,61651336,61802390,151054,-,-
BAC100_O09,4,4q13.1,61715760,61797332,81572,-,-
BAC113_H07,4,4q13.1,61857898,61961474,103576,-,-
BAC249_B17,4,4q13.1,62102492,62251188,148696,-,-
BAC37_K24,4,4q13.1,62115265,62241619,126354,-,-
BAC77_M18,4,4q13.1,62332403,62447392,114989,-,-
BAC78_K15,4,4q13.1,62440739,62531012,90273,-,-
BAC149_J16,4,4q13.1,62474192,62558402,84210,-,-
BAC28_L03,4,4q13.1,62474269,62575690,101421,-,-
BAC37_I16,4,4q13.1,62614994,62740085,125091,-,-
BAC252_O17,4,4q13.1,62781159,62938871,157712,-,-
BAC22_F02,4,4q13.1,62851436,63001407,149971,-,-
BAC238_B16,4,4q13.1,62880071,62962190,82119,-,-
BAC114_P07,4,4q13.1,62979037,63060693,81656,-,-
BAC233_C23,4,4q13.1,62990833,63076681,85848,-,-
BAC124_A21,4,4q13.1,63462050,63553690,91640,-,-
BAC179_A18,4,4q13.1,63541627,63643934,102307,-,-
BAC102_A03,4,4q13.1,63628943,63742468,113525,-,-
BAC15_O04,4,4q13.1,63643929,63731350,87421,-,-
BAC97_L24,4,4q13.1,63657356,63734961,77605,-,-
BAC66_P21,4,4q13.1,63801598,63885673,84075,-,-
BAC228_M21,4,4q13.1,63922303,64002501,80198,-,-
BAC249_I05,4,4q13.1,63981245,64054822,73577,-,-
BAC140_K20,4,4q13.1,64221108,64306369,85261,-,-
BAC20_J03,4,4q13.1,64385197,64478720,93523,-,-
BAC175_L14,4,4q13.1,64601503,64669288,67785,-,-
BAC117_O14,4,4q13.1,64715235,64800256,85021,-,-
BAC151_D18,4,4q13.1,64925200,65012077,86877,-,-
BAC100_K24,4,4q13.1,65089842,65188303,98461,-,-
BAC126_F19,4,4q13.1,65126170,65230227,104057,-,-
BAC20_J10,4,4q13.1,65174231,65323321,149090,-,-
BAC116_B24,4,4q13.1,65204219,65336544,132325,-,-
BAC176_L15,4,4q13.1,65537335,65617530,80195,-,-
BAC28_H06,4,4q13.1,65817890,65888480,70590,-,-
BAC115_K08,4,4q13.1,65907820,65993917,86097,-,-
BAC52_O07,4,4q13.1,65937499,66027242,89743,-,-
BAC27_I21,4,4q13.2,66467231,66566253,99022,-,-
BAC147_L15,4,4q13.2,66549565,66638518,88953,-,-
BAC126_F10,4,4q13.2,67010445,67134573,124128,-,-
BAC106_N03,4,4q13.2,67010445,67107225,96780,-,-
BAC103_A17,4,4q13.2,67252517,67339562,87045,-,-
BAC41_G13,4,4q13.2,67453122,67530365,77243,-,-
BAC219_M19,4,4q13.2,67484613,67564877,80264,-,-
BAC146_O14,4,4q13.2,67516993,67599475,82482,-,-
BAC34_N08,4,4q13.2,67641125,67740658,99533,-,-
BAC195_I01,4,4q13.2,67641140,67696489,55349,-,-
BAC156_B14,4,4q13.2,67641140,67731787,90647,-,-
BAC248_E03,4,4q13.2,67690862,67763958,73096,-,-
BAC31_K02,4,4q13.2,67980024,68084953,104929,-,-
BAC86_P04,4,4q13.2,68006756,68115992,109236,-,-
BAC68_I16,4,4q13.2,68012741,68143249,130508,-,-
BAC241_P04,4,4q13.2,68050994,68130202,79208,-,-
BAC202_F02,4,4q13.2,68092710,68172112,79402,-,-
BAC106_O05,4,4q13.2,68146046,68246390,100344,-,-
BAC117_F05,4,4q13.2,68162924,68275447,112523,-,-
BAC232_G21,4,4q13.2,68172125,68246320,74195,-,-
BAC116_N07,4,4q13.2,68172130,68266047,93917,-,-
BAC96_D06,4,4q13.2,68188805,68266037,77232,-,-
BAC79_F01,4,4q13.2,68197084,68297024,99940,-,-
BAC18_A16,4,4q13.2,68397775,68559529,161754,-,-
BAC45_L12,4,4q13.2,68475653,68559548,83895,-,-
BAC122_A14,4,4q13.2,68475675,68601151,125476,-,-
BAC183_O15,4,4q13.2,68519992,68601235,81243,-,-
BAC166_I09,4,4q13.2,68606183,68729168,122985,-,-
BAC46_L18,4,4q13.2,68612924,68732944,120020,-,-
BAC19_M04,4,4q13.2,68627328,68732914,105586,-,-
BAC193_C23,4,4q13.2,68742860,68836915,94055,-,-
BAC51_E05,4,4q13.2,68751962,68845333,93371,-,-
BAC50_H07,4,4q13.2,68787184,68890958,103774,-,-
BAC151_K02,4,4q13.2,68888805,69027236,138431,-,-
BAC33_B18,4,4q13.2,69052038,69154110,102072,yes,-
BAC189_J24,4,4q13.2,69091257,69175780,84523,-,-
BAC110_I03,4,4q13.2,69170356,69228188,57832,-,-
BAC237_E14,4,4q13.2,69585684,69655169,69485,-,-
BAC27_H23,4,4q13.2,69638905,69743212,104307,yes,-
BAC193_A05,4,4q13.2,69680443,69748723,68280,yes,-
BAC100_O04,4,4q13.2,69798129,69883044,84915,yes,-
BAC175_D19,4,4q13.2,69801433,69873265,71832,yes,-
BAC69_I04,4,4q13.2,69870946,70000476,129530,yes,-
BAC142_K13,4,4q13.2,69875722,69963046,87324,yes,-
BAC181_L22,4,4q13.2,69878542,69978347,99805,yes,-
BAC199_N22,4,4q13.2,69883040,70005564,122524,yes,-
BAC154_D06,4,4q13.2,70040969,70123317,82348,yes,-
BAC240_H14,4,4q13.2,70066203,70155501,89298,yes,-
BAC153_A05,4,4q13.2,70168916,70251397,82481,yes,-
BAC108_E12,4,4q13.2,70169597,70249129,79532,-,-
BAC222_M07,4,4q13.2-4q13.3,70322393,70405364,82971,yes,-
BAC155_A22,4,4q13.2-4q13.3,70386856,70480831,93975,-,-
BAC226_K04,4,4q13.2-4q13.3,70397268,70492568,95300,-,-
BAC203_D08,4,4q13.3,70480907,70562477,81570,yes,-
BAC127_D01,4,4q13.3,70530015,70615329,85314,-,-
BAC28_P09,4,4q13.3,70705576,70850084,144508,-,-
BAC144_F06,4,4q13.3,70743161,70850084,106923,-,-
BAC105_H14,4,4q13.3,70809622,70898447,88825,-,-
BAC247_K03,4,4q13.3,70811978,70896288,84310,-,-
BAC60_F04,4,4q13.3,70825603,70950830,125227,-,-
BAC153_E09,4,4q13.3,71032889,71112892,80003,-,-
BAC183_O23,4,4q13.3,71113193,71201741,88548,-,-
BAC175_I21,4,4q13.3,71129316,71214127,84811,-,-
BAC155_I13,4,4q13.3,71147511,71235235,87724,-,-
BAC90_P09,4,4q13.3,71722535,71826691,104156,-,-
BAC52_J24,4,4q13.3,71757945,71842540,84595,-,-
BAC139_N16,4,4q13.3,71761718,71846089,84371,-,-
BAC133_G21,4,4q13.3,71828180,71922800,94620,-,-
BAC172_H21,4,4q13.3,71891170,71986455,95285,-,-
BAC115_J03,4,4q13.3,71901640,72007471,105831,-,-
BAC141_J16,4,4q13.3,71901642,71967656,66014,-,-
BAC201_F23,4,4q13.3,71933000,72007449,74449,-,-
BAC43_K19,4,4q13.3,71939269,72054873,115604,-,-
BAC42_M22,4,4q13.3,71982843,72080495,97652,-,-
BAC155_F07,4,4q13.3,72007500,72080529,73029,-,-
BAC140_I18,4,4q13.3,72007500,72081900,74400,-,-
BAC145_B08,4,4q13.3,72171355,72269155,97800,-,-
BAC144_D09,4,4q13.3,72320832,72388851,68019,-,-
BAC42_D14,4,4q13.3,72346683,72446002,99319,-,-
BAC154_O01,4,4q13.3,72351279,72426343,75064,-,-
BAC237_N18,4,4q13.3,72388842,72502566,113724,-,-
BAC204_C14,4,4q13.3,72570948,72704168,133220,-,-
BAC233_I16,4,4q13.3,72604675,72687135,82460,-,-
BAC84_J18,4,4q13.3,72687943,72714076,26133,-,-
BAC227_L19,4,4q13.3,72871672,72957330,85658,-,-
BAC178_K22,4,4q13.3,73002422,73084419,81997,-,-
BAC128_E20,4,4q13.3,73035927,73166235,130308,-,-
BAC78_F10,4,4q13.3,73058195,73140907,82712,-,-
BAC64_E21,4,4q13.3,73067411,73175303,107892,-,-
BAC176_G14,4,4q13.3,73393978,73505886,111908,-,-
BAC64_I21,4,4q13.3,73402067,73516443,114376,-,-
BAC114_N13,4,4q13.3,73544125,73684782,140657,-,-
BAC126_D03,4,4q13.3,73623739,73764619,140880,-,-
BAC126_N13,4,4q13.3,73623760,73764619,140859,-,-
BAC69_B13,4,4q13.3,73651947,73765732,113785,-,-
BAC100_J22,4,4q13.3,73807490,73905106,97616,-,-
BAC158_O22,4,4q13.3,73866755,73946649,79894,-,-
BAC247_K15,4,4q13.3,74027762,74131045,103283,-,-
BAC227_K03,4,4q13.3,74033528,74109581,76053,-,-
BAC100_P20,4,4q13.3,74097888,74205969,108081,-,-
BAC84_B20,4,4q13.3,74109598,74235595,125997,-,-
BAC122_M07,4,4q13.3,74132985,74223705,90720,-,-
BAC96_F05,4,4q13.3,74155451,74235105,79654,-,-
BAC200_K03,4,4q13.3,74293509,74376350,82841,-,-
BAC160_I07,4,4q13.3,74347103,74446050,98947,-,-
BAC57_A18,4,4q13.3,74391591,74481123,89532,-,-
BAC50_K01,4,4q13.3,74391591,74484112,92521,-,-
BAC182_P19,4,4q13.3,74451889,74519834,67945,-,-
BAC1_C16,4,4q13.3,74536267,74654550,118283,-,-
BAC106_G19,4,4q13.3,74935655,75024863,89208,-,-
BAC97_N20,4,4q13.3,74954925,75049790,94865,-,-
BAC127_E10,4,4q13.3,74975690,75084149,108459,-,-
BAC127_M09,4,4q13.3,74980069,75139610,159541,-,-
BAC83_E10,4,4q13.3,75049786,75153412,103626,-,-
BAC123_O20,4,4q13.3,75218411,75324887,106476,-,-
BAC129_P22,4,4q13.3,75332430,75416653,84223,-,-
BAC71_E08,4,4q13.3,75367758,75467954,100196,-,-
BAC230_H13,4,4q13.3,75382596,75460924,78328,-,-
BAC63_I21,4,4q13.3,75391891,75486418,94527,-,-
BAC41_M15,4,4q13.3,75391896,75499954,108058,-,-
BAC238_I06,4,4q13.3,75394398,75462989,68591,-,-
BAC183_P02,4,4q13.3,75450262,75541255,90993,-,-
BAC249_O01,4,4q13.3,75547533,75632859,85326,-,-
BAC35_H16,4,4q13.3,75738633,75837623,98990,-,-
BAC120_J01,4,4q13.3,75784436,75891170,106734,-,-
BAC76_C05,4,4q13.3,75791903,75882884,90981,-,-
BAC224_L18,4,4q13.3,75829462,75922649,93187,-,-
BAC168_F08,4,4q13.3,75858015,75939367,81352,-,-
BAC114_F13,4,4q13.3,75881888,75979176,97288,-,-
BAC60_H13,4,4q13.3,75939500,76024373,84873,-,-
BAC100_M10,4,4q13.3,76007842,76102862,95020,-,-
BAC71_K20,4,4q13.3,76033576,76129040,95464,-,-
BAC23_M18,4,4q13.3,76047371,76149155,101784,-,-
BAC194_C17,4,4q13.3,76075283,76157684,82401,-,-
BAC81_A07,4,4q13.3,76255439,76373682,118243,-,-
BAC66_D10,4,4q13.3,76290378,76316959,26581,-,-
BAC1_A20,4,4q13.3,76320322,76399727,79405,-,-
BAC227_K22,4,4q13.3,76340723,76423380,82657,-,-
BAC146_B17,4,4q13.3-4q21.1,76439443,76524502,85059,-,-
BAC195_E16,4,4q21.1,76537995,76633001,95006,-,-
BAC60_L24,4,4q21.1,76546049,76666442,120393,-,-
BAC146_C14,4,4q21.1,76632196,76750012,117816,-,-
BAC210_N23,4,4q21.1,76643580,76749904,106324,-,-
BAC244_P16,4,4q21.1,76644754,76750012,105258,-,-
BAC41_M20,4,4q21.1,76666440,76750012,83572,-,-
BAC124_K19,4,4q21.1,76788073,76871945,83872,-,-
BAC60_L09,4,4q21.1,76788073,76894662,106589,-,-
BAC37_H15,4,4q21.1,76894656,76997468,102812,-,-
BAC168_M11,4,4q21.1,76935578,77013793,78215,-,-
BAC51_M08,4,4q21.1,76935833,77013795,77962,-,-
BAC200_M08,4,4q21.1,76944646,77051042,106396,-,-
BAC26_O15,4,4q21.1,77063735,77177519,113784,-,-
BAC56_K19,4,4q21.1,77222338,77320470,98132,-,-
BAC126_C12,4,4q21.1,77240986,77351337,110351,-,-
BAC182_K08,4,4q21.1,77241181,77357192,116011,-,-
BAC83_N11,4,4q21.1,77241181,77333361,92180,-,-
BAC97_G07,4,4q21.1,77393998,77471843,77845,-,-
BAC1_M24,4,4q21.1,77418773,77500783,82010,-,-
BAC61_I10,4,4q21.1,77427417,77517801,90384,-,-
BAC90_O06,4,4q21.1,77505020,77525043,20023,-,-
BAC56_I07,4,4q21.1,77517186,77610247,93061,-,-
BAC165_J10,4,4q21.1,77549452,77625689,76237,-,-
BAC184_O14,4,4q21.1,77549482,77666075,116593,-,-
BAC221_G11,4,4q21.1,77627611,77714399,86788,-,-
BAC33_C16,4,4q21.1,77663384,77749319,85935,-,-
BAC105_B14,4,4q21.1,77696465,77810214,113749,-,-
BAC59_E21,4,4q21.1,77706757,77828226,121469,-,-
BAC22_A09,4,4q21.1,77713302,77801173,87871,-,-
BAC142_O21,4,4q21.1,77735112,77813381,78269,-,-
BAC194_J13,4,4q21.1,77810211,77920477,110266,-,-
BAC82_N09,4,4q21.1,77825692,77952890,127198,-,-
BAC52_B04,4,4q21.1,78013975,78098887,84912,-,-
BAC234_A10,4,4q21.1,78020787,78098951,78164,-,-
BAC52_K12,4,4q21.1,78116216,78199442,83226,-,-
BAC25_C01,4,4q21.1,78242316,78429304,186988,-,-
BAC120_L21,4,4q21.1,78251334,78337220,85886,-,-
BAC41_O05,4,4q21.1,78338989,78446698,107709,-,-
BAC160_F01,4,4q21.1,78353054,78442559,89505,-,-
BAC189_G18,4,4q21.1,78373635,78501971,128336,-,-
BAC175_A01,4,4q21.1,78373636,78471433,97797,-,-
BAC132_A21,4,4q21.1,78381633,78450437,68804,-,-
BAC67_F13,4,4q21.1,78522007,78663691,141684,-,-
BAC41_E01,4,4q21.1,78574124,78688166,114042,-,-
BAC78_N20,4,4q21.1,78593568,78689321,95753,-,-
BAC127_E16,4,4q21.1,78603570,78717577,114007,-,-
BAC229_D11,4,4q21.1,78643086,78734705,91619,-,-
BAC64_G06,4,4q21.1,78689934,78824048,134114,-,-
BAC17_D16,4,4q21.1,78767832,78870290,102458,-,-
BAC218_C19,4,4q21.1,78857787,78914794,57007,-,-
BAC78_J17,4,4q21.1,78928059,79064447,136388,-,-
BAC124_L17,4,4q21.1,78976196,79076571,100375,-,-
BAC41_L21,4,4q21.1,79004198,79107809,103611,-,-
BAC139_J05,4,4q21.1,79092453,79187016,94563,-,-
BAC38_H11,4,4q21.1,79094121,79188360,94239,-,-
BAC38_H24,4,4q21.1,79094121,79188363,94242,-,-
BAC122_O07,4,4q21.21,79201475,79304909,103434,-,-
BAC150_F14,4,4q21.21,79206090,79337217,131127,-,-
BAC28_J04,4,4q21.21,79214189,79330372,116183,-,-
BAC132_E04,4,4q21.21,79214189,79312742,98553,-,-
BAC244_E13,4,4q21.21,79344810,79428978,84168,-,-
BAC38_M14,4,4q21.21,79350648,79428862,78214,-,-
BAC250_L03,4,4q21.21,79416294,79508322,92028,-,-
BAC158_B10,4,4q21.21,79424431,79530439,106008,-,-
BAC188_J13,4,4q21.21,79424435,79519297,94862,-,-
BAC51_L05,4,4q21.21,79460860,79612992,152132,-,-
BAC73_O09,4,4q21.21,79497266,79510821,13555,-,-
BAC162_J13,4,4q21.21,79506633,79582873,76240,-,-
BAC59_G11,4,4q21.21,79519872,79602243,82371,-,-
BAC75_P14,4,4q21.21,79635304,79756783,121479,-,-
BAC12_K10,4,4q21.21,79655664,79756783,101119,-,-
BAC108_D15,4,4q21.21,79761193,79862648,101455,-,-
BAC19_M23,4,4q21.21,79807311,79893386,86075,-,-
BAC197_G15,4,4q21.21,79856559,79950964,94405,-,-
BAC18_A10,4,4q21.21,79951844,80042385,90541,-,-
BAC34_D23,4,4q21.21,80337386,80426036,88650,-,-
BAC11_K12,4,4q21.21,80397840,80507648,109808,-,-
BAC84_J12,4,4q21.21,80522780,80661136,138356,-,-
BAC133_A15,4,4q21.21,80597265,80687804,90539,-,-
BAC102_A13,4,4q21.21,80790822,80878164,87342,-,-
BAC198_O23,4,4q21.21,80913413,81001541,88128,-,-
BAC139_N05,4,4q21.21,81055250,81162454,107204,-,-
BAC189_L23,4,4q21.21,81228638,81312233,83595,-,-
BAC157_E03,4,4q21.21,81292325,81378573,86248,-,-
BAC170_L09,4,4q21.21,81292546,81411882,119336,-,-
BAC11_M01,4,4q21.21,81411892,81497390,85498,-,-
BAC101_G21,4,4q21.21,81426030,81536883,110853,-,-
BAC233_B13,4,4q21.21,81472753,81578083,105330,-,-
BAC102_F24,4,4q21.21,81560192,81641543,81351,-,-
BAC127_F13,4,4q21.21,81575615,81670034,94419,-,-
BAC62_L17,4,4q21.21,81673249,81755525,82276,-,-
BAC34_D04,4,4q21.21,81713633,81839256,125623,-,-
BAC154_J08,4,4q21.21,81734345,81817693,83348,-,-
BAC180_J08,4,4q21.21,81755611,81814912,59301,-,-
BAC231_K01,4,4q21.21,81869372,81952138,82766,-,-
BAC72_O07,4,4q21.21,81957134,82065341,108207,-,-
BAC125_F19,4,4q21.21,82007569,82180119,172550,-,-
BAC32_I17,4,4q21.21,82197626,82318741,121115,-,-
BAC124_L13,4,4q21.21,82203039,82368406,165367,-,-
BAC55_D11,4,4q21.21,82250003,82358240,108237,-,-
BAC135_A19,4,4q21.21,82397009,82483294,86285,-,-
BAC173_G22,4,4q21.21,82400385,82483880,83495,-,-
BAC144_J04,4,4q21.21,82400492,82483655,83163,-,-
BAC127_F02,4,4q21.21,82439244,82549594,110350,-,-
BAC154_B07,4,4q21.21,82444156,82558208,114052,-,-
BAC241_D16,4,4q21.21,82469516,82567904,98388,-,-
BAC226_B01,4,4q21.21-4q21.22,82541847,82641695,99848,-,-
BAC51_B12,4,4q21.21-4q21.22,82541849,82629555,87706,-,-
BAC189_P11,4,4q21.21-4q21.22,82588408,82674690,86282,-,-
BAC52_J08,4,4q21.22,82667820,82785386,117566,-,-
BAC73_E04,4,4q21.22,82684449,82774848,90399,-,-
BAC167_O22,4,4q21.22,82985019,83068555,83536,-,-
BAC170_C22,4,4q21.22,83001237,83159682,158445,-,-
BAC170_J11,4,4q21.22,83015296,83100673,85377,-,-
BAC82_O17,4,4q21.22,83070908,83266324,195416,-,-
BAC115_C10,4,4q21.22,83093579,83207212,113633,-,-
BAC248_I14,4,4q21.22,83185450,83277886,92436,-,-
BAC240_J16,4,4q21.22,83195034,83277625,82591,-,-
BAC244_J23,4,4q21.22,83195136,83284603,89467,-,-
BAC21_M10,4,4q21.22,83333110,83485015,151905,-,-
BAC199_F08,4,4q21.22,83364110,83431413,67303,-,-
BAC217_H21,4,4q21.22,83367778,83476957,109179,-,-
BAC76_K16,4,4q21.22,83417949,83505729,87780,-,-
BAC23_K16,4,4q21.22,83443408,83571504,128096,-,-
BAC10_F13,4,4q21.22,83443408,83579584,136176,-,-
BAC34_L23,4,4q21.22,83451929,83568295,116366,-,-
BAC46_I13,4,4q21.22,83505741,83669930,164189,-,-
BAC51_L09,4,4q21.22,83519075,83625573,106498,-,-
BAC92_J08,4,4q21.22,83526175,83609369,83194,-,-
BAC157_D13,4,4q21.22,83581036,83692816,111780,-,-
BAC97_J13,4,4q21.22,83625596,83709133,83537,-,-
BAC39_K14,4,4q21.22,83641791,83735516,93725,-,-
BAC199_C24,4,4q21.22,83674377,83796253,121876,-,-
BAC196_I13,4,4q21.22,83682240,83788196,105956,-,-
BAC126_O16,4,4q21.22,83718140,83814561,96421,-,-
BAC68_E11,4,4q21.22,83817236,83952527,135291,-,-
BAC27_A12,4,4q21.22,83873819,83963936,90117,-,-
BAC238_A17,4,4q21.22,83894293,84032282,137989,-,-
BAC118_K16,4,4q21.22,83945605,84031223,85618,-,-
BAC33_I23,4,4q21.22,83963942,84091325,127383,-,-
BAC80_K08,4,4q21.22,84014127,84108140,94013,-,-
BAC220_N12,4,4q21.22,84034277,84129941,95664,-,-
BAC206_O07,4,4q21.22,84080584,84091161,10577,-,-
BAC36_H06,4,4q21.22,84092254,84221374,129120,-,-
BAC61_H12,4,4q21.22,84113811,84221609,107798,-,-
BAC64_P07,4,4q21.22,84136601,84221405,84804,-,-
BAC132_K16,4,4q21.22,84190848,84293489,102641,-,-
BAC244_B05,4,4q21.22-4q21.23,84205970,84305004,99034,-,-
BAC42_J20,4,4q21.22-4q21.23,84256991,84407161,150170,-,-
BAC238_N08,4,4q21.22-4q21.23,84275781,84382343,106562,-,-
BAC234_C19,4,4q21.23,84305015,84384769,79754,-,-
BAC196_C08,4,4q21.23,84333595,84424502,90907,-,-
BAC175_O24,4,4q21.23,84333595,84424502,90907,-,-
BAC109_O16,4,4q21.23,84337690,84445567,107877,-,-
BAC250_D04,4,4q21.23,84376520,84473451,96931,-,-
BAC22_A13,4,4q21.23,84462583,84578203,115620,-,-
BAC160_C06,4,4q21.23,84495157,84575148,79991,-,-
BAC31_N02,4,4q21.23,84544679,84712364,167685,-,-
BAC82_L15,4,4q21.23,84559358,84709362,150004,-,-
BAC247_E10,4,4q21.23,84559358,84638491,79133,-,-
BAC25_J01,4,4q21.23,84563493,84644806,81313,-,-
BAC120_K06,4,4q21.23,84586079,84687733,101654,-,-
BAC180_I06,4,4q21.23,84589586,84728623,139037,-,-
BAC59_A22,4,4q21.23,84599819,84729147,129328,-,-
BAC170_J18,4,4q21.23,84618041,84708097,90056,-,-
BAC224_D04,4,4q21.23,84644828,84724146,79318,-,-
BAC68_O07,4,4q21.23,84648837,84723161,74324,-,-
BAC92_E10,4,4q21.23,84709357,84796001,86644,-,-
BAC18_M20,4,4q21.23,84772639,84875581,102942,-,-
BAC147_I14,4,4q21.23,84785304,84856089,70785,-,-
BAC68_J04,4,4q21.23,84810896,84897111,86215,-,-
BAC184_E06,4,4q21.23,84875575,84946862,71287,-,-
BAC153_A06,4,4q21.23,84899721,84969951,70230,-,-
BAC41_M12,4,4q21.23,84919054,85078928,159874,-,-
BAC201_L19,4,4q21.23,84919252,85031584,112332,-,-
BAC4_N10,4,4q21.23,84939513,85022519,83006,-,-
BAC100_O16,4,4q21.23,84993696,85125504,131808,-,-
BAC161_F06,4,4q21.23,85072815,85164648,91833,-,-
BAC69_N08,4,4q21.23,85208970,85304991,96021,-,-
BAC41_I10,4,4q21.23,85284156,85372064,87908,-,-
BAC180_C22,4,4q21.23,85526131,85617351,91220,-,-
BAC193_O16,4,4q21.23,85628429,85733606,105177,-,-
BAC247_L05,4,4q21.23,85703550,85783799,80249,-,-
BAC82_N08,4,4q21.23,85733694,85825240,91546,-,-
BAC160_E01,4,4q21.23,85751647,85845084,93437,-,-
BAC88_N22,4,4q21.23,85827031,85927684,100653,-,-
BAC51_P10,4,4q21.23,85837035,85945722,108687,-,-
BAC169_J17,4,4q21.23,85890180,85977541,87361,-,-
BAC58_N09,4,4q21.23,85987465,86072301,84836,-,-
BAC239_J21,4,4q21.23,86210220,86306714,96494,-,-
BAC248_D12,4,4q21.23,86248420,86336056,87636,-,-
BAC137_J07,4,4q21.23,86466094,86539696,73602,-,-
BAC41_J20,4,4q21.23,86824917,86917076,92159,-,-
BAC89_L16,4,4q21.3,87106323,87200258,93935,-,-
BAC33_F24,4,4q21.3,87256974,87375651,118677,-,-
BAC168_G17,4,4q21.3,87256974,87333794,76820,-,-
BAC155_K16,4,4q21.3,87256976,87348558,91582,-,-
BAC11_J16,4,4q21.3,87257006,87379398,122392,-,-
BAC5_A20,4,4q21.3,87278501,87406853,128352,-,-
BAC135_K22,4,4q21.3,87760060,87843231,83171,-,-
BAC19_H14,4,4q21.3,87875599,87967595,91996,-,-
BAC32_C01,4,4q21.3,87875949,87982285,106336,-,-
BAC177_D10,4,4q21.3,87890157,87995883,105726,-,-
BAC177_N16,4,4q21.3,87890159,87995883,105724,-,-
BAC218_C14,4,4q21.3,87951470,88049541,98071,-,-
BAC16_I19,4,4q21.3,87967564,88061324,93760,-,-
BAC33_C19,4,4q21.3,87967594,88063939,96345,-,-
BAC147_K19,4,4q21.3,87982270,88062861,80591,-,-
BAC143_C05,4,4q21.3,87995878,88062861,66983,-,-
BAC41_C13,4,4q21.3,87996194,88071288,75094,-,-
BAC33_D03,4,4q21.3,88013391,88095094,81703,-,-
BAC191_F18,4,4q21.3,88013391,88099376,85985,-,-
BAC50_F07,4,4q21.3,88067541,88193994,126453,-,-
BAC130_C09,4,4q21.3-4q22.1,88123300,88207331,84031,-,-
BAC243_I09,4,4q21.3-4q22.1,88183564,88310283,126719,-,-
BAC219_A09,4,4q22.1,88238341,88353892,115551,-,-
BAC49_J17,4,4q22.1,88255307,88325320,70013,-,-
BAC192_K15,4,4q22.1,88266059,88367966,101907,-,-
BAC86_L11,4,4q22.1,88349763,88457024,107261,-,-
BAC175_N09,4,4q22.1,88367677,88494091,126414,yes,-
BAC37_N21,4,4q22.1,88415372,88530687,115315,yes,-
BAC97_P15,4,4q22.1,88522751,88610561,87810,-,-
BAC248_P08,4,4q22.1,88531291,88610551,79260,-,-
BAC217_A07,4,4q22.1,88729771,88834697,104926,-,-
BAC54_J04,4,4q22.1,88941174,89037945,96771,-,-
BAC196_D10,4,4q22.1,88963949,89061217,97268,-,-
BAC51_H04,4,4q22.1,89001416,89115410,113994,-,-
BAC33_I01,4,4q22.1,89086477,89214854,128377,-,-
BAC96_M04,4,4q22.1,89103171,89191317,88146,-,-
BAC163_M19,4,4q22.1,89104887,89205537,100650,-,-
BAC81_G07,4,4q22.1,89183403,89274766,91363,-,-
BAC191_M22,4,4q22.1,89247470,89359517,112047,-,-
BAC75_M19,4,4q22.1,89247470,89369252,121782,-,-
BAC205_D05,4,4q22.1,89253836,89348397,94561,-,-
BAC150_N19,4,4q22.1,89269965,89367916,97951,-,-
BAC233_H17,4,4q22.1,89274846,89382830,107984,-,-
BAC80_D04,4,4q22.1,89275105,89417604,142499,-,-
BAC26_H03,4,4q22.1,89290937,89402801,111864,-,-
BAC238_A20,4,4q22.1,89313026,89392191,79165,-,-
BAC151_G01,4,4q22.1,89392466,89481977,89511,-,-
BAC252_N04,4,4q22.1,89651714,89781828,130114,-,-
BAC107_O17,4,4q22.1,89657110,89747346,90236,-,-
BAC206_I22,4,4q22.1,89683315,89743921,60606,-,-
BAC144_E07,4,4q22.1,89861668,89965169,103501,-,-
BAC142_H15,4,4q22.1,89961890,90063520,101630,-,-
BAC199_E14,4,4q22.1,89965164,90047366,82202,-,-
BAC225_F03,4,4q22.1,90036818,90122418,85600,-,-
BAC95_E06,4,4q22.1,90047459,90138817,91358,-,-
BAC242_H04,4,4q22.1,90097571,90173059,75488,-,-
BAC182_C08,4,4q22.1,90103490,90223176,119686,-,-
BAC162_A12,4,4q22.1,90140556,90222760,82204,-,-
BAC1_I15,4,4q22.1,90253190,90367070,113880,-,-
BAC31_J13,4,4q22.1,90268945,90360718,91773,-,-
BAC144_F20,4,4q22.1,90285866,90386181,100315,-,-
BAC31_P07,4,4q22.1,90352054,90482915,130861,-,-
BAC5_J01,4,4q22.1,90367089,90533165,166076,-,-
BAC73_M08,4,4q22.1,90533160,90638933,105773,-,-
BAC116_P10,4,4q22.1,90620595,90735659,115064,-,-
BAC200_G12,4,4q22.1,90734499,90847413,112914,-,-
BAC153_D17,4,4q22.1,90840338,90968486,128148,-,-
BAC117_E24,4,4q22.1,90957826,91055543,97717,-,-
BAC236_L01,4,4q22.1,91134595,91215112,80517,-,-
BAC176_M20,4,4q22.1,91213936,91305339,91403,-,-
BAC250_K10,4,4q22.1,91219259,91345724,126465,-,-
BAC130_L07,4,4q22.1,91418237,91518788,100551,-,-
BAC21_G11,4,4q22.1,91418333,91558594,140261,-,-
BAC88_P14,4,4q22.1,91482121,91561476,79355,-,-
BAC224_P08,4,4q22.1,91647078,91731324,84246,-,-
BAC244_M06,4,4q22.1,91755115,91879161,124046,-,-
BAC22_H06,4,4q22.1,91758422,91866237,107815,-,-
BAC137_B06,4,4q22.1,91792013,91908417,116404,-,-
BAC172_B05,4,4q22.1,91834728,91929175,94447,-,-
BAC174_A16,4,4q22.1,91851404,91937817,86413,-,-
BAC227_H10,4,4q22.1,91881232,91978450,97218,-,-
BAC54_G03,4,4q22.1,91981325,92080362,99037,-,-
BAC243_H09,4,4q22.1,92166060,92254411,88351,-,-
BAC96_J13,4,4q22.1,92224778,92323679,98901,-,-
BAC191_G02,4,4q22.1,92229155,92319774,90619,-,-
BAC52_C04,4,4q22.1,92293542,92385400,91858,-,-
BAC222_F21,4,4q22.1,92323544,92410322,86778,-,-
BAC171_B23,4,4q22.1,92419708,92513181,93473,-,-
BAC244_N03,4,4q22.1,92431379,92512001,80622,-,-
BAC10_G18,4,4q22.1,92432499,92597982,165483,-,-
BAC45_G14,4,4q22.1,92513914,92603042,89128,-,-
BAC107_I01,4,4q22.1,92558103,92686031,127928,-,-
BAC181_L20,4,4q22.1,92604434,92686031,81597,-,-
BAC8_L15,4,4q22.1,92666362,92749807,83445,-,-
BAC139_G20,4,4q22.1,92749440,92840769,91329,-,-
BAC106_N11,4,4q22.1,92886238,92974860,88622,-,-
BAC53_K05,4,4q22.1,92917582,93038306,120724,-,-
BAC118_B15,4,4q22.1,92951436,93038306,86870,-,-
BAC30_J16,4,4q22.1,93118272,93197449,79177,-,-
BAC20_J22,4,4q22.1,93128337,93229395,101058,-,-
BAC116_B17,4,4q22.1,93222962,93326836,103874,-,-
BAC25_N06,4,4q22.1,93463864,93582340,118476,-,-
BAC162_M16,4,4q22.1,93497801,93578446,80645,-,-
BAC62_N22,4,4q22.1,93523927,93612945,89018,-,-
BAC249_C11,4,4q22.1,93705762,93718689,12927,-,-
BAC102_K18,4,4q22.1,93887569,93978768,91199,-,-
BAC228_C14,4,4q22.1,93887857,93978111,90254,-,-
BAC227_N17,4,4q22.1-4q22.2,93978781,94065943,87162,-,-
BAC65_P03,4,4q22.2,94007777,94104411,96634,-,-
BAC174_E02,4,4q22.2,94035628,94111096,75468,-,-
BAC199_G18,4,4q22.2,94362649,94446518,83869,-,-
BAC86_G01,4,4q22.2,94478007,94575040,97033,-,-
BAC66_G14,4,4q22.2,94559732,94644610,84878,-,-
BAC113_M23,4,4q22.2,94604745,94694543,89798,-,-
BAC109_F13,4,4q22.2,94663896,94794169,130273,-,-
BAC186_A01,4,4q22.2,94771097,94857189,86092,-,-
BAC141_K14,4,4q22.2,94820741,94902684,81943,-,-
BAC32_B18,4,4q22.2,95132956,95229258,96302,-,-
BAC105_K04,4,4q22.2-4q22.3,95291559,95466152,174593,-,-
BAC37_G02,4,4q22.2-4q22.3,95359649,95454012,94363,-,-
BAC191_C13,4,4q22.2-4q22.3,95390322,95466152,75830,-,-
BAC59_F01,4,4q22.3,95494626,95571171,76545,-,-
BAC67_H12,4,4q22.3,95526848,95646697,119849,-,-
BAC35_A17,4,4q22.3,95540836,95646697,105861,-,-
BAC171_L16,4,4q22.3,95692595,95783063,90468,-,-
BAC36_M24,4,4q22.3,95715269,95837819,122550,-,-
BAC135_H01,4,4q22.3,95767532,95849747,82215,-,-
BAC116_I01,4,4q22.3,95810097,95922942,112845,-,-
BAC233_L06,4,4q22.3,95837817,95925112,87295,-,-
BAC117_D02,4,4q22.3,96174414,96278679,104265,-,-
BAC150_D04,4,4q22.3,96211317,96301344,90027,-,-
BAC165_H17,4,4q22.3,96281862,96462654,180792,-,-
BAC120_A23,4,4q22.3,96301371,96449630,148259,-,-
BAC86_H05,4,4q22.3,96301371,96435349,133978,-,-
BAC166_C08,4,4q22.3,96701895,96792826,90931,-,-
BAC117_B17,4,4q22.3,96717346,96792826,75480,-,-
BAC194_M08,4,4q22.3,96720331,96798061,77730,-,-
BAC92_P20,4,4q22.3,96801806,96917214,115408,-,-
BAC30_N15,4,4q22.3,96815703,96932840,117137,-,-
BAC223_M09,4,4q22.3,96980611,97084579,103968,-,-
BAC84_J09,4,4q22.3,96980611,97084579,103968,-,-
BAC235_L21,4,4q22.3,97076756,97158590,81834,-,-
BAC37_H04,4,4q22.3,97252146,97364557,112411,-,-
BAC39_B22,4,4q22.3,97358100,97449289,91189,-,-
BAC78_N01,4,4q22.3,97395368,97502444,107076,-,-
BAC148_P06,4,4q22.3,97405102,97479677,74575,-,-
BAC230_I07,4,4q22.3,97454553,97551745,97192,-,-
BAC6_F11,4,4q22.3,97510141,97653907,143766,-,-
BAC96_G12,4,4q22.3,97787399,97896095,108696,-,-
BAC96_O12,4,4q22.3,97968826,98058631,89805,-,-
BAC52_E03,4,4q22.3,98173372,98323181,149809,-,-
BAC20_M06,4,4q22.3,98228854,98314628,85774,-,-
BAC152_A15,4,4q22.3,98360958,98478849,117891,-,-
BAC135_J02,4,4q22.3,98418815,98511042,92227,-,-
BAC234_G08,4,4q22.3,98553301,98612224,58923,-,-
BAC2_N22,4,4q22.3,98590393,98678578,88185,-,-
BAC198_G11,4,4q22.3,98750400,98830830,80430,-,-
BAC38_G03,4,4q23,99106944,99206763,99819,-,-
BAC50_G10,4,4q23,99208625,99311251,102626,-,-
BAC154_A10,4,4q23,99353611,99443535,89924,-,-
BAC228_A15,4,4q23,99443842,99522629,78787,-,-
BAC40_K21,4,4q23,99463735,99576619,112884,-,-
BAC237_C19,4,4q23,99472794,99576624,103830,-,-
BAC8_J18,4,4q23,99609590,99734987,125397,-,-
BAC158_D20,4,4q23,99616940,99694933,77993,-,-
BAC158_C20,4,4q23,99616940,99694933,77993,-,-
BAC104_M06,4,4q23,99663597,99741998,78401,-,-
BAC171_P21,4,4q23,99685402,99787205,101803,-,-
BAC192_B10,4,4q23,99706121,99787208,81087,-,-
BAC198_I07,4,4q23,99706141,99787208,81067,-,-
BAC40_L08,4,4q23,99979346,100107709,128363,-,-
BAC162_M02,4,4q23,99983468,100061146,77678,-,-
BAC197_O16,4,4q23,100035042,100137195,102153,-,-
BAC198_N17,4,4q23,100059751,100169557,109806,-,-
BAC30_I03,4,4q23,100171913,100291272,119359,-,-
BAC54_L16,4,4q23,100181508,100270680,89172,-,-
BAC80_M07,4,4q23,100295575,100375506,79931,-,-
BAC128_O01,4,4q23,100319068,100409474,90406,-,-
BAC10_A09,4,4q23,100342411,100432517,90106,-,-
BAC190_P14,4,4q23,100432739,100516280,83541,-,-
BAC27_J08,4,4q23,100677384,100765067,87683,-,-
BAC125_O22,4,4q23,100680238,100848521,168283,-,-
BAC224_C07,4,4q23,100717027,100804345,87318,-,-
BAC60_O07,4,4q23,100816120,100919868,103748,-,-
BAC18_L02,4,4q23,100838782,100953737,114955,-,-
BAC78_E07,4,4q23,100867115,100968236,101121,-,-
BAC141_A02,4,4q23,100867152,100977054,109902,-,-
BAC55_P05,4,4q23,100953819,101063258,109439,-,-
BAC110_L02,4,4q23,101070012,101164388,94376,-,-
BAC24_P19,4,4q23,101076266,101196262,119996,-,-
BAC169_M02,4,4q23,101202181,101282464,80283,-,-
BAC119_C17,4,4q23,101215311,101328620,113309,-,-
BAC125_E15,4,4q23,101574844,101698001,123157,-,-
BAC76_E11,4,4q23,101642546,101732509,89963,-,-
BAC231_E21,4,4q23,101682481,101762226,79745,-,-
BAC89_I18,4,4q23,101801194,101949819,148625,-,-
BAC235_K01,4,4q23,101947095,102036491,89396,-,-
BAC133_N08,4,4q23,102063949,102216967,153018,-,-
BAC160_P08,4,4q23,102178238,102255098,76860,-,-
BAC6_P21,4,4q23,102178238,102251982,73744,-,-
BAC43_M18,4,4q23,102178959,102288886,109927,-,-
BAC178_J19,4,4q23,102194318,102285102,90784,-,-
BAC88_D04,4,4q23,102241528,102324552,83024,-,-
BAC219_B02,4,4q23-4q24,102430804,102516882,86078,-,-
BAC57_P21,4,4q23-4q24,102450212,102537553,87341,-,-
BAC28_L06,4,4q23-4q24,102490818,102577878,87060,-,-
BAC163_M24,4,4q24,102580720,102662511,81791,-,-
BAC154_B20,4,4q24,102608823,102693294,84471,-,-
BAC155_G02,4,4q24,102694683,102783670,88987,-,-
BAC151_O16,4,4q24,102805916,102944999,139083,-,-
BAC12_M14,4,4q24,102805916,102873718,67802,-,-
BAC159_A03,4,4q24,102828454,102923753,95299,-,-
BAC176_K16,4,4q24,103014721,103103395,88674,-,-
BAC36_O16,4,4q24,103462709,103603635,140926,-,-
BAC39_M01,4,4q24,103483917,103579205,95288,-,-
BAC117_J20,4,4q24,103522749,103617727,94978,-,-
BAC107_E08,4,4q24,103530055,103617727,87672,-,-
BAC127_N17,4,4q24,103579811,103669660,89849,-,-
BAC151_N17,4,4q24,103606505,103683282,76777,-,-
BAC160_P06,4,4q24,103610212,103683262,73050,-,-
BAC83_C05,4,4q24,103772752,103881167,108415,-,-
BAC50_M06,4,4q24,103968906,104061379,92473,-,-
BAC196_B01,4,4q24,103997510,104080327,82817,-,-
BAC66_N18,4,4q24,104118945,104273566,154621,-,-
BAC177_H03,4,4q24,104123580,104217325,93745,-,-
BAC12_P10,4,4q24,104143620,104255414,111794,-,-
BAC171_M13,4,4q24,104527889,104623548,95659,-,-
BAC139_F04,4,4q24,104531296,104608604,77308,-,-
BAC79_B24,4,4q24,104615181,104720868,105687,-,-
BAC112_B02,4,4q24,104666017,104799754,133737,-,-
BAC170_J21,4,4q24,104751689,104851891,100202,-,-
BAC125_A09,4,4q24,105045436,105165560,120124,-,-
BAC72_D09,4,4q24,105055809,105141214,85405,-,-
BAC28_N13,4,4q24,105350311,105468792,118481,-,-
BAC194_J09,4,4q24,105475263,105610208,134945,-,-
BAC208_O22,4,4q24,105484718,105575123,90405,-,-
BAC81_C01,4,4q24,105499102,105615559,116457,-,-
BAC18_I24,4,4q24,105629334,105777269,147935,-,-
BAC187_M05,4,4q24,105640474,105728396,87922,-,-
BAC154_L06,4,4q24,105679219,105758695,79476,-,-
BAC187_J23,4,4q24,105868026,105974222,106196,-,-
BAC75_D04,4,4q24,105872957,105992558,119601,-,-
BAC165_G01,4,4q24,105887876,106008149,120273,-,-
BAC123_E20,4,4q24,105898917,106003900,104983,-,-
BAC124_D08,4,4q24,106085962,106180700,94738,-,-
BAC148_O17,4,4q24,106131471,106222516,91045,-,-
BAC175_G13,4,4q24,106233749,106320845,87096,-,-
BAC189_A10,4,4q24,106268243,106353726,85483,-,-
BAC184_L12,4,4q24,106398782,106497748,98966,-,-
BAC183_B02,4,4q24,106437926,106550294,112368,-,-
BAC186_A19,4,4q24,106490024,106573224,83200,-,-
BAC166_A10,4,4q24,106658492,106789957,131465,-,-
BAC57_L20,4,4q24,106851700,106955821,104121,-,-
BAC66_F04,4,4q24,106875089,106976141,101052,-,-
BAC233_A14,4,4q24,106892372,106976141,83769,-,-
BAC243_J18,4,4q24,107001215,107102896,101681,-,-
BAC190_H02,4,4q24,107043586,107120375,76789,-,-
BAC176_F14,4,4q24,107072638,107188594,115956,-,-
BAC224_K14,4,4q24,107131285,107237407,106122,-,-
BAC230_P13,4,4q24,107173285,107259000,85715,-,-
BAC221_N04,4,4q24,107532125,107610438,78313,-,-
BAC35_D04,4,4q24,107627500,107720137,92637,-,-
BAC69_G04,4,4q24,107786929,107880958,94029,-,-
BAC69_B02,4,4q24,107786942,107880958,94016,-,-
BAC59_E13,4,4q24-4q25,107809549,107932758,123209,-,-
BAC1_J05,4,4q25,107942386,108083784,141398,-,-
BAC30_C23,4,4q25,108180967,108314848,133881,-,-
BAC119_J19,4,4q25,108273668,108365415,91747,-,-
BAC202_N14,4,4q25,108411032,108538806,127774,-,-
BAC122_I13,4,4q25,108559936,108715010,155074,-,-
BAC243_L20,4,4q25,108564317,108640448,76131,-,-
BAC44_N04,4,4q25,108564396,108664105,99709,-,-
BAC50_N03,4,4q25,108567574,108672887,105313,-,-
BAC183_H06,4,4q25,108567845,108659596,91751,-,-
BAC234_E18,4,4q25,108604667,108689936,85269,-,-
BAC59_D11,4,4q25,108692306,108803786,111480,-,-
BAC65_O15,4,4q25,108823981,108900610,76629,-,-
BAC222_G15,4,4q25,108867238,108950079,82841,-,-
BAC149_A24,4,4q25,108900674,108982916,82242,-,-
BAC78_D04,4,4q25,108980408,109085335,104927,-,-
BAC193_P01,4,4q25,109027225,109119130,91905,-,-
BAC76_P21,4,4q25,109033898,109143518,109620,-,-
BAC11_J10,4,4q25,109033898,109143518,109620,-,-
BAC103_P15,4,4q25,109033900,109164289,130389,-,-
BAC59_P03,4,4q25,109143730,109238536,94806,-,-
BAC119_N08,4,4q25,109164280,109256336,92056,-,-
BAC198_C21,4,4q25,109234421,109326326,91905,-,-
BAC82_A23,4,4q25,109254920,109409426,154506,-,-
BAC179_I12,4,4q25,109284074,109367763,83689,-,-
BAC238_N20,4,4q25,109326577,109418406,91829,-,-
BAC41_N23,4,4q25,109516028,109634423,118395,-,-
BAC232_F11,4,4q25,109681548,109760716,79168,-,-
BAC32_E07,4,4q25,109681548,109784575,103027,-,-
BAC181_F06,4,4q25,109681550,109753589,72039,-,-
BAC80_M13,4,4q25,109872425,109963683,91258,-,-
BAC32_P18,4,4q25,109872594,109962289,89695,-,-
BAC179_G03,4,4q25,109877064,109963683,86619,-,-
BAC104_C01,4,4q25,109932725,110019903,87178,-,-
BAC24_J06,4,4q25,110021551,110121045,99494,-,-
BAC46_F21,4,4q25,110053358,110138369,85011,-,-
BAC115_C13,4,4q25,110284871,110404724,119853,-,-
BAC109_F02,4,4q25,110406686,110504619,97933,-,-
BAC248_H07,4,4q25,110480680,110567219,86539,-,-
BAC178_N05,4,4q25,110665948,110754158,88210,-,-
BAC38_I07,4,4q25,110789354,110876938,87584,-,-
BAC235_H16,4,4q25,110799694,110878467,78773,-,-
BAC90_L03,4,4q25,110804360,110942573,138213,-,-
BAC95_P20,4,4q25,110810370,110910874,100504,-,-
BAC222_H20,4,4q25,110832078,110925814,93736,-,-
BAC217_E21,4,4q25,110845715,110936537,90822,-,-
BAC238_H17,4,4q25,110878738,110938103,59365,-,-
BAC54_E17,4,4q25,110917477,111003968,86491,-,-
BAC236_L07,4,4q25,110919375,110995550,76175,-,-
BAC96_A18,4,4q25,110938098,111027829,89731,-,-
BAC73_G10,4,4q25,110989050,111006431,17381,-,-
BAC71_F06,4,4q25,111075492,111272684,197192,-,-
BAC172_B10,4,4q25,111166392,111253665,87273,-,-
BAC185_O15,4,4q25,111414061,111552419,138358,-,-
BAC229_P17,4,4q25,111416058,111492194,76136,-,-
BAC173_M13,4,4q25,111421687,111522288,100601,-,-
BAC60_B07,4,4q25,111572541,111676072,103531,-,-
BAC34_N19,4,4q25,111676064,111782059,105995,-,-
BAC224_I07,4,4q25,111804050,111911304,107254,-,-
BAC228_P16,4,4q25,111957235,112052880,95645,-,-
BAC234_E23,4,4q25,112222137,112295516,73379,-,-
BAC165_M14,4,4q25,112259716,112361451,101735,-,-
BAC250_D19,4,4q25,112517826,112596458,78632,-,-
BAC73_D14,4,4q25,112922373,113020013,97640,-,-
BAC53_I14,4,4q25,113149498,113335191,185693,-,-
BAC240_O09,4,4q25,113202403,113281995,79592,-,-
BAC226_B21,4,4q25,113234392,113335308,100916,-,-
BAC49_O15,4,4q25,113234858,113348077,113219,-,-
BAC61_D09,4,4q25,113359824,113502317,142493,-,-
BAC231_F01,4,4q25,113381811,113473377,91566,-,-
BAC145_L14,4,4q25,113415344,113502317,86973,-,-
BAC150_O11,4,4q25,113531231,113619989,88758,-,-
BAC83_K03,4,4q25,113622393,113710777,88384,-,-
BAC102_I08,4,4q25,113660903,113740604,79701,-,-
BAC109_I11,4,4q25,113676220,113787125,110905,-,-
BAC78_H17,4,4q25,113764785,113859865,95080,-,-
BAC1_O08,4,4q25,113788899,113945914,157015,-,-
BAC102_M14,4,4q25,113916857,114029768,112911,-,-
BAC74_G08,4,4q25,113916857,114008958,92101,-,-
BAC62_A23,4,4q25-4q26,114065828,114148714,82886,-,-
BAC232_M21,4,4q25-4q26,114077950,114153185,75235,-,-
BAC141_J06,4,4q26,114134330,114216676,82346,-,-
BAC194_L01,4,4q26,114182937,114271299,88362,-,-
BAC106_K04,4,4q26,114244355,114340190,95835,-,-
BAC83_F06,4,4q26,114363723,114448803,85080,-,-
BAC64_G12,4,4q26,114435702,114528470,92768,-,-
BAC157_J19,4,4q26,114471944,114555344,83400,-,-
BAC133_A21,4,4q26,114500221,114607927,107706,-,-
BAC183_A20,4,4q26,114567489,114670041,102552,-,-
BAC180_H19,4,4q26,114754070,114856972,102902,-,-
BAC116_F09,4,4q26,115003667,115093657,89990,-,-
BAC169_G14,4,4q26,115162692,115226239,63547,-,-
BAC20_K12,4,4q26,115221126,115333244,112118,-,-
BAC81_D17,4,4q26,115278091,115393202,115111,-,-
BAC163_F12,4,4q26,115298090,115372259,74169,-,-
BAC63_E20,4,4q26,115352988,115445759,92771,-,-
BAC116_M02,4,4q26,115453394,115549697,96303,-,-
BAC102_O22,4,4q26,115776797,115855295,78498,-,-
BAC186_L20,4,4q26,115796139,115896016,99877,-,-
BAC44_G05,4,4q26,115924480,116079748,155268,-,-
BAC195_J22,4,4q26,115933044,116002488,69444,-,-
BAC248_H11,4,4q26,116436878,116536263,99385,-,-
BAC149_G15,4,4q26,116586341,116670385,84044,-,-
BAC146_J01,4,4q26,116712881,116792670,79789,-,-
BAC36_D07,4,4q26,116712881,116803918,91037,-,-
BAC162_B03,4,4q26,117073473,117160996,87523,-,-
BAC64_N07,4,4q26,117386750,117481992,95242,-,-
BAC199_B01,4,4q26,117441920,117508284,66364,-,-
BAC66_J16,4,4q26,117576864,117679006,102142,-,-
BAC38_O19,4,4q26,117602455,117692531,90076,-,-
BAC89_B15,4,4q26,117632540,117731649,99109,-,-
BAC13_A02,4,4q26,117682461,117780861,98400,-,-
BAC10_K13,4,4q26,117758052,117868912,110860,-,-
BAC198_F13,4,4q26,117857789,117985279,127490,-,-
BAC163_G04,4,4q26,118398687,118470175,71488,-,-
BAC103_I19,4,4q26,118531681,118639386,107705,-,-
BAC167_J17,4,4q26,118615157,118716226,101069,-,-
BAC118_E10,4,4q26,118639379,118729347,89968,-,-
BAC237_G17,4,4q26,118691392,118793035,101643,-,-
BAC237_G06,4,4q26,118735072,118825428,90356,-,-
BAC218_G11,4,4q26,119000790,119083335,82545,-,-
BAC127_A18,4,4q26,119008719,119131884,123165,-,-
BAC78_C23,4,4q26,119140926,119244424,103498,-,-
BAC126_H08,4,4q26,119244418,119371177,126759,-,-
BAC152_P08,4,4q26,119298959,119384449,85490,-,-
BAC90_E04,4,4q26,119371318,119468483,97165,-,-
BAC195_M17,4,4q26,119478696,119569742,91046,-,-
BAC133_P16,4,4q26,119522690,119658013,135323,-,-
BAC32_H11,4,4q26,119569759,119675678,105919,-,-
BAC101_K12,4,4q26,119677767,119770699,92932,-,-
BAC66_G15,4,4q26,119745864,119836213,90349,-,-
BAC74_F10,4,4q26,119793634,119882211,88577,-,-
BAC232_A03,4,4q26,119856392,119958167,101775,-,-
BAC231_F21,4,4q26,119895147,119990543,95396,-,-
BAC109_L08,4,4q26,119949238,120046287,97049,-,-
BAC106_G18,4,4q26,119954872,120046033,91161,-,-
BAC134_P13,4,4q26,119982227,120059883,77656,-,-
BAC168_E09,4,4q26,119990838,120089649,98811,-,-
BAC30_N21,4,4q26,120049222,120165673,116451,-,-
BAC56_K01,4,4q26,120062734,120149038,86304,-,-
BAC42_E01,4,4q26,120149068,120241159,92091,-,-
BAC148_G13,4,4q26,120306659,120395135,88476,-,-
BAC224_B10,4,4q26,120315373,120395085,79712,-,-
BAC135_A18,4,4q26,120468658,120555521,86863,-,-
BAC116_F13,4,4q26-4q27,120501584,120619607,118023,-,-
BAC15_F04,4,4q26-4q27,120501584,120633334,131750,-,-
BAC146_I12,4,4q27,120633403,120713174,79771,-,-
BAC65_E21,4,4q27,120816480,120902304,85824,-,-
BAC25_A08,4,4q27,120827662,120946853,119191,-,-
BAC38_E20,4,4q27,120829659,120928546,98887,-,-
BAC92_H08,4,4q27,120856749,120958448,101699,-,-
BAC196_F18,4,4q27,121093593,121195802,102209,-,-
BAC29_I20,4,4q27,121117002,121129975,12973,-,-
BAC90_C18,4,4q27,121282895,121375922,93027,-,-
BAC64_A10,4,4q27,121282973,121399796,116823,-,-
BAC128_L02,4,4q27,121347348,121435819,88471,-,-
BAC37_O06,4,4q27,121348798,121487602,138804,-,-
BAC83_F07,4,4q27,121436120,121517538,81418,-,-
BAC192_I09,4,4q27,121436120,121527489,91369,-,-
BAC173_I11,4,4q27,121495345,121569771,74426,-,-
BAC221_K14,4,4q27,121631447,121733783,102336,-,-
BAC82_M21,4,4q27,121647211,121793895,146684,-,-
BAC100_L16,4,4q27,121649639,121765955,116316,-,-
BAC34_J01,4,4q27,121666655,121689848,23193,-,-
BAC142_K15,4,4q27,121695419,121706230,10811,-,-
BAC68_H04,4,4q27,122241489,122333127,91638,-,-
BAC173_O23,4,4q27,122328089,122423597,95508,-,-
BAC132_J12,4,4q27,122339919,122423595,83676,-,-
BAC6_P04,4,4q27,122372803,122479027,106224,-,-
BAC149_I09,4,4q27,122655104,122764105,109001,-,-
BAC73_C14,4,4q27,122711723,122826533,114810,-,-
BAC186_G12,4,4q27,122823748,122922123,98375,-,-
BAC235_P10,4,4q27,122828486,122915057,86571,-,-
BAC106_G07,4,4q27,122834914,122927003,92089,-,-
BAC156_A09,4,4q27,122834935,122938163,103228,-,-
BAC121_L21,4,4q27,122927137,123024129,96992,-,-
BAC48_G11,4,4q27,122931314,123024125,92811,-,-
BAC27_O16,4,4q27,122952355,123058190,105835,-,-
BAC224_M20,4,4q27,123249952,123348119,98167,-,-
BAC102_B14,4,4q27,123403503,123420823,17320,-,-
BAC247_H12,4,4q27,123504932,123598108,93176,-,-
BAC162_L23,4,4q27,123585173,123653175,68002,-,-
BAC161_L08,4,4q27,123802825,123885006,82181,-,-
BAC185_K10,4,4q27,123862652,123986008,123356,-,-
BAC143_K15,4,4q27,123888724,123997970,109246,-,-
BAC105_B05,4,4q27,123888730,123981336,92606,-,-
BAC70_P07,4,4q27-4q28.1,123896598,124036664,140066,-,-
BAC57_E19,4,4q27-4q28.1,123924535,124023041,98506,-,-
BAC68_K18,4,4q27-4q28.1,123924562,124036681,112119,-,-
BAC232_P08,4,4q27-4q28.1,123944882,124071132,126250,-,-
BAC185_E18,4,4q28.1,124065518,124174445,108927,-,-
BAC130_E14,4,4q28.1,124076653,124172156,95503,-,-
BAC211_N08,4,4q28.1,124101954,124194375,92421,-,-
BAC122_N09,4,4q28.1,124217223,124331966,114743,-,-
BAC244_P12,4,4q28.1,124226753,124318709,91956,-,-
BAC236_F03,4,4q28.1,124226792,124326701,99909,-,-
BAC120_O02,4,4q28.1,124247683,124346353,98670,-,-
BAC221_M05,4,4q28.1,124297990,124388573,90583,-,-
BAC106_M12,4,4q28.1,124480027,124582162,102135,yes,-
BAC166_F11,4,4q28.1,124487909,124569147,81238,yes,-
BAC123_P23,4,4q28.1,124574595,124678088,103493,-,-
BAC221_J16,4,4q28.1,124622782,124704187,81405,-,-
BAC219_P01,4,4q28.1,124636532,124717129,80597,-,-
BAC120_I01,4,4q28.1,124723500,124816091,92591,-,-
BAC204_J21,4,4q28.1,124744710,124839161,94451,-,-
BAC54_O19,4,4q28.1,124757841,124838737,80896,-,-
BAC176_M09,4,4q28.1,124845937,124939846,93909,-,-
BAC144_H08,4,4q28.1,124945897,125027082,81185,-,-
BAC131_F06,4,4q28.1,124952627,125083145,130518,-,-
BAC63_P04,4,4q28.1,125027405,125109052,81647,-,-
BAC24_A19,4,4q28.1,125050563,125124453,73890,-,-
BAC197_K01,4,4q28.1,125330813,125400377,69564,-,-
BAC226_I19,4,4q28.1,125370591,125460549,89958,-,-
BAC73_F08,4,4q28.1,125371442,125475501,104059,-,-
BAC178_J15,4,4q28.1,125447117,125539246,92129,-,-
BAC140_J12,4,4q28.1,125558751,125643074,84323,-,-
BAC235_E17,4,4q28.1,125608445,125717236,108791,-,-
BAC219_D10,4,4q28.1,125774819,125876805,101986,-,-
BAC141_L20,4,4q28.1,125836027,125928354,92327,-,-
BAC77_E16,4,4q28.1,125851206,125948428,97222,-,-
BAC44_E11,4,4q28.1,125894656,126015076,120420,-,-
BAC179_L06,4,4q28.1,125895700,125982914,87214,-,-
BAC147_P07,4,4q28.1,126108013,126199077,91064,-,-
BAC117_F06,4,4q28.1,126132256,126223968,91712,-,-
BAC184_A03,4,4q28.1,126150987,126244069,93082,-,-
BAC147_I09,4,4q28.1,126178557,126258491,79934,-,-
BAC149_M03,4,4q28.1,126207000,126289376,82376,-,-
BAC45_C18,4,4q28.1,126244093,126337256,93163,-,-
BAC220_K08,4,4q28.1,126244635,126350405,105770,-,-
BAC172_F18,4,4q28.1,126491229,126507356,16127,-,-
BAC247_K04,4,4q28.1,126626048,126711583,85535,-,-
BAC50_E24,4,4q28.1,126697005,126791449,94444,-,-
BAC223_H12,4,4q28.1,126745016,126876715,131699,-,-
BAC241_G04,4,4q28.1,126791513,126868983,77470,-,-
BAC34_N07,4,4q28.1,126833313,126928912,95599,-,-
BAC79_H12,4,4q28.1,126842509,126928915,86406,-,-
BAC31_M17,4,4q28.1,126868976,126978951,109975,-,-
BAC232_H13,4,4q28.1,126869929,126957104,87175,-,-
BAC37_K18,4,4q28.1,126899466,126985069,85603,-,-
BAC10_C01,4,4q28.1,126980457,127069130,88673,-,-
BAC191_P20,4,4q28.1,127062404,127145576,83172,-,-
BAC53_G17,4,4q28.1,127090603,127189021,98418,-,-
BAC70_D12,4,4q28.1,127198294,127294423,96129,-,-
BAC50_K19,4,4q28.1,127227773,127357073,129300,-,-
BAC12_N12,4,4q28.1,127330517,127412298,81781,-,-
BAC14_H21,4,4q28.1,127456428,127547269,90841,-,-
BAC65_E03,4,4q28.1,127552550,127578766,26216,-,-
BAC211_C02,4,4q28.1,127552560,127636932,84372,-,-
BAC69_B21,4,4q28.1,127769409,127858338,88929,-,-
BAC29_A14,4,4q28.1,127895573,127995444,99871,-,-
BAC109_I12,4,4q28.1,128131445,128224161,92716,-,-
BAC51_B10,4,4q28.1,128374298,128461302,87004,-,-
BAC116_L15,4,4q28.1,128451959,128535962,84003,-,-
BAC110_I02,4,4q28.1,128542569,128627591,85022,-,-
BAC121_P19,4,4q28.1,128851515,128951655,100140,-,-
BAC166_H20,4,4q28.1,128895156,128973776,78620,-,-
BAC123_J15,4,4q28.1,128901004,128991832,90828,-,-
BAC95_F05,4,4q28.1-4q28.2,129089113,129104361,15248,-,-
BAC92_B16,4,4q28.1-4q28.2,129093039,129246024,152985,-,-
BAC218_H03,4,4q28.2,129102491,129216105,113614,-,-
BAC236_L08,4,4q28.2,129108403,129189837,81434,-,-
BAC22_K03,4,4q28.2,129161003,129276920,115917,-,-
BAC189_D15,4,4q28.2,129187717,129242635,54918,-,-
BAC110_D05,4,4q28.2,129253097,129358042,104945,-,-
BAC82_J22,4,4q28.2,129261072,129365059,103987,-,-
BAC166_I07,4,4q28.2,129283131,129405453,122322,-,-
BAC59_D18,4,4q28.2,129318863,129419999,101136,-,-
BAC88_J09,4,4q28.2,129358037,129467251,109214,-,-
BAC30_M11,4,4q28.2,129426873,129519492,92619,-,-
BAC197_E07,4,4q28.2,129505188,129589620,84432,-,-
BAC82_J10,4,4q28.2,129516481,129600058,83577,-,-
BAC99_K01,4,4q28.2,129597046,129699110,102064,-,-
BAC15_M21,4,4q28.2,129630823,129716487,85664,-,-
BAC213_M02,4,4q28.2,129630908,129718426,87518,-,-
BAC36_J17,4,4q28.2,129699105,129831138,132033,-,-
BAC134_N21,4,4q28.2,129700282,129804358,104076,-,-
BAC100_N02,4,4q28.2,129718436,129853111,134675,-,-
BAC238_A06,4,4q28.2,129809554,129892488,82934,-,-
BAC48_H17,4,4q28.2,129822863,129840718,17855,-,-
BAC173_B05,4,4q28.2,129978573,130122773,144200,-,-
BAC76_D24,4,4q28.2,130058749,130171507,112758,-,-
BAC252_H09,4,4q28.2,130180642,130326561,145919,-,-
BAC114_J17,4,4q28.2,130203926,130300776,96850,-,-
BAC118_E18,4,4q28.2,130250133,130337099,86966,-,-
BAC52_F01,4,4q28.2,130266982,130371671,104689,-,-
BAC136_G02,4,4q28.2,130266982,130371671,104689,-,-
BAC48_K18,4,4q28.2,130269440,130371661,102221,-,-
BAC191_N01,4,4q28.2,130359894,130440477,80583,-,-
BAC105_K14,4,4q28.2,130418864,130514332,95468,-,-
BAC92_M07,4,4q28.2,130506086,130645263,139177,-,-
BAC137_N08,4,4q28.2,130686255,130801433,115178,-,-
BAC39_I12,4,4q28.2,130755107,130893091,137984,-,-
BAC114_H19,4,4q28.2,131059871,131154571,94700,-,-
BAC59_L02,4,4q28.2,131084928,131206017,121089,-,-
BAC67_B03,4,4q28.2,131169572,131251577,82005,-,-
BAC148_P02,4,4q28.2-4q28.3,131284294,131359134,74840,-,-
BAC53_H19,4,4q28.3,131395755,131489440,93685,-,-
BAC189_G06,4,4q28.3,131425507,131536172,110665,-,-
BAC146_D20,4,4q28.3,131579920,131665725,85805,-,-
BAC132_J22,4,4q28.3,131681187,131892567,211380,-,-
BAC139_A24,4,4q28.3,131742071,131849774,107703,-,-
BAC232_D08,4,4q28.3,131839073,131919585,80512,-,-
BAC127_A14,4,4q28.3,132210937,132304157,93220,-,-
BAC18_I20,4,4q28.3,132210937,132300305,89368,-,-
BAC235_E12,4,4q28.3,132295035,132373715,78680,-,-
BAC162_F07,4,4q28.3,132573638,132662238,88600,-,-
BAC90_E21,4,4q28.3,132687167,132787144,99977,-,-
BAC157_D17,4,4q28.3,132695499,132787144,91645,-,-
BAC71_I19,4,4q28.3,132696439,132789877,93438,-,-
BAC25_O02,4,4q28.3,132923921,133002589,78668,-,-
BAC77_E07,4,4q28.3,133106148,133191076,84928,-,-
BAC81_E22,4,4q28.3,133291862,133436923,145061,-,-
BAC134_E01,4,4q28.3,133307474,133434145,126671,-,-
BAC117_F08,4,4q28.3,133442870,133554369,111499,-,-
BAC191_F04,4,4q28.3,133810725,133893782,83057,-,-
BAC80_K22,4,4q28.3,133859418,133958749,99331,-,-
BAC39_E12,4,4q28.3,133984371,134154929,170558,-,-
BAC166_M09,4,4q28.3,134027861,134106563,78702,-,-
BAC202_P20,4,4q28.3,134027958,134126539,98581,-,-
BAC220_D24,4,4q28.3,134266064,134345943,79879,-,-
BAC198_E03,4,4q28.3,134391943,134470718,78775,-,-
BAC26_J06,4,4q28.3,134405640,134526856,121216,-,-
BAC59_I22,4,4q28.3,134634557,134726393,91836,-,-
BAC100_B15,4,4q28.3,134758443,134889821,131378,-,-
BAC20_E07,4,4q28.3,135098399,135245091,146692,-,-
BAC2_L24,4,4q28.3,135144764,135223879,79115,-,-
BAC224_M12,4,4q28.3,135267909,135412353,144444,-,-
BAC64_P03,4,4q28.3,135305751,135406054,100303,-,-
BAC176_M05,4,4q28.3,135329636,135403831,74195,-,-
BAC120_L11,4,4q28.3,135362902,135445293,82391,-,-
BAC181_C17,4,4q28.3,135416571,135515093,98522,-,-
BAC39_C06,4,4q28.3,135436410,135508563,72153,-,-
BAC240_B21,4,4q28.3,135441541,135529246,87705,-,-
BAC86_H14,4,4q28.3,135609207,135709083,99876,-,-
BAC5_K03,4,4q28.3,135816143,135933979,117836,-,-
BAC38_D03,4,4q28.3,135871297,135971612,100315,-,-
BAC151_F22,4,4q28.3,136186956,136273877,86921,-,-
BAC58_A08,4,4q28.3,136198865,136312359,113494,-,-
BAC150_H16,4,4q28.3,136413293,136501072,87779,-,-
BAC91_D06,4,4q28.3,136419778,136508859,89081,-,-
BAC188_O16,4,4q28.3,136444653,136548743,104090,-,-
BAC51_D12,4,4q28.3,136576868,136667255,90387,-,-
BAC62_P16,4,4q28.3,136752152,136843143,90991,-,-
BAC58_N20,4,4q28.3,137164856,137247610,82754,-,-
BAC97_A05,4,4q28.3,137394213,137486791,92578,-,-
BAC73_J04,4,4q28.3,137413988,137519921,105933,-,-
BAC151_K03,4,4q28.3,137468659,137559490,90831,-,-
BAC37_K01,4,4q28.3,137559511,137676644,117133,-,-
BAC101_K04,4,4q28.3,137651991,137781853,129862,-,-
BAC105_F01,4,4q28.3,137661472,137755996,94524,-,-
BAC31_C14,4,4q28.3,137687944,137774154,86210,-,-
BAC89_C13,4,4q28.3,137764914,137857409,92495,-,-
BAC226_B14,4,4q28.3,138078151,138176256,98105,-,-
BAC23_A14,4,4q28.3,138213454,138289101,75647,-,-
BAC102_K01,4,4q28.3,138233504,138358960,125456,-,-
BAC28_L01,4,4q28.3,138416770,138514880,98110,-,-
BAC80_L20,4,4q28.3,138486335,138575139,88804,-,-
BAC238_B22,4,4q28.3,138727344,138813701,86357,-,-
BAC45_H15,4,4q28.3,138957832,139076013,118181,-,-
BAC84_I18,4,4q28.3,139069261,139168716,99455,-,-
BAC140_M18,4,4q28.3,139168709,139248661,79952,-,-
BAC109_M22,4,4q28.3,139168709,139297999,129290,-,-
BAC31_K08,4,4q28.3,139215026,139297996,82970,-,-
BAC31_P24,4,4q28.3,139221804,139316135,94331,-,-
BAC135_D21,4,4q28.3,139225493,139324790,99297,-,-
BAC243_M01,4,4q28.3,139239827,139320654,80827,-,-
BAC81_N08,4,4q28.3,139239892,139356628,116736,-,-
BAC124_H14,4,4q31.1,139602583,139716002,113419,-,-
BAC242_B07,4,4q31.1,139639218,139724491,85273,-,-
BAC86_F06,4,4q31.1,139645446,139745863,100417,-,-
BAC37_D20,4,4q31.1,139718182,139829851,111669,-,-
BAC143_I16,4,4q31.1,139738543,139788228,49685,-,-
BAC144_H22,4,4q31.1,139766995,139849127,82132,-,-
BAC142_M10,4,4q31.1,139845025,139928972,83947,-,-
BAC168_J03,4,4q31.1,139866913,139941491,74578,-,-
BAC198_C12,4,4q31.1,139906293,139993377,87084,-,-
BAC44_D03,4,4q31.1,140061384,140154602,93218,-,-
BAC166_N12,4,4q31.1,140080959,140198849,117890,-,-
BAC132_P19,4,4q31.1,140107223,140176461,69238,-,-
BAC10_L22,4,4q31.1,140222055,140321288,99233,-,-
BAC137_F12,4,4q31.1,140222078,140321288,99210,-,-
BAC109_M01,4,4q31.1,140226115,140349903,123788,-,-
BAC196_F12,4,4q31.1,140244080,140321288,77208,-,-
BAC75_C18,4,4q31.1,140270147,140385635,115488,-,-
BAC125_B09,4,4q31.1,140305285,140437784,132499,-,-
BAC22_N12,4,4q31.1,140321973,140437244,115271,-,-
BAC27_H14,4,4q31.1,140333779,140437775,103996,-,-
BAC102_H06,4,4q31.1,140350142,140477389,127247,-,-
BAC106_M02,4,4q31.1,140355426,140440723,85297,-,-
BAC165_D10,4,4q31.1,140385636,140477976,92340,-,-
BAC157_G24,4,4q31.1,140385636,140481417,95781,-,-
BAC157_H24,4,4q31.1,140385636,140481417,95781,-,-
BAC224_N14,4,4q31.1,140433430,140502205,68775,-,-
BAC5_A19,4,4q31.1,140450441,140547641,97200,-,-
BAC179_P15,4,4q31.1,140452318,140539478,87160,-,-
BAC126_C16,4,4q31.1,140461143,140546540,85397,-,-
BAC27_K18,4,4q31.1,140574480,140720131,145651,-,-
BAC61_P06,4,4q31.1,140604628,140727738,123110,-,-
BAC99_O24,4,4q31.1,140610009,140692479,82470,-,-
BAC183_C23,4,4q31.1,140613632,140700320,86688,-,-
BAC140_B23,4,4q31.1,140631495,140727736,96241,-,-
BAC143_K06,4,4q31.1,140640027,140745530,105503,-,-
BAC170_K14,4,4q31.1,140648549,140757997,109448,-,-
BAC21_N22,4,4q31.1,140730708,140818490,87782,-,-
BAC86_M23,4,4q31.1,140840087,140955168,115081,-,-
BAC71_C10,4,4q31.1,140857836,140974800,116964,-,-
BAC37_E05,4,4q31.1,140922330,141039965,117635,-,-
BAC69_L20,4,4q31.1,140928088,141045677,117589,-,-
BAC226_D21,4,4q31.1,141028766,141122385,93619,-,-
BAC179_K10,4,4q31.1,141056562,141164187,107625,-,-
BAC45_I01,4,4q31.1,141122570,141272870,150300,-,-
BAC16_G10,4,4q31.1,141129791,141208278,78487,-,-
BAC159_A06,4,4q31.1,141169325,141249740,80415,-,-
BAC151_B03,4,4q31.1,141169325,141250050,80725,-,-
BAC42_F15,4,4q31.1,141211102,141336651,125549,-,-
BAC105_H18,4,4q31.1,141211382,141349653,138271,-,-
BAC179_P21,4,4q31.1,141219100,141329270,110170,-,-
BAC115_O06,4,4q31.1,141292350,141383902,91552,-,-
BAC82_B12,4,4q31.1,141295244,141418274,123030,-,-
BAC108_L09,4,4q31.1,141335461,141460527,125066,-,-
BAC49_F09,4,4q31.1,141335479,141460367,124888,-,-
BAC120_C07,4,4q31.1,141396145,141490753,94608,-,-
BAC128_L04,4,4q31.1,141415491,141425745,10254,-,-
BAC66_K07,4,4q31.1,141425739,141524439,98700,-,-
BAC169_J03,4,4q31.1-4q31.21,141641355,141740546,99191,-,-
BAC129_H15,4,4q31.21,141783486,141912885,129399,-,-
BAC128_M04,4,4q31.21,141814289,141897712,83423,-,-
BAC126_G08,4,4q31.21,141850132,142015767,165635,-,-
BAC122_L14,4,4q31.21,141850132,142015739,165607,-,-
BAC37_E16,4,4q31.21,141851616,141980820,129204,-,-
BAC23_A23,4,4q31.21,141907792,142059433,151641,-,-
BAC239_L21,4,4q31.21,141989076,142067431,78355,-,-
BAC184_H12,4,4q31.21,142090930,142176268,85338,-,-
BAC75_J04,4,4q31.21,142090995,142202922,111927,-,-
BAC22_M07,4,4q31.21,142126107,142186783,60676,-,-
BAC198_O11,4,4q31.21,142272185,142349640,77455,-,-
BAC154_O04,4,4q31.21,142289066,142380089,91023,-,-
BAC234_B19,4,4q31.21,142372129,142447611,75482,-,-
BAC229_C07,4,4q31.21,142380344,142467569,87225,-,-
BAC155_O05,4,4q31.21,142396126,142522115,125989,-,-
BAC50_G02,4,4q31.21,142431667,142584122,152455,-,-
BAC105_D12,4,4q31.21,142598489,142711938,113449,-,-
BAC170_N20,4,4q31.21,142648752,142723534,74782,-,-
BAC190_A09,4,4q31.21,142677371,142807643,130272,-,-
BAC56_C17,4,4q31.21,142800980,142915195,114215,-,-
BAC39_L08,4,4q31.21,142818865,142902128,83263,-,-
BAC24_I01,4,4q31.21,142860458,142951734,91276,-,-
BAC69_B11,4,4q31.21,142904067,143016288,112221,-,-
BAC125_J23,4,4q31.21,143009451,143102518,93067,-,-
BAC180_J23,4,4q31.21,143088321,143178115,89794,-,-
BAC140_L16,4,4q31.21,143088868,143173665,84797,-,-
BAC57_E18,4,4q31.21,143181129,143297845,116716,-,-
BAC56_K18,4,4q31.21,143416558,143554858,138300,-,-
BAC122_O01,4,4q31.21,143453834,143555205,101371,-,-
BAC25_N02,4,4q31.21,143655417,143704778,49361,-,-
BAC68_A12,4,4q31.21,143704776,143762925,58149,-,-
BAC63_G20,4,4q31.21,143762942,143864815,101873,-,-
BAC237_C13,4,4q31.21,143865574,143952089,86515,-,-
BAC241_F19,4,4q31.21,143981818,144067556,85738,-,-
BAC73_C18,4,4q31.21,144079309,144154544,75235,-,-
BAC68_M03,4,4q31.21,144095673,144180289,84616,-,-
BAC42_O24,4,4q31.21,144155679,144291093,135414,-,-
BAC160_C17,4,4q31.21,144274674,144355567,80893,-,-
BAC155_D02,4,4q31.21,144416174,144519232,103058,-,-
BAC73_K09,4,4q31.21,144437695,144533484,95789,-,-
BAC131_D10,4,4q31.21,144519417,144610275,90858,-,-
BAC92_M23,4,4q31.21,144521110,144640758,119648,-,-
BAC157_I18,4,4q31.21,144592141,144681206,89065,-,-
BAC155_N05,4,4q31.21,144640750,144741558,100808,-,-
BAC27_F10,4,4q31.21,144681222,144796425,115203,-,-
BAC198_F06,4,4q31.21,144698547,144797489,98942,-,-
BAC11_G06,4,4q31.21-4q31.22,144923143,145020122,96979,-,-
BAC75_O23,4,4q31.22,145004725,145134168,129443,yes,-
BAC136_G24,4,4q31.22,145006873,145118104,111231,yes,-
BAC156_B19,4,4q31.22,145218808,145308567,89759,-,-
BAC36_K03,4,4q31.22,145221340,145312179,90839,-,-
BAC42_N18,4,4q31.22,145229033,145308567,79534,-,-
BAC6_D13,4,4q31.22,145392895,145470372,77477,-,-
BAC128_G03,4,4q31.22,145392895,145502201,109306,-,-
BAC39_F11,4,4q31.22,145539192,145643331,104139,-,-
BAC126_D04,4,4q31.22,145826431,145938459,112028,-,-
BAC105_I16,4,4q31.22,145917413,146039311,121898,-,-
BAC236_G10,4,4q31.22,145917416,146024669,107253,-,-
BAC27_B15,4,4q31.22,146039330,146130930,91600,-,-
BAC52_N10,4,4q31.22,146095532,146198148,102616,-,-
BAC69_M05,4,4q31.22,146126718,146235250,108532,-,-
BAC96_D19,4,4q31.22,146198143,146285822,87679,-,-
BAC139_O10,4,4q31.22,146275698,146354137,78439,-,-
BAC76_K15,4,4q31.22,146285816,146378132,92316,-,-
BAC127_A03,4,4q31.22,146285844,146400671,114827,-,-
BAC99_D14,4,4q31.22,146285849,146378132,92283,-,-
BAC42_P09,4,4q31.22,146350219,146463602,113383,-,-
BAC178_P08,4,4q31.22,146425407,146519970,94563,-,-
BAC154_N04,4,4q31.22,146454080,146562296,108216,-,-
BAC181_D10,4,4q31.22,146519959,146606519,86560,-,-
BAC169_K03,4,4q31.22,146519963,146594057,74094,-,-
BAC89_C04,4,4q31.22,146596086,146700754,104668,yes,-
BAC37_M01,4,4q31.22,146599475,146695149,95674,-,-
BAC126_P01,4,4q31.22,146613040,146716301,103261,yes,-
BAC71_B12,4,4q31.22,146634078,146752901,118823,-,-
BAC65_M14,4,4q31.22,146736706,146839757,103051,-,-
BAC226_F09,4,4q31.22,146744942,146829479,84537,-,-
BAC96_A06,4,4q31.22,146760229,146845450,85221,-,-
BAC78_H21,4,4q31.22,146767842,146851766,83924,-,-
BAC95_J03,4,4q31.22,146814217,146911778,97561,-,-
BAC159_E05,4,4q31.22,146844091,146933850,89759,-,-
BAC78_I08,4,4q31.22,146845445,146933850,88405,-,-
BAC248_B04,4,4q31.22,146846814,146933850,87036,-,-
BAC218_L13,4,4q31.22,146852131,146933850,81719,-,-
BAC45_F12,4,4q31.22,146911967,147014372,102405,-,-
BAC185_E12,4,4q31.22,146942451,147058635,116184,-,-
BAC24_G06,4,4q31.22,146952884,147048804,95920,-,-
BAC233_K13,4,4q31.22,147014390,147113779,99389,-,-
BAC56_E09,4,4q31.22,147017438,147102063,84625,-,-
BAC54_E01,4,4q31.22,147027653,147172968,145315,-,-
BAC38_H12,4,4q31.22,147107274,147227924,120650,-,-
BAC114_E18,4,4q31.22,147187865,147283979,96114,-,-
BAC144_H01,4,4q31.22,147284789,147371431,86642,-,-
BAC240_H09,4,4q31.22,147299714,147401988,102274,-,-
BAC95_L07,4,4q31.22,147314923,147415597,100674,-,-
BAC64_B01,4,4q31.22,147345757,147461221,115464,-,-
BAC244_K03,4,4q31.22,147354642,147437855,83213,-,-
BAC157_H23,4,4q31.22,147461216,147553063,91847,-,-
BAC102_J22,4,4q31.22,147466905,147558324,91419,-,-
BAC199_L11,4,4q31.22,147476555,147567768,91213,-,-
BAC160_C01,4,4q31.22,147584210,147669287,85077,-,-
BAC78_B21,4,4q31.22,147624338,147645107,20769,-,-
BAC46_K14,4,4q31.22-4q31.23,147641431,147777344,135913,-,-
BAC60_A21,4,4q31.23,147742965,147847435,104470,-,-
BAC58_M12,4,4q31.23,147742965,147879419,136454,-,-
BAC161_J15,4,4q31.23,147797833,147855173,57340,-,-
BAC237_E03,4,4q31.23,147852149,147944254,92105,-,-
BAC6_P11,4,4q31.23,147935404,148040724,105320,-,-
BAC246_N17,4,4q31.23,148117443,148210941,93498,-,-
BAC106_P17,4,4q31.23,148133315,148244415,111100,-,-
BAC182_D08,4,4q31.23,148155155,148253035,97880,-,-
BAC148_D16,4,4q31.23,148162281,148253035,90754,-,-
BAC181_O12,4,4q31.23,148300996,148397118,96122,-,-
BAC106_G12,4,4q31.23,148338778,148453959,115181,-,-
BAC129_F01,4,4q31.23,148446621,148540358,93737,-,-
BAC162_D18,4,4q31.23,148461746,148605095,143349,-,-
BAC109_N09,4,4q31.23,148558894,148640731,81837,-,-
BAC51_H22,4,4q31.23,148567530,148673576,106046,-,-
BAC115_C20,4,4q31.23,148567838,148665084,97246,-,-
BAC46_D10,4,4q31.23,148637933,148770841,132908,-,-
BAC224_E01,4,4q31.23,148744794,148864128,119334,-,-
BAC136_N23,4,4q31.23,148778911,148867513,88602,-,-
BAC89_K09,4,4q31.23,148785551,148864106,78555,-,-
BAC56_F07,4,4q31.23,148819727,148904748,85021,-,-
BAC42_F01,4,4q31.23,148942946,149052451,109505,-,-
BAC121_M23,4,4q31.23,148972083,149093877,121794,-,-
BAC13_P19,4,4q31.23,149006428,149101820,95392,-,-
BAC169_I10,4,4q31.23,149050253,149182147,131894,-,-
BAC116_H05,4,4q31.23,149074858,149202638,127780,-,-
BAC141_I19,4,4q31.23,149110086,149167206,57120,-,-
BAC20_D21,4,4q31.23,149129116,149202635,73519,-,-
BAC5_D24,4,4q31.23,149178554,149273425,94871,-,-
BAC52_M01,4,4q31.23,149203994,149364131,160137,-,-
BAC49_B09,4,4q31.23,149260638,149364083,103445,-,-
BAC186_D19,4,4q31.23,149281356,149373509,92153,-,-
BAC26_H05,4,4q31.23,149314715,149406258,91543,-,-
BAC24_H19,4,4q31.23,149498242,149581558,83316,-,-
BAC81_M02,4,4q31.23,149856036,149953695,97659,-,-
BAC230_A02,4,4q31.23,149864802,149943806,79004,-,-
BAC220_O14,4,4q31.23,149889525,150030851,141326,-,-
BAC34_F16,4,4q31.23,149890350,149979129,88779,-,-
BAC46_C01,4,4q31.23,150068728,150191891,123163,-,-
BAC14_I05,4,4q31.23,150110023,150233876,123853,-,-
BAC81_H15,4,4q31.23,150130921,150282624,151703,-,-
BAC144_B22,4,4q31.23,150200089,150271736,71647,-,-
BAC223_B04,4,4q31.23,150267041,150385165,118124,-,-
BAC143_M11,4,4q31.23,150691692,150768246,76554,-,-
BAC240_E22,4,4q31.23,150782796,150859213,76417,-,-
BAC144_F19,4,4q31.23,150844850,150928459,83609,-,-
BAC79_C08,4,4q31.3,151027628,151160509,132881,-,-
BAC147_C14,4,4q31.3,151066386,151182978,116592,-,-
BAC24_E01,4,4q31.3,151246145,151329506,83361,-,-
BAC104_O08,4,4q31.3,151289263,151405932,116669,-,-
BAC168_F16,4,4q31.3,151403358,151473277,69919,-,-
BAC120_I18,4,4q31.3,151431221,151603053,171832,-,-
BAC82_H17,4,4q31.3,151449726,151545665,95939,-,-
BAC166_H08,4,4q31.3,151645095,151725393,80298,-,-
BAC248_C20,4,4q31.3,151684557,151789125,104568,-,-
BAC69_C06,4,4q31.3,151790837,151919466,128629,-,-
BAC114_P23,4,4q31.3,151796148,151876586,80438,-,-
BAC187_M02,4,4q31.3,151805691,151893432,87741,-,-
BAC175_J04,4,4q31.3,151836375,151911171,74796,-,-
BAC246_D08,4,4q31.3,151948857,152031632,82775,-,-
BAC154_L03,4,4q31.3,151958083,152042797,84714,-,-
BAC37_B20,4,4q31.3,152029907,152112371,82464,-,-
BAC102_N16,4,4q31.3,152092497,152188899,96402,-,-
BAC50_L11,4,4q31.3,152137661,152231133,93472,-,-
BAC108_O18,4,4q31.3,152153438,152262687,109249,-,-
BAC178_D10,4,4q31.3,152202503,152314357,111854,-,-
BAC74_C12,4,4q31.3,152262723,152367014,104291,-,-
BAC169_M19,4,4q31.3,152303775,152444894,141119,-,-
BAC92_A05,4,4q31.3,152616174,152699131,82957,-,-
BAC243_I12,4,4q31.3,152619711,152711722,92011,-,-
BAC172_H17,4,4q31.3,152636927,152737713,100786,-,-
BAC157_N17,4,4q31.3,152669806,152752726,82920,-,-
BAC15_C07,4,4q31.3,152706656,152880382,173726,-,-
BAC40_F01,4,4q31.3,152740856,152880559,139703,-,-
BAC184_I17,4,4q31.3,152752758,152855705,102947,-,-
BAC142_K16,4,4q31.3,152753001,152846837,93836,-,-
BAC22_H20,4,4q31.3,152760748,152938465,177717,-,-
BAC53_G07,4,4q31.3,152809318,152982803,173485,-,-
BAC115_K11,4,4q31.3,152927075,153048803,121728,-,-
BAC48_H07,4,4q31.3,152967215,153067584,100369,-,-
BAC66_B24,4,4q31.3,152986861,153097056,110195,-,-
BAC23_C12,4,4q31.3,152994068,153128169,134101,-,-
BAC141_L05,4,4q31.3,153006247,153118662,112415,-,-
BAC80_D09,4,4q31.3,153007273,153097056,89783,-,-
BAC90_C15,4,4q31.3,153022828,153152140,129312,-,-
BAC146_L19,4,4q31.3,153078055,153164382,86327,-,-
BAC57_J06,4,4q31.3,153124228,153272566,148338,-,-
BAC241_L14,4,4q31.3,153216412,153320289,103877,-,-
BAC228_M02,4,4q31.3,153320284,153396275,75991,-,-
BAC101_P21,4,4q31.3,153360513,153524235,163722,-,-
BAC82_E18,4,4q31.3,153436972,153605438,168466,-,-
BAC143_G10,4,4q31.3,153447522,153533251,85729,-,-
BAC161_H03,4,4q31.3,153457190,153542451,85261,-,-
BAC48_P02,4,4q31.3,153702470,153808626,106156,-,-
BAC141_I14,4,4q31.3,153706277,153777268,70991,-,-
BAC11_C12,4,4q31.3,153777260,153884301,107041,-,-
BAC25_N17,4,4q31.3,153778418,153897230,118812,-,-
BAC233_E10,4,4q31.3,153780215,153860575,80360,-,-
BAC147_L13,4,4q31.3,153786364,153883485,97121,-,-
BAC175_E09,4,4q31.3,153913040,154000105,87065,-,-
BAC126_B12,4,4q31.3,153956080,154075178,119098,-,-
BAC222_I06,4,4q31.3,153992739,154099707,106968,-,-
BAC76_B21,4,4q31.3,154055448,154206301,150853,-,-
BAC173_E09,4,4q31.3,154058735,154137243,78508,-,-
BAC129_I21,4,4q31.3,154060280,154157474,97194,-,-
BAC51_L23,4,4q31.3,154069501,154203594,134093,-,-
BAC74_D04,4,4q31.3,154145408,154248584,103176,-,-
BAC178_I20,4,4q31.3,154161645,154248584,86939,-,-
BAC177_H01,4,4q31.3,154237373,154331697,94324,-,-
BAC140_P16,4,4q31.3,154261190,154351768,90578,-,-
BAC183_G16,4,4q31.3,154288000,154383812,95812,-,-
BAC219_C09,4,4q31.3,154293930,154392417,98487,-,-
BAC21_I16,4,4q31.3,154301214,154418274,117060,-,-
BAC81_D04,4,4q31.3,154328447,154342297,13850,-,-
BAC166_E02,4,4q31.3,154392734,154474309,81575,-,-
BAC97_D02,4,4q31.3,154512469,154658261,145792,-,-
BAC114_J13,4,4q31.3,154514089,154594680,80591,-,-
BAC149_H07,4,4q31.3,154525916,154616001,90085,-,-
BAC229_E08,4,4q31.3,154571723,154665000,93277,-,-
BAC17_H24,4,4q31.3,154571723,154662844,91121,-,-
BAC74_J10,4,4q31.3,154571723,154667047,95324,-,-
BAC135_J05,4,4q31.3,154588409,154709031,120622,-,-
BAC88_J11,4,4q31.3,154629868,154725410,95542,-,-
BAC102_L11,4,4q31.3,154655433,154772139,116706,-,-
BAC88_C10,4,4q31.3,154685557,154806633,121076,-,-
BAC140_G19,4,4q31.3,154702060,154778180,76120,-,-
BAC238_G17,4,4q31.3,154714441,154833198,118757,-,-
BAC97_E09,4,4q31.3,154717440,154828253,110813,-,-
BAC129_A14,4,4q31.3,154809009,154909169,100160,-,-
BAC197_J10,4,4q31.3-4q32.1,154959622,155111138,151516,-,-
BAC248_E13,4,4q31.3-4q32.1,155000218,155127013,126795,-,-
BAC43_I06,4,4q31.3-4q32.1,155046960,155207792,160832,-,-
BAC26_G08,4,4q31.3-4q32.1,155076381,155150560,74179,-,-
BAC110_G15,4,4q31.3-4q32.1,155076409,155207807,131398,-,-
BAC234_F23,4,4q32.1,155263675,155348042,84367,-,-
BAC56_I22,4,4q32.1,155266863,155357900,91037,-,-
BAC175_C20,4,4q32.1,155298339,155407257,108918,-,-
BAC1_P14,4,4q32.1,155346227,155454930,108703,-,-
BAC57_H03,4,4q32.1,155432901,155521570,88669,-,-
BAC90_A17,4,4q32.1,155501513,155606270,104757,-,-
BAC187_E07,4,4q32.1,155509136,155593597,84461,-,-
BAC184_E16,4,4q32.1,155553301,155616031,62730,-,-
BAC42_I10,4,4q32.1,155593613,155698864,105251,-,-
BAC124_M01,4,4q32.1,155604520,155745954,141434,-,-
BAC32_D16,4,4q32.1,155606541,155698549,92008,-,-
BAC97_O20,4,4q32.1,155696402,155824543,128141,-,-
BAC45_N01,4,4q32.1,155734378,155825282,90904,-,-
BAC157_P24,4,4q32.1,155742570,155825282,82712,-,-
BAC84_G10,4,4q32.1,155751308,155850277,98969,-,-
BAC46_G10,4,4q32.1,155759952,155811217,51265,-,-
BAC233_I20,4,4q32.1,156177799,156270527,92728,-,-
BAC39_O03,4,4q32.1,156185125,156297551,112426,-,-
BAC59_K12,4,4q32.1,156201539,156336406,134867,-,-
BAC197_B20,4,4q32.1,156230074,156318041,87967,-,-
BAC74_H12,4,4q32.1,156230078,156318041,87963,-,-
BAC24_N23,4,4q32.1,156336702,156475747,139045,-,-
BAC82_K03,4,4q32.1,156561103,156662626,101523,-,-
BAC192_D04,4,4q32.1,156663717,156729635,65918,-,-
BAC122_E23,4,4q32.1,156751189,156867702,116513,-,-
BAC143_L06,4,4q32.1,156895102,156956061,60959,-,-
BAC170_E03,4,4q32.1,156967612,157061350,93738,-,-
BAC242_G03,4,4q32.1,157033312,157106996,73684,yes,-
BAC21_K19,4,4q32.1,157061380,157117424,56044,yes,-
BAC226_H08,4,4q32.1,157570091,157642888,72797,-,-
BAC233_J10,4,4q32.1,157624659,157708950,84291,-,-
BAC97_M07,4,4q32.1,157705462,157843265,137803,-,-
BAC72_K06,4,4q32.1,157778729,157885094,106365,-,-
BAC95_H17,4,4q32.1,157831745,157938350,106605,-,-
BAC41_O11,4,4q32.1,157831745,157956901,125156,-,-
BAC64_J08,4,4q32.1,158210685,158302740,92055,-,-
BAC96_C19,4,4q32.1,158234734,158326676,91942,-,-
BAC38_L19,4,4q32.1,158234736,158327766,93030,-,-
BAC168_O15,4,4q32.1,158280981,158386161,105180,-,-
BAC100_L21,4,4q32.1,158621141,158715996,94855,-,-
BAC196_N15,4,4q32.1,158715478,158824875,109397,-,-
BAC22_P05,4,4q32.1,158899791,158995061,95270,-,-
BAC139_E09,4,4q32.1,158909282,158987205,77923,-,-
BAC227_O13,4,4q32.1,158963191,158980974,17783,-,-
BAC33_K02,4,4q32.1,159017810,159154557,136747,-,-
BAC130_H20,4,4q32.1,159301921,159439126,137205,-,-
BAC52_N18,4,4q32.1,159376217,159480419,104202,-,-
BAC160_J08,4,4q32.1,159384736,159488568,103832,-,-
BAC146_H19,4,4q32.1,159494306,159575014,80708,-,-
BAC188_J04,4,4q32.1,159670854,159778998,108144,-,-
BAC72_C04,4,4q32.1,159675629,159775225,99596,-,-
BAC121_A20,4,4q32.1,159690841,159788616,97775,-,-
BAC139_G16,4,4q32.1,159754900,159844889,89989,-,-
BAC20_K21,4,4q32.1,159840573,159932974,92401,-,-
BAC248_H15,4,4q32.1,159851507,159946483,94976,-,-
BAC233_O03,4,4q32.1,160009404,160069283,59879,-,-
BAC108_I04,4,4q32.1,160013017,160107376,94359,-,-
BAC36_D01,4,4q32.1,160056195,160166699,110504,-,-
BAC37_L17,4,4q32.1,160056418,160172890,116472,-,-
BAC192_D17,4,4q32.1,160166693,160274881,108188,-,-
BAC161_B06,4,4q32.1,160170576,160247166,76590,-,-
BAC92_N13,4,4q32.1,160172884,160351228,178344,-,-
BAC57_M18,4,4q32.1,160195690,160355205,159515,-,-
BAC37_B07,4,4q32.1,160211070,160299635,88565,-,-
BAC52_B13,4,4q32.1,160211070,160292334,81264,-,-
BAC37_E01,4,4q32.1,160286666,160423971,137305,-,-
BAC239_A04,4,4q32.1,160342316,160427524,85208,-,-
BAC60_E22,4,4q32.1,160455373,160554142,98769,-,-
BAC36_G23,4,4q32.1,160541635,160638541,96906,-,-
BAC5_I23,4,4q32.1,160555414,160638546,83132,-,-
BAC92_B22,4,4q32.1,160760603,160862345,101742,-,-
BAC23_D07,4,4q32.1,161101235,161206606,105371,-,-
BAC30_O16,4,4q32.1,161182037,161270214,88177,-,-
BAC243_L09,4,4q32.1,161250005,161336765,86760,-,-
BAC215_C02,4,4q32.1,161386968,161482200,95232,-,-
BAC38_P21,4,4q32.1-4q32.2,161446647,161535608,88961,-,-
BAC166_B20,4,4q32.1-4q32.2,161482450,161561988,79538,-,-
BAC149_N23,4,4q32.2,161516293,161629898,113605,-,-
BAC196_I02,4,4q32.2,161525817,161649242,123425,-,-
BAC25_L07,4,4q32.2,161647704,161777122,129418,-,-
BAC241_B17,4,4q32.2,161789571,161881031,91460,-,-
BAC166_P02,4,4q32.2,161867296,161949731,82435,-,-
BAC96_D22,4,4q32.2,161885150,161977909,92759,-,-
BAC57_K20,4,4q32.2,162276396,162398346,121950,-,-
BAC204_G08,4,4q32.2,162357146,162456133,98987,-,-
BAC15_D06,4,4q32.2,162416118,162510711,94593,-,-
BAC199_D06,4,4q32.2,162565146,162634622,69476,-,-
BAC28_B19,4,4q32.2,162569773,162660231,90458,-,-
BAC17_C12,4,4q32.2,162766018,162870561,104543,-,-
BAC65_I01,4,4q32.2,162793765,162908107,114342,-,-
BAC185_L05,4,4q32.2,162894264,162971376,77112,-,-
BAC4_F22,4,4q32.2,162911940,162997646,85706,-,-
BAC106_B14,4,4q32.2,162957192,163062090,104898,-,-
BAC125_O13,4,4q32.2,162957683,163072996,115313,-,-
BAC89_D11,4,4q32.2,163011517,163103331,91814,-,-
BAC33_G13,4,4q32.2,163056639,163154986,98347,-,-
BAC186_J15,4,4q32.2,163073165,163178948,105783,-,-
BAC118_F17,4,4q32.2,163156888,163243161,86273,-,-
BAC48_G08,4,4q32.2,163264766,163367105,102339,-,-
BAC76_H01,4,4q32.2,163346275,163424837,78562,-,-
BAC102_P20,4,4q32.2,163453688,163555409,101721,-,-
BAC104_K02,4,4q32.2,163506127,163611419,105292,-,-
BAC49_J06,4,4q32.2,163588958,163677094,88136,-,-
BAC146_P14,4,4q32.2,163681795,163791292,109497,-,-
BAC108_N02,4,4q32.2,163911216,164007163,95947,-,-
BAC69_A16,4,4q32.2,163948050,164094160,146110,-,-
BAC27_N07,4,4q32.2,164145398,164249710,104312,-,-
BAC101_D19,4,4q32.2,164170100,164296036,125936,-,-
BAC67_B22,4,4q32.2,164173596,164268915,95319,-,-
BAC234_M16,4,4q32.2,164188715,164275447,86732,-,-
BAC233_D10,4,4q32.2,164194567,164275787,81220,-,-
BAC86_M14,4,4q32.2,164206746,164308644,101898,-,-
BAC36_P20,4,4q32.3,164560759,164748390,187631,-,-
BAC4_L24,4,4q32.3,164565116,164645096,79980,-,-
BAC86_H10,4,4q32.3,164571392,164696807,125415,-,-
BAC143_H08,4,4q32.3,164643883,164715876,71993,-,-
BAC52_H11,4,4q32.3,164648664,164751445,102781,-,-
BAC144_B10,4,4q32.3,164804042,164887250,83208,-,-
BAC199_F14,4,4q32.3,164910809,165005763,94954,-,-
BAC44_D18,4,4q32.3,164972525,165077141,104616,-,-
BAC11_C16,4,4q32.3,165108629,165214842,106213,-,-
BAC67_M17,4,4q32.3,165114926,165237473,122547,-,-
BAC119_J07,4,4q32.3,165141133,165230446,89313,-,-
BAC142_I22,4,4q32.3,165260138,165347089,86951,-,-
BAC67_G07,4,4q32.3,165476532,165567505,90973,-,-
BAC184_E22,4,4q32.3,165634989,165727004,92015,-,-
BAC58_I24,4,4q32.3,165634989,165799126,164137,-,-
BAC162_N23,4,4q32.3,165636313,165738602,102289,-,-
BAC165_D21,4,4q32.3,165818387,165910917,92530,-,-
BAC142_K14,4,4q32.3,165887371,165978728,91357,-,-
BAC116_L14,4,4q32.3,165898791,165994221,95430,-,-
BAC170_A24,4,4q32.3,165902778,166037840,135062,-,-
BAC237_I02,4,4q32.3,165946132,166036587,90455,-,-
BAC41_M09,4,4q32.3,165973780,166075449,101669,-,-
BAC35_G08,4,4q32.3,165994271,166117433,123162,-,-
BAC158_O03,4,4q32.3,166023676,166104886,81210,-,-
BAC226_B10,4,4q32.3,166047979,166140307,92328,-,-
BAC135_C17,4,4q32.3,166081797,166163016,81219,-,-
BAC117_K13,4,4q32.3,166104964,166246930,141966,-,-
BAC82_L06,4,4q32.3,166118494,166205471,86977,-,-
BAC66_G09,4,4q32.3,166130232,166233257,103025,-,-
BAC165_F08,4,4q32.3,166163280,166255275,91995,-,-
BAC153_N09,4,4q32.3,166166403,166233257,66854,-,-
BAC2_A14,4,4q32.3,166187652,166284345,96693,-,-
BAC217_C21,4,4q32.3,166187652,166291599,103947,-,-
BAC29_O21,4,4q32.3,166205479,166353332,147853,-,-
BAC169_L19,4,4q32.3,166266055,166353332,87277,-,-
BAC41_C10,4,4q32.3,166272413,166386287,113874,-,-
BAC227_P22,4,4q32.3,166284620,166378771,94151,-,-
BAC153_B11,4,4q32.3,166284620,166386287,101667,-,-
BAC141_H17,4,4q32.3,166381777,166466832,85055,-,-
BAC184_B20,4,4q32.3,166386304,166466832,80528,-,-
BAC189_L17,4,4q32.3,166411293,166577921,166628,-,-
BAC85_P03,4,4q32.3,166434294,166526042,91748,-,-
BAC38_H15,4,4q32.3,166617481,166718679,101198,-,-
BAC169_F02,4,4q32.3,166672221,166751858,79637,-,-
BAC243_F17,4,4q32.3,166682452,166774454,92002,-,-
BAC226_O17,4,4q32.3,166840418,166940871,100453,-,-
BAC34_P20,4,4q32.3,166897283,167056623,159340,-,-
BAC188_J22,4,4q32.3,166960279,167056625,96346,-,-
BAC154_O23,4,4q32.3,166960963,167062056,101093,-,-
BAC135_B10,4,4q32.3,167012470,167085641,73171,-,-
BAC178_M13,4,4q32.3,167260189,167298338,38149,-,-
BAC80_I21,4,4q32.3,167298472,167396996,98524,-,-
BAC125_C03,4,4q32.3,167321825,167413189,91364,-,-
BAC32_C20,4,4q32.3,167946038,168033021,86983,-,-
BAC148_N14,4,4q32.3,168056142,168166742,110600,-,-
BAC56_L02,4,4q32.3,168066962,168156056,89094,-,-
BAC222_E19,4,4q32.3,168477249,168555231,77982,-,-
BAC146_H09,4,4q32.3,168509341,168590765,81424,-,-
BAC145_L07,4,4q32.3,168590074,168674440,84366,-,-
BAC221_M04,4,4q32.3,168674458,168736785,62327,-,-
BAC150_H17,4,4q32.3,168737071,168816141,79070,-,-
BAC166_J08,4,4q32.3,169003225,169113726,110501,-,-
BAC113_J12,4,4q32.3,169030063,169146054,115991,-,-
BAC44_M06,4,4q32.3,169113223,169252162,138939,-,-
BAC232_B15,4,4q32.3,169250469,169361272,110803,-,-
BAC27_B22,4,4q32.3,169415870,169537086,121216,-,-
BAC218_P12,4,4q32.3,169500883,169583414,82531,-,-
BAC232_M23,4,4q32.3,169501497,169515808,14311,-,-
BAC23_D12,4,4q32.3,169776154,169859702,83548,-,-
BAC134_M16,4,4q32.3,169792289,169870914,78625,-,-
BAC162_O05,4,4q32.3,169792809,169896604,103795,-,-
BAC191_B22,4,4q32.3,169823717,169936199,112482,-,-
BAC32_M09,4,4q32.3,169853874,169976768,122894,-,-
BAC10_K14,4,4q32.3,169858211,169981712,123501,-,-
BAC172_B13,4,4q32.3,169859966,169945541,85575,-,-
BAC125_O08,4,4q32.3,169894674,169991227,96553,-,-
BAC157_P10,4,4q32.3,169969985,170078568,108583,-,-
BAC175_P23,4,4q32.3,169994398,170078550,84152,-,-
BAC142_I13,4,4q32.3,169994398,170071414,77016,-,-
BAC150_A18,4,4q32.3,170000101,170088036,87935,-,-
BAC44_M07,4,4q32.3,170002900,170153661,150761,-,-
BAC49_P05,4,4q32.3,170101042,170253980,152938,-,-
BAC121_E23,4,4q32.3,170131919,170214249,82330,-,-
BAC108_G16,4,4q32.3,170162492,170287494,125002,-,-
BAC196_N03,4,4q32.3,170230101,170331138,101037,-,-
BAC217_M11,4,4q32.3,170257272,170347391,90119,-,-
BAC85_E09,4,4q32.3-4q33,170378453,170479105,100652,-,-
BAC88_M07,4,4q33,170486992,170618064,131072,-,-
BAC123_M16,4,4q33,170498212,170592456,94244,-,-
BAC134_P17,4,4q33,170629918,170740271,110353,-,-
BAC70_N12,4,4q33,170639559,170765636,126077,-,-
BAC31_B01,4,4q33,170799398,170916755,117357,-,-
BAC101_F01,4,4q33,170881370,170967435,86065,-,-
BAC241_B13,4,4q33,170886267,170965529,79262,-,-
BAC150_P23,4,4q33,170899083,170993012,93929,-,-
BAC108_B15,4,4q33,170915455,171014894,99439,-,-
BAC155_D22,4,4q33,170961218,171074814,113596,-,-
BAC189_N19,4,4q33,170994279,171073102,78823,-,-
BAC197_K04,4,4q33,171008341,171089130,80789,-,-
BAC37_J11,4,4q33,171008345,171153515,145170,-,-
BAC2_K21,4,4q33,171047822,171153459,105637,-,-
BAC25_M22,4,4q33,171091083,171182673,91590,-,-
BAC186_H05,4,4q33,171094453,171183256,88803,-,-
BAC168_B17,4,4q33,171103221,171183253,80032,-,-
BAC187_K13,4,4q33,171151852,171264017,112165,-,-
BAC217_O12,4,4q33,171153553,171242525,88972,-,-
BAC222_N11,4,4q33,171239311,171332563,93252,-,-
BAC113_N09,4,4q33,171252432,171332564,80132,-,-
BAC248_C08,4,4q33,171290830,171368629,77799,-,-
BAC134_K11,4,4q33,171346990,171440542,93552,-,-
BAC192_J16,4,4q33,171569710,171661951,92241,-,-
BAC170_N16,4,4q33,171569713,171598567,28854,-,-
BAC95_N09,4,4q33,171573668,171667619,93951,-,-
BAC144_N11,4,4q33,171671878,171758192,86314,-,-
BAC175_G08,4,4q33,171676320,171764111,87791,-,-
BAC129_F15,4,4q33,172029832,172117585,87753,-,-
BAC162_P10,4,4q33-4q34.1,172142860,172233803,90943,-,-
BAC124_M19,4,4q33-4q34.1,172192608,172292761,100153,-,-
BAC34_L02,4,4q34.1,172212128,172319968,107840,-,-
BAC59_L15,4,4q34.1,172358642,172466570,107928,-,-
BAC92_B05,4,4q34.1,172412823,172511546,98723,-,-
BAC107_O04,4,4q34.1,172457839,172554623,96784,-,-
BAC162_G12,4,4q34.1,172701312,172798831,97519,-,-
BAC39_A14,4,4q34.1,172778957,172873801,94844,-,-
BAC104_N08,4,4q34.1,173067365,173178007,110642,-,-
BAC8_F13,4,4q34.1,173158288,173268750,110462,-,-
BAC59_M23,4,4q34.1,173284736,173408735,123999,-,-
BAC27_M13,4,4q34.1,173341095,173435609,94514,-,-
BAC163_M15,4,4q34.1,173423695,173536691,112996,-,-
BAC161_D07,4,4q34.1,173485872,173574656,88784,-,-
BAC246_K09,4,4q34.1,173544525,173632650,88125,-,-
BAC132_A08,4,4q34.1,173634215,173739526,105311,-,-
BAC127_C13,4,4q34.1,173695153,173794052,98899,-,-
BAC202_E14,4,4q34.1,173695471,173797482,102011,-,-
BAC8_A03,4,4q34.1,173820998,173959317,138319,-,-
BAC169_M18,4,4q34.1,173883541,173973754,90213,-,-
BAC128_M10,4,4q34.1,173958943,174087222,128279,-,-
BAC12_F10,4,4q34.1,174085240,174216067,130827,-,-
BAC78_D15,4,4q34.1,174151205,174238909,87704,-,-
BAC116_D15,4,4q34.1,174268316,174385895,117579,-,-
BAC144_E04,4,4q34.1,174269454,174363896,94442,-,-
BAC86_O16,4,4q34.1,174296563,174385895,89332,-,-
BAC82_K21,4,4q34.1,174320793,174411929,91136,-,-
BAC84_K24,4,4q34.1,174323054,174411929,88875,-,-
BAC150_A11,4,4q34.1,174329176,174436626,107450,-,-
BAC176_O21,4,4q34.1,174329176,174438692,109516,-,-
BAC106_H24,4,4q34.1,174363889,174460127,96238,-,-
BAC48_C08,4,4q34.1,174411927,174555394,143467,-,-
BAC90_M02,4,4q34.1,174444630,174532430,87800,-,-
BAC96_C12,4,4q34.1,174488338,174589261,100923,-,-
BAC238_N19,4,4q34.1,174560328,174671433,111105,-,-
BAC162_C21,4,4q34.1,174625526,174706091,80565,-,-
BAC129_H12,4,4q34.1,174634851,174737354,102503,-,-
BAC68_J02,4,4q34.1,174644784,174727716,82932,-,-
BAC167_D02,4,4q34.1,174681053,174790130,109077,-,-
BAC131_L07,4,4q34.1,174737870,174849251,111381,-,-
BAC61_G17,4,4q34.1,174759646,174825453,65807,-,-
BAC165_H12,4,4q34.1,174903979,174985923,81944,-,-
BAC55_P16,4,4q34.1,174921516,175015975,94459,-,-
BAC81_B07,4,4q34.1,175004416,175088365,83949,-,-
BAC167_F15,4,4q34.1,175040115,175125314,85199,-,-
BAC226_G16,4,4q34.1,175218503,175310083,91580,-,-
BAC55_K19,4,4q34.1,175527465,175544974,17509,-,-
BAC51_C08,4,4q34.1,175542836,175642005,99169,-,-
BAC49_L22,4,4q34.1,175844099,175933491,89392,-,-
BAC117_O12,4,4q34.1,175858869,176006087,147218,-,-
BAC228_A16,4,4q34.1,175976076,176066883,90807,-,-
BAC194_K08,4,4q34.1,176066905,176152202,85297,-,-
BAC29_O06,4,4q34.1,176079533,176172426,92893,-,-
BAC42_B09,4,4q34.1,176179233,176252539,73306,-,-
BAC50_I06,4,4q34.1,176232692,176334517,101825,-,-
BAC43_C06,4,4q34.1,176232708,176356691,123983,-,-
BAC16_M10,4,4q34.1,176283435,176382262,98827,-,-
BAC67_J19,4,4q34.2,176624037,176762432,138395,-,-
BAC154_D07,4,4q34.2,176693212,176765572,72360,-,-
BAC169_H13,4,4q34.2,176852742,176945196,92454,-,-
BAC154_P19,4,4q34.2,176852746,176967871,115125,-,-
BAC52_O24,4,4q34.2,176884717,176967515,82798,-,-
BAC131_G13,4,4q34.2,176967865,177060571,92706,-,-
BAC124_J18,4,4q34.2,177011829,177102290,90461,-,-
BAC69_L06,4,4q34.2,177084870,177175519,90649,-,-
BAC247_E04,4,4q34.2,177086605,177181315,94710,-,-
BAC73_E11,4,4q34.2,177142196,177252696,110500,-,-
BAC1_B08,4,4q34.2,177277146,177390726,113580,-,-
BAC28_C10,4,4q34.2,177288056,177378260,90204,-,-
BAC69_N13,4,4q34.2,177329794,177426097,96303,-,-
BAC137_D13,4,4q34.2,177397474,177499243,101769,-,-
BAC146_B08,4,4q34.2,177400178,177488889,88711,-,-
BAC141_A10,4,4q34.2,177414299,177491187,76888,-,-
BAC192_I13,4,4q34.2,177484773,177573422,88649,-,-
BAC172_B06,4,4q34.2,177495363,177598218,102855,-,-
BAC58_F10,4,4q34.2,177513475,177600154,86679,-,-
BAC193_O05,4,4q34.2,177538785,177623927,85142,-,-
BAC23_N11,4,4q34.2,177539765,177623927,84162,-,-
BAC177_C23,4,4q34.2,177571501,177677761,106260,-,-
BAC108_J13,4,4q34.2,177651249,177729484,78235,-,-
BAC195_I16,4,4q34.2,177660649,177733240,72591,-,-
BAC230_F21,4,4q34.2,177701982,177774009,72027,-,-
BAC152_C21,4,4q34.2-4q34.3,177733254,177839113,105859,-,-
BAC8_G13,4,4q34.3,178024164,178125869,101705,-,-
BAC78_L03,4,4q34.3,178096258,178201363,105105,-,-
BAC150_G03,4,4q34.3,178101456,178223289,121833,-,-
BAC173_L11,4,4q34.3,178147052,178236242,89190,-,-
BAC252_L16,4,4q34.3,178236470,178405252,168782,-,-
BAC115_N19,4,4q34.3,178375851,178502546,126695,-,-
BAC153_C08,4,4q34.3,178682082,178765844,83762,-,-
BAC200_F06,4,4q34.3,178777676,178880339,102663,-,-
BAC200_O15,4,4q34.3,178792224,178880338,88114,-,-
BAC186_P08,4,4q34.3,178799008,178907035,108027,-,-
BAC60_F15,4,4q34.3,178887333,178989074,101741,-,-
BAC63_M09,4,4q34.3,178891877,178963218,71341,-,-
BAC92_J03,4,4q34.3,178947629,179043489,95860,-,-
BAC22_F21,4,4q34.3,178989091,179108795,119704,-,-
BAC217_I06,4,4q34.3,179109067,179226579,117512,-,-
BAC146_P01,4,4q34.3,179155218,179235188,79970,-,-
BAC152_I08,4,4q34.3,179379695,179501518,121823,-,-
BAC154_B03,4,4q34.3,179400894,179486446,85552,-,-
BAC108_I18,4,4q34.3,179451374,179480139,28765,-,-
BAC83_J21,4,4q34.3,179516651,179714651,198000,-,-
BAC171_N13,4,4q34.3,179544305,179649651,105346,-,-
BAC84_K22,4,4q34.3,179636167,179735104,98937,-,-
BAC126_G09,4,4q34.3,179711475,179802149,90674,-,-
BAC122_J12,4,4q34.3,179711490,179802149,90659,-,-
BAC83_G22,4,4q34.3,179732499,179912660,180161,-,-
BAC101_C20,4,4q34.3,179732499,179821188,88689,-,-
BAC135_P03,4,4q34.3,179780868,179870781,89913,-,-
BAC224_O08,4,4q34.3,179816209,179911325,95116,-,-
BAC17_F06,4,4q34.3,179818997,179938500,119503,-,-
BAC2_K08,4,4q34.3,179980260,180073715,93455,-,-
BAC101_J08,4,4q34.3,180038330,180156700,118370,-,-
BAC89_G11,4,4q34.3,180073712,180156254,82542,-,-
BAC51_N07,4,4q34.3,180225463,180320841,95378,-,-
BAC75_I10,4,4q34.3,180230193,180345030,114837,-,-
BAC80_I23,4,4q34.3,180235520,180368792,133272,-,-
BAC72_C03,4,4q34.3,180260229,180373793,113564,-,-
BAC91_O24,4,4q34.3,180394645,180480357,85712,-,-
BAC27_N02,4,4q34.3,180441156,180567081,125925,-,-
BAC163_H07,4,4q34.3,180539191,180592402,53211,-,-
BAC58_N13,4,4q34.3,180567092,180684105,117013,-,-
BAC100_O11,4,4q34.3,180671749,180770039,98290,-,-
BAC105_N15,4,4q34.3,180684599,180774191,89592,-,-
BAC57_K04,4,4q34.3,180752818,180842612,89794,-,-
BAC86_D04,4,4q34.3,180816726,180887370,70644,-,-
BAC53_K16,4,4q34.3,180849720,180940044,90324,-,-
BAC37_O09,4,4q34.3,180854749,180946584,91835,-,-
BAC202_O24,4,4q34.3,181003494,181086668,83174,-,-
BAC36_G15,4,4q34.3,181016674,181104682,88008,-,-
BAC123_G03,4,4q34.3,181512469,181608194,95725,-,-
BAC56_L22,4,4q34.3,181527870,181719297,191427,-,-
BAC54_N12,4,4q34.3,181528188,181619330,91142,-,-
BAC188_K16,4,4q34.3,181574645,181699675,125030,-,-
BAC167_A05,4,4q34.3,181593064,181702228,109164,-,-
BAC234_H21,4,4q34.3,181814619,181921046,106427,-,-
BAC28_M12,4,4q34.3,181864053,181958366,94313,-,-
BAC152_D10,4,4q34.3,181972558,182059407,86849,-,-
BAC137_O11,4,4q34.3,182223403,182326211,102808,-,-
BAC173_O16,4,4q34.3,182274045,182370716,96671,-,-
BAC81_H10,4,4q34.3,182308653,182426829,118176,-,-
BAC65_C02,4,4q34.3,182329326,182419725,90399,-,-
BAC14_O10,4,4q34.3,182371674,182499638,127964,-,-
BAC160_D11,4,4q34.3,182485709,182565325,79616,-,-
BAC160_B02,4,4q34.3-4q35.1,182565451,182650060,84609,-,-
BAC76_N08,4,4q35.1,182651953,182765173,113220,-,-
BAC58_A02,4,4q35.1,182651953,182754477,102524,-,-
BAC116_P07,4,4q35.1,182822269,182916833,94564,-,-
BAC249_B14,4,4q35.1,182827290,182922611,95321,-,-
BAC176_E07,4,4q35.1,182843970,182929577,85607,-,-
BAC128_P19,4,4q35.1,182843987,182929577,85590,-,-
BAC183_J03,4,4q35.1,182857627,182947947,90320,-,-
BAC123_B23,4,4q35.1,183003114,183124114,121000,-,-
BAC103_D14,4,4q35.1,183088951,183217432,128481,-,-
BAC243_J14,4,4q35.1,183205161,183280936,75775,-,-
BAC12_A17,4,4q35.1,183281532,183409045,127513,-,-
BAC176_P03,4,4q35.1,183331624,183419424,87800,-,-
BAC218_G22,4,4q35.1,183419417,183503756,84339,-,-
BAC63_G02,4,4q35.1,183470958,183570913,99955,-,-
BAC205_B20,4,4q35.1,183613466,183696011,82545,-,-
BAC200_N18,4,4q35.1,183689784,183783892,94108,-,-
BAC157_D11,4,4q35.1,183696245,183794863,98618,-,-
BAC123_E21,4,4q35.1,183822715,183918880,96165,-,-
BAC176_I12,4,4q35.1,183823308,183907181,83873,-,-
BAC71_M02,4,4q35.1,183959421,184073470,114049,-,-
BAC172_P09,4,4q35.1,183960731,184121890,161159,-,-
BAC197_P17,4,4q35.1,184066372,184160672,94300,-,-
BAC55_B01,4,4q35.1,184087536,184190191,102655,-,-
BAC180_A03,4,4q35.1,184092757,184204425,111668,-,-
BAC60_P03,4,4q35.1,184183031,184279931,96900,-,-
BAC236_A14,4,4q35.1,184193385,184279934,86549,-,-
BAC86_B10,4,4q35.1,184195163,184275772,80609,-,-
BAC50_M01,4,4q35.1,184386557,184482118,95561,-,-
BAC36_F03,4,4q35.1,184406827,184532239,125412,-,-
BAC63_L04,4,4q35.1,184423547,184543147,119600,-,-
BAC127_C16,4,4q35.1,184423547,184513054,89507,-,-
BAC135_N21,4,4q35.1,184427630,184537299,109669,-,-
BAC115_H06,4,4q35.1,184477246,184562023,84777,-,-
BAC211_I08,4,4q35.1,184477290,184563119,85829,-,-
BAC221_H03,4,4q35.1,184479618,184553736,74118,-,-
BAC29_G19,4,4q35.1,184479698,184568268,88570,-,-
BAC141_H18,4,4q35.1,184483174,184563119,79945,-,-
BAC78_G01,4,4q35.1,184517122,184606000,88878,-,-
BAC78_D09,4,4q35.1,184562014,184665553,103539,-,-
BAC32_B06,4,4q35.1,184562014,184665066,103052,-,-
BAC248_N22,4,4q35.1,184562407,184654281,91874,-,-
BAC153_A08,4,4q35.1,184568256,184665555,97299,-,-
BAC123_H20,4,4q35.1,184599325,184703085,103760,-,-
BAC156_J17,4,4q35.1,184715331,184819298,103967,-,-
BAC53_G06,4,4q35.1,184751590,184866730,115140,-,-
BAC159_E08,4,4q35.1,184754524,184848687,94163,-,-
BAC105_D04,4,4q35.1,184754524,184833601,79077,-,-
BAC55_F23,4,4q35.1,184843046,184943841,100795,-,-
BAC106_I17,4,4q35.1,184848684,184942382,93698,-,-
BAC75_F06,4,4q35.1,185017277,185160813,143536,-,-
BAC192_F09,4,4q35.1,185046473,185192608,146135,-,-
BAC155_E20,4,4q35.1,185046481,185170057,123576,-,-
BAC134_H23,4,4q35.1,185079865,185170059,90194,-,-
BAC11_P01,4,4q35.1,185087108,185223109,136001,-,-
BAC103_D15,4,4q35.1,185099119,185215099,115980,-,-
BAC226_P14,4,4q35.1,185099123,185197801,98678,-,-
BAC188_B15,4,4q35.1,185142953,185219796,76843,-,-
BAC122_F07,4,4q35.1,185170053,185277253,107200,-,-
BAC128_C19,4,4q35.1,185226370,185436783,210413,-,-
BAC190_L01,4,4q35.1,185276298,185411984,135686,-,-
BAC112_P01,4,4q35.1,185313806,185436783,122977,-,-
BAC226_O09,4,4q35.1,185342521,185445356,102835,-,-
BAC175_P16,4,4q35.1,185352088,185437802,85714,-,-
BAC140_F12,4,4q35.1,185375167,185482360,107193,-,-
BAC95_M23,4,4q35.1,185379242,185518305,139063,-,-
BAC122_O19,4,4q35.1,185385131,185499743,114612,-,-
BAC111_E03,4,4q35.1,185388195,185482208,94013,-,-
BAC252_P14,4,4q35.1,185495978,185625777,129799,-,-
BAC26_C20,4,4q35.1,185539172,185642548,103376,-,-
BAC97_B06,4,4q35.1,185546395,185673108,126713,-,-
BAC154_K19,4,4q35.1,185551479,185659826,108347,-,-
BAC184_I13,4,4q35.1,185555289,185640202,84913,-,-
BAC183_J20,4,4q35.1,185579894,185676800,96906,-,-
BAC65_D23,4,4q35.1,185579894,185676716,96822,-,-
BAC81_G05,4,4q35.1,185608819,185711002,102183,-,-
BAC131_M23,4,4q35.1,185659820,185725310,65490,-,-
BAC143_O18,4,4q35.1,185669325,185750844,81519,-,-
BAC103_J11,4,4q35.1,185673100,185772449,99349,-,-
BAC56_F14,4,4q35.1,185677450,185787565,110115,-,-
BAC28_N17,4,4q35.1,185725389,185854667,129278,-,-
BAC38_E23,4,4q35.1,185725585,185846509,120924,-,-
BAC45_J16,4,4q35.1,185760735,185889670,128935,-,-
BAC44_C06,4,4q35.1,185787785,185889607,101822,-,-
BAC67_H01,4,4q35.1,185792763,185889674,96911,-,-
BAC53_B07,4,4q35.1,185803562,185919678,116116,-,-
BAC37_L07,4,4q35.1,185842118,185943721,101603,-,-
BAC152_A08,4,4q35.1,185842949,185949426,106477,-,-
BAC137_F17,4,4q35.1,185843018,185949574,106556,-,-
BAC190_J09,4,4q35.1,185865137,185943725,78588,-,-
BAC29_H16,4,4q35.1,185889690,186034595,144905,-,-
BAC146_N10,4,4q35.1,185905777,186041583,135806,-,-
BAC131_I17,4,4q35.1,185910766,186014244,103478,-,-
BAC166_I19,4,4q35.1,185949419,186034595,85176,-,-
BAC74_B08,4,4q35.1,185954973,186063443,108470,-,-
BAC227_I07,4,4q35.1,185960000,186069528,109528,-,-
BAC229_H06,4,4q35.1,185966575,186073277,106702,-,-
BAC124_N07,4,4q35.1,185976300,186068904,92604,-,-
BAC57_D14,4,4q35.1,186098577,186229637,131060,-,-
BAC36_O11,4,4q35.1,186120517,186218659,98142,-,-
BAC73_L07,4,4q35.1,186229157,186339830,110673,-,-
BAC32_A08,4,4q35.1,186229631,186317097,87466,-,-
BAC73_C21,4,4q35.1,186305539,186416339,110800,-,-
BAC84_A06,4,4q35.1,186312153,186393388,81235,-,-
BAC122_L13,4,4q35.1,186319279,186415091,95812,-,-
BAC155_C06,4,4q35.1,186320265,186424436,104171,-,-
BAC135_N05,4,4q35.1,186321303,186421318,100015,-,-
BAC235_K03,4,4q35.1,186339822,186424439,84617,-,-
BAC36_K09,4,4q35.1,186339822,186450159,110337,-,-
BAC50_L13,4,4q35.1,186339826,186487229,147403,-,-
BAC200_D15,4,4q35.1,186385011,186499769,114758,-,-
BAC40_L09,4,4q35.1,186464943,186584814,119871,-,-
BAC143_J17,4,4q35.1,186487226,186636690,149464,-,-
BAC109_H08,4,4q35.1,186626008,186759624,133616,-,-
BAC120_C09,4,4q35.1,186684909,186909659,224750,-,-
BAC234_F14,4,4q35.1,186735935,186840863,104928,-,-
BAC176_J04,4,4q35.1,186735935,186819019,83084,-,-
BAC27_L15,4,4q35.1,186746250,186847111,100861,-,-
BAC8_F15,4,4q35.1,186752380,186859140,106760,-,-
BAC1_P20,4,4q35.1,186858732,186981781,123049,-,-
BAC128_G09,4,4q35.1,186865425,186960152,94727,-,-
BAC193_K20,4,4q35.1,186909652,187018404,108752,-,-
BAC168_E10,4,4q35.1,187020890,187104304,83414,-,-
BAC143_I10,4,4q35.1,187127693,187236711,109018,-,-
BAC106_L09,4,4q35.1,187152817,187277031,124214,-,-
BAC162_A03,4,4q35.1,187166996,187262659,95663,-,-
BAC21_P03,4,4q35.1,187187218,187277026,89808,-,-
BAC235_J05,4,4q35.1,187198360,187294708,96348,-,-
BAC154_K06,4,4q35.1,187203675,187290068,86393,-,-
BAC187_D14,4,4q35.1-4q35.2,187262665,187351043,88378,-,-
BAC208_L12,4,4q35.1-4q35.2,187294725,187363548,68823,-,-
BAC144_O11,4,4q35.1-4q35.2,187297345,187405922,108577,-,-
BAC76_I10,4,4q35.2,187351076,187458322,107246,-,-
BAC113_K14,4,4q35.2,187365137,187458309,93172,-,-
BAC67_G15,4,4q35.2,187378166,187516244,138078,-,-
BAC189_P01,4,4q35.2,187405915,187483518,77603,-,-
BAC32_K20,4,4q35.2,187516263,187642653,126390,-,-
BAC6_B18,4,4q35.2,187541136,187619229,78093,-,-
BAC242_C03,4,4q35.2,187554717,187619229,64512,-,-
BAC187_N23,4,4q35.2,187619222,187708569,89347,-,-
BAC196_G14,4,4q35.2,187662908,187750360,87452,-,-
BAC172_P20,4,4q35.2,187662908,187750906,87998,-,-
BAC71_G08,4,4q35.2,187711204,187871808,160604,-,-
BAC84_P22,4,4q35.2,187757398,187869407,112009,-,-
BAC105_B19,4,4q35.2,187825990,187939247,113257,-,-
BAC22_O06,4,4q35.2,187841238,187939081,97843,-,-
BAC232_B08,4,4q35.2,187922361,188018421,96060,-,-
BAC94_O20,4,4q35.2,187937779,188087356,149577,-,-
BAC41_I15,4,4q35.2,187955425,188032308,76883,-,-
BAC193_I15,4,4q35.2,187981217,188074941,93724,-,-
BAC227_H03,4,4q35.2,188182120,188284173,102053,-,-
BAC182_J19,4,4q35.2,188250752,188355510,104758,-,-
BAC91_G20,4,4q35.2,188262453,188344402,81949,-,-
BAC163_F05,4,4q35.2,188303583,188388009,84426,-,-
BAC167_I05,4,4q35.2,188313824,188449583,135759,-,-
BAC73_M07,4,4q35.2,188388034,188500525,112491,-,-
BAC56_F05,4,4q35.2,188509845,188645021,135176,-,-
BAC20_J02,4,4q35.2,188571410,188679408,107998,-,-
BAC48_O08,4,4q35.2,188773514,188853254,79740,-,-
BAC30_J14,4,4q35.2,188938487,189017277,78790,-,-
BAC49_B07,4,4q35.2,189014581,189108847,94266,-,-
BAC246_I06,4,4q35.2,189049008,189129739,80731,-,-
BAC4_P11,4,4q35.2,189089499,189183105,93606,-,-
BAC107_M19,4,4q35.2,189095365,189188754,93389,-,-
BAC56_D09,4,4q35.2,189095380,189238317,142937,-,-
BAC144_C06,4,4q35.2,189102366,189203318,100952,-,-
BAC33_E06,4,4q35.2,189122226,189234978,112752,-,-
BAC172_C19,4,4q35.2,189203312,189265551,62239,-,-
BAC50_F09,4,4q35.2,189282361,189380014,97653,-,-
BAC96_J04,4,4q35.2,189360212,189525759,165547,-,-
BAC37_F08,4,4q35.2,189383414,189499352,115938,-,-
BAC60_K13,4,4q35.2,189390627,189480767,90140,-,-
BAC69_C04,4,4q35.2,189410113,189493160,83047,-,-
BAC84_E05,4,4q35.2,189493152,189583433,90281,-,-
BAC147_L19,4,4q35.2,189525753,189616577,90824,-,-
BAC228_A18,4,4q35.2,189542375,189624418,82043,-,-
BAC165_B21,4,4q35.2,189542375,189621061,78686,-,-
BAC51_N11,4,4q35.2,189542382,189642540,100158,-,-
BAC27_L24,4,4q35.2,189548077,189648411,100334,-,-
BAC143_B09,4,4q35.2,189548077,189629395,81318,-,-
BAC37_F15,4,4q35.2,189574877,189709156,134279,-,-
BAC26_D04,4,4q35.2,189621300,189735666,114366,-,-
BAC13_I07,4,4q35.2,189648752,189758445,109693,-,-
BAC150_E05,4,4q35.2,189648752,189763038,114286,-,-
BAC186_K09,4,4q35.2,189769313,189876651,107338,-,-
BAC158_N22,4,4q35.2,189776048,189887314,111266,-,-
BAC158_A23,4,4q35.2,189776048,189887314,111266,-,-
BAC198_A13,4,4q35.2,189937687,190022602,84915,-,-
BAC177_M10,4,4q35.2,189940435,190012263,71828,-,-
BAC143_F07,4,4q35.2,189978888,190059006,80118,-,-
BAC200_I03,4,4q35.2,190038298,190129076,90778,-,-
BAC117_N13,4,4q35.2,190207051,190323378,116327,-,-
BAC107_F06,4,4q35.2,190312230,190402944,90714,-,-
BAC72_G14,4,4q35.2,190457567,190574271,116704,-,-
BAC234_F02,4,4q35.2,190512721,190632466,119745,-,-
BAC35_N10,4,4q35.2,190512813,190631262,118449,-,-
BAC246_B07,4,4q35.2,190521637,190605307,83670,-,-
BAC139_I03,4,4q35.2,190544053,190640326,96273,yes,-
BAC64_I20,4,4q35.2,190576138,190713895,137757,-,-
BAC66_E19,4,4q35.2,190601610,190690788,89178,yes,-
BAC150_E13,4,4q35.2,190712135,190794324,82189,-,-
BAC246_F06,4,4q35.2,190713163,190813837,100674,-,-
BAC226_C02,4,4q35.2,190717437,190817156,99719,-,-
BAC165_C05,4,4q35.2,190717437,190794322,76885,-,-
BAC106_P19,4,4q35.2,190733475,190815280,81805,-,-
BAC73_J13,4,4q35.2,190733475,190825537,92062,-,-
BAC176_E16,4,4q35.2,190794315,190885450,91135,-,-
BAC25_K20,4,4q35.2,190797234,190885784,88550,-,-
BAC139_H10,4,4q35.2,190797234,190893612,96378,-,-
BAC183_I08,4,4q35.2,190813402,190897325,83923,-,-
BAC175_E15,4,4q35.2,190819418,190893656,74238,-,-
BAC33_N10,4,4q35.2,190894063,191009130,115067,-,-
BAC242_I08,4,4q35.2,190923862,191038246,114384,-,-
BAC42_F22,4,4q35.2,190923862,191030569,106707,-,-
BAC131_B18,4,4q35.2,190923870,191023941,100071,-,-
BAC191_F14,4,4q35.2,190963764,191006683,42919,-,-
BAC59_G06,4,4q35.2,191039892,191134985,95093,-,-
BAC234_J16,4,4q35.2,191123125,191204934,81809,-,-
BAC252_L21,5,5p15.33,129142,243412,114270,-,-
BAC128_K03,5,5p15.33,203859,298137,94278,-,-
BAC111_A05,5,5p15.33,300301,388669,88368,-,-
BAC86_M05,5,5p15.33,388661,566921,178260,-,-
BAC28_G03,5,5p15.33,388668,471210,82542,-,-
BAC130_M18,5,5p15.33,555546,654069,98523,-,-
BAC175_M08,5,5p15.33,557250,688780,131530,-,-
BAC151_L22,5,5p15.33,630295,719827,89532,-,-
BAC117_B21,5,5p15.33,710040,796300,86260,yes,-
BAC149_F17,5,5p15.33,719985,898102,178117,-,-
BAC249_I16,5,5p15.33,726884,784357,57473,-,-
BAC203_H19,5,5p15.33,765626,868306,102680,-,-
BAC169_O14,5,5p15.33,791181,868564,77383,-,-
BAC191_O13,5,5p15.33,848306,960395,112089,yes,-
BAC68_E06,5,5p15.33,886878,970160,83282,yes,-
BAC6_B15,5,5p15.33,925023,1017356,92333,yes,-
BAC247_H03,5,5p15.33,970198,1049040,78842,-,-
BAC61_H11,5,5p15.33,1102610,1194724,92114,yes,-
BAC90_N23,5,5p15.33,1106855,1241476,134621,-,-
BAC135_O15,5,5p15.33,1170289,1258046,87757,-,-
BAC18_O05,5,5p15.33,1274205,1292684,18479,-,-
BAC211_N04,5,5p15.33,1363559,1465354,101795,-,-
BAC122_J11,5,5p15.33,1370767,1445795,75028,-,-
BAC211_M10,5,5p15.33,1370791,1489469,118678,-,-
BAC131_N10,5,5p15.33,1371025,1471007,99982,-,-
BAC63_F14,5,5p15.33,1383611,1478429,94818,-,-
BAC237_H02,5,5p15.33,1415610,1510718,95108,yes,-
BAC54_E11,5,5p15.33,1463341,1633482,170141,-,-
BAC34_B09,5,5p15.33,1471005,1584667,113662,-,-
BAC34_B10,5,5p15.33,1471005,1584667,113662,-,-
BAC29_F02,5,5p15.33,1506274,1611756,105482,-,-
BAC18_F14,5,5p15.33,1510731,1637064,126333,-,-
BAC213_E13,5,5p15.33,1622024,1721855,99831,-,-
BAC91_O23,5,5p15.33,1637254,1749320,112066,-,-
BAC217_D13,5,5p15.33,1650428,1737314,86886,-,-
BAC175_K14,5,5p15.33,1657964,1748849,90885,-,-
BAC188_G12,5,5p15.33,1746256,1832870,86614,-,-
BAC175_E04,5,5p15.33,1794506,1915773,121267,-,-
BAC76_O24,5,5p15.33,1796170,1903434,107264,-,-
BAC247_N16,5,5p15.33,1817565,1915771,98206,-,-
BAC151_C12,5,5p15.33,1817565,1903683,86118,-,-
BAC179_N23,5,5p15.33,1824089,1915773,91684,-,-
BAC69_N04,5,5p15.33,1907653,1999251,91598,-,-
BAC158_L04,5,5p15.33,1907654,2037758,130104,-,-
BAC244_C11,5,5p15.33,1928805,2040865,112060,-,-
BAC125_G18,5,5p15.33,2033611,2153151,119540,-,-
BAC83_J08,5,5p15.33,2037816,2122315,84499,-,-
BAC197_J20,5,5p15.33,2037839,2120668,82829,-,-
BAC105_B18,5,5p15.33,2046352,2166166,119814,-,-
BAC5_H06,5,5p15.33,2053017,2153167,100150,-,-
BAC66_C02,5,5p15.33,2062650,2165823,103173,-,-
BAC193_G12,5,5p15.33,2062798,2165823,103025,-,-
BAC36_K24,5,5p15.33,2311800,2447486,135686,-,-
BAC107_O02,5,5p15.33,2366996,2447537,80541,-,-
BAC104_G21,5,5p15.33,2392933,2501075,108142,-,-
BAC32_I12,5,5p15.33,2483531,2612240,128709,-,-
BAC183_B03,5,5p15.33,2514978,2612240,97262,-,-
BAC143_B15,5,5p15.33,2593931,2676370,82439,-,-
BAC61_O23,5,5p15.33,2648949,2732716,83767,-,-
BAC72_D04,5,5p15.33,2654266,2774238,119972,-,-
BAC199_F16,5,5p15.33,2734867,2817497,82630,-,-
BAC109_N14,5,5p15.33,2928904,3058525,129621,-,-
BAC33_L02,5,5p15.33,2943147,3033558,90411,-,-
BAC181_E12,5,5p15.33,2999772,3098915,99143,-,-
BAC50_C18,5,5p15.33,3018733,3136232,117499,-,-
BAC108_J05,5,5p15.33,3058544,3137431,78887,-,-
BAC77_E02,5,5p15.33,3088577,3242879,154302,-,-
BAC110_N16,5,5p15.33,3112603,3227187,114584,-,-
BAC65_N10,5,5p15.33,3112603,3233759,121156,-,-
BAC163_J10,5,5p15.33,3217742,3347209,129467,-,-
BAC132_F08,5,5p15.33,3217742,3302137,84395,-,-
BAC71_C17,5,5p15.33,3254122,3363241,109119,-,-
BAC29_H12,5,5p15.33,3274659,3363264,88605,-,-
BAC141_O08,5,5p15.33,3277088,3357987,80899,-,-
BAC250_D10,5,5p15.33,3412853,3491053,78200,-,-
BAC15_D09,5,5p15.33,3412881,3514538,101657,-,-
BAC67_N07,5,5p15.33,3452748,3585300,132552,-,-
BAC176_H02,5,5p15.33,3452748,3532036,79288,-,-
BAC120_L17,5,5p15.33,3476957,3562170,85213,-,-
BAC76_L20,5,5p15.33,3514606,3662387,147781,-,-
BAC87_O17,5,5p15.33,3603091,3701371,98280,-,-
BAC233_H08,5,5p15.33,3633478,3728512,95034,-,-
BAC193_M07,5,5p15.33,3728895,3850507,121612,-,-
BAC237_E02,5,5p15.33,3743618,3828817,85199,-,-
BAC34_E06,5,5p15.33,3792527,3881967,89440,-,-
BAC44_F08,5,5p15.33,3814291,3892474,78183,-,-
BAC124_N21,5,5p15.33,3828812,3916138,87326,-,-
BAC120_E12,5,5p15.33,3861553,3953520,91967,-,-
BAC40_D07,5,5p15.33,3925799,4049322,123523,-,-
BAC224_A08,5,5p15.33,3956687,4034260,77573,-,-
BAC187_O05,5,5p15.33,3959385,4029940,70555,-,-
BAC179_F12,5,5p15.33,4043431,4156105,112674,-,-
BAC106_P07,5,5p15.33,4142118,4241445,99327,-,-
BAC244_A11,5,5p15.33,4142161,4221522,79361,-,-
BAC35_C02,5,5p15.33,4241484,4359748,118264,-,-
BAC177_O18,5,5p15.33,4267370,4364834,97464,-,-
BAC72_L14,5,5p15.33-5p15.32,4324045,4437315,113270,-,-
BAC53_I03,5,5p15.33-5p15.32,4329598,4432232,102634,-,-
BAC97_J19,5,5p15.33-5p15.32,4364885,4464094,99209,-,-
BAC59_H16,5,5p15.33-5p15.32,4364885,4455042,90157,-,-
BAC124_O14,5,5p15.33-5p15.32,4388079,4467890,79811,-,-
BAC23_O21,5,5p15.32,4437344,4558733,121389,-,-
BAC250_F13,5,5p15.32,4455048,4545966,90918,-,-
BAC120_J18,5,5p15.32,4468050,4548094,80044,-,-
BAC240_E17,5,5p15.32,4503319,4587383,84064,-,-
BAC36_E17,5,5p15.32,4577653,4666278,88625,-,-
BAC78_B24,5,5p15.32,4578018,4665935,87917,-,-
BAC141_O06,5,5p15.32,4579376,4656109,76733,-,-
BAC2_N07,5,5p15.32,4593902,4688882,94980,-,-
BAC236_M10,5,5p15.32,4690488,4763551,73063,-,-
BAC238_N03,5,5p15.32,4718999,4866474,147475,-,-
BAC83_D14,5,5p15.32,4800654,4884803,84149,-,-
BAC57_H16,5,5p15.32,4886843,4976394,89551,-,-
BAC37_D06,5,5p15.32,4924882,5061781,136899,-,-
BAC200_B04,5,5p15.32,4945479,5027293,81814,-,-
BAC59_I21,5,5p15.32,4945479,5027293,81814,-,-
BAC84_C03,5,5p15.32,4956398,5045490,89092,-,-
BAC1_J16,5,5p15.32,4994259,5103135,108876,-,-
BAC97_J08,5,5p15.32,5013492,5103135,89643,-,-
BAC165_I11,5,5p15.32,5031782,5121619,89837,-,-
BAC97_E15,5,5p15.32,5118463,5235127,116664,-,-
BAC10_D10,5,5p15.32,5136444,5220297,83853,-,-
BAC227_O20,5,5p15.32,5220292,5230627,10335,-,-
BAC182_C20,5,5p15.32,5235479,5334283,98804,-,-
BAC154_L08,5,5p15.32,5336183,5417202,81019,-,-
BAC26_I23,5,5p15.32,5380315,5470507,90192,-,-
BAC62_E03,5,5p15.32,5482214,5566175,83961,-,-
BAC89_L15,5,5p15.32,5520561,5604973,84412,-,-
BAC56_N04,5,5p15.32,5536473,5634173,97700,-,-
BAC24_M22,5,5p15.32,5562617,5699231,136614,-,-
BAC42_P07,5,5p15.32,5598105,5782078,183973,-,-
BAC188_F16,5,5p15.32,5605281,5699612,94331,-,-
BAC163_H05,5,5p15.32,5657381,5741209,83828,-,-
BAC229_M02,5,5p15.32,5701793,5772865,71072,-,-
BAC29_P17,5,5p15.32,5720195,5819146,98951,-,-
BAC33_N01,5,5p15.32,5720199,5823150,102951,-,-
BAC39_I10,5,5p15.32,5735918,5819149,83231,-,-
BAC36_I19,5,5p15.32,5778788,5910824,132036,-,-
BAC106_I10,5,5p15.32,5782782,5872133,89351,-,-
BAC86_I08,5,5p15.32,5782784,5886294,103510,-,-
BAC33_J10,5,5p15.32,5782792,5880734,97942,-,-
BAC61_P05,5,5p15.32-5p15.31,5874485,6004791,130306,-,-
BAC166_N22,5,5p15.32-5p15.31,5935722,6023648,87926,-,-
BAC111_F08,5,5p15.31,6035797,6155900,120103,-,-
BAC53_N21,5,5p15.31,6081688,6172627,90939,-,-
BAC247_N06,5,5p15.31,6121259,6224248,102989,-,-
BAC110_I11,5,5p15.31,6121262,6263005,141743,-,-
BAC119_O22,5,5p15.31,6275911,6369704,93793,-,-
BAC234_M21,5,5p15.31,6286326,6396673,110347,-,-
BAC238_H11,5,5p15.31,6286326,6382893,96567,-,-
BAC241_K11,5,5p15.31,6304673,6396673,92000,-,-
BAC130_E06,5,5p15.31,6317564,6400383,82819,-,-
BAC46_G07,5,5p15.31,6410618,6505331,94713,-,-
BAC62_P15,5,5p15.31,6414344,6527791,113447,-,-
BAC32_F22,5,5p15.31,6511967,6620015,108048,-,-
BAC69_I08,5,5p15.31,6554119,6693456,139337,-,-
BAC50_B21,5,5p15.31,6556185,6693444,137259,-,-
BAC149_O19,5,5p15.31,6560882,6693444,132562,-,-
BAC33_N12,5,5p15.31,6560882,6666675,105793,-,-
BAC147_H05,5,5p15.31,6571271,6670062,98791,-,-
BAC155_D04,5,5p15.31,6573180,6670065,96885,-,-
BAC142_E02,5,5p15.31,6584231,6672477,88246,-,-
BAC155_M05,5,5p15.31,6652609,6733158,80549,-,-
BAC6_N11,5,5p15.31,6693450,6866842,173392,-,-
BAC149_B17,5,5p15.31,6693658,6792352,98694,-,-
BAC37_H22,5,5p15.31,6721417,6888762,167345,-,-
BAC157_E23,5,5p15.31,6722813,6798826,76013,-,-
BAC118_O10,5,5p15.31,6762324,6850249,87925,-,-
BAC170_N24,5,5p15.31,6771845,6847971,76126,-,-
BAC175_I10,5,5p15.31,6779101,6905159,126058,-,-
BAC18_N03,5,5p15.31,6809622,6893145,83523,-,-
BAC83_B11,5,5p15.31,6840844,6946394,105550,-,-
BAC49_E10,5,5p15.31,6868117,7003305,135188,-,-
BAC103_K13,5,5p15.31,6956445,7042435,85990,-,-
BAC197_N10,5,5p15.31,6959287,7053454,94167,-,-
BAC163_E06,5,5p15.31,6991062,7074926,83864,-,-
BAC220_D03,5,5p15.31,7053447,7145959,92512,-,-
BAC176_D13,5,5p15.31,7103854,7205930,102076,-,-
BAC73_M02,5,5p15.31,7103854,7215778,111924,-,-
BAC17_C07,5,5p15.31,7235767,7287280,51513,-,-
BAC56_D02,5,5p15.31,7239870,7314305,74435,-,-
BAC81_P13,5,5p15.31,7375887,7480006,104119,-,-
BAC175_H06,5,5p15.31,7404586,7527840,123254,-,-
BAC221_L09,5,5p15.31,7436343,7530657,94314,-,-
BAC222_D22,5,5p15.31,7484413,7626390,141977,-,-
BAC175_D24,5,5p15.31,7580385,7653231,72846,-,-
BAC231_L23,5,5p15.31,7583396,7678462,95066,-,-
BAC90_M21,5,5p15.31,7602487,7689138,86651,-,-
BAC9_B08,5,5p15.31,7641654,7735614,93960,-,-
BAC238_I05,5,5p15.31,7745346,7757620,12274,-,-
BAC21_E20,5,5p15.31,7758010,7849787,91777,-,-
BAC84_N11,5,5p15.31,7888082,8010643,122561,-,-
BAC34_K02,5,5p15.31,7911021,8021760,110739,-,-
BAC160_I22,5,5p15.31,7913271,8007257,93986,-,-
BAC33_B11,5,5p15.31,7920718,8033318,112600,-,-
BAC96_F16,5,5p15.31,7925399,8021762,96363,-,-
BAC30_K13,5,5p15.31,7962738,8115207,152469,-,-
BAC124_H05,5,5p15.31-5p15.2,8081432,8205730,124298,-,-
BAC57_O10,5,5p15.31-5p15.2,8114611,8207023,92412,-,-
BAC235_G05,5,5p15.31-5p15.2,8114612,8225126,110514,-,-
BAC161_P17,5,5p15.31-5p15.2,8115217,8232923,117706,-,-
BAC243_D13,5,5p15.31-5p15.2,8127954,8225126,97172,-,-
BAC110_N11,5,5p15.31-5p15.2,8198323,8290546,92223,-,-
BAC18_P07,5,5p15.2,8287695,8359204,71509,-,-
BAC124_J05,5,5p15.2,8359218,8456777,97559,-,-
BAC51_P11,5,5p15.2,8359349,8456576,97227,-,-
BAC230_G14,5,5p15.2,8409005,8508546,99541,-,-
BAC44_G01,5,5p15.2,8422030,8535212,113182,-,-
BAC168_H12,5,5p15.2,8492196,8601514,109318,-,-
BAC56_B13,5,5p15.2,8536607,8657042,120435,-,-
BAC199_F09,5,5p15.2,8544270,8669212,124942,-,-
BAC46_J07,5,5p15.2,8728412,8821486,93074,-,-
BAC105_N05,5,5p15.2,8921545,9012429,90884,-,-
BAC119_M02,5,5p15.2,9116445,9207157,90712,-,-
BAC234_K14,5,5p15.2,9117095,9195477,78382,-,-
BAC81_E06,5,5p15.2,9117095,9220905,103810,-,-
BAC30_M01,5,5p15.2,9238807,9334122,95315,-,-
BAC160_M10,5,5p15.2,9261048,9349841,88793,-,-
BAC170_I24,5,5p15.2,9300891,9397092,96201,-,-
BAC69_A21,5,5p15.2,9305415,9392705,87290,-,-
BAC67_I08,5,5p15.2,9309385,9394273,84888,-,-
BAC186_E12,5,5p15.2,9309385,9404083,94698,-,-
BAC143_N22,5,5p15.2,9511494,9591939,80445,-,-
BAC206_I13,5,5p15.2,9591934,9697824,105890,-,-
BAC252_N08,5,5p15.2,9710410,9842377,131967,-,-
BAC64_P22,5,5p15.2,9737985,9835999,98014,-,-
BAC200_E05,5,5p15.2,9761722,9855167,93445,-,-
BAC240_K06,5,5p15.2,9775708,9856013,80305,-,-
BAC6_D24,5,5p15.2,9941759,10044618,102859,-,-
BAC192_E03,5,5p15.2,9984167,10077369,93202,-,-
BAC176_A01,5,5p15.2,10010963,10092564,81601,-,-
BAC170_E02,5,5p15.2,10010963,10092564,81601,-,-
BAC24_O17,5,5p15.2,10100161,10205835,105674,-,-
BAC235_E04,5,5p15.2,10221419,10310700,89281,-,-
BAC196_H04,5,5p15.2,10221419,10307147,85728,-,-
BAC204_G19,5,5p15.2,10284292,10389223,104931,-,-
BAC66_F06,5,5p15.2,10383575,10492182,108607,-,-
BAC108_J16,5,5p15.2,10487962,10635985,148023,-,-
BAC36_E08,5,5p15.2,10504182,10587527,83345,-,-
BAC236_B20,5,5p15.2,10515144,10595847,80703,-,-
BAC8_J11,5,5p15.2,10534751,10643694,108943,-,-
BAC221_P01,5,5p15.2,10543640,10643701,100061,-,-
BAC115_A21,5,5p15.2,10551474,10656345,104871,-,-
BAC141_L07,5,5p15.2,10621353,10706001,84648,-,-
BAC176_M22,5,5p15.2,10778659,10866962,88303,-,-
BAC132_I24,5,5p15.2,10903324,10977067,73743,-,-
BAC106_I04,5,5p15.2,10903324,11012441,109117,-,-
BAC175_F12,5,5p15.2,10921971,11012063,90092,-,-
BAC220_L14,5,5p15.2,10956260,11036211,79951,-,-
BAC75_F09,5,5p15.2,11007717,11104042,96325,-,-
BAC172_K04,5,5p15.2,11017755,11104362,86607,-,-
BAC169_M11,5,5p15.2,11017779,11106770,88991,-,-
BAC180_C09,5,5p15.2,11031225,11128036,96811,-,-
BAC248_F02,5,5p15.2,11056306,11145891,89585,-,-
BAC97_A16,5,5p15.2,11067683,11167859,100176,-,-
BAC119_K22,5,5p15.2,11073366,11170180,96814,-,-
BAC86_A10,5,5p15.2,11150323,11247671,97348,-,-
BAC151_L09,5,5p15.2,11153445,11258291,104846,-,-
BAC242_E15,5,5p15.2,11163446,11277493,114047,-,-
BAC43_F04,5,5p15.2,11167856,11277473,109617,-,-
BAC230_D02,5,5p15.2,11174227,11263887,89660,-,-
BAC21_B09,5,5p15.2,11183875,11277506,93631,-,-
BAC151_L10,5,5p15.2,11203036,11296998,93962,-,-
BAC82_A09,5,5p15.2,11209208,11342873,133665,-,-
BAC171_C20,5,5p15.2,11326643,11417402,90759,-,-
BAC187_A21,5,5p15.2,11334734,11425537,90803,-,-
BAC135_L06,5,5p15.2,11432565,11516796,84231,-,-
BAC173_O13,5,5p15.2,11868499,11962995,94496,-,-
BAC77_N16,5,5p15.2,11891183,12037489,146306,-,-
BAC105_A02,5,5p15.2,11905095,12011940,106845,-,-
BAC153_M02,5,5p15.2,11985702,12078812,93110,-,-
BAC55_L20,5,5p15.2,12007678,12131126,123448,-,-
BAC169_I12,5,5p15.2,12037517,12163844,126327,-,-
BAC223_P22,5,5p15.2,12037517,12114683,77166,-,-
BAC123_G09,5,5p15.2,12070158,12152488,82330,-,-
BAC128_E04,5,5p15.2,12070173,12217451,147278,-,-
BAC43_K10,5,5p15.2,12316252,12426543,110291,-,-
BAC23_J19,5,5p15.2,12334227,12462153,127926,-,-
BAC155_G24,5,5p15.2,12494165,12578085,83920,-,-
BAC55_N03,5,5p15.2,12550024,12659249,109225,-,-
BAC182_I10,5,5p15.2,12789332,12879576,90244,-,-
BAC175_O23,5,5p15.2,12824218,12927549,103331,-,-
BAC131_F09,5,5p15.2,12824218,12918683,94465,-,-
BAC191_M16,5,5p15.2,12868343,12971916,103573,-,-
BAC58_I20,5,5p15.2,13146087,13282606,136519,-,-
BAC237_H15,5,5p15.2,13219194,13345477,126283,-,-
BAC4_P05,5,5p15.2,13219221,13314459,95238,-,-
BAC178_K12,5,5p15.2,13290432,13362533,72101,-,-
BAC151_H24,5,5p15.2,13312654,13456247,143593,-,-
BAC50_P10,5,5p15.2,13406148,13556460,150312,-,-
BAC86_J16,5,5p15.2,13446202,13542886,96684,-,-
BAC96_K16,5,5p15.2,13663864,13761562,97698,-,-
BAC230_P16,5,5p15.2,13680051,13787856,107805,-,-
BAC132_B03,5,5p15.2,13694352,13787859,93507,-,-
BAC186_M06,5,5p15.2,13702729,13787854,85125,-,-
BAC43_K23,5,5p15.2,13787864,13890301,102437,-,-
BAC68_C18,5,5p15.2,13829099,13967034,137935,-,-
BAC37_K08,5,5p15.2,13896106,14048276,152170,-,-
BAC37_B18,5,5p15.2,13930108,14031245,101137,-,-
BAC221_L15,5,5p15.2,13930125,14014222,84097,-,-
BAC151_E09,5,5p15.2,13930125,14024928,94803,-,-
BAC145_J23,5,5p15.2,14031237,14113891,82654,-,-
BAC31_M08,5,5p15.2,14113884,14280024,166140,-,-
BAC116_I11,5,5p15.2,14113978,14201152,87174,-,-
BAC54_J02,5,5p15.2,14166465,14263410,96945,-,-
BAC19_F07,5,5p15.2,14187558,14284345,96787,-,-
BAC210_L05,5,5p15.2,14187619,14287440,99821,-,-
BAC160_B20,5,5p15.2,14264388,14340445,76057,-,-
BAC194_K22,5,5p15.2,14303692,14381739,78047,-,-
BAC139_F07,5,5p15.2,14308285,14418474,110189,-,-
BAC86_B20,5,5p15.2,14309256,14409481,100225,-,-
BAC188_F22,5,5p15.2,14331185,14415334,84149,-,-
BAC77_O18,5,5p15.2,14390687,14491161,100474,-,-
BAC107_D13,5,5p15.2,14393000,14541760,148760,-,-
BAC33_C10,5,5p15.2,14465115,14563019,97904,-,-
BAC184_J06,5,5p15.2,14476110,14576921,100811,-,-
BAC134_D14,5,5p15.2,14491502,14578174,86672,-,-
BAC92_A22,5,5p15.2,14525416,14627360,101944,-,-
BAC209_E18,5,5p15.2,14537587,14621337,83750,-,-
BAC57_F19,5,5p15.2,14598202,14703816,105614,-,-
BAC111_O09,5,5p15.2,14621406,14703655,82249,-,-
BAC120_G13,5,5p15.2,14621742,14710497,88755,-,-
BAC91_H15,5,5p15.2,14627398,14727861,100463,-,-
BAC46_M22,5,5p15.2,14705602,14793438,87836,-,-
BAC123_B17,5,5p15.2,14734489,14814582,80093,-,-
BAC53_I05,5,5p15.2,14737578,14831743,94165,-,-
BAC148_B24,5,5p15.2,14835892,14939603,103711,-,-
BAC58_H19,5,5p15.2,14841217,14950550,109333,-,-
BAC46_L15,5,5p15.2,14926533,15024003,97470,-,-
BAC71_P04,5,5p15.2,14950592,15054604,104012,-,-
BAC90_N09,5,5p15.1,15127616,15215729,88113,-,-
BAC186_N20,5,5p15.1,15163546,15259064,95518,-,-
BAC176_B19,5,5p15.1,15199503,15259062,59559,-,-
BAC165_P06,5,5p15.1,15254191,15363717,109526,-,-
BAC154_K02,5,5p15.1,15352930,15479227,126297,-,-
BAC34_K19,5,5p15.1,15352930,15460185,107255,-,-
BAC185_C13,5,5p15.1,15485526,15575041,89515,-,-
BAC131_B04,5,5p15.1,15524414,15593619,69205,-,-
BAC116_K24,5,5p15.1,15548235,15648435,100200,-,-
BAC91_F08,5,5p15.1,15583809,15664420,80611,-,-
BAC11_J08,5,5p15.1,15695573,15799003,103430,-,-
BAC8_M07,5,5p15.1,15788577,15909023,120446,-,-
BAC237_J04,5,5p15.1,15830420,15952629,122209,-,-
BAC40_M23,5,5p15.1,15889514,15988375,98861,-,-
BAC17_O13,5,5p15.1,15889704,15988663,98959,-,-
BAC50_C24,5,5p15.1,15896529,16011664,115135,-,-
BAC133_E14,5,5p15.1,15955733,16032995,77262,-,-
BAC86_A03,5,5p15.1,15963892,16060595,96703,-,-
BAC73_D16,5,5p15.1,15988514,16079829,91315,-,-
BAC148_J18,5,5p15.1,16038716,16138513,99797,-,-
BAC41_H13,5,5p15.1,16040426,16167766,127340,-,-
BAC226_E21,5,5p15.1,16052545,16138513,85968,-,-
BAC177_F09,5,5p15.1,16165053,16322069,157016,-,-
BAC59_C11,5,5p15.1,16165053,16253215,88162,-,-
BAC106_H21,5,5p15.1,16167781,16283800,116019,-,-
BAC149_J09,5,5p15.1,16182181,16279698,97517,-,-
BAC153_F17,5,5p15.1,16213881,16339655,125774,-,-
BAC209_N16,5,5p15.1,16249654,16332552,82898,-,-
BAC109_J08,5,5p15.1,16253373,16371792,118419,-,-
BAC63_O04,5,5p15.1,16279693,16377775,98082,-,-
BAC91_B18,5,5p15.1,16546135,16666688,120553,-,-
BAC162_J11,5,5p15.1,16758096,16833979,75883,-,-
BAC33_B01,5,5p15.1,16807730,16925327,117597,-,-
BAC109_M15,5,5p15.1,16810687,16909658,98971,-,-
BAC109_K21,5,5p15.1,16810687,16909658,98971,-,-
BAC186_M23,5,5p15.1,16853597,16955759,102162,-,-
BAC200_C09,5,5p15.1,16958318,17041612,83294,-,-
BAC57_M13,5,5p15.1,16998538,17125101,126563,-,-
BAC217_H20,5,5p15.1,17034342,17142708,108366,-,-
BAC109_K20,5,5p15.1,17068616,17158744,90128,-,-
BAC53_N13,5,5p15.1,17190025,17273626,83601,-,-
BAC234_I20,5,5p15.1,17202693,17288902,86209,-,-
BAC171_G22,5,5p15.1,17291586,17392313,100727,-,-
BAC38_E15,5,5p15.1,17294224,17382902,88678,-,-
BAC24_I23,5,5p15.1,17320984,17492201,171217,-,-
BAC223_B02,5,5p15.1,17343352,17418579,75227,-,-
BAC152_H02,5,5p15.1,17368343,17456624,88281,-,-
BAC73_I12,5,5p15.1,17368343,17472497,104154,-,-
BAC192_F17,5,5p15.1,17678587,17778379,99792,-,-
BAC234_O17,5,5p15.1,17918932,18010558,91626,-,-
BAC149_F20,5,5p15.1,17919224,18010558,91334,-,-
BAC219_K12,5,5p15.1,17925482,18010558,85076,-,-
BAC175_E02,5,5p15.1,17969733,18037835,68102,-,-
BAC108_B23,5,5p15.1,18102452,18190016,87564,-,-
BAC152_L18,5,5p15.1,18162940,18244797,81857,-,-
BAC242_K05,5,5p15.1,18213000,18311722,98722,-,-
BAC78_A11,5,5p15.1,18368921,18468113,99192,-,-
BAC109_G23,5,5p15.1,18380707,18490648,109941,-,-
BAC1_I19,5,5p15.1-5p14.3,18442479,18532272,89793,-,-
BAC55_D10,5,5p15.1-5p14.3,18442486,18527615,85129,-,-
BAC115_F20,5,5p15.1-5p14.3,18490642,18572910,82268,-,-
BAC170_L02,5,5p14.3,18613963,18701172,87209,-,-
BAC229_K02,5,5p14.3,18721799,18796498,74699,-,-
BAC120_J13,5,5p14.3,19031013,19131274,100261,-,-
BAC162_L20,5,5p14.3,19077527,19179723,102196,-,-
BAC248_F01,5,5p14.3,19134211,19209816,75605,-,-
BAC80_D03,5,5p14.3,19301766,19394944,93178,-,-
BAC192_N12,5,5p14.3,19301766,19398448,96682,-,-
BAC55_N18,5,5p14.3,19655892,19781770,125878,-,-
BAC35_K10,5,5p14.3,19767621,19861515,93894,-,-
BAC50_K08,5,5p14.3,20172747,20299308,126561,-,-
BAC114_D15,5,5p14.3,20423804,20529667,105863,-,-
BAC176_G12,5,5p14.3,20434130,20529715,95585,-,-
BAC126_P15,5,5p14.3,20474352,20595111,120759,-,-
BAC126_B10,5,5p14.3,20474355,20595111,120756,-,-
BAC159_G12,5,5p14.3,20477868,20614256,136388,-,-
BAC170_H10,5,5p14.3,20512601,20586732,74131,-,-
BAC80_G10,5,5p14.3,20512601,20650466,137865,-,-
BAC19_M18,5,5p14.3,20637719,20748183,110464,-,-
BAC35_C09,5,5p14.3,20669726,20808679,138953,-,-
BAC25_K06,5,5p14.3,20808904,20826615,17711,-,-
BAC128_A20,5,5p14.3,20832029,20930391,98362,-,-
BAC85_O08,5,5p14.3,20881635,20971206,89571,-,-
BAC42_K02,5,5p14.3,20957108,21051339,94231,-,-
BAC224_H01,5,5p14.3,20976836,21065347,88511,-,-
BAC75_F21,5,5p14.3,21053230,21145046,91816,-,-
BAC15_G15,5,5p14.3,21159822,21280239,120417,-,-
BAC13_P04,5,5p14.3,21159833,21254680,94847,-,-
BAC21_C21,5,5p14.3,21159867,21239265,79398,-,-
BAC32_G11,5,5p14.3,21224743,21330106,105363,-,-
BAC55_H12,5,5p14.3,21226953,21287549,60596,-,-
BAC38_K17,5,5p14.3,21239363,21313325,73962,-,-
BAC244_N07,5,5p14.3,21251300,21330564,79264,-,-
BAC131_H01,5,5p14.3,21340582,21430472,89890,-,-
BAC46_E22,5,5p14.3,21376097,21496009,119912,-,-
BAC141_G05,5,5p14.3,21390941,21490810,99869,-,-
BAC168_P15,5,5p14.3,21490805,21565121,74316,-,-
BAC237_F17,5,5p14.3,21525949,21644051,118102,-,-
BAC52_D12,5,5p14.3,21679437,21771344,91907,-,-
BAC69_F12,5,5p14.3,21835251,21974387,139136,-,-
BAC180_O08,5,5p14.3,21947862,22049051,101189,-,-
BAC231_O19,5,5p14.3,22455001,22535675,80674,-,-
BAC118_P11,5,5p14.3,22465188,22587433,122245,-,-
BAC244_F06,5,5p14.3,22468035,22545689,77654,-,-
BAC124_F20,5,5p14.3,22676828,22817095,140267,-,-
BAC35_C08,5,5p14.3,22693762,22789070,95308,-,-
BAC132_L19,5,5p14.3,22766947,22850875,83928,-,-
BAC12_D21,5,5p14.3,22804924,22889527,84603,-,-
BAC22_F24,5,5p14.3,22820845,22922141,101296,-,-
BAC63_C06,5,5p14.2,23498603,23584633,86030,-,-
BAC63_D17,5,5p14.2,23531209,23661853,130644,-,-
BAC61_O02,5,5p14.2,23623898,23758739,134841,-,-
BAC224_F01,5,5p14.2,23809120,23936264,127144,-,-
BAC237_D09,5,5p14.2,24070606,24148013,77407,-,-
BAC68_C01,5,5p14.2,24235501,24354284,118783,-,-
BAC59_G18,5,5p14.2,24361430,24443496,82066,-,-
BAC58_N07,5,5p14.2,24361430,24454946,93516,-,-
BAC46_K04,5,5p14.2,24362635,24496185,133550,-,-
BAC102_N11,5,5p14.2,24403053,24505677,102624,-,-
BAC105_J19,5,5p14.2,24403762,24517466,113704,-,-
BAC168_E02,5,5p14.2,24427182,24517466,90284,-,-
BAC140_J14,5,5p14.2,24454940,24534769,79829,-,-
BAC73_D19,5,5p14.2,24545125,24685740,140615,-,-
BAC66_K19,5,5p14.2-5p14.1,24589102,24726438,137336,-,-
BAC41_O16,5,5p14.2-5p14.1,24664751,24785705,120954,-,-
BAC131_N09,5,5p14.1,24718352,24807714,89362,-,-
BAC194_N06,5,5p14.1,24827823,24910155,82332,-,-
BAC118_B07,5,5p14.1,24838542,24945147,106605,-,-
BAC180_H06,5,5p14.1,24966837,25059357,92520,-,-
BAC82_E21,5,5p14.1,25019682,25105710,86028,-,-
BAC39_N12,5,5p14.1,25032933,25138301,105368,-,-
BAC226_M22,5,5p14.1,25089192,25195229,106037,-,-
BAC198_N11,5,5p14.1,25380050,25499625,119575,-,-
BAC97_H19,5,5p14.1,25606113,25708080,101967,-,-
BAC139_B08,5,5p14.1,25807601,25908852,101251,-,-
BAC152_H04,5,5p14.1,25826018,25921829,95811,-,-
BAC82_H05,5,5p14.1,25831331,25999431,168100,-,-
BAC76_N19,5,5p14.1,25888413,25976505,88092,-,-
BAC200_H12,5,5p14.1,25899717,25987026,87309,-,-
BAC40_B10,5,5p14.1,25909498,25921825,12327,-,-
BAC107_F12,5,5p14.1,25987020,26098375,111355,-,-
BAC33_N18,5,5p14.1,25999429,26158704,159275,-,-
BAC84_I21,5,5p14.1,26149825,26240491,90666,-,-
BAC162_I12,5,5p14.1,26380623,26476818,96195,-,-
BAC140_C01,5,5p14.1,26409591,26515556,105965,-,-
BAC219_L17,5,5p14.1,26674802,26756708,81906,-,-
BAC43_J13,5,5p14.1,26783612,26859621,76009,-,-
BAC23_K20,5,5p14.1,26921080,27052590,131510,-,-
BAC106_J06,5,5p14.1,27075577,27175089,99512,-,-
BAC224_A24,5,5p14.1,27189276,27273452,84176,-,-
BAC157_G04,5,5p14.1,27214290,27227939,13649,-,-
BAC84_A12,5,5p14.1,27228225,27341887,113662,-,-
BAC177_B09,5,5p14.1,27322632,27445798,123166,-,-
BAC31_O10,5,5p14.1,27341540,27359954,18414,-,-
BAC160_G12,5,5p14.1,27749565,27848594,99029,-,-
BAC148_H08,5,5p14.1,27815984,27905356,89372,-,-
BAC131_F02,5,5p14.1,27864374,27975754,111380,-,-
BAC76_K01,5,5p14.1,27983037,28030622,47585,-,-
BAC117_M21,5,5p14.1,28033374,28123127,89753,-,-
BAC165_B06,5,5p14.1,28193973,28287243,93270,-,-
BAC132_J03,5,5p14.1,28245741,28331043,85302,-,-
BAC96_E12,5,5p14.1,28331923,28419799,87876,-,-
BAC59_F07,5,5p14.1,28419798,28526443,106645,-,-
BAC52_G04,5,5p14.1,28419803,28529549,109746,-,-
BAC88_G22,5,5p14.1,28580034,28697745,117711,-,-
BAC210_N09,5,5p14.1,28584227,28671870,87643,-,-
BAC147_E02,5,5p14.1,28712150,28796994,84844,-,-
BAC51_B19,5,5p14.1,29072362,29208553,136191,-,-
BAC67_I01,5,5p14.1,29129656,29236887,107231,-,-
BAC86_H21,5,5p14.1,29145598,29251259,105661,-,-
BAC72_P11,5,5p14.1-5p13.3,29298187,29371040,72853,-,-
BAC127_O23,5,5p13.3,29391734,29526658,134924,-,-
BAC29_H07,5,5p13.3,29618808,29713116,94308,-,-
BAC75_H13,5,5p13.3,29667693,29758702,91009,-,-
BAC69_C05,5,5p13.3,29758699,29858728,100029,-,-
BAC82_B20,5,5p13.3,29787653,29858728,71075,-,-
BAC147_M16,5,5p13.3,30151747,30285909,134162,-,-
BAC56_C21,5,5p13.3,30151751,30251353,99602,-,-
BAC36_L11,5,5p13.3,30496719,30597989,101270,-,-
BAC51_C18,5,5p13.3,30563702,30678334,114632,-,-
BAC195_F21,5,5p13.3,30787760,30885814,98054,-,-
BAC82_F17,5,5p13.3,30985087,31096273,111186,-,-
BAC243_J22,5,5p13.3,31004920,31154644,149724,-,-
BAC104_A19,5,5p13.3,31029273,31134016,104743,-,-
BAC132_P22,5,5p13.3,31029287,31144175,114888,-,-
BAC218_G05,5,5p13.3,31100022,31188765,88743,-,-
BAC128_K11,5,5p13.3,31210097,31335889,125792,-,-
BAC70_B08,5,5p13.3,31292093,31379313,87220,-,-
BAC252_E24,5,5p13.3,31404843,31521757,116914,-,-
BAC151_K13,5,5p13.3,31415454,31521499,106045,-,-
BAC132_B11,5,5p13.3,31508558,31745349,236791,-,-
BAC141_D13,5,5p13.3,31514281,31594407,80126,-,-
BAC73_I20,5,5p13.3,31521800,31618572,96772,-,-
BAC29_F06,5,5p13.3,31594400,31748841,154441,-,-
BAC83_J22,5,5p13.3,31647043,31662625,15582,-,-
BAC190_D06,5,5p13.3,31647045,31752203,105158,-,-
BAC243_G02,5,5p13.3,31662619,31748924,86305,-,-
BAC100_E07,5,5p13.3,31773862,31883984,110122,-,-
BAC232_C15,5,5p13.3,31775809,31860548,84739,-,-
BAC187_K01,5,5p13.3,31843817,31951448,107631,-,-
BAC23_D10,5,5p13.3,31843819,31995544,151725,-,-
BAC235_B07,5,5p13.3,31846864,31951448,104584,-,-
BAC21_M02,5,5p13.3,31860615,31947276,86661,-,-
BAC160_K15,5,5p13.3,31864026,31951447,87421,-,-
BAC36_J03,5,5p13.3,31996583,32144120,147537,-,-
BAC246_F24,5,5p13.3,32024605,32103742,79137,-,-
BAC228_D15,5,5p13.3,32057614,32144103,86489,-,-
BAC22_F04,5,5p13.3,32066090,32208914,142824,-,-
BAC234_C22,5,5p13.3,32091181,32182884,91703,-,-
BAC142_C03,5,5p13.3,32095319,32200077,104758,-,-
BAC45_I04,5,5p13.3,32202872,32295363,92491,-,-
BAC130_B18,5,5p13.3,32221943,32320824,98881,-,-
BAC218_J18,5,5p13.3,32355526,32452130,96604,-,-
BAC218_D20,5,5p13.3,32471224,32575833,104609,-,-
BAC62_G11,5,5p13.3,32482543,32575831,93288,-,-
BAC141_G21,5,5p13.3,32486913,32576652,89739,-,-
BAC224_J19,5,5p13.3,32497484,32576652,79168,-,-
BAC171_K09,5,5p13.3,32498943,32588475,89532,-,-
BAC141_F05,5,5p13.3,32510300,32593735,83435,-,-
BAC38_G02,5,5p13.3,32510394,32621151,110757,-,-
BAC45_F14,5,5p13.3,32593773,32711819,118046,-,-
BAC65_O20,5,5p13.3,32626476,32708715,82239,-,-
BAC232_H03,5,5p13.3,32626649,32711855,85206,-,-
BAC8_G17,5,5p13.3,32664018,32775028,111010,-,-
BAC213_B19,5,5p13.3,32664044,32751988,87944,-,-
BAC24_N14,5,5p13.3,32746296,32893481,147185,-,-
BAC67_K16,5,5p13.3,32808053,32899331,91278,-,-
BAC199_B20,5,5p13.3,32944317,33050023,105706,-,-
BAC55_C20,5,5p13.3,32957947,33050021,92074,-,-
BAC220_L13,5,5p13.3,32995996,33088150,92154,-,-
BAC220_H07,5,5p13.3,33204905,33288754,83849,-,-
BAC180_P06,5,5p13.3,33207180,33288759,81579,-,-
BAC224_J22,5,5p13.3,33514461,33652189,137728,-,-
BAC18_G16,5,5p13.3,33526310,33673349,147039,-,-
BAC69_D15,5,5p13.3,33537590,33647027,109437,-,-
BAC250_N09,5,5p13.3,33553786,33686027,132241,-,-
BAC15_G18,5,5p13.3,33553879,33640663,86784,-,-
BAC161_M06,5,5p13.3,33590017,33673603,83586,-,-
BAC57_I08,5,5p13.3,33661288,33761392,100104,-,-
BAC148_P10,5,5p13.3,33686305,33785169,98864,-,-
BAC158_D22,5,5p13.3,33697503,33789019,91516,-,-
BAC39_J17,5,5p13.3,33708324,33848368,140044,-,-
BAC167_J24,5,5p13.3,33756747,33822262,65515,-,-
BAC198_J19,5,5p13.3,33767308,33868161,100853,-,-
BAC67_B11,5,5p13.3,33957400,34054062,96662,-,-
BAC127_J03,5,5p13.3,34036102,34123882,87780,-,-
BAC247_L23,5,5p13.3,34058736,34139814,81078,-,-
BAC92_C23,5,5p13.3,34069829,34163314,93485,-,-
BAC42_M01,5,5p13.3,34081987,34198558,116571,-,-
BAC199_P14,5,5p13.3,34203189,34219980,16791,-,-
BAC195_L22,5,5p13.3,34219975,34267503,47528,-,-
BAC55_C22,5,5p13.3,34219975,34286103,66128,-,-
BAC26_J09,5,5p13.3,34219975,34365934,145959,-,-
BAC65_N05,5,5p13.3-5p13.2,34302713,34444302,141589,-,-
BAC135_F14,5,5p13.3-5p13.2,34365960,34473666,107706,-,-
BAC150_K23,5,5p13.2,34419122,34514506,95384,-,-
BAC32_M08,5,5p13.2,34448998,34610482,161484,-,-
BAC234_D17,5,5p13.2,34511052,34610586,99534,-,-
BAC251_L01,5,5p13.2,34511248,34610615,99367,-,-
BAC250_O10,5,5p13.2,34516079,34606100,90021,-,-
BAC233_J07,5,5p13.2,34516752,34610617,93865,-,-
BAC227_K24,5,5p13.2,34636794,34729633,92839,-,-
BAC242_I03,5,5p13.2,34638611,34739597,100986,-,-
BAC31_L24,5,5p13.2,34669318,34760829,91511,-,-
BAC80_J18,5,5p13.2,34716201,34828919,112718,-,-
BAC122_A24,5,5p13.2,34724082,34839773,115691,-,-
BAC131_O07,5,5p13.2,34726038,34825847,99809,-,-
BAC105_K13,5,5p13.2,34771356,34864057,92701,-,-
BAC246_F18,5,5p13.2,34785535,34888280,102745,-,-
BAC54_D02,5,5p13.2,34817274,35028015,210741,-,-
BAC183_A04,5,5p13.2,34879353,34987080,107727,-,-
BAC137_P02,5,5p13.2,34883514,34980355,96841,-,-
BAC155_D07,5,5p13.2,34888321,35005918,117597,-,-
BAC1_L14,5,5p13.2,35072829,35178737,105908,-,-
BAC62_I07,5,5p13.2,35171896,35272868,100972,-,-
BAC108_F23,5,5p13.2,35354022,35454138,100116,-,-
BAC19_B01,5,5p13.2,35411402,35500922,89520,-,-
BAC148_F10,5,5p13.2,35454146,35531988,77842,-,-
BAC179_M20,5,5p13.2,35459142,35540871,81729,-,-
BAC63_C12,5,5p13.2,35479680,35557269,77589,-,-
BAC17_H04,5,5p13.2,35761312,35892453,131141,-,-
BAC205_B12,5,5p13.2,35858657,35965569,106912,-,-
BAC162_C22,5,5p13.2,35870801,35985062,114261,-,-
BAC196_E14,5,5p13.2,35953746,36051642,97896,-,-
BAC145_D20,5,5p13.2,35957696,36051633,93937,-,-
BAC84_L06,5,5p13.2,36046983,36198722,151739,-,-
BAC109_H04,5,5p13.2,36099985,36202131,102146,-,-
BAC143_F09,5,5p13.2,36123577,36204485,80908,-,-
BAC84_O05,5,5p13.2,36224880,36305159,80279,-,-
BAC63_A06,5,5p13.2,36377359,36495562,118203,-,-
BAC230_O18,5,5p13.2,36453781,36544651,90870,-,-
BAC91_M24,5,5p13.2,36466586,36560428,93842,-,-
BAC148_M05,5,5p13.2,36484857,36563264,78407,-,-
BAC79_O10,5,5p13.2,36571268,36664234,92966,-,-
BAC186_E11,5,5p13.2,36573255,36649031,75776,-,-
BAC229_O06,5,5p13.2,36709429,36819310,109881,-,-
BAC137_N02,5,5p13.2,36748638,36845971,97333,-,-
BAC242_C13,5,5p13.2,36765931,36847325,81394,-,-
BAC125_M15,5,5p13.2,36793618,36884512,90894,-,-
BAC153_D19,5,5p13.2,36802987,36898693,95706,-,-
BAC116_L23,5,5p13.2,37003985,37136722,132737,-,-
BAC230_L08,5,5p13.2,37071450,37156064,84614,-,-
BAC113_N07,5,5p13.2,37072409,37186370,113961,-,-
BAC219_F04,5,5p13.2,37106944,37213211,106267,-,-
BAC181_N06,5,5p13.2,37106944,37190933,83989,-,-
BAC1_J11,5,5p13.2,37111606,37231683,120077,-,-
BAC83_M16,5,5p13.2,37213210,37328707,115497,-,-
BAC36_O15,5,5p13.2,37245745,37368813,123068,-,-
BAC220_G14,5,5p13.2,37245974,37322635,76661,-,-
BAC241_F06,5,5p13.2,37254299,37342259,87960,-,-
BAC53_F17,5,5p13.2,37297012,37446598,149586,-,-
BAC238_N09,5,5p13.2,37317405,37411804,94399,-,-
BAC32_B04,5,5p13.2,37346222,37441580,95358,-,-
BAC240_G19,5,5p13.2,37407975,37522816,114841,-,-
BAC173_L23,5,5p13.2,37446592,37545648,99056,-,-
BAC152_N20,5,5p13.2,37643919,37738780,94861,-,-
BAC97_O13,5,5p13.2,37685432,37774397,88965,-,-
BAC72_M02,5,5p13.2,37792284,37909935,117651,-,-
BAC161_K04,5,5p13.2,37865974,37962931,96957,-,-
BAC192_G18,5,5p13.2,37984067,38079197,95130,-,-
BAC152_M06,5,5p13.2,37984067,38086008,101941,-,-
BAC146_L15,5,5p13.2,38010882,38093671,82789,-,-
BAC143_N10,5,5p13.2,38010882,38090254,79372,-,-
BAC168_F10,5,5p13.2,38106487,38179500,73013,-,-
BAC54_M06,5,5p13.2,38161870,38273242,111372,-,-
BAC128_E22,5,5p13.2,38216032,38306395,90363,-,-
BAC220_I04,5,5p13.2,38356504,38434571,78067,-,-
BAC83_I07,5,5p13.2-5p13.1,38397781,38528101,130320,-,-
BAC55_L24,5,5p13.2-5p13.1,38403985,38527847,123862,-,-
BAC244_P14,5,5p13.2-5p13.1,38416145,38550424,134279,-,-
BAC242_N02,5,5p13.2-5p13.1,38466155,38550424,84269,-,-
BAC103_K15,5,5p13.2-5p13.1,38484251,38574649,90398,-,-
BAC132_F14,5,5p13.1,38578194,38670745,92551,-,-
BAC73_A04,5,5p13.1,38616679,38745420,128741,-,-
BAC36_N14,5,5p13.1,38739588,38839185,99597,-,-
BAC76_E14,5,5p13.1,38784048,38883191,99143,-,-
BAC155_B23,5,5p13.1,38828202,38929404,101202,-,-
BAC75_D02,5,5p13.1,38875592,38972540,96948,-,-
BAC95_K19,5,5p13.1,38945487,39052028,106541,-,-
BAC116_C07,5,5p13.1,39000297,39106951,106654,-,-
BAC182_B12,5,5p13.1,39066501,39159383,92882,-,-
BAC36_F18,5,5p13.1,39148476,39248881,100405,-,-
BAC86_M24,5,5p13.1,39159377,39323778,164401,-,-
BAC189_F16,5,5p13.1,39159377,39260776,101399,-,-
BAC83_D08,5,5p13.1,39171329,39260777,89448,-,-
BAC241_H11,5,5p13.1,39395569,39489655,94086,-,-
BAC140_G03,5,5p13.1,39542296,39646033,103737,-,-
BAC144_G14,5,5p13.1,39542296,39643815,101519,-,-
BAC152_F17,5,5p13.1,39678494,39770632,92138,-,-
BAC246_F04,5,5p13.1,39692429,39773875,81446,-,-
BAC152_N04,5,5p13.1,39773985,39876336,102351,-,-
BAC88_L23,5,5p13.1,40007815,40148580,140765,-,-
BAC69_O04,5,5p13.1,40046425,40127373,80948,-,-
BAC184_D09,5,5p13.1,40046434,40062045,15611,-,-
BAC74_E03,5,5p13.1,40162056,40239756,77700,-,-
BAC16_L22,5,5p13.1,40262531,40373118,110587,-,-
BAC246_D24,5,5p13.1,40391292,40476324,85032,-,-
BAC124_I10,5,5p13.1,40442039,40584255,142216,-,-
BAC195_A14,5,5p13.1,40553965,40654907,100942,-,-
BAC30_C01,5,5p13.1,40724571,40871085,146514,-,-
BAC211_M14,5,5p13.1,40771391,40855136,83745,-,-
BAC244_N20,5,5p13.1,40777246,40889788,112542,-,-
BAC203_H10,5,5p13.1,40788195,40859328,71133,-,-
BAC161_I07,5,5p13.1,40800026,40879625,79599,-,-
BAC67_A07,5,5p13.1,40844563,40922632,78069,-,-
BAC234_F03,5,5p13.1,40845734,40922623,76889,-,-
BAC27_E21,5,5p13.1,40889798,41022960,133162,-,-
BAC144_L06,5,5p13.1,40907431,40985908,78477,-,-
BAC204_M20,5,5p13.1,40931675,41036791,105116,-,-
BAC120_I02,5,5p13.1,40940267,41022971,82704,-,-
BAC240_J09,5,5p13.1,40960288,41065555,105267,-,-
BAC139_H08,5,5p13.1,40960291,41040976,80685,-,-
BAC197_E22,5,5p13.1,40964444,41049509,85065,-,-
BAC190_F11,5,5p13.1,40969922,41040976,71054,-,-
BAC94_E11,5,5p13.1,41041285,41128356,87071,-,-
BAC182_P15,5,5p13.1,41085702,41156125,70423,-,-
BAC246_J11,5,5p13.1,41095554,41185928,90374,-,-
BAC230_O24,5,5p13.1,41248039,41326181,78142,-,-
BAC196_C10,5,5p13.1,41254619,41366598,111979,-,-
BAC144_M11,5,5p13.1,41254619,41384384,129765,-,-
BAC51_D03,5,5p13.1,41286584,41429298,142714,-,-
BAC79_H01,5,5p13.1,41494102,41587642,93540,-,-
BAC43_F20,5,5p13.1,41541102,41653137,112035,-,-
BAC25_E11,5,5p13.1,41832447,41932722,100275,-,-
BAC230_K15,5,5p13.1,41859995,41936294,76299,-,-
BAC56_F04,5,5p13.1,41906644,41984716,78072,-,-
BAC106_M03,5,5p13.1,41977667,42071368,93701,-,-
BAC113_I16,5,5p13.1,42024667,42098732,74065,-,-
BAC150_C22,5,5p13.1,42073343,42153904,80561,-,-
BAC199_H12,5,5p13.1,42226371,42312110,85739,-,-
BAC192_J14,5,5p12,42458581,42545341,86760,-,-
BAC60_I08,5,5p12,42480202,42675742,195540,-,-
BAC168_N09,5,5p12,42657289,42737464,80175,-,-
BAC104_H24,5,5p12,42791173,42941482,150309,-,-
BAC75_J05,5,5p12,42902468,42915074,12606,-,-
BAC233_J20,5,5p12,42941476,43012373,70897,-,-
BAC34_P01,5,5p12,42984914,43059655,74741,-,-
BAC188_B19,5,5p12,43159549,43281875,122326,-,-
BAC71_G01,5,5p12,43180814,43267013,86199,-,-
BAC42_I02,5,5p12,43363526,43521648,158122,-,-
BAC170_G20,5,5p12,43409823,43521648,111825,-,-
BAC249_L09,5,5p12,43415365,43501826,86461,-,-
BAC180_P14,5,5p12,43415365,43501826,86461,-,-
BAC81_B15,5,5p12,43423502,43521648,98146,-,-
BAC27_C14,5,5p12,43442145,43553715,111570,-,-
BAC66_N05,5,5p12,43477091,43573068,95977,-,-
BAC30_M14,5,5p12,43528548,43618028,89480,-,-
BAC241_P03,5,5p12,43536590,43627097,90507,-,-
BAC137_C20,5,5p12,43673272,43760596,87324,-,-
BAC123_K13,5,5p12,44001655,44104716,103061,-,-
BAC144_K22,5,5p12,44104876,44197440,92564,-,-
BAC179_A22,5,5p12,44299627,44361880,62253,-,-
BAC69_A02,5,5p12,44338589,44428152,89563,-,-
BAC103_A15,5,5p12,44353873,44444884,91011,-,-
BAC146_O19,5,5p12,44389372,44464307,74935,-,-
BAC6_F05,5,5p12,44616547,44746703,130156,-,-
BAC70_O06,5,5p12,44638278,44727448,89170,-,-
BAC226_H03,5,5p12,44650743,44794555,143812,-,-
BAC88_N13,5,5p12,44876659,44981650,104991,-,-
BAC136_D17,5,5p12,45063276,45161284,98008,-,-
BAC246_J01,5,5p12,45152474,45229068,76594,-,-
BAC38_E14,5,5p12,45225206,45329656,104450,-,-
BAC63_O20,5,5p12-5p11,45783188,45895295,112107,-,-
BAC123_B24,5,5q11.1,49451665,49467858,16193,-,-
BAC189_H20,5,5q11.1,49767255,49869431,102176,-,-
BAC117_L20,5,5q11.1,49768973,49868439,99466,-,-
BAC222_D10,5,5q11.1,50036577,50093100,56523,-,-
BAC160_O19,5,5q11.1,50148664,50286623,137959,-,-
BAC125_K20,5,5q11.1,50217112,50327044,109932,-,-
BAC235_J02,5,5q11.1,50426020,50499715,73695,-,-
BAC37_A09,5,5q11.1-5q11.2,50426042,50506962,80920,-,-
BAC184_J12,5,5q11.2,50523806,50595215,71409,-,-
BAC145_D23,5,5q11.2,50616778,50710533,93755,-,-
BAC211_E14,5,5q11.2,50625690,50713714,88024,-,-
BAC19_P05,5,5q11.2,50660913,50771686,110773,-,-
BAC84_D15,5,5q11.2,50676168,50786595,110427,-,-
BAC148_P13,5,5q11.2,50704427,50789157,84730,-,-
BAC21_E24,5,5q11.2,50791320,50898485,107165,-,-
BAC137_L22,5,5q11.2,50960851,51064729,103878,-,-
BAC50_B24,5,5q11.2,51014470,51089460,74990,-,-
BAC22_C19,5,5q11.2,51040630,51124374,83744,-,-
BAC60_O24,5,5q11.2,51048542,51162039,113497,-,-
BAC88_C15,5,5q11.2,51181704,51274173,92469,-,-
BAC44_N02,5,5q11.2,51224381,51304564,80183,-,-
BAC10_I18,5,5q11.2,51235224,51273034,37810,-,-
BAC32_B15,5,5q11.2,51287165,51376167,89002,-,-
BAC184_C01,5,5q11.2,51330503,51416213,85710,-,-
BAC190_L14,5,5q11.2,51333311,51414289,80978,-,-
BAC68_E07,5,5q11.2,51379414,51495649,116235,-,-
BAC157_A02,5,5q11.2,51750601,51831681,81080,-,-
BAC175_J03,5,5q11.2,52030717,52143956,113239,-,-
BAC29_G23,5,5q11.2,52037248,52148998,111750,-,-
BAC172_C14,5,5q11.2,52306996,52424858,117862,-,-
BAC199_B12,5,5q11.2,52307021,52384055,77034,-,-
BAC25_O21,5,5q11.2,52439321,52531943,92622,-,-
BAC97_K20,5,5q11.2,52455161,52541656,86495,-,-
BAC240_I19,5,5q11.2,52502371,52577984,75613,-,-
BAC12_C17,5,5q11.2,52684198,52786105,101907,-,-
BAC246_P10,5,5q11.2,52754706,52839747,85041,-,-
BAC46_J13,5,5q11.2,52813468,52927854,114386,-,-
BAC241_D14,5,5q11.2,52882795,52990098,107303,-,-
BAC42_H23,5,5q11.2,52915618,53023679,108061,-,-
BAC33_C06,5,5q11.2,52996789,53110885,114096,-,-
BAC57_D21,5,5q11.2,53029174,53110885,81711,-,-
BAC57_D22,5,5q11.2,53029228,53110885,81657,-,-
BAC241_G02,5,5q11.2,53111147,53193093,81946,-,-
BAC233_M17,5,5q11.2,53131726,53276670,144944,-,-
BAC40_D03,5,5q11.2,53153508,53346112,192604,-,-
BAC54_J22,5,5q11.2,53264647,53352922,88275,-,-
BAC239_O13,5,5q11.2,53449382,53520687,71305,-,-
BAC2_O02,5,5q11.2,53469479,53577985,108506,-,-
BAC122_E07,5,5q11.2,53598464,53743239,144775,-,-
BAC161_I16,5,5q11.2,53673929,53811028,137099,-,-
BAC148_B15,5,5q11.2,53735732,53811044,75312,-,-
BAC183_G24,5,5q11.2,53790902,53898107,107205,-,-
BAC144_I09,5,5q11.2,53792932,53894575,101643,-,-
BAC122_B04,5,5q11.2,53832558,53923148,90590,-,-
BAC45_E02,5,5q11.2,53878643,54015844,137201,-,-
BAC187_M08,5,5q11.2,53914889,53999202,84313,-,-
BAC51_G22,5,5q11.2,53969724,54126517,156793,-,-
BAC219_E05,5,5q11.2,54039756,54128206,88450,-,-
BAC31_E24,5,5q11.2,54062604,54172503,109899,-,-
BAC69_L03,5,5q11.2,54238646,54353906,115260,-,-
BAC11_H08,5,5q11.2,54238695,54345781,107086,-,-
BAC117_D12,5,5q11.2,54307638,54438237,130599,-,-
BAC169_P02,5,5q11.2,54345786,54424942,79156,-,-
BAC101_N05,5,5q11.2,54354172,54487723,133551,yes,-
BAC179_I06,5,5q11.2,54358145,54470317,112172,yes,-
BAC153_G20,5,5q11.2,54420828,54504890,84062,yes,-
BAC194_F10,5,5q11.2,54465209,54555362,90153,-,-
BAC199_L23,5,5q11.2,54470662,54567120,96458,-,-
BAC116_N12,5,5q11.2,54470666,54600000,129334,-,-
BAC39_B02,5,5q11.2,54492982,54600302,107320,-,-
BAC84_H15,5,5q11.2,54562463,54678871,116408,-,-
BAC96_D17,5,5q11.2,54589491,54680770,91279,-,-
BAC64_I18,5,5q11.2,54589491,54678875,89384,-,-
BAC171_N04,5,5q11.2,54633826,54695845,62019,-,-
BAC34_A12,5,5q11.2,54681069,54794231,113162,-,-
BAC95_I19,5,5q11.2,54746206,54921498,175292,-,-
BAC84_O16,5,5q11.2,54846236,54971167,124931,-,-
BAC148_C22,5,5q11.2,54961293,55051562,90269,-,-
BAC56_G18,5,5q11.2,54961305,55056353,95048,-,-
BAC186_D06,5,5q11.2,54961316,55056702,95386,-,-
BAC58_H15,5,5q11.2,54967783,55069332,101549,-,-
BAC78_M14,5,5q11.2,54971160,55100365,129205,-,-
BAC148_G02,5,5q11.2,54971161,55051564,80403,-,-
BAC83_O08,5,5q11.2,55120739,55221322,100583,-,-
BAC224_H16,5,5q11.2,55132841,55237995,105154,-,-
BAC218_O22,5,5q11.2,55156597,55234489,77892,-,-
BAC195_E06,5,5q11.2,55400041,55507165,107124,-,-
BAC180_K12,5,5q11.2,55425426,55507542,82116,-,-
BAC148_A22,5,5q11.2,55425750,55507613,81863,-,-
BAC153_P11,5,5q11.2,55446083,55554299,108216,-,-
BAC244_K02,5,5q11.2,55455458,55551411,95953,-,-
BAC237_B09,5,5q11.2,55456413,55551405,94992,-,-
BAC149_I06,5,5q11.2,55456413,55551411,94998,-,-
BAC52_C09,5,5q11.2,55456413,55551411,94998,-,-
BAC39_A23,5,5q11.2,55456430,55551411,94981,-,-
BAC21_A24,5,5q11.2,55470548,55551411,80863,-,-
BAC9_E24,5,5q11.2,55507330,55623139,115809,-,-
BAC211_M06,5,5q11.2,55507637,55596455,88818,-,-
BAC195_O08,5,5q11.2,55554293,55619683,65390,-,-
BAC193_J07,5,5q11.2,55554293,55647562,93269,-,-
BAC222_I01,5,5q11.2,55554409,55642132,87723,-,-
BAC41_C04,5,5q11.2,55642166,55735143,92977,-,-
BAC56_D18,5,5q11.2,55671958,55752981,81023,-,-
BAC185_O16,5,5q11.2,55750345,55833786,83441,-,-
BAC81_B03,5,5q11.2,55764932,55851024,86092,-,-
BAC232_G05,5,5q11.2,55836198,55936112,99914,-,-
BAC171_A01,5,5q11.2,55922904,56025866,102962,-,-
BAC58_P04,5,5q11.2,56002197,56110268,108071,-,-
BAC208_A16,5,5q11.2,56026164,56100200,74036,-,-
BAC104_D09,5,5q11.2,56051018,56153105,102087,-,-
BAC37_J07,5,5q11.2,56110479,56207261,96782,-,-
BAC170_D13,5,5q11.2,56112696,56205588,92892,-,-
BAC29_M01,5,5q11.2,56242653,56378998,136345,-,-
BAC31_K21,5,5q11.2,56337502,56532350,194848,-,-
BAC5_J02,5,5q11.2,56337502,56493588,156086,-,-
BAC18_C18,5,5q11.2,56337502,56418907,81405,-,-
BAC238_B23,5,5q11.2,56379418,56532350,152932,-,-
BAC135_P04,5,5q11.2,56385815,56495135,109320,-,-
BAC89_P07,5,5q11.2,56386507,56525156,138649,-,-
BAC86_O04,5,5q11.2,56386507,56493520,107013,-,-
BAC148_C20,5,5q11.2,56394724,56487252,92528,-,-
BAC126_J20,5,5q11.2,56495129,56584712,89583,-,-
BAC126_B23,5,5q11.2,56495129,56584712,89583,-,-
BAC56_K10,5,5q11.2,56525221,56635377,110156,-,-
BAC18_F13,5,5q11.2,56582180,56672455,90275,-,-
BAC226_L16,5,5q11.2,56592340,56690865,98525,-,-
BAC193_B10,5,5q11.2,56667733,56773716,105983,-,-
BAC103_E13,5,5q11.2,56697200,56785247,88047,-,-
BAC146_H16,5,5q11.2,56737214,56826352,89138,-,-
BAC244_F03,5,5q11.2,56751115,56883588,132473,-,-
BAC95_K05,5,5q11.2,56826808,56928146,101338,-,-
BAC249_A03,5,5q11.2,56836182,56921254,85072,-,-
BAC75_P22,5,5q11.2,56913217,56930835,17618,-,-
BAC52_I08,5,5q11.2,56928148,57028895,100747,-,-
BAC27_E17,5,5q11.2,56958912,57071778,112866,-,-
BAC53_B08,5,5q11.2,57036704,57148713,112009,-,-
BAC56_D21,5,5q11.2,57056800,57137018,80218,-,-
BAC218_O09,5,5q11.2,57072516,57148713,76197,-,-
BAC125_N21,5,5q11.2,57076811,57187671,110860,-,-
BAC105_O05,5,5q11.2,57076811,57155741,78930,-,-
BAC148_I18,5,5q11.2,57137044,57255793,118749,-,-
BAC36_O06,5,5q11.2,57148711,57287603,138892,-,-
BAC240_D22,5,5q11.2,57167500,57269677,102177,-,-
BAC244_N05,5,5q11.2,57255782,57356676,100894,-,-
BAC228_E04,5,5q11.2,57287693,57376122,88429,-,-
BAC171_K15,5,5q11.2,57479598,57593962,114364,-,-
BAC246_G07,5,5q11.2,57571128,57658710,87582,-,-
BAC50_G18,5,5q11.2,57603213,57714966,111753,-,-
BAC48_F16,5,5q11.2,57674627,57773814,99187,-,-
BAC233_K17,5,5q11.2,57788136,57878985,90849,-,-
BAC22_F15,5,5q11.2,57924506,58100229,175723,-,-
BAC96_C06,5,5q11.2,58173110,58278842,105732,-,-
BAC187_M16,5,5q11.2,58436349,58512796,76447,-,-
BAC235_B01,5,5q11.2,58446085,58520607,74522,-,-
BAC63_A23,5,5q11.2,58491501,58630689,139188,-,-
BAC156_E24,5,5q11.2,58505228,58611348,106120,-,-
BAC108_P18,5,5q11.2,58519733,58608906,89173,-,-
BAC121_C05,5,5q11.2,58520598,58643438,122840,-,-
BAC84_I20,5,5q11.2,58544178,58626708,82530,-,-
BAC192_I24,5,5q11.2,58570788,58643693,72905,-,-
BAC77_H10,5,5q11.2,58611457,58710300,98843,-,-
BAC59_L12,5,5q11.2,58704745,58837414,132669,-,-
BAC117_F17,5,5q11.2,58769584,58858802,89218,-,-
BAC143_J10,5,5q11.2,58773374,58858372,84998,-,-
BAC240_N18,5,5q11.2,58773376,58859817,86441,-,-
BAC127_D21,5,5q11.2-5q12.1,58805570,58920504,114934,-,-
BAC26_N09,5,5q11.2-5q12.1,58817610,58909782,92172,-,-
BAC67_I19,5,5q11.2-5q12.1,58844869,58943655,98786,-,-
BAC202_C02,5,5q12.1,59002978,59090644,87666,-,-
BAC239_E10,5,5q12.1,59059018,59152479,93461,-,-
BAC200_A10,5,5q12.1,59065347,59154682,89335,-,-
BAC240_P17,5,5q12.1,59197167,59282353,85186,-,-
BAC182_L04,5,5q12.1,59197167,59273980,76813,-,-
BAC194_P21,5,5q12.1,59209103,59329475,120372,-,-
BAC116_N03,5,5q12.1,59313460,59415903,102443,-,-
BAC140_I17,5,5q12.1,59317059,59400001,82942,-,-
BAC109_E17,5,5q12.1,59606697,59689283,82586,-,-
BAC110_B14,5,5q12.1,59626458,59712934,86476,-,-
BAC24_N19,5,5q12.1,59626462,59735745,109283,-,-
BAC239_P10,5,5q12.1,59760396,59842538,82142,-,-
BAC24_I11,5,5q12.1,59846341,59943610,97269,-,-
BAC128_C11,5,5q12.1,59929668,60035804,106136,-,-
BAC144_P08,5,5q12.1,59934915,60030975,96060,-,-
BAC136_F15,5,5q12.1,60060958,60226368,165410,-,-
BAC196_B04,5,5q12.1,60111074,60202486,91412,-,-
BAC237_D11,5,5q12.1,60119091,60203908,84817,-,-
BAC90_D05,5,5q12.1,60215717,60344862,129145,-,-
BAC16_K15,5,5q12.1,60232402,60348058,115656,-,-
BAC149_J03,5,5q12.1,60246845,60301302,54457,-,-
BAC156_L13,5,5q12.1,60383908,60433576,49668,-,-
BAC243_D21,5,5q12.1,60391550,60477763,86213,-,-
BAC110_K14,5,5q12.1,60463767,60566562,102795,-,-
BAC237_E24,5,5q12.1,60490784,60577419,86635,-,-
BAC86_O19,5,5q12.1,60616927,60739411,122484,-,-
BAC145_A07,5,5q12.1,60635782,60736176,100394,-,-
BAC109_C16,5,5q12.1,60643701,60767074,123373,-,-
BAC161_A15,5,5q12.1,60649035,60733398,84363,-,-
BAC42_L07,5,5q12.1,60687149,60767144,79995,-,-
BAC124_L04,5,5q12.1,60700738,60794257,93519,-,-
BAC141_I08,5,5q12.1,60733393,60834688,101295,-,-
BAC193_H20,5,5q12.1,60781317,60871060,89743,-,-
BAC168_A14,5,5q12.1,60786992,60879461,92469,-,-
BAC168_F14,5,5q12.1,60879454,60971783,92329,-,-
BAC203_L15,5,5q12.1,61001885,61099229,97344,-,-
BAC149_A13,5,5q12.1,61011718,61108171,96453,-,-
BAC134_K19,5,5q12.1,61037847,61119567,81720,-,-
BAC18_D04,5,5q12.1,61135316,61230631,95315,-,-
BAC220_B21,5,5q12.1,61163415,61239533,76118,-,-
BAC69_O02,5,5q12.1,61184080,61265984,81904,-,-
BAC176_A20,5,5q12.1,61361444,61458807,97363,-,-
BAC195_O01,5,5q12.1,61367502,61478655,111153,-,-
BAC233_F20,5,5q12.1,61404709,61502463,97754,-,-
BAC35_D16,5,5q12.1,61449298,61537125,87827,-,-
BAC242_D17,5,5q12.1,61453995,61537263,83268,-,-
BAC67_B10,5,5q12.1,61518283,61611546,93263,-,-
BAC224_B20,5,5q12.1,61615458,61697679,82221,-,-
BAC56_G23,5,5q12.1,61687650,61790971,103321,-,-
BAC71_C21,5,5q12.1,61801911,61904105,102194,-,-
BAC57_M14,5,5q12.1,61823436,61916845,93409,-,-
BAC96_K05,5,5q12.1,61841181,61920840,79659,-,-
BAC21_H20,5,5q12.1,61938420,62039257,100837,-,-
BAC124_C05,5,5q12.1,61938424,62029941,91517,-,-
BAC95_C14,5,5q12.1,61939972,62033789,93817,-,-
BAC195_N01,5,5q12.1,61954502,62074561,120059,-,-
BAC65_H15,5,5q12.1,61955247,62077285,122038,-,-
BAC223_E17,5,5q12.1,61957108,62039257,82149,-,-
BAC189_P22,5,5q12.1,61959539,62084454,124915,-,-
BAC190_F18,5,5q12.1,61973081,62046190,73109,-,-
BAC153_E11,5,5q12.1,62074741,62147476,72735,-,-
BAC239_J07,5,5q12.1,62165910,62235758,69848,-,-
BAC14_F21,5,5q12.1,62221536,62374928,153392,-,-
BAC90_P23,5,5q12.1,62228920,62329298,100378,-,-
BAC160_M03,5,5q12.1,62295103,62374928,79825,-,-
BAC64_L21,5,5q12.1,62433211,62522497,89286,-,-
BAC90_N04,5,5q12.1,62522886,62633976,111090,-,-
BAC199_C12,5,5q12.1,62554561,62664632,110071,-,-
BAC43_M01,5,5q12.1,62618947,62754819,135872,-,-
BAC78_D14,5,5q12.1,62799883,62897956,98073,-,-
BAC173_N01,5,5q12.1-5q12.2,62985834,63064045,78211,-,-
BAC106_F10,5,5q12.2,63446028,63467491,21463,-,-
BAC82_H02,5,5q12.2-5q12.3,63579005,63706670,127665,-,-
BAC8_D12,5,5q12.3,63720158,63835459,115301,-,-
BAC144_I11,5,5q12.3,63737164,63813854,76690,-,-
BAC28_D12,5,5q12.3,63815366,63939610,124244,-,-
BAC248_B01,5,5q12.3,63864953,63939559,74606,-,-
BAC233_C02,5,5q12.3,63865290,63980481,115191,-,-
BAC124_C07,5,5q12.3,63989354,64089444,100090,-,-
BAC146_O10,5,5q12.3,64011245,64119444,108199,-,-
BAC140_C04,5,5q12.3,64015597,64106341,90744,-,-
BAC92_K18,5,5q12.3,64038507,64158938,120431,-,-
BAC252_F04,5,5q12.3,64212556,64333749,121193,-,-
BAC204_K20,5,5q12.3,64232610,64333525,100915,-,-
BAC20_N08,5,5q12.3,64334023,64446978,112955,-,-
BAC53_K21,5,5q12.3,64337641,64453095,115454,-,-
BAC124_C21,5,5q12.3,64348189,64454087,105898,-,-
BAC237_C24,5,5q12.3,64364828,64454087,89259,-,-
BAC25_L13,5,5q12.3,64435594,64517154,81560,-,-
BAC122_D13,5,5q12.3,64436325,64517979,81654,-,-
BAC154_L11,5,5q12.3,64517158,64611498,94340,-,-
BAC22_K06,5,5q12.3,64581673,64704576,122903,-,-
BAC105_N16,5,5q12.3,64586081,64695492,109411,-,-
BAC150_H09,5,5q12.3,64611507,64695492,83985,-,-
BAC103_N03,5,5q12.3,64682701,64767510,84809,-,-
BAC128_H11,5,5q12.3,64722021,64814171,92150,-,-
BAC86_L15,5,5q12.3,64767834,64884667,116833,-,-
BAC74_A11,5,5q12.3,64804874,64902662,97788,-,-
BAC175_H04,5,5q12.3,64814348,64902913,88565,-,-
BAC7_M16,5,5q12.3,64885028,64972151,87123,-,-
BAC175_K20,5,5q12.3,64908655,64996995,88340,-,-
BAC169_E20,5,5q12.3,64908655,64984538,75883,-,-
BAC72_B01,5,5q12.3,64943941,65052401,108460,-,-
BAC83_O13,5,5q12.3,65206398,65302829,96431,-,-
BAC4_P19,5,5q12.3,65330986,65423328,92342,-,-
BAC150_F08,5,5q12.3,65438876,65533868,94992,-,-
BAC122_G03,5,5q12.3,65441316,65550819,109503,-,-
BAC106_C20,5,5q12.3,65489919,65584755,94836,-,-
BAC124_K17,5,5q12.3,65521577,65643760,122183,-,-
BAC89_L17,5,5q12.3,65550856,65638338,87482,-,-
BAC83_K10,5,5q12.3,65553899,65644319,90420,-,-
BAC210_N13,5,5q12.3,65570701,65669787,99086,-,-
BAC38_J01,5,5q12.3,65596892,65686819,89927,-,-
BAC175_H05,5,5q12.3,65664492,65785213,120721,-,-
BAC175_K18,5,5q12.3,65740264,65816536,76272,-,-
BAC141_B22,5,5q12.3,65774909,65864734,89825,-,-
BAC83_N18,5,5q12.3,65774912,65897855,122943,-,-
BAC81_A02,5,5q12.3,65801722,65907692,105970,-,-
BAC81_A01,5,5q12.3,65801722,65907692,105970,-,-
BAC217_H19,5,5q12.3,65934826,66037261,102435,-,-
BAC28_H19,5,5q12.3,66106827,66205703,98876,-,-
BAC160_A15,5,5q12.3,66110037,66205702,95665,-,-
BAC241_A13,5,5q12.3,66124719,66228820,104101,-,-
BAC40_G06,5,5q12.3,66205719,66296386,90667,-,-
BAC132_M21,5,5q12.3,66220632,66368721,148089,-,-
BAC159_C12,5,5q12.3,66284424,66368721,84297,-,-
BAC249_N13,5,5q12.3,66366180,66452002,85822,-,-
BAC133_N10,5,5q12.3-5q13.1,66490937,66592981,102044,-,-
BAC92_G18,5,5q12.3-5q13.1,66499818,66596197,96379,-,-
BAC97_G11,5,5q13.1,66545178,66654305,109127,-,-
BAC171_G18,5,5q13.1,66589403,66670302,80899,-,-
BAC190_I16,5,5q13.1,66598645,66690819,92174,-,-
BAC175_L12,5,5q13.1,66598645,66705823,107178,-,-
BAC158_P04,5,5q13.1,66600612,66714531,113919,-,-
BAC84_K12,5,5q13.1,66696152,66796702,100550,-,-
BAC60_O23,5,5q13.1,66743975,66848916,104941,-,-
BAC34_O16,5,5q13.1,66781150,66895165,114015,-,-
BAC118_H13,5,5q13.1,66781154,66891267,110113,-,-
BAC199_O22,5,5q13.1,66825725,66921416,95691,-,-
BAC144_D14,5,5q13.1,66884731,66975308,90577,-,-
BAC228_I12,5,5q13.1,66895159,66978517,83358,-,-
BAC41_I12,5,5q13.1,66938461,67083797,145336,-,-
BAC127_F08,5,5q13.1,67017752,67092913,75161,-,-
BAC67_A11,5,5q13.1,67024575,67144230,119655,-,-
BAC62_L15,5,5q13.1,67181379,67287245,105866,-,-
BAC2_A08,5,5q13.1,67270865,67346595,75730,-,-
BAC218_F10,5,5q13.1,67345818,67448267,102449,-,-
BAC124_C03,5,5q13.1,67346699,67455543,108844,-,-
BAC10_B07,5,5q13.1,67360903,67455537,94634,-,-
BAC148_F20,5,5q13.1,67370052,67482803,112751,-,-
BAC26_B12,5,5q13.1,67424707,67548181,123474,-,-
BAC139_H04,5,5q13.1,67448458,67548173,99715,-,-
BAC157_B03,5,5q13.1,67491252,67575452,84200,-,-
BAC66_C01,5,5q13.1,67503585,67601863,98278,-,-
BAC110_O10,5,5q13.1,67506768,67625583,118815,-,-
BAC139_M24,5,5q13.1,67562083,67642304,80221,-,-
BAC176_D10,5,5q13.1,67566459,67652658,86199,-,-
BAC43_B15,5,5q13.1,67630294,67746791,116497,-,-
BAC224_B12,5,5q13.1,67639212,67714169,74957,-,-
BAC175_J05,5,5q13.1,67681404,67767039,85635,-,-
BAC43_O13,5,5q13.1,67689765,67782090,92325,-,-
BAC8_L06,5,5q13.1,67772545,67871501,98956,-,-
BAC179_O24,5,5q13.1,67790711,67871516,80805,-,-
BAC59_F23,5,5q13.1,67816457,67897387,80930,-,-
BAC170_P08,5,5q13.1,67870961,67947517,76556,-,-
BAC22_G04,5,5q13.1,67892828,67982753,89925,-,-
BAC140_C21,5,5q13.1,67897401,67977864,80463,-,-
BAC8_P07,5,5q13.1,67965694,68082848,117154,-,-
BAC151_M16,5,5q13.1,67979939,68064107,84168,-,-
BAC153_N15,5,5q13.1,68079824,68175488,95664,-,-
BAC25_B23,5,5q13.1,68189852,68322534,132682,-,-
BAC31_M13,5,5q13.1-5q13.2,68362194,68446718,84524,-,-
BAC118_G18,5,5q13.1-5q13.2,68372422,68466207,93785,-,-
BAC78_L02,5,5q13.2,68426431,68521745,95314,-,-
BAC26_P12,5,5q13.2,68457968,68560969,103001,-,-
BAC51_H19,5,5q13.2,68559822,68681980,122158,yes,-
BAC37_L21,5,5q13.2,68560991,68674617,113626,yes,-
BAC56_H06,5,5q13.2,68585260,68674617,89357,-,-
BAC67_M12,5,5q13.2,68585272,68667011,81739,-,-
BAC213_N07,5,5q13.2,68616909,68689500,72591,-,-
BAC42_O13,5,5q13.2,68646517,68786207,139690,-,-
BAC51_L02,5,5q13.2,68752400,68840590,88190,-,-
BAC106_E02,5,5q13.2,68800578,69759748,959170,-,-
BAC168_P06,5,5q13.2,68928611,69035838,107227,-,-
BAC125_A03,5,5q13.2,68936659,69039995,103336,-,-
BAC123_M09,5,5q13.2,69026930,70744454,1717524,-,-
BAC160_D13,5,5q13.2,69190399,69252824,62425,-,-
BAC203_E11,5,5q13.2,69191862,69262503,70641,-,-
BAC237_I01,5,5q13.2,69388178,70386033,997855,-,-
BAC85_P06,5,5q13.2,69388226,70440794,1052568,-,-
BAC70_F01,5,5q13.2,69410620,70427722,1017102,-,-
BAC72_B02,5,5q13.2,69429314,70386033,956719,-,-
BAC56_C05,5,5q13.2,69434454,70427934,993480,-,-
BAC123_G07,5,5q13.2,70386460,70540795,154335,-,-
BAC58_J19,5,5q13.2,70699970,70834437,134467,-,-
BAC132_J04,5,5q13.2,70715871,70834437,118566,-,-
BAC209_O06,5,5q13.2,70830701,70920098,89397,-,-
BAC176_D04,5,5q13.2,70830701,70909075,78374,-,-
BAC48_C04,5,5q13.2,70830701,70911629,80928,-,-
BAC167_N04,5,5q13.2,70870160,70984673,114513,-,-
BAC161_J10,5,5q13.2,70908304,71026158,117854,-,-
BAC162_L19,5,5q13.2,70909069,71001093,92024,-,-
BAC155_P06,5,5q13.2,70920220,70990748,70528,-,-
BAC101_M10,5,5q13.2,70946524,71045054,98530,-,-
BAC159_C06,5,5q13.2,71109783,71191273,81490,-,-
BAC68_L16,5,5q13.2,71204995,71338666,133671,-,-
BAC19_N21,5,5q13.2,71208377,71347956,139579,-,-
BAC90_L12,5,5q13.2,71305622,71392943,87321,-,-
BAC244_H21,5,5q13.2,71357494,71428454,70960,-,-
BAC191_C01,5,5q13.2,71399225,71487349,88124,-,-
BAC135_G23,5,5q13.2,71407678,71491109,83431,-,-
BAC237_B02,5,5q13.2,71448934,71560365,111431,-,-
BAC180_E04,5,5q13.2,71487682,71548829,61147,-,-
BAC148_I11,5,5q13.2,71509604,71613874,104270,-,-
BAC247_K02,5,5q13.2,71591096,71697312,106216,-,-
BAC92_O02,5,5q13.2,71634421,71719963,85542,-,-
BAC154_D21,5,5q13.2,71682013,71773185,91172,-,-
BAC139_F10,5,5q13.2,71682013,71773179,91166,-,-
BAC55_L04,5,5q13.2,71742046,71859134,117088,-,-
BAC230_D03,5,5q13.2,71972009,72139986,167977,-,-
BAC124_B11,5,5q13.2,71990380,72077736,87356,-,-
BAC50_J03,5,5q13.2,72004372,72118516,114144,-,-
BAC192_L16,5,5q13.2,72174456,72234075,59619,-,-
BAC67_L19,5,5q13.2,72241672,72362783,121111,-,-
BAC197_I22,5,5q13.2,72245638,72354309,108671,-,-
BAC195_P03,5,5q13.2,72364461,72447483,83022,-,-
BAC246_F15,5,5q13.2,72393804,72492085,98281,-,-
BAC154_I09,5,5q13.2,72398897,72491626,92729,-,-
BAC223_D01,5,5q13.2,72398897,72469012,70115,-,-
BAC31_J14,5,5q13.2,72492082,72584858,92776,-,-
BAC219_H15,5,5q13.2,72507016,72637253,130237,-,-
BAC193_E09,5,5q13.2,72510774,72655230,144456,-,-
BAC180_N21,5,5q13.2,72561358,72655227,93869,-,-
BAC146_K16,5,5q13.2,72581899,72694390,112491,-,-
BAC41_D17,5,5q13.2,72592752,72710630,117878,-,-
BAC18_L05,5,5q13.2,72665017,72749733,84716,-,-
BAC192_P16,5,5q13.2,72665017,72749734,84717,-,-
BAC144_P21,5,5q13.2,72695378,72795892,100514,-,-
BAC224_H19,5,5q13.2,72725504,72811321,85817,-,-
BAC106_I02,5,5q13.2,72749758,72855278,105520,-,-
BAC231_N15,5,5q13.2,72914152,73023260,109108,-,-
BAC204_H10,5,5q13.2,72939922,73023100,83178,-,-
BAC175_M05,5,5q13.2,72993651,73102535,108884,-,-
BAC131_P16,5,5q13.2,73004348,73092236,87888,-,-
BAC141_O13,5,5q13.2,73025640,73108123,82483,-,-
BAC132_P01,5,5q13.2,73070541,73174852,104311,-,-
BAC10_I09,5,5q13.2,73113730,73240109,126379,-,-
BAC5_K05,5,5q13.2,73161479,73289399,127920,-,-
BAC149_O18,5,5q13.2-5q13.3,73175422,73302892,127470,-,-
BAC125_J20,5,5q13.2-5q13.3,73242914,73331600,88686,-,-
BAC75_K13,5,5q13.2-5q13.3,73296179,73421705,125526,-,-
BAC176_L08,5,5q13.3,73313210,73408453,95243,-,-
BAC162_P06,5,5q13.3,73329304,73409152,79848,-,-
BAC100_J14,5,5q13.3,73553763,73651396,97633,-,-
BAC175_I05,5,5q13.3,73589708,73672783,83075,-,-
BAC178_H11,5,5q13.3,73626434,73711489,85055,-,-
BAC75_J06,5,5q13.3,73696887,73825646,128759,-,-
BAC126_B19,5,5q13.3,73745252,73868651,123399,-,-
BAC22_P24,5,5q13.3,73745252,73851786,106534,-,-
BAC26_J08,5,5q13.3,73756273,73905136,148863,-,-
BAC235_H22,5,5q13.3,73792440,73874894,82454,-,-
BAC158_J20,5,5q13.3,73792443,73906374,113931,-,-
BAC218_N11,5,5q13.3,73930684,74026077,95393,-,-
BAC97_D01,5,5q13.3,73997184,74099153,101969,-,-
BAC118_C20,5,5q13.3,74003632,74099153,95521,-,-
BAC35_L09,5,5q13.3,74054257,74193449,139192,-,-
BAC240_B07,5,5q13.3,74096092,74214162,118070,-,-
BAC68_J13,5,5q13.3,74096092,74193431,97339,-,-
BAC142_D07,5,5q13.3,74099196,74209651,110455,-,-
BAC173_I09,5,5q13.3,74100650,74214159,113509,-,-
BAC128_N08,5,5q13.3,74100650,74209651,109001,-,-
BAC236_P19,5,5q13.3,74104384,74183208,78824,-,-
BAC144_N04,5,5q13.3,74104384,74193475,89091,-,-
BAC24_L09,5,5q13.3,74104384,74193473,89089,-,-
BAC81_I10,5,5q13.3,74104384,74214162,109778,-,-
BAC36_L09,5,5q13.3,74104388,74214162,109774,-,-
BAC17_J23,5,5q13.3,74170115,74193283,23168,-,-
BAC143_K11,5,5q13.3,74259950,74373705,113755,-,-
BAC23_C23,5,5q13.3,74267526,74361531,94005,-,-
BAC84_J08,5,5q13.3,74283501,74405293,121792,-,-
BAC246_F11,5,5q13.3,74292064,74379435,87371,-,-
BAC24_A23,5,5q13.3,74349881,74400485,50604,-,-
BAC61_N11,5,5q13.3,74416101,74504612,88511,-,-
BAC80_B24,5,5q13.3,74463955,74575560,111605,-,-
BAC130_D15,5,5q13.3,74463955,74616267,152312,-,-
BAC119_I19,5,5q13.3,74489579,74611580,122001,-,-
BAC212_P17,5,5q13.3,74495498,74575899,80401,-,-
BAC73_K11,5,5q13.3,74575898,74653069,77171,-,-
BAC222_O20,5,5q13.3,74612170,74733299,121129,-,-
BAC169_P07,5,5q13.3,74653075,74750567,97492,-,-
BAC141_L06,5,5q13.3,74750562,74839614,89052,-,-
BAC57_I16,5,5q13.3,74802465,74907466,105001,-,-
BAC39_J02,5,5q13.3,74802468,74880742,78274,-,-
BAC196_H11,5,5q13.3,74839608,74911552,71944,-,-
BAC185_P16,5,5q13.3,75030938,75126574,95636,-,-
BAC194_P03,5,5q13.3,75168064,75260345,92281,-,-
BAC11_A14,5,5q13.3,75168172,75268200,100028,-,-
BAC129_C16,5,5q13.3,75247037,75260345,13308,-,-
BAC117_B05,5,5q13.3,75385574,75479364,93790,-,-
BAC137_C11,5,5q13.3,75421787,75505776,83989,-,-
BAC169_H14,5,5q13.3,75421790,75513087,91297,-,-
BAC120_H12,5,5q13.3,75429647,75515462,85815,-,-
BAC59_E08,5,5q13.3,75447881,75549088,101207,-,-
BAC17_A15,5,5q13.3,75455097,75545526,90429,-,-
BAC100_J09,5,5q13.3,75513081,75600592,87511,-,-
BAC109_K02,5,5q13.3,75528276,75623408,95132,-,-
BAC218_P16,5,5q13.3,75565390,75661622,96232,-,-
BAC178_D12,5,5q13.3,75606523,75722366,115843,-,-
BAC178_C12,5,5q13.3,75606592,75722366,115774,-,-
BAC234_M03,5,5q13.3,75627169,75711143,83974,-,-
BAC224_F22,5,5q13.3,75641343,75730492,89149,-,-
BAC204_B08,5,5q13.3,75651123,75750174,99051,-,-
BAC70_H12,5,5q13.3,75711187,75787236,76049,-,-
BAC235_A15,5,5q13.3,75727856,75817905,90049,-,-
BAC237_G05,5,5q13.3,75802183,75879061,76878,-,-
BAC165_G21,5,5q13.3,75867280,75978670,111390,-,-
BAC30_B02,5,5q13.3,76000046,76085052,85006,-,-
BAC165_J06,5,5q13.3,76040663,76150085,109422,-,-
BAC59_I05,5,5q13.3,76048971,76150086,101115,-,-
BAC24_C21,5,5q13.3,76049470,76185008,135538,-,-
BAC160_L10,5,5q13.3,76087140,76174265,87125,-,-
BAC135_M06,5,5q13.3,76142682,76268549,125867,-,-
BAC173_F19,5,5q13.3,76150116,76236759,86643,-,-
BAC90_E01,5,5q13.3,76162455,76290303,127848,-,-
BAC247_J12,5,5q13.3,76174447,76253957,79510,-,-
BAC152_L14,5,5q13.3,76174447,76295290,120843,-,-
BAC224_H22,5,5q13.3,76181181,76287003,105822,-,-
BAC103_C18,5,5q13.3,76255989,76364540,108551,-,-
BAC197_G23,5,5q13.3-5q14.1,76311903,76400019,88116,-,-
BAC75_O17,5,5q13.3-5q14.1,76311903,76405792,93889,-,-
BAC230_B07,5,5q14.1,76430794,76544030,113236,-,-
BAC51_K12,5,5q14.1,76456528,76596964,140436,-,-
BAC200_I08,5,5q14.1,76665454,76746723,81269,-,-
BAC96_B13,5,5q14.1,76683238,76785013,101775,-,-
BAC84_A23,5,5q14.1,76701289,76803648,102359,-,-
BAC134_M07,5,5q14.1,76990473,77059892,69419,-,-
BAC1_L06,5,5q14.1,77006234,77143572,137338,-,-
BAC74_K09,5,5q14.1,77048031,77143571,95540,-,-
BAC119_C13,5,5q14.1,77061647,77150658,89011,-,-
BAC221_O17,5,5q14.1,77085919,77198399,112480,-,-
BAC101_L23,5,5q14.1,77164945,77292495,127550,-,-
BAC100_F19,5,5q14.1,77184595,77262399,77804,-,-
BAC15_G12,5,5q14.1,77245775,77360639,114864,-,-
BAC109_G22,5,5q14.1,77302687,77447917,145230,-,-
BAC139_J10,5,5q14.1,77400949,77488648,87699,-,-
BAC102_E24,5,5q14.1,77456236,77580832,124596,-,-
BAC123_I22,5,5q14.1,77478495,77595633,117138,-,-
BAC238_K19,5,5q14.1,77481550,77568345,86795,-,-
BAC70_J09,5,5q14.1,77530074,77653241,123167,-,-
BAC240_I07,5,5q14.1,77646326,77769167,122841,-,-
BAC36_D13,5,5q14.1,77653236,77743139,89903,-,-
BAC110_B03,5,5q14.1,77776765,77851268,74503,-,-
BAC242_F14,5,5q14.1,77806096,77889810,83714,-,-
BAC167_L19,5,5q14.1,77824310,77923383,99073,-,-
BAC167_M22,5,5q14.1,77824326,77923383,99057,-,-
BAC43_N21,5,5q14.1,77868793,77969433,100640,-,-
BAC248_E19,5,5q14.1,77881701,77971591,89890,-,-
BAC20_M13,5,5q14.1,77889329,78017310,127981,-,-
BAC244_A20,5,5q14.1,77889835,77969435,79600,-,-
BAC66_M22,5,5q14.1,77929446,78038103,108657,-,-
BAC189_L06,5,5q14.1,77968982,78060509,91527,-,-
BAC69_J20,5,5q14.1,77999859,78119750,119891,-,-
BAC175_F17,5,5q14.1,78000711,78079487,78776,-,-
BAC18_G12,5,5q14.1,78061472,78130338,68866,-,-
BAC46_G03,5,5q14.1,78063496,78224617,161121,-,-
BAC118_F11,5,5q14.1,78146633,78228781,82148,-,-
BAC141_P06,5,5q14.1,78146634,78228781,82147,-,-
BAC75_L17,5,5q14.1,78209275,78309191,99916,-,-
BAC112_C03,5,5q14.1,78212459,78292071,79612,-,-
BAC242_K09,5,5q14.1,78250149,78328824,78675,-,-
BAC27_L17,5,5q14.1,78264441,78375136,110695,-,-
BAC5_B05,5,5q14.1,78283037,78367403,84366,-,-
BAC25_K05,5,5q14.1,78327406,78489564,162158,-,-
BAC83_M11,5,5q14.1,78330524,78475340,144816,-,-
BAC227_N16,5,5q14.1,78342937,78421029,78092,-,-
BAC118_M13,5,5q14.1,78475333,78672004,196671,-,-
BAC184_J19,5,5q14.1,78477577,78580172,102595,-,-
BAC181_C22,5,5q14.1,78566664,78659377,92713,-,-
BAC199_A08,5,5q14.1,78640335,78720932,80597,-,-
BAC27_F03,5,5q14.1,78675477,78775609,100132,-,-
BAC55_D24,5,5q14.1,78804919,78934460,129541,-,-
BAC23_E02,5,5q14.1,78841552,79002221,160669,-,-
BAC36_P07,5,5q14.1,78866992,78998861,131869,-,-
BAC65_L11,5,5q14.1,78869934,78962987,93053,-,-
BAC173_E11,5,5q14.1,79001400,79086557,85157,-,-
BAC95_E09,5,5q14.1,79158935,79243812,84877,-,-
BAC33_I08,5,5q14.1,79191318,79291597,100279,-,-
BAC59_M13,5,5q14.1,79191742,79315101,123359,-,-
BAC110_F18,5,5q14.1,79270968,79351364,80396,-,-
BAC35_J09,5,5q14.1,79340692,79438161,97469,-,-
BAC249_D14,5,5q14.1,79344189,79438186,93997,-,-
BAC67_H08,5,5q14.1,79374025,79506515,132490,-,-
BAC218_K23,5,5q14.1,79505225,79592153,86928,-,-
BAC65_F18,5,5q14.1,79539962,79640438,100476,-,-
BAC43_C18,5,5q14.1,79544849,79676394,131545,-,-
BAC46_D20,5,5q14.1,79549137,79725045,175908,-,-
BAC24_M21,5,5q14.1,79590228,79700833,110605,-,-
BAC180_B05,5,5q14.1,79640524,79728348,87824,-,-
BAC190_P05,5,5q14.1,79689989,79784008,94019,-,-
BAC105_E15,5,5q14.1,79727537,79844296,116759,-,-
BAC57_M10,5,5q14.1,79884178,80005691,121513,-,-
BAC231_O13,5,5q14.1,79930318,80028713,98395,-,-
BAC195_N14,5,5q14.1,79930323,80027324,97001,-,-
BAC136_A03,5,5q14.1,79945467,80028713,83246,-,-
BAC124_N08,5,5q14.1,79947716,80049076,101360,-,-
BAC189_P07,5,5q14.1,79998750,80092364,93614,-,-
BAC118_L09,5,5q14.1,80383197,80476141,92944,-,-
BAC226_G19,5,5q14.1,80464264,80553029,88765,-,-
BAC234_E09,5,5q14.1,80482325,80572776,90451,-,-
BAC113_M12,5,5q14.1,80510256,80611999,101743,-,-
BAC153_K14,5,5q14.1,80557803,80641133,83330,-,-
BAC235_M20,5,5q14.1,80563456,80643627,80171,-,-
BAC125_N10,5,5q14.1,80628213,80708708,80495,-,-
BAC199_O08,5,5q14.1,80650427,80717567,67140,-,-
BAC131_C03,5,5q14.1,80717561,80808560,90999,-,-
BAC118_K13,5,5q14.1,80740191,80822612,82421,-,-
BAC148_H16,5,5q14.1,80758426,80850660,92234,-,-
BAC237_I22,5,5q14.1,80785452,80877881,92429,-,-
BAC123_O03,5,5q14.1,80872088,80965105,93017,-,-
BAC110_J12,5,5q14.1,80965382,81052049,86667,-,-
BAC173_N03,5,5q14.1,80983912,81069755,85843,-,-
BAC65_C08,5,5q14.1,81009010,81110245,101235,-,-
BAC165_E07,5,5q14.1,81167454,81265605,98151,-,-
BAC55_H13,5,5q14.1,81171703,81262267,90564,-,-
BAC150_D10,5,5q14.1-5q14.2,81289646,81370758,81112,-,-
BAC194_J16,5,5q14.2,81311901,81409766,97865,-,-
BAC95_M16,5,5q14.2,81401655,81492958,91303,-,-
BAC60_O18,5,5q14.2,81525768,81628081,102313,-,-
BAC150_G21,5,5q14.2,81525768,81596145,70377,-,-
BAC12_E06,5,5q14.2,81591436,81745295,153859,-,-
BAC191_B09,5,5q14.2,81616320,81631191,14871,-,-
BAC23_O02,5,5q14.2,81676760,81770434,93674,-,-
BAC158_I18,5,5q14.2,81728837,81808693,79856,-,-
BAC167_H17,5,5q14.2,81787918,81896766,108848,-,-
BAC131_H17,5,5q14.2,81799152,81865633,66481,-,-
BAC92_N20,5,5q14.2,81906209,82002175,95966,-,-
BAC117_O20,5,5q14.2,81988656,82108551,119895,-,-
BAC51_N09,5,5q14.2,82193614,82349157,155543,-,-
BAC177_K19,5,5q14.2,82225615,82312128,86513,-,-
BAC143_L16,5,5q14.2,82225615,82312128,86513,-,-
BAC67_J21,5,5q14.2,82254513,82361870,107357,-,-
BAC172_L21,5,5q14.2,82352462,82439520,87058,-,-
BAC25_M02,5,5q14.2,82398350,82509841,111491,-,-
BAC223_H22,5,5q14.2,82704576,82791752,87176,-,-
BAC175_I08,5,5q14.2-5q14.3,82785860,82873324,87464,-,-
BAC179_G16,5,5q14.3,83004527,83091714,87187,-,-
BAC161_G08,5,5q14.3,83031381,83053043,21662,-,-
BAC113_J11,5,5q14.3,83267515,83391665,124150,-,-
BAC59_P12,5,5q14.3,83424014,83520749,96735,-,-
BAC67_N16,5,5q14.3,83492612,83598848,106236,-,-
BAC162_P02,5,5q14.3,83517264,83597295,80031,-,-
BAC51_C11,5,5q14.3,83635884,83768557,132673,-,-
BAC244_F19,5,5q14.3,83718796,83830740,111944,-,-
BAC71_F17,5,5q14.3,83738282,83811992,73710,-,-
BAC96_G20,5,5q14.3,83743544,83828122,84578,-,-
BAC142_M13,5,5q14.3,83761428,83841755,80327,-,-
BAC165_C01,5,5q14.3,83893323,84031319,137996,-,-
BAC178_H16,5,5q14.3,83944547,84055946,111399,-,-
BAC191_D11,5,5q14.3,84004639,84077149,72510,-,-
BAC140_B13,5,5q14.3,84013097,84089588,76491,-,-
BAC88_L08,5,5q14.3,84152086,84234538,82452,-,-
BAC65_F11,5,5q14.3,84234538,84457443,222905,-,-
BAC73_B21,5,5q14.3,84654730,84750482,95752,-,-
BAC144_D03,5,5q14.3,84905125,84985205,80080,-,-
BAC217_P18,5,5q14.3,84912446,85001907,89461,-,-
BAC69_K21,5,5q14.3,84926820,85064220,137400,-,-
BAC154_I21,5,5q14.3,84991540,85106887,115347,-,-
BAC61_L22,5,5q14.3,85165261,85280431,115170,-,-
BAC169_L12,5,5q14.3,85340602,85424460,83858,-,-
BAC12_I18,5,5q14.3,85384724,85536659,151935,-,-
BAC25_M19,5,5q14.3,85401743,85482972,81229,-,-
BAC155_H04,5,5q14.3,85497587,85594739,97152,-,-
BAC128_L07,5,5q14.3,85524650,85713549,188899,-,-
BAC141_M13,5,5q14.3,85639803,85714717,74914,-,-
BAC133_D22,5,5q14.3,85657028,85745612,88584,-,-
BAC55_N13,5,5q14.3,85781167,85861579,80412,-,-
BAC116_L13,5,5q14.3,85813902,85861581,47679,-,-
BAC91_N16,5,5q14.3,85853316,85946088,92772,-,-
BAC51_M20,5,5q14.3,85881260,85999131,117871,-,-
BAC237_O08,5,5q14.3,86383782,86498940,115158,-,-
BAC234_N18,5,5q14.3,86441989,86545996,104007,-,-
BAC144_J22,5,5q14.3,86548837,86633675,84838,-,-
BAC12_H03,5,5q14.3,86558129,86665249,107120,-,-
BAC65_F10,5,5q14.3,86588034,86669874,81840,-,-
BAC72_C20,5,5q14.3,86593517,86700625,107108,-,-
BAC249_K22,5,5q14.3,86716572,86858715,142143,-,-
BAC176_O17,5,5q14.3,86752267,86857108,104841,-,-
BAC128_H23,5,5q14.3,86794751,86920601,125850,-,-
BAC48_H15,5,5q14.3,86840673,86954103,113430,-,-
BAC71_K02,5,5q14.3,86846181,86926811,80630,-,-
BAC159_P10,5,5q14.3,87075211,87174069,98858,-,-
BAC42_F07,5,5q14.3,87135148,87239377,104229,-,-
BAC188_E16,5,5q14.3,87394792,87474979,80187,-,-
BAC126_D13,5,5q14.3,87398827,87503846,105019,-,-
BAC193_B01,5,5q14.3,87625630,87752225,126595,-,-
BAC155_K14,5,5q14.3,87661000,87748802,87802,-,-
BAC40_B22,5,5q14.3,87708781,87810650,101869,-,-
BAC69_J18,5,5q14.3,87806202,87902524,96322,-,-
BAC17_A03,5,5q14.3,87813993,87917167,103174,-,-
BAC81_B23,5,5q14.3,87874931,87965538,90607,-,-
BAC29_D17,5,5q14.3,87983275,88080419,97144,-,-
BAC33_B23,5,5q14.3,88065644,88118104,52460,-,-
BAC124_E08,5,5q14.3,88108384,88197977,89593,-,-
BAC53_C10,5,5q14.3,88244873,88361314,116441,-,-
BAC24_E04,5,5q14.3,88261151,88442386,181235,-,-
BAC162_M09,5,5q14.3,88279685,88365593,85908,-,-
BAC162_C12,5,5q14.3,88317004,88342928,25924,-,-
BAC167_F02,5,5q14.3,88365668,88474745,109077,-,-
BAC191_H21,5,5q14.3,88376451,88442158,65707,-,-
BAC185_B19,5,5q14.3,88416577,88491032,74455,-,-
BAC141_F17,5,5q14.3,88492658,88580410,87752,-,-
BAC217_O20,5,5q14.3,88522792,88602012,79220,-,-
BAC90_L01,5,5q14.3,88555293,88673944,118651,-,-
BAC240_G18,5,5q14.3,88766093,88854223,88130,-,-
BAC96_A22,5,5q14.3,88829626,88966187,136561,-,-
BAC168_J15,5,5q14.3,88864482,88949222,84740,-,-
BAC198_H11,5,5q14.3,88897528,88976626,79098,-,-
BAC91_F13,5,5q14.3,89091503,89133967,42464,-,-
BAC172_J09,5,5q14.3,89191642,89275370,83728,-,-
BAC191_H05,5,5q14.3,89325283,89405422,80139,-,-
BAC67_K15,5,5q14.3,89405739,89504069,98330,-,-
BAC127_A16,5,5q14.3,89597568,89677606,80038,-,-
BAC135_I12,5,5q14.3,89817738,89876294,58556,-,-
BAC86_G06,5,5q14.3,89839214,89942400,103186,-,-
BAC137_G14,5,5q14.3,89947647,90025671,78024,-,-
BAC236_F11,5,5q14.3,90006632,90097002,90370,-,-
BAC219_G12,5,5q14.3,90125229,90218117,92888,-,-
BAC55_E16,5,5q14.3,90125229,90267865,142636,-,-
BAC208_A13,5,5q14.3,90127694,90226984,99290,-,-
BAC225_J06,5,5q14.3,90128445,90212440,83995,-,-
BAC63_C23,5,5q14.3,90135659,90233731,98072,-,-
BAC244_K10,5,5q14.3,90176230,90274074,97844,-,-
BAC123_I09,5,5q14.3,90217492,90305068,87576,-,-
BAC219_L13,5,5q14.3,90268186,90340747,72561,-,-
BAC128_N24,5,5q14.3,90357423,90524651,167228,-,-
BAC115_D02,5,5q14.3,90477858,90588111,110253,-,-
BAC43_I08,5,5q14.3,90491528,90602253,110725,-,-
BAC163_I10,5,5q14.3,90524650,90690389,165739,-,-
BAC53_P02,5,5q14.3,90613802,90731005,117203,-,-
BAC182_J18,5,5q14.3,90638707,90701666,62959,-,-
BAC185_K13,5,5q14.3,90642836,90715489,72653,-,-
BAC77_O08,5,5q14.3,90703843,90788106,84263,-,-
BAC186_D11,5,5q14.3,90712195,90817431,105236,-,-
BAC126_H14,5,5q14.3,90731000,90814187,83187,-,-
BAC146_H01,5,5q14.3,90869281,90982131,112850,-,-
BAC240_G15,5,5q14.3,90912493,91003250,90757,-,-
BAC221_N19,5,5q14.3,90937266,91040615,103349,-,-
BAC197_K15,5,5q14.3,91005466,91100147,94681,-,-
BAC52_M09,5,5q14.3,91271256,91374062,102806,-,-
BAC21_O04,5,5q14.3,91508362,91606534,98172,-,-
BAC177_N19,5,5q14.3,91771307,91865616,94309,-,-
BAC243_A11,5,5q15,91965672,92046082,80410,-,-
BAC179_G24,5,5q15,91971097,92065569,94472,-,-
BAC226_N12,5,5q15,92175313,92252124,76811,-,-
BAC95_P11,5,5q15,92427896,92517419,89523,-,-
BAC136_K04,5,5q15,92572372,92663692,91320,-,-
BAC151_L04,5,5q15,92610142,92689283,79141,-,-
BAC66_M23,5,5q15,92645451,92792229,146778,-,-
BAC231_G15,5,5q15,92689279,92774525,85246,-,-
BAC146_L18,5,5q15,92959006,93037903,78897,-,-
BAC237_N24,5,5q15,92959006,93067071,108065,-,-
BAC40_C19,5,5q15,92990503,93090558,100055,-,-
BAC181_K18,5,5q15,93060328,93165013,104685,-,-
BAC97_L02,5,5q15,93090765,93206899,116134,-,-
BAC139_D20,5,5q15,93107156,93197913,90757,-,-
BAC48_P09,5,5q15,93300271,93388659,88388,-,-
BAC88_O02,5,5q15,93388708,93484509,95801,-,-
BAC185_N05,5,5q15,93420014,93536105,116091,-,-
BAC218_B09,5,5q15,93458740,93532165,73425,-,-
BAC141_K01,5,5q15,93498712,93580337,81625,-,-
BAC191_H03,5,5q15,93597313,93680395,83082,-,-
BAC197_N08,5,5q15,93648234,93739504,91270,-,-
BAC13_G12,5,5q15,93649942,93744655,94713,-,-
BAC128_P21,5,5q15,93744669,93813172,68503,-,-
BAC175_A09,5,5q15,94017637,94100268,82631,-,-
BAC149_O20,5,5q15,94193489,94286203,92714,-,-
BAC67_F22,5,5q15,94472302,94583902,111600,-,-
BAC188_B18,5,5q15,94533171,94608225,75054,-,-
BAC147_D19,5,5q15,94577797,94676364,98567,-,-
BAC63_G12,5,5q15,94697970,94788221,90251,-,-
BAC61_I16,5,5q15,94709608,94808400,98792,-,-
BAC112_N02,5,5q15,94721498,94814596,93098,-,-
BAC236_C19,5,5q15,94950711,95029119,78408,-,-
BAC127_B04,5,5q15,94973443,95102091,128648,-,-
BAC171_L11,5,5q15,95004398,95084643,80245,-,-
BAC183_E13,5,5q15,95008545,95088409,79864,-,-
BAC58_B07,5,5q15,95044350,95167160,122810,-,-
BAC179_G05,5,5q15,95121993,95207968,85975,-,-
BAC108_E06,5,5q15,95130750,95213730,82980,-,-
BAC246_B05,5,5q15,95151776,95240999,89223,-,-
BAC22_G03,5,5q15,95168728,95262720,93992,-,-
BAC113_B05,5,5q15,95207982,95317665,109683,-,-
BAC19_O07,5,5q15,95228721,95317349,88628,-,-
BAC12_H16,5,5q15,95336764,95427308,90544,-,-
BAC92_N06,5,5q15,95365252,95461159,95907,-,-
BAC167_G09,5,5q15,95505382,95612383,107001,-,-
BAC220_E14,5,5q15,95542536,95612383,69847,-,-
BAC64_F10,5,5q15,95547697,95690800,143103,-,-
BAC39_J21,5,5q15,95562634,95651649,89015,-,-
BAC68_A06,5,5q15,95601714,95696585,94871,-,-
BAC126_N14,5,5q15,95686166,95776538,90372,-,-
BAC126_B24,5,5q15,95686176,95776538,90362,-,-
BAC83_I19,5,5q15,95730720,95833224,102504,-,-
BAC6_N01,5,5q15,95783942,95903223,119281,-,-
BAC104_D13,5,5q15,96008299,96105410,97111,-,-
BAC226_J21,5,5q15,96137331,96236343,99012,-,-
BAC165_L23,5,5q15,96180029,96282638,102609,-,-
BAC88_H02,5,5q15,96200397,96295633,95236,-,-
BAC117_N16,5,5q15,96265783,96359335,93552,-,-
BAC84_C22,5,5q15,96277034,96347554,70520,-,-
BAC169_G05,5,5q15,96277040,96381471,104431,-,-
BAC82_C05,5,5q15,96406447,96502663,96216,-,-
BAC78_P14,5,5q15,96589631,96677774,88143,-,-
BAC190_K16,5,5q15,96677770,96756576,78806,-,-
BAC174_A13,5,5q15,96721975,96806102,84127,-,-
BAC110_D10,5,5q15,96775287,96899484,124197,-,-
BAC206_B18,5,5q15,96775287,96847673,72386,-,-
BAC61_K15,5,5q15,96817762,96935133,117371,-,-
BAC53_M23,5,5q15,96899479,97025658,126179,-,-
BAC56_C20,5,5q15,97043097,97156727,113630,-,-
BAC69_P03,5,5q15,97126648,97272891,146243,-,-
BAC20_C16,5,5q21.1,97354235,97474006,119771,-,-
BAC115_J14,5,5q21.1,97360339,97470458,110119,-,-
BAC18_B20,5,5q21.1,97707093,97851088,143995,-,-
BAC218_M16,5,5q21.1,97710380,97807522,97142,-,-
BAC182_F01,5,5q21.1,97802816,97899015,96199,-,-
BAC57_N12,5,5q21.1,97864557,97976450,111893,-,-
BAC236_J07,5,5q21.1,97910725,98034069,123344,-,-
BAC100_A06,5,5q21.1,97992462,98096793,104331,-,-
BAC185_C19,5,5q21.1,98010767,98131027,120260,-,-
BAC171_I15,5,5q21.1,98019895,98085615,65720,-,-
BAC95_F01,5,5q21.1,98025195,98131027,105832,-,-
BAC129_F21,5,5q21.1,98025200,98134555,109355,-,-
BAC106_B13,5,5q21.1,98131021,98194630,63609,-,-
BAC46_O04,5,5q21.1,98134615,98219122,84507,-,-
BAC124_A20,5,5q21.1,98144958,98242530,97572,-,-
BAC238_B12,5,5q21.1,98194770,98300129,105359,-,-
BAC48_F07,5,5q21.1,98219770,98328639,108869,-,-
BAC102_H04,5,5q21.1,98233919,98346939,113020,-,-
BAC122_K04,5,5q21.1,98242524,98386017,143493,-,-
BAC159_E04,5,5q21.1,98242524,98346796,104272,-,-
BAC176_H10,5,5q21.1,98281071,98355661,74590,-,-
BAC121_D17,5,5q21.1,98294509,98400119,105610,-,-
BAC80_F03,5,5q21.1,98361834,98461615,99781,-,-
BAC165_M05,5,5q21.1,98726388,98804940,78552,-,-
BAC129_E03,5,5q21.1,98800375,98934844,134469,-,-
BAC78_H05,5,5q21.1,98814333,98921267,106934,-,-
BAC19_C04,5,5q21.1,98907872,99021606,113734,-,-
BAC170_G10,5,5q21.1,99049184,99148790,99606,-,-
BAC101_N09,5,5q21.1,99208154,99285529,77375,-,-
BAC162_H24,5,5q21.1,99547074,99627901,80827,-,-
BAC101_P07,5,5q21.1,99586478,99765212,178734,-,-
BAC149_K12,5,5q21.1,99685866,99787007,101141,-,-
BAC83_C19,5,5q21.1,99716755,99799990,83235,-,-
BAC152_J19,5,5q21.1,99866471,99942573,76102,-,-
BAC155_P16,5,5q21.1,99866946,99942079,75133,-,-
BAC69_I07,5,5q21.1,99894051,100011218,117167,-,-
BAC12_F06,5,5q21.1,99942508,100067015,124507,-,-
BAC61_C15,5,5q21.1,100023992,100107034,83042,-,-
BAC65_M06,5,5q21.1,100130507,100264111,133604,-,-
BAC70_J20,5,5q21.1,100130520,100229624,99104,-,-
BAC82_D07,5,5q21.1,100302973,100411533,108560,-,-
BAC91_F02,5,5q21.1,100361602,100452449,90847,-,-
BAC118_G06,5,5q21.1,100382820,100470787,87967,-,-
BAC82_M12,5,5q21.1,100516401,100639693,123292,-,-
BAC60_D13,5,5q21.1,100521964,100665729,143765,-,-
BAC152_H15,5,5q21.1,100527235,100617383,90148,-,-
BAC123_C15,5,5q21.1,100639688,100731186,91498,-,-
BAC89_A09,5,5q21.1,100758661,100875014,116353,-,-
BAC82_K08,5,5q21.1,100916803,101037825,121022,-,-
BAC134_F12,5,5q21.1,101093209,101182170,88961,-,-
BAC31_L21,5,5q21.1,101128606,101253187,124581,-,-
BAC38_J24,5,5q21.1,101471293,101570445,99152,-,-
BAC52_P12,5,5q21.1,101582082,101695020,112938,-,-
BAC183_N23,5,5q21.1,101984161,102072745,88584,-,-
BAC160_I24,5,5q21.1,102107464,102207813,100349,-,-
BAC1_F01,5,5q21.1,102129145,102262233,133088,-,-
BAC101_J23,5,5q21.1,102297346,102384808,87462,-,-
BAC72_G13,5,5q21.1,102392673,102470761,78088,-,-
BAC7_K08,5,5q21.1,102470782,102566436,95654,-,-
BAC247_G17,5,5q21.1-5q21.2,102733282,102836468,103186,-,-
BAC41_B10,5,5q21.1-5q21.2,102749174,102836470,87296,-,-
BAC33_A22,5,5q21.1-5q21.2,102775843,102862178,86335,-,-
BAC239_O09,5,5q21.1-5q21.2,102795898,102892935,97037,-,-
BAC19_D20,5,5q21.2,102803168,102903598,100430,-,-
BAC39_B13,5,5q21.2,102820830,102953528,132698,-,-
BAC219_N18,5,5q21.2,103018297,103123311,105014,-,-
BAC54_N06,5,5q21.2,103022687,103150771,128084,-,-
BAC27_D18,5,5q21.2,103069382,103179421,110039,-,-
BAC175_B06,5,5q21.2,103137975,103282944,144969,-,-
BAC22_A15,5,5q21.2,103150770,103258129,107359,-,-
BAC240_M16,5,5q21.2,103209056,103223746,14690,-,-
BAC181_N02,5,5q21.2,103226807,103325911,99104,-,-
BAC64_P14,5,5q21.2,103325898,103408724,82826,-,-
BAC25_L15,5,5q21.2,103430163,103521457,91294,-,-
BAC20_F01,5,5q21.2,103436066,103559314,123248,-,-
BAC80_J10,5,5q21.2,103731600,103829457,97857,-,-
BAC84_D16,5,5q21.2,103875340,103977203,101863,-,-
BAC115_P10,5,5q21.2,103998793,104099552,100759,-,-
BAC191_O02,5,5q21.2,104181197,104285801,104604,-,-
BAC45_L07,5,5q21.2,104209628,104328497,118869,-,-
BAC167_G06,5,5q21.3,104897582,105013644,116062,-,-
BAC176_A21,5,5q21.3,105094244,105208462,114218,-,-
BAC32_D06,5,5q21.3,105167180,105265079,97899,-,-
BAC82_M07,5,5q21.3,105460271,105565506,105235,-,-
BAC125_I21,5,5q21.3,106062863,106234294,171431,-,-
BAC49_L04,5,5q21.3,106138852,106269903,131051,-,-
BAC244_E16,5,5q21.3,106145933,106255426,109493,-,-
BAC53_N23,5,5q21.3,106355986,106483549,127563,-,-
BAC95_B09,5,5q21.3,106476164,106566626,90462,-,-
BAC238_J17,5,5q21.3,106593835,106695210,101375,-,-
BAC126_A01,5,5q21.3,106596308,106704917,108609,-,-
BAC92_K04,5,5q21.3,106614700,106751881,137181,-,-
BAC96_H21,5,5q21.3,106751875,106875226,123351,-,-
BAC179_F17,5,5q21.3,106757798,106856173,98375,-,-
BAC143_L10,5,5q21.3,106757798,106834959,77161,-,-
BAC193_M21,5,5q21.3,106818042,106937444,119402,-,-
BAC168_C17,5,5q21.3,107235948,107323756,87808,-,-
BAC92_D15,5,5q21.3,107477053,107587525,110472,-,-
BAC112_P02,5,5q21.3,107698385,107778740,80355,-,-
BAC156_I21,5,5q21.3,107735766,107823609,87843,-,-
BAC19_I12,5,5q21.3,107768172,107854971,86799,-,-
BAC29_J21,5,5q21.3,107855391,107946683,91292,-,-
BAC192_E22,5,5q21.3,107855489,107929661,74172,-,-
BAC180_G09,5,5q21.3,107995692,108085424,89732,-,-
BAC68_K14,5,5q21.3,107999071,108085427,86356,-,-
BAC74_N06,5,5q21.3,108044652,108123758,79106,-,-
BAC163_J02,5,5q21.3,108094673,108180703,86030,-,-
BAC162_H06,5,5q21.3,108118848,108199398,80550,-,-
BAC219_I20,5,5q21.3,108157420,108242244,84824,-,-
BAC52_M11,5,5q21.3,108157420,108242243,84823,-,-
BAC4_F23,5,5q21.3,108157420,108244269,86849,-,-
BAC82_B03,5,5q21.3,108157422,108260819,103397,-,-
BAC169_C02,5,5q21.3,108233036,108315859,82823,-,-
BAC8_A12,5,5q21.3,108252171,108351046,98875,-,-
BAC178_H02,5,5q21.3,108282105,108351046,68941,-,-
BAC84_B01,5,5q21.3,108283276,108390696,107420,-,-
BAC76_M01,5,5q21.3,108418932,108462831,43899,-,-
BAC102_G12,5,5q21.3,108594783,108732694,137911,-,-
BAC39_P05,5,5q21.3,108763610,108831700,68090,-,-
BAC208_I22,5,5q21.3,108784116,108864775,80659,-,-
BAC68_I12,5,5q21.3,108822748,108955913,133165,-,-
BAC34_A03,5,5q21.3,108830904,108963331,132427,-,-
BAC151_N09,5,5q21.3,108899599,108984495,84896,-,-
BAC82_L12,5,5q21.3,108962865,109052312,89447,-,-
BAC195_J06,5,5q21.3,109023935,109105334,81399,-,-
BAC186_L19,5,5q21.3,109030261,109113004,82743,-,-
BAC187_E23,5,5q21.3,109107991,109229146,121155,-,-
BAC33_A02,5,5q21.3,109112752,109198719,85967,-,-
BAC56_L10,5,5q21.3,109182061,109306311,124250,-,-
BAC189_E08,5,5q21.3,109222146,109306314,84168,-,-
BAC204_B18,5,5q21.3,109238285,109298622,60337,-,-
BAC88_E19,5,5q21.3,109468462,109561907,93445,-,-
BAC238_I04,5,5q21.3,109498930,109583385,84455,-,-
BAC33_A05,5,5q21.3-5q22.1,109499411,109631882,132471,-,-
BAC240_P14,5,5q22.1,109630915,109714015,83100,-,-
BAC217_K17,5,5q22.1,109638090,109739902,101812,-,-
BAC150_I03,5,5q22.1,109825035,109916271,91236,-,-
BAC151_C04,5,5q22.1,109832067,109903341,71274,-,-
BAC158_M06,5,5q22.1,109864576,109937730,73154,-,-
BAC45_C12,5,5q22.1,109876971,110004307,127336,-,-
BAC37_M09,5,5q22.1,109904373,110059857,155484,-,-
BAC144_L24,5,5q22.1,109912006,109995329,83323,-,-
BAC113_O08,5,5q22.1,110213986,110309449,95463,-,-
BAC193_F02,5,5q22.1,110253006,110358382,105376,-,-
BAC123_P08,5,5q22.1,110273753,110358382,84629,-,-
BAC81_N11,5,5q22.1,110276302,110365933,89631,-,-
BAC69_B20,5,5q22.1,110280961,110375423,94462,-,-
BAC23_K14,5,5q22.1,110517448,110609823,92375,-,-
BAC163_M03,5,5q22.1,110681055,110774840,93785,-,-
BAC116_D12,5,5q22.1,110681057,110787462,106405,-,-
BAC246_G03,5,5q22.1,110730479,110869087,138608,-,-
BAC45_L13,5,5q22.1,110763373,110902664,139291,-,-
BAC52_E11,5,5q22.1,110835103,110925791,90688,-,-
BAC171_I19,5,5q22.1,110838797,110952043,113246,-,-
BAC56_P22,5,5q22.1,110873619,110964907,91288,-,-
BAC109_G10,5,5q22.1,110886335,110964438,78103,-,-
BAC236_P23,5,5q22.1,110980891,111065910,85019,-,-
BAC116_J21,5,5q22.1,111011636,111103069,91433,-,-
BAC244_H14,5,5q22.1,111194895,111276055,81160,-,-
BAC195_K14,5,5q22.1,111242975,111329736,86761,-,-
BAC124_H13,5,5q22.1,111332993,111433541,100548,-,-
BAC199_F10,5,5q22.1,111398244,111482733,84489,-,-
BAC127_J10,5,5q22.1-5q22.2,111439239,111579077,139838,-,-
BAC182_O12,5,5q22.1-5q22.2,111490813,111574760,83947,-,-
BAC128_I06,5,5q22.1-5q22.2,111494852,111626835,131983,-,-
BAC92_D13,5,5q22.2,111553486,111643509,90023,-,-
BAC141_K10,5,5q22.2,111584006,111674935,90929,-,-
BAC115_M06,5,5q22.2,111699929,111794283,94354,-,-
BAC25_H09,5,5q22.2,111705472,111826824,121352,-,-
BAC72_L01,5,5q22.2,111715877,111812773,96896,-,-
BAC2_E12,5,5q22.2,111734671,111909606,174935,-,-
BAC141_K21,5,5q22.2,111739147,111812772,73625,-,-
BAC92_H09,5,5q22.2,111812766,111909606,96840,-,-
BAC37_E12,5,5q22.2,111812769,111912960,100191,-,-
BAC84_P07,5,5q22.2,111829445,111921783,92338,-,-
BAC213_O08,5,5q22.2,111878180,111973632,95452,-,-
BAC43_B05,5,5q22.2,111922367,112029565,107198,-,-
BAC236_F22,5,5q22.2,111973822,112073994,100172,-,-
BAC96_M21,5,5q22.2,112071517,112175228,103711,-,-
BAC37_A07,5,5q22.2,112074219,112201417,127198,-,-
BAC58_K08,5,5q22.2,112095914,112247229,151315,-,-
BAC65_B09,5,5q22.2,112100916,112201422,100506,-,-
BAC44_H09,5,5q22.2,112130271,112249326,119055,-,-
BAC31_D15,5,5q22.2,112249319,112436603,187284,-,-
BAC131_N16,5,5q22.2,112322470,112437779,115309,-,-
BAC118_K08,5,5q22.2,112396857,112522934,126077,-,-
BAC175_I17,5,5q22.2,112546914,112623318,76404,-,-
BAC139_M23,5,5q22.2,112566458,112663325,96867,-,-
BAC186_J07,5,5q22.2,112596768,112655828,59060,-,-
BAC37_A15,5,5q22.2,112663320,112824951,161631,-,-
BAC154_O21,5,5q22.2,112665587,112784530,118943,-,-
BAC172_D08,5,5q22.2,112665587,112762396,96809,-,-
BAC26_C12,5,5q22.2,112665592,112758359,92767,-,-
BAC105_I18,5,5q22.2,112717581,112842185,124604,-,-
BAC108_B12,5,5q22.2,112761167,112888016,126849,-,-
BAC183_C16,5,5q22.2,112796698,112893133,96435,-,-
BAC48_I09,5,5q22.2,112841528,112997816,156288,-,-
BAC160_B01,5,5q22.2,112940697,113017208,76511,-,-
BAC169_B08,5,5q22.2,112961647,113038084,76437,-,-
BAC61_F10,5,5q22.2,112999960,113098009,98049,-,-
BAC160_O12,5,5q22.2-5q22.3,113048362,113128288,79926,-,-
BAC175_M09,5,5q22.3,113103727,113201101,97374,-,-
BAC41_L02,5,5q22.3,113106422,113179005,72583,-,-
BAC127_I13,5,5q22.3,113212276,113302884,90608,-,-
BAC240_K09,5,5q22.3,113438238,113542033,103795,-,-
BAC239_H05,5,5q22.3,113539496,113635364,95868,-,-
BAC96_L01,5,5q22.3,113634641,113756402,121761,-,-
BAC156_G15,5,5q22.3,113641233,113736147,94914,-,-
BAC249_A23,5,5q22.3,113701993,113789919,87926,-,-
BAC252_A11,5,5q22.3,113701994,113810742,108748,-,-
BAC161_I01,5,5q22.3,113701997,113777875,75878,-,-
BAC196_F16,5,5q22.3,113721995,113800377,78382,-,-
BAC19_N17,5,5q22.3,113853147,113972109,118962,-,-
BAC185_P01,5,5q22.3,113936562,114011514,74952,-,-
BAC217_F09,5,5q22.3,113962967,114069756,106789,-,-
BAC157_O17,5,5q22.3,113985400,114105757,120357,-,-
BAC196_P20,5,5q22.3,114150753,114248973,98220,-,-
BAC171_N16,5,5q22.3,114156167,114228234,72067,-,-
BAC246_I11,5,5q22.3,114243613,114313856,70243,-,-
BAC160_L19,5,5q22.3,114287335,114411813,124478,-,-
BAC20_C04,5,5q22.3,114314794,114416789,101995,-,-
BAC231_B07,5,5q22.3,114314853,114445894,131041,-,-
BAC158_M03,5,5q22.3,114346906,114441719,94813,-,-
BAC158_P02,5,5q22.3,114347186,114441719,94533,-,-
BAC141_D23,5,5q22.3,114371458,114454755,83297,-,-
BAC68_D19,5,5q22.3,114446975,114595159,148184,-,-
BAC162_E16,5,5q22.3,114461499,114552212,90713,-,-
BAC115_L09,5,5q22.3,114601496,114706563,105067,-,-
BAC240_K24,5,5q22.3,114753723,114840259,86536,-,-
BAC88_O13,5,5q22.3,114814332,114903842,89510,-,-
BAC69_B09,5,5q22.3,114860431,114943241,82810,-,-
BAC143_F06,5,5q22.3,114863100,114962182,99082,-,-
BAC8_K11,5,5q22.3,115001413,115077696,76283,-,-
BAC5_A17,5,5q22.3-5q23.1,115145425,115253703,108278,-,-
BAC168_M02,5,5q23.1,115297092,115401921,104829,-,-
BAC173_K15,5,5q23.1,115328522,115433409,104887,-,-
BAC252_N03,5,5q23.1,115335532,115476395,140863,-,-
BAC218_E04,5,5q23.1,115407587,115480006,72419,-,-
BAC226_G18,5,5q23.1,115476668,115592325,115657,-,-
BAC143_B13,5,5q23.1,115760455,115839271,78816,-,-
BAC37_P04,5,5q23.1,115766371,115880666,114295,-,-
BAC70_A06,5,5q23.1,115794930,115879751,84821,-,-
BAC179_J13,5,5q23.1,115949400,116038131,88731,-,-
BAC61_M22,5,5q23.1,115971173,116064095,92922,-,-
BAC73_M04,5,5q23.1,116010334,116106610,96276,-,-
BAC124_J15,5,5q23.1,116048215,116139900,91685,-,-
BAC86_J17,5,5q23.1,116067541,116180138,112597,-,-
BAC147_N05,5,5q23.1,116071209,116164550,93341,-,-
BAC18_B08,5,5q23.1,116111309,116257432,146123,-,-
BAC178_H22,5,5q23.1,116114663,116200169,85506,-,-
BAC12_D17,5,5q23.1,116140233,116229546,89313,-,-
BAC200_A06,5,5q23.1,116148668,116253162,104494,-,-
BAC52_I23,5,5q23.1,116164569,116253164,88595,-,-
BAC22_E18,5,5q23.1,116187861,116299116,111255,-,-
BAC41_N05,5,5q23.1,116189321,116280941,91620,-,-
BAC27_I03,5,5q23.1,116282614,116372558,89944,-,-
BAC195_A17,5,5q23.1,116385780,116463575,77795,-,-
BAC235_K23,5,5q23.1,116436137,116528781,92644,-,-
BAC57_G20,5,5q23.1,116522784,116623013,100229,-,-
BAC24_I17,5,5q23.1,116556210,116658849,102639,-,-
BAC16_D22,5,5q23.1,116716069,116811470,95401,-,-
BAC84_F03,5,5q23.1,116728671,116811548,82877,-,-
BAC135_L09,5,5q23.1,116996185,117072025,75840,-,-
BAC33_M21,5,5q23.1,117242959,117338376,95417,-,-
BAC52_E20,5,5q23.1,117247038,117328166,81128,-,-
BAC217_I13,5,5q23.1,117337091,117419150,82059,-,-
BAC76_K10,5,5q23.1,117492814,117589571,96757,-,-
BAC137_P16,5,5q23.1,117547417,117648044,100627,-,-
BAC130_B08,5,5q23.1,117718990,117811285,92295,-,-
BAC179_H08,5,5q23.1,117745557,117835942,90385,-,-
BAC39_L12,5,5q23.1,117756004,117886625,130621,-,-
BAC33_F01,5,5q23.1,117815040,117898925,83885,-,-
BAC67_D12,5,5q23.1,117824701,117835942,11241,-,-
BAC107_O01,5,5q23.1,117966721,118037154,70433,-,-
BAC24_N15,5,5q23.1,117972151,118053956,81805,-,-
BAC2_H01,5,5q23.1,117992150,118007281,15131,-,-
BAC122_M13,5,5q23.1,118002506,118109767,107261,-,-
BAC222_J04,5,5q23.1,118094665,118182836,88171,-,-
BAC63_K19,5,5q23.1,118109761,118285586,175825,-,-
BAC22_G01,5,5q23.1,118316952,118457654,140702,-,-
BAC52_B18,5,5q23.1,118348488,118467996,119508,-,-
BAC66_O06,5,5q23.1,118380357,118470532,90175,-,-
BAC33_H11,5,5q23.1,118510695,118595459,84764,-,-
BAC191_H11,5,5q23.1,118510900,118595465,84565,-,-
BAC114_A14,5,5q23.1,118551276,118664594,113318,-,-
BAC113_J04,5,5q23.1,118561601,118691366,129765,-,-
BAC218_L22,5,5q23.1,118593545,118671986,78441,-,-
BAC126_H13,5,5q23.1,118614693,118728369,113676,-,-
BAC11_N16,5,5q23.1,118661959,118747587,85628,-,-
BAC162_K01,5,5q23.1,118666318,118779412,113094,-,-
BAC18_P17,5,5q23.1,118763825,118863675,99850,-,-
BAC150_O07,5,5q23.1,118795275,118886622,91347,-,-
BAC165_I20,5,5q23.1,118832013,118913992,81979,-,-
BAC77_I17,5,5q23.1,118832551,118914069,81518,-,-
BAC39_F12,5,5q23.1,118866109,118959333,93224,-,-
BAC131_H14,5,5q23.1,119012853,119075942,63089,-,-
BAC161_C19,5,5q23.1,119012856,119110145,97289,-,-
BAC112_B01,5,5q23.1,119027027,119126825,99798,-,-
BAC80_C13,5,5q23.1,119239636,119280559,40923,-,-
BAC124_L12,5,5q23.1,119357138,119444411,87273,-,-
BAC26_K02,5,5q23.1,119514264,119600878,86614,-,-
BAC150_M08,5,5q23.1,119698912,119804641,105729,-,-
BAC95_G03,5,5q23.1,119894969,120015950,120981,-,-
BAC146_K17,5,5q23.1,119935271,120015950,80679,-,-
BAC36_I10,5,5q23.1,119959825,120041483,81658,-,-
BAC107_P16,5,5q23.1,120041815,120204768,162953,-,-
BAC57_O16,5,5q23.1,120250437,120381255,130818,-,-
BAC133_K16,5,5q23.1,120265106,120351489,86383,-,-
BAC105_A13,5,5q23.1,120270709,120395571,124862,-,-
BAC239_M16,5,5q23.1,120320386,120428323,107937,-,-
BAC227_G21,5,5q23.1,120321916,120431338,109422,-,-
BAC57_H11,5,5q23.1,120518700,120611641,92941,-,-
BAC243_K16,5,5q23.1,120585314,120668141,82827,-,-
BAC72_M16,5,5q23.1,120731029,120836893,105864,-,-
BAC130_N06,5,5q23.1,120861826,120925531,63705,-,-
BAC43_L18,5,5q23.1,121145709,121249312,103603,-,-
BAC31_E08,5,5q23.1,121281553,121381774,100221,-,-
BAC127_B17,5,5q23.1,121344637,121412013,67376,-,-
BAC201_J17,5,5q23.1-5q23.2,121446747,121550529,103782,-,-
BAC85_H20,5,5q23.1-5q23.2,121466629,121550517,83888,-,-
BAC103_J12,5,5q23.2,121516215,121600617,84402,-,-
BAC244_J14,5,5q23.2,121516217,121624054,107837,-,-
BAC121_D12,5,5q23.2,121571791,121668427,96636,-,-
BAC90_N14,5,5q23.2,121645346,121729562,84216,-,-
BAC141_N23,5,5q23.2,121661330,121733590,72260,-,-
BAC155_O02,5,5q23.2,121722214,121818558,96344,-,-
BAC242_J09,5,5q23.2,121724991,121824940,99949,-,-
BAC79_O24,5,5q23.2,121736141,121832573,96432,-,-
BAC52_A22,5,5q23.2,121762406,121900312,137906,-,-
BAC244_G09,5,5q23.2,121827659,121921995,94336,-,-
BAC31_D17,5,5q23.2,121907776,122010398,102622,-,-
BAC34_F06,5,5q23.2,121958498,122083635,125137,-,-
BAC14_A16,5,5q23.2,122014187,122149974,135787,-,-
BAC133_B06,5,5q23.2,122022382,122187311,164929,-,-
BAC97_K21,5,5q23.2,122070738,122212857,142119,-,-
BAC46_J06,5,5q23.2,122139786,122267393,127607,-,-
BAC84_P17,5,5q23.2,122191994,122292924,100930,-,-
BAC84_C14,5,5q23.2,122245391,122325523,80132,-,-
BAC27_K13,5,5q23.2,122314556,122425864,111308,-,-
BAC194_C13,5,5q23.2,122331182,122423024,91842,-,-
BAC122_J06,5,5q23.2,122338224,122456421,118197,-,-
BAC48_N12,5,5q23.2,122437326,122546652,109326,-,-
BAC21_J16,5,5q23.2,122456733,122564806,108073,-,-
BAC36_L22,5,5q23.2,122579624,122716961,137337,-,-
BAC144_K01,5,5q23.2,122634208,122723518,89310,-,-
BAC229_K16,5,5q23.2,122745370,122816392,71022,-,-
BAC237_J16,5,5q23.2,122809372,122904778,95406,-,-
BAC171_J01,5,5q23.2,123122539,123233538,110999,-,-
BAC193_L23,5,5q23.2,123309324,123425229,115905,-,-
BAC102_F01,5,5q23.2,123339908,123425229,85321,-,-
BAC81_M03,5,5q23.2,123389908,123505133,115225,-,-
BAC67_O09,5,5q23.2,123491543,123580541,88998,-,-
BAC83_A04,5,5q23.2,123608991,123695437,86446,-,-
BAC195_E15,5,5q23.2,123716112,123803121,87009,-,-
BAC154_P02,5,5q23.2,123806150,123906269,100119,-,-
BAC122_B22,5,5q23.2,123806283,123955389,149106,-,-
BAC58_P09,5,5q23.2,123811269,123901834,90565,-,-
BAC191_I08,5,5q23.2,123811384,123901835,90451,-,-
BAC197_J04,5,5q23.2,123840872,123940412,99540,-,-
BAC152_J11,5,5q23.2,123912224,123992082,79858,-,-
BAC223_H08,5,5q23.2,123914303,123992115,77812,-,-
BAC85_J17,5,5q23.2,123955454,124043693,88239,-,-
BAC109_K22,5,5q23.2,123962752,124043638,80886,-,-
BAC194_D09,5,5q23.2,123992172,124090601,98429,-,-
BAC73_B16,5,5q23.2,124019416,124157673,138257,-,-
BAC165_O08,5,5q23.2,124028232,124120255,92023,-,-
BAC101_B09,5,5q23.2,124063074,124156672,93598,-,-
BAC118_F06,5,5q23.2,124128491,124212971,84480,-,-
BAC97_G23,5,5q23.2,124239937,124345060,105123,-,-
BAC61_B23,5,5q23.2,124250074,124338937,88863,-,-
BAC63_L19,5,5q23.2,124266241,124351769,85528,-,-
BAC241_J16,5,5q23.2,124347880,124427524,79644,-,-
BAC250_L22,5,5q23.2,124348204,124427528,79324,-,-
BAC102_G24,5,5q23.2,124721519,124733630,12111,-,-
BAC56_L08,5,5q23.2,124768469,124883647,115178,-,-
BAC233_N09,5,5q23.2,125006344,125082361,76017,-,-
BAC172_E03,5,5q23.2,125113609,125230550,116941,-,-
BAC145_H20,5,5q23.2,125128006,125198920,70914,-,-
BAC158_O01,5,5q23.2,125198913,125303103,104190,-,-
BAC117_J14,5,5q23.2,125379036,125492380,113344,-,-
BAC235_G07,5,5q23.2,125388164,125470788,82624,-,-
BAC231_I09,5,5q23.2,125395763,125477390,81627,-,-
BAC133_K04,5,5q23.2,125718910,125920165,201255,-,-
BAC42_J05,5,5q23.2,125896832,126059258,162426,-,-
BAC69_K05,5,5q23.2,125905304,126047266,141962,-,-
BAC222_P22,5,5q23.2,125924514,126033171,108657,-,-
BAC241_N02,5,5q23.2,126016056,126109933,93877,-,-
BAC162_K08,5,5q23.2,126017106,126142952,125846,-,-
BAC151_I17,5,5q23.2,126030754,126135123,104369,-,-
BAC167_H23,5,5q23.2,126142946,126250301,107355,-,-
BAC172_G17,5,5q23.2,126269776,126352326,82550,-,-
BAC157_B18,5,5q23.2,126407961,126430852,22891,-,-
BAC113_O14,5,5q23.2,126421538,126552348,130810,-,-
BAC42_O07,5,5q23.2,126422671,126552348,129677,-,-
BAC193_A20,5,5q23.2,126450438,126556664,106226,-,-
BAC29_L07,5,5q23.2,126457445,126562095,104650,-,-
BAC58_L24,5,5q23.2,126510988,126592537,81549,-,-
BAC155_P07,5,5q23.2,126694116,126782483,88367,-,-
BAC133_I13,5,5q23.2,126714136,126810630,96494,-,-
BAC132_I05,5,5q23.2,126764666,126877157,112491,-,-
BAC181_M14,5,5q23.2,126877152,126966738,89586,-,-
BAC209_N10,5,5q23.2,127007622,127099894,92272,-,-
BAC11_I10,5,5q23.2,127026240,127161714,135474,-,-
BAC89_M05,5,5q23.2,127179956,127277912,97956,-,-
BAC53_A02,5,5q23.2,127180388,127290235,109847,-,-
BAC121_C01,5,5q23.2-5q23.3,127191914,127311335,119421,-,-
BAC179_J20,5,5q23.3,127351885,127441851,89966,-,-
BAC150_G19,5,5q23.3,127422510,127503301,80791,-,-
BAC227_O22,5,5q23.3,127443754,127528822,85068,-,-
BAC222_B18,5,5q23.3,127556277,127670359,114082,-,-
BAC46_G15,5,5q23.3,127557427,127698301,140874,-,-
BAC14_G17,5,5q23.3,127598867,127677123,78256,-,-
BAC85_C11,5,5q23.3,127627560,127729211,101651,-,-
BAC84_M07,5,5q23.3,127648064,127759110,111046,-,-
BAC96_L03,5,5q23.3,127845986,127937968,91982,-,-
BAC15_E06,5,5q23.3,128073997,128169742,95745,-,-
BAC62_A20,5,5q23.3,128218965,128309647,90682,-,-
BAC228_L15,5,5q23.3,128313014,128423596,110582,-,-
BAC239_M07,5,5q23.3,128492983,128580144,87161,-,-
BAC246_B03,5,5q23.3,128709738,128800889,91151,-,-
BAC116_F10,5,5q23.3,128709739,128826175,116436,-,-
BAC22_A14,5,5q23.3,128713605,128826176,112571,-,-
BAC117_J10,5,5q23.3,128724854,128795346,70492,-,-
BAC35_J03,5,5q23.3,128803881,128898309,94428,-,-
BAC51_B03,5,5q23.3,128878370,128988283,109913,-,-
BAC92_L15,5,5q23.3,128965253,129060136,94883,-,-
BAC231_C19,5,5q23.3,128969579,129045640,76061,-,-
BAC66_P17,5,5q23.3,129045281,129147112,101831,-,-
BAC91_B22,5,5q23.3,129066728,129166693,99965,-,-
BAC127_N09,5,5q23.3,129248509,129395993,147484,-,-
BAC229_D07,5,5q23.3,129291044,129383492,92448,-,-
BAC173_O20,5,5q23.3,129390333,129465488,75155,-,-
BAC151_K08,5,5q23.3,129390335,129409947,19612,-,-
BAC128_H08,5,5q23.3,129445866,129532177,86311,-,-
BAC23_K22,5,5q23.3,129486363,129631195,144832,-,-
BAC59_K07,5,5q23.3,129640919,129760879,119960,-,-
BAC8_F03,5,5q23.3,129661027,129765066,104039,-,-
BAC146_D07,5,5q23.3,129667113,129760879,93766,-,-
BAC26_B07,5,5q23.3,129687271,129790152,102881,-,-
BAC176_C11,5,5q23.3,129712845,129786974,74129,-,-
BAC172_I22,5,5q23.3,129715052,129831568,116516,-,-
BAC43_P08,5,5q23.3,129863769,129983036,119267,-,-
BAC129_I13,5,5q23.3,129901175,129983039,81864,-,-
BAC150_L08,5,5q23.3,129921982,130008437,86455,-,-
BAC169_N08,5,5q23.3,130023597,130114070,90473,-,-
BAC197_E18,5,5q23.3,130083975,130168140,84165,-,-
BAC77_I18,5,5q23.3,130090429,130168148,77719,-,-
BAC144_B14,5,5q23.3,130240276,130327399,87123,-,-
BAC202_L20,5,5q23.3,130256101,130344057,87956,-,-
BAC222_L09,5,5q23.3-5q31.1,130327407,130463347,135940,-,-
BAC186_B03,5,5q23.3-5q31.1,130344077,130440060,95983,-,-
BAC2_A16,5,5q31.1,130425373,130514644,89271,-,-
BAC236_G19,5,5q31.1,130486125,130577710,91585,yes,-
BAC53_F01,5,5q31.1,130498889,130621852,122963,-,-
BAC228_J16,5,5q31.1,130500776,130577711,76935,yes,-
BAC147_E06,5,5q31.1,130693842,130792816,98974,-,-
BAC196_H17,5,5q31.1,130704293,130799462,95169,-,-
BAC149_J17,5,5q31.1,130704293,130793025,88732,-,-
BAC20_C07,5,5q31.1,130708998,130793910,84912,-,-
BAC149_B13,5,5q31.1,130715334,130802051,86717,-,-
BAC112_F03,5,5q31.1,130793062,130921810,128748,-,-
BAC142_D04,5,5q31.1,130802078,130893717,91639,-,-
BAC71_O12,5,5q31.1,130870432,130959747,89315,-,-
BAC8_H11,5,5q31.1,130960038,131072381,112343,-,-
BAC69_K16,5,5q31.1,131145024,131248725,103701,-,-
BAC148_L22,5,5q31.1,131159945,131258822,98877,-,-
BAC102_J13,5,5q31.1,131228831,131327037,98206,-,-
BAC63_F13,5,5q31.1,131230579,131310983,80404,-,-
BAC129_N08,5,5q31.1,131253673,131345345,91672,-,-
BAC232_P14,5,5q31.1,131258849,131327037,68188,-,-
BAC222_P07,5,5q31.1,131327159,131419091,91932,-,-
BAC234_C13,5,5q31.1,131365942,131448484,82542,-,-
BAC141_I18,5,5q31.1,131391759,131468135,76376,-,-
BAC52_K19,5,5q31.1,131391759,131505438,113679,-,-
BAC48_D09,5,5q31.1,131461788,131567814,106026,-,-
BAC59_O21,5,5q31.1,131558026,131675194,117168,-,-
BAC53_L07,5,5q31.1,131593118,131706867,113749,-,-
BAC219_G15,5,5q31.1,131643513,131729818,86305,-,-
BAC252_G08,5,5q31.1,131731372,131884173,152801,-,-
BAC33_D20,5,5q31.1,131772410,131859047,86637,-,-
BAC227_D08,5,5q31.1,131812590,131898622,86032,-,-
BAC93_M05,5,5q31.1,131840453,131953563,113110,-,-
BAC161_A19,5,5q31.1,131920326,132030842,110516,-,-
BAC43_N23,5,5q31.1,131950707,132071872,121165,-,-
BAC165_I17,5,5q31.1,131981034,132071872,90838,-,-
BAC124_P07,5,5q31.1,132023155,132135860,112705,-,-
BAC222_M05,5,5q31.1,132054694,132167554,112860,-,-
BAC33_N16,5,5q31.1,132118272,132235785,117513,-,-
BAC128_F20,5,5q31.1,132131126,132224907,93781,-,-
BAC129_F02,5,5q31.1,132147271,132247534,100263,-,-
BAC113_D05,5,5q31.1,132147271,132232563,85292,-,-
BAC140_H19,5,5q31.1,132181267,132262999,81732,-,-
BAC172_I04,5,5q31.1,132238644,132324183,85539,-,-
BAC21_P21,5,5q31.1,132340625,132424407,83782,-,-
BAC103_C03,5,5q31.1,132371509,132468006,96497,-,-
BAC63_I07,5,5q31.1,132414815,132493154,78339,-,-
BAC157_J14,5,5q31.1,132424732,132516836,92104,-,-
BAC46_C07,5,5q31.1,132432671,132513780,81109,-,-
BAC10_L02,5,5q31.1,132460838,132591212,130374,-,-
BAC240_B19,5,5q31.1,132461157,132574034,112877,-,-
BAC55_F12,5,5q31.1,132477498,132591219,113721,-,-
BAC199_D18,5,5q31.1,132516832,132613876,97044,-,-
BAC180_C18,5,5q31.1,132557900,132650689,92789,-,-
BAC30_F16,5,5q31.1,132569465,132667708,98243,-,-
BAC102_N18,5,5q31.1,132574095,132697888,123793,-,-
BAC194_C12,5,5q31.1,132576059,132685796,109737,-,-
BAC52_A16,5,5q31.1,132577883,132668064,90181,-,-
BAC46_B10,5,5q31.1,132587572,132683301,95729,-,-
BAC135_B08,5,5q31.1,132591213,132695592,104379,-,-
BAC124_F21,5,5q31.1,132599158,132685792,86634,-,-
BAC129_N06,5,5q31.1,132599158,132702160,103002,-,-
BAC176_N14,5,5q31.1,132609612,132702140,92528,-,-
BAC31_A11,5,5q31.1,132613877,132789388,175511,-,-
BAC249_D21,5,5q31.1,132633464,132806968,173504,-,-
BAC62_C11,5,5q31.1,132710174,132864033,153859,-,-
BAC4_N04,5,5q31.1,132753320,132845540,92220,-,-
BAC132_I08,5,5q31.1,132796819,132900663,103844,-,-
BAC39_E04,5,5q31.1,132806966,132900663,93697,-,-
BAC161_C03,5,5q31.1,132817972,132902649,84677,-,-
BAC26_D06,5,5q31.1,132817972,132914158,96186,-,-
BAC147_O10,5,5q31.1,132829538,132939041,109503,-,-
BAC95_G05,5,5q31.1,132829566,132935086,105520,-,-
BAC129_B18,5,5q31.1,132895321,132978293,82972,-,-
BAC41_J05,5,5q31.1,132920796,133037919,117123,-,-
BAC137_D23,5,5q31.1,132967202,133053115,85913,-,-
BAC234_J24,5,5q31.1,133041195,133108871,67676,-,-
BAC40_E11,5,5q31.1,133060525,133146433,85908,-,-
BAC109_A11,5,5q31.1,133060525,133147455,86930,-,-
BAC36_D22,5,5q31.1,133147727,133278136,130409,-,-
BAC233_L10,5,5q31.1,133158540,133238186,79646,-,-
BAC107_C16,5,5q31.1,133217685,133311006,93321,-,-
BAC153_K16,5,5q31.1,133217685,133347539,129854,-,-
BAC77_F06,5,5q31.1,133238390,133413167,174777,-,-
BAC24_E09,5,5q31.1,133304187,133463919,159732,-,-
BAC190_L16,5,5q31.1,133329206,133449012,119806,-,-
BAC17_B02,5,5q31.1,133333782,133417727,83945,-,-
BAC31_H07,5,5q31.1,133361320,133452793,91473,-,-
BAC250_I02,5,5q31.1,133361321,133449012,87691,-,-
BAC71_D07,5,5q31.1,133449010,133606447,157437,-,-
BAC230_I05,5,5q31.1,133524367,133606447,82080,-,-
BAC109_M09,5,5q31.1,133604213,133688990,84777,-,-
BAC154_E10,5,5q31.1,133606441,133694308,87867,-,-
BAC178_P14,5,5q31.1,133640924,133802701,161777,-,-
BAC81_K17,5,5q31.1,133705238,133843056,137818,-,-
BAC146_F08,5,5q31.1,133705238,133791702,86464,-,-
BAC226_E20,5,5q31.1,133736510,133825484,88974,-,-
BAC165_M18,5,5q31.1,133791609,133873702,82093,-,-
BAC51_G21,5,5q31.1,133935335,134041899,106564,-,-
BAC193_A14,5,5q31.1,133956079,134047891,91812,-,-
BAC80_H14,5,5q31.1,133956283,134077741,121458,-,-
BAC166_N06,5,5q31.1,133973909,134088177,114268,-,-
BAC48_H18,5,5q31.1,133973909,134065426,91517,-,-
BAC53_F24,5,5q31.1,134047993,134158359,110366,-,-
BAC177_D08,5,5q31.1,134056584,134152002,95418,-,-
BAC192_P08,5,5q31.1,134099244,134196962,97718,-,-
BAC147_O11,5,5q31.1,134112675,134188790,76115,-,-
BAC43_D15,5,5q31.1,134133859,134281227,147368,-,-
BAC141_F15,5,5q31.1,134175351,134280162,104811,-,-
BAC182_D18,5,5q31.1,134197828,134275494,77666,-,-
BAC92_G11,5,5q31.1,134237079,134394741,157662,-,-
BAC30_B06,5,5q31.1,134240916,134360077,119161,-,-
BAC236_I12,5,5q31.1,134281079,134366349,85270,-,-
BAC92_I09,5,5q31.1,134305370,134461365,155995,-,-
BAC27_N23,5,5q31.1,134366901,134477059,110158,-,-
BAC89_H06,5,5q31.1,134481616,134610713,129097,-,-
BAC43_E24,5,5q31.1,134625049,134716134,91085,-,-
BAC84_F04,5,5q31.1,134642614,134746072,103458,-,-
BAC147_C03,5,5q31.1,134675261,134773794,98533,-,-
BAC73_M03,5,5q31.1,134747700,134847000,99300,-,-
BAC144_A22,5,5q31.1,134775509,134863871,88362,-,-
BAC187_F17,5,5q31.1,134828022,134945079,117057,-,-
BAC219_D06,5,5q31.1,134828279,134925716,97437,-,-
BAC242_L16,5,5q31.1,134845872,134863871,17999,-,-
BAC184_C22,5,5q31.1,134867706,134962021,94315,-,-
BAC141_H03,5,5q31.1,134897233,134976855,79622,-,-
BAC71_O08,5,5q31.1,134915956,135026006,110050,-,-
BAC186_B19,5,5q31.1,134935013,135034737,99724,-,-
BAC248_D10,5,5q31.1,134965398,135064838,99440,-,-
BAC37_C04,5,5q31.1,134967731,135063469,95738,-,-
BAC1_G12,5,5q31.1,135103165,135240156,136991,-,-
BAC198_K17,5,5q31.1,135107553,135212547,104994,-,-
BAC144_F13,5,5q31.1,135107584,135242485,134901,-,-
BAC19_A16,5,5q31.1,135110649,135182739,72090,-,-
BAC235_C04,5,5q31.1,135110914,135193672,82758,-,-
BAC38_L16,5,5q31.1,135110914,135209266,98352,-,-
BAC219_E01,5,5q31.1,135193673,135292381,98708,-,-
BAC66_K16,5,5q31.1,135221871,135235580,13709,-,-
BAC143_L18,5,5q31.1,135221882,135315064,93182,-,-
BAC165_B19,5,5q31.1,135255936,135341610,85674,-,-
BAC249_H10,5,5q31.1-5q31.2,135315057,135413862,98805,-,-
BAC64_D21,5,5q31.1-5q31.2,135325184,135429614,104430,-,-
BAC167_K03,5,5q31.1-5q31.2,135340080,135429875,89795,-,-
BAC67_A17,5,5q31.1-5q31.2,135348471,135429884,81413,-,-
BAC150_H07,5,5q31.1-5q31.2,135350461,135429883,79422,-,-
BAC229_L03,5,5q31.1-5q31.2,135352798,135471065,118267,-,-
BAC244_F18,5,5q31.1-5q31.2,135385702,135469887,84185,-,-
BAC59_N13,5,5q31.1-5q31.2,135390747,135502260,111513,-,-
BAC165_I21,5,5q31.2,135413940,135497346,83406,-,-
BAC148_G05,5,5q31.2,135614447,135712929,98482,-,-
BAC84_H22,5,5q31.2,135637334,135738309,100975,-,-
BAC56_O06,5,5q31.2,135738303,135833462,95159,-,-
BAC153_N10,5,5q31.2,135849328,135949858,100530,-,-
BAC51_M05,5,5q31.2,135900062,136026329,126267,-,-
BAC222_M04,5,5q31.2,135920957,136054484,133527,-,-
BAC40_N05,5,5q31.2,136043155,136175100,131945,-,-
BAC249_O11,5,5q31.2,136043183,136140982,97799,-,-
BAC134_H14,5,5q31.2,136106269,136218133,111864,-,-
BAC140_I15,5,5q31.2,136133021,136156843,23822,-,-
BAC34_D10,5,5q31.2,136173880,136332411,158531,-,-
BAC137_O02,5,5q31.2,136175220,136297157,121937,-,-
BAC105_J13,5,5q31.2,136271586,136366023,94437,-,-
BAC9_F02,5,5q31.2,136336400,136420184,83784,-,-
BAC139_A14,5,5q31.2,136354029,136452556,98527,-,-
BAC107_L04,5,5q31.2,136367445,136475756,108311,-,-
BAC219_F20,5,5q31.2,136374616,136467897,93281,-,-
BAC51_H16,5,5q31.2,136466966,136548477,81511,-,-
BAC151_C08,5,5q31.2,136506871,136582208,75337,-,-
BAC122_I08,5,5q31.2,136536418,136630689,94271,-,-
BAC150_F16,5,5q31.2,136590685,136684785,94100,-,-
BAC10_N14,5,5q31.2,136591410,136660590,69180,-,-
BAC13_B14,5,5q31.2,136608770,136756881,148111,-,-
BAC151_M17,5,5q31.2,136608780,136683923,75143,-,-
BAC226_H05,5,5q31.2,136633867,136752315,118448,-,-
BAC144_J24,5,5q31.2,136671096,136768725,97629,-,-
BAC23_B12,5,5q31.2,136671096,136788617,117521,-,-
BAC243_D17,5,5q31.2,136684898,136756887,71989,-,-
BAC97_L04,5,5q31.2,136696931,136770137,73206,-,-
BAC75_I12,5,5q31.2,136777931,136904659,126728,-,-
BAC22_G16,5,5q31.2,137154529,137310960,156431,-,-
BAC125_F18,5,5q31.2,137156641,137239383,82742,-,-
BAC49_A08,5,5q31.2,137161231,137296563,135332,-,-
BAC161_E10,5,5q31.2,137310967,137418327,107360,-,-
BAC90_N13,5,5q31.2,137324937,137396705,71768,-,-
BAC12_H09,5,5q31.2,137383286,137531706,148420,-,-
BAC36_G10,5,5q31.2,137407836,137535565,127729,-,-
BAC161_B01,5,5q31.2,137410661,137516843,106182,-,-
BAC197_N12,5,5q31.2,137410661,137506871,96210,-,-
BAC157_E04,5,5q31.2,137432954,137511747,78793,-,-
BAC85_M01,5,5q31.2,137432954,137521981,89027,-,-
BAC181_L21,5,5q31.2,137441788,137511747,69959,-,-
BAC60_B17,5,5q31.2,137441788,137570290,128502,-,-
BAC116_I13,5,5q31.2,137529727,137661251,131524,-,-
BAC78_N03,5,5q31.2,137553256,137640588,87332,-,-
BAC63_G07,5,5q31.2,137622166,137719422,97256,-,-
BAC189_P21,5,5q31.2,137623847,137703269,79422,-,-
BAC186_P15,5,5q31.2,137623847,137708593,84746,-,-
BAC196_H09,5,5q31.2,137640582,137787638,147056,-,-
BAC224_N10,5,5q31.2,137640582,137732955,92373,-,-
BAC199_B10,5,5q31.2,137672828,137761448,88620,-,-
BAC116_J22,5,5q31.2,137717767,137836566,118799,-,-
BAC235_L18,5,5q31.2,137849871,137942895,93024,-,-
BAC96_A14,5,5q31.2,137929270,138013345,84075,-,-
BAC73_G17,5,5q31.2,137932246,138020870,88624,-,-
BAC118_P01,5,5q31.2,137985083,138160658,175575,-,-
BAC21_G04,5,5q31.2,138011718,138112153,100435,-,-
BAC103_I18,5,5q31.2,138012125,138083433,71308,-,-
BAC67_M08,5,5q31.2,138027317,138106282,78965,-,-
BAC117_E20,5,5q31.2,138158763,138249231,90468,-,-
BAC175_F06,5,5q31.2,138239537,138377004,137467,-,-
BAC125_C07,5,5q31.2,138262215,138349101,86886,-,-
BAC124_N15,5,5q31.2,138268132,138349101,80969,-,-
BAC196_J10,5,5q31.2,138293812,138418263,124451,-,-
BAC135_G13,5,5q31.2,138299076,138389237,90161,-,-
BAC56_B20,5,5q31.2,138341441,138444241,102800,-,-
BAC100_P14,5,5q31.2,138405833,138502955,97122,-,-
BAC120_I19,5,5q31.2,138418258,138502334,84076,-,-
BAC170_L10,5,5q31.2,138444234,138520710,76476,-,-
BAC42_N15,5,5q31.2,138478116,138578665,100549,-,-
BAC124_K20,5,5q31.2,138491132,138650113,158981,-,-
BAC22_K17,5,5q31.2,138514605,138640724,126119,-,-
BAC12_A19,5,5q31.2,138554892,138650113,95221,-,-
BAC171_K01,5,5q31.2,138556631,138650113,93482,-,-
BAC168_C02,5,5q31.2,138569028,138650113,81085,-,-
BAC180_K17,5,5q31.2,138670777,138758916,88139,-,-
BAC213_E16,5,5q31.2,138681288,138759443,78155,-,-
BAC175_D03,5,5q31.2,138683029,138774104,91075,-,-
BAC60_D10,5,5q31.2,138684524,138796733,112209,-,-
BAC24_B04,5,5q31.2,138700787,138796729,95942,-,-
BAC96_B19,5,5q31.2,138911950,138993355,81405,-,-
BAC150_C15,5,5q31.2-5q31.3,138933474,139037269,103795,-,-
BAC236_F12,5,5q31.3,139076307,139197513,121206,-,-
BAC131_K17,5,5q31.3,139150165,139241567,91402,-,-
BAC186_F07,5,5q31.3,139197508,139302110,104602,-,-
BAC25_J06,5,5q31.3,139237618,139369208,131590,-,-
BAC58_O05,5,5q31.3,139241562,139332643,91081,-,-
BAC36_M10,5,5q31.3,139343642,139451764,108122,-,-
BAC137_M06,5,5q31.3,139415973,139501310,85337,-,-
BAC37_I15,5,5q31.3,139432945,139566896,133951,-,-
BAC167_K06,5,5q31.3,139492769,139596141,103372,-,-
BAC80_K05,5,5q31.3,139522200,139663259,141059,-,-
BAC234_I22,5,5q31.3,139526829,139635177,108348,-,-
BAC124_O04,5,5q31.3,139566974,139663276,96302,-,-
BAC192_O10,5,5q31.3,139592055,139687556,95501,-,-
BAC135_F03,5,5q31.3,139593015,139689790,96775,-,-
BAC198_O13,5,5q31.3,139683615,139769664,86049,-,-
BAC203_N15,5,5q31.3,139683783,139768302,84519,-,-
BAC56_N03,5,5q31.3,139701425,139871697,170272,-,-
BAC83_M24,5,5q31.3,139726126,139871030,144904,-,-
BAC182_G09,5,5q31.3,139799902,139871030,71128,-,-
BAC118_I22,5,5q31.3,139840205,139949301,109096,-,-
BAC90_E19,5,5q31.3,139872024,139949261,77237,-,-
BAC154_O08,5,5q31.3,139902921,139986784,83863,-,-
BAC83_P23,5,5q31.3,139986987,140084153,97166,-,-
BAC186_O23,5,5q31.3,140005292,140143879,138587,-,-
BAC113_A24,5,5q31.3,140015495,140111332,95837,-,-
BAC100_P05,5,5q31.3,140021465,140128456,106991,-,-
BAC111_I20,5,5q31.3,140060144,140158663,98519,-,-
BAC152_F09,5,5q31.3,140128463,140207438,78975,-,-
BAC50_J13,5,5q31.3,140137833,140244420,106587,-,-
BAC49_K03,5,5q31.3,140143970,140249769,105799,-,-
BAC131_C19,5,5q31.3,140166077,140249768,83691,-,-
BAC66_L13,5,5q31.3,140207456,140300389,92933,-,-
BAC63_A02,5,5q31.3,140253476,140345297,91821,-,-
BAC103_N18,5,5q31.3,140259453,140365874,106421,-,-
BAC38_L13,5,5q31.3,140264794,140275895,11101,-,-
BAC223_E02,5,5q31.3,140343332,140467432,124100,-,-
BAC26_F08,5,5q31.3,140347240,140446173,98933,-,-
BAC110_J08,5,5q31.3,140358478,140467319,108841,-,-
BAC221_B06,5,5q31.3,140386148,140478418,92270,-,-
BAC91_K24,5,5q31.3,140392538,140473478,80940,-,-
BAC201_F22,5,5q31.3,140478628,140564583,85955,yes,-
BAC41_G10,5,5q31.3,140478628,140574731,96103,yes,-
BAC175_L19,5,5q31.3,140519407,140612056,92649,yes,-
BAC73_C15,5,5q31.3,140695368,140793915,98547,-,-
BAC128_D20,5,5q31.3,140704294,140853128,148834,-,-
BAC177_G15,5,5q31.3,140715475,140787227,71752,-,-
BAC173_K12,5,5q31.3,140824672,140899624,74952,-,-
BAC135_O09,5,5q31.3,140962316,141041385,79069,-,-
BAC152_F21,5,5q31.3,141041399,141126528,85129,-,-
BAC156_A10,5,5q31.3,141102598,141196227,93629,-,-
BAC220_M04,5,5q31.3,141107222,141184372,77150,-,-
BAC136_I02,5,5q31.3,141110942,141202474,91532,-,-
BAC209_P20,5,5q31.3,141112920,141196227,83307,-,-
BAC84_B24,5,5q31.3,141121461,141207306,85845,-,-
BAC129_F18,5,5q31.3,141125695,141212084,86389,-,-
BAC142_B12,5,5q31.3,141126518,141240966,114448,-,-
BAC91_A05,5,5q31.3,141241585,141327381,85796,-,-
BAC111_O14,5,5q31.3,141269043,141428744,159701,-,-
BAC92_E06,5,5q31.3,141270098,141389960,119862,-,-
BAC126_O10,5,5q31.3,141350960,141428554,77594,-,-
BAC240_C08,5,5q31.3,141412965,141503680,90715,-,-
BAC141_O11,5,5q31.3,141428783,141503684,74901,-,-
BAC96_J05,5,5q31.3,141437154,141563538,126384,-,-
BAC92_N04,5,5q31.3,141525042,141630040,104998,-,-
BAC244_E11,5,5q31.3,141555300,141663637,108337,-,-
BAC61_E10,5,5q31.3,141563565,141712943,149378,-,-
BAC153_H14,5,5q31.3,141576351,141675058,98707,-,-
BAC231_E23,5,5q31.3,141578719,141675058,96339,-,-
BAC39_E01,5,5q31.3,141675052,141780171,105119,-,-
BAC75_H11,5,5q31.3,141691689,141810256,118567,-,-
BAC50_H04,5,5q31.3,141708912,141815977,107065,-,-
BAC190_D03,5,5q31.3,141713099,141786529,73430,-,-
BAC244_D13,5,5q31.3,141722533,141818435,95902,-,-
BAC156_L16,5,5q31.3,141722567,141922588,200021,-,-
BAC59_K03,5,5q31.3,141772506,141901878,129372,-,-
BAC146_B01,5,5q31.3,141773042,141863364,90322,-,-
BAC145_A01,5,5q31.3,141810651,141905263,94612,-,-
BAC69_A15,5,5q31.3,141815981,141942450,126469,-,-
BAC161_G21,5,5q31.3,141822599,141904049,81450,-,-
BAC63_C15,5,5q31.3,141942445,142025414,82969,-,-
BAC56_E03,5,5q31.3,141942445,142028322,85877,-,-
BAC197_P04,5,5q31.3,141954587,142032677,78090,-,-
BAC169_C13,5,5q31.3,141971648,142056940,85292,-,-
BAC243_G16,5,5q31.3,141994636,142092968,98332,-,-
BAC84_L03,5,5q31.3,142057234,142163807,106573,-,-
BAC249_B11,5,5q31.3,142124891,142212735,87844,-,-
BAC236_L02,5,5q31.3,142154814,142238803,83989,-,-
BAC131_J19,5,5q31.3,142184811,142315628,130817,-,-
BAC52_J19,5,5q31.3,142212952,142295055,82103,-,-
BAC221_G20,5,5q31.3,142213577,142320769,107192,-,-
BAC172_F06,5,5q31.3,142223559,142327662,104103,-,-
BAC252_A19,5,5q31.3,142301418,142444802,143384,-,-
BAC221_F15,5,5q31.3,142350013,142444802,94789,-,-
BAC19_K14,5,5q31.3,142350013,142469602,119589,-,-
BAC218_D13,5,5q31.3,142351831,142444802,92971,-,-
BAC89_M04,5,5q31.3,142357995,142447763,89768,-,-
BAC53_I17,5,5q31.3,142823772,142913389,89617,-,-
BAC224_A15,5,5q31.3,142844701,142964877,120176,-,-
BAC56_C06,5,5q31.3,142854057,142964875,110818,-,-
BAC79_H20,5,5q31.3,142964195,143055100,90905,-,-
BAC128_H10,5,5q31.3-5q32,143055135,143136498,81363,-,-
BAC76_G06,5,5q32,143168529,143253342,84813,-,-
BAC149_P11,5,5q32,143431278,143511240,79962,-,-
BAC108_P03,5,5q32,143548195,143689457,141262,-,-
BAC244_O15,5,5q32,143573838,143667818,93980,-,-
BAC246_H13,5,5q32,143661988,143745795,83807,-,-
BAC184_D04,5,5q32,143902661,144006305,103644,-,-
BAC79_B21,5,5q32,144154880,144249921,95041,-,-
BAC126_D19,5,5q32,144345563,144468923,123360,-,-
BAC145_F19,5,5q32,144450824,144540083,89259,-,-
BAC48_M15,5,5q32,144709813,144823652,113839,-,-
BAC251_A09,5,5q32,144777331,144873154,95823,-,-
BAC18_L06,5,5q32,144856309,144995855,139546,-,-
BAC60_A19,5,5q32,144903921,145045023,141102,-,-
BAC236_C14,5,5q32,144964802,145055766,90964,-,-
BAC175_L17,5,5q32,145151969,145275489,123520,-,-
BAC120_L16,5,5q32,145151969,145234618,82649,-,-
BAC123_J08,5,5q32,145234612,145347856,113244,-,-
BAC92_E22,5,5q32,145243918,145423129,179211,yes,-
BAC22_A07,5,5q32,145243929,145333919,89990,-,-
BAC120_J10,5,5q32,145348010,145492401,144391,-,-
BAC162_C05,5,5q32,145369797,145471508,101711,-,-
BAC146_H11,5,5q32,145371988,145471368,99380,-,-
BAC10_N22,5,5q32,145380560,145475242,94682,-,-
BAC54_M20,5,5q32,145437922,145509894,71972,-,-
BAC181_D06,5,5q32,145443631,145560130,116499,-,-
BAC108_K04,5,5q32,145469867,145596300,126433,-,-
BAC155_C21,5,5q32,145471842,145561633,89791,-,-
BAC182_L15,5,5q32,145473297,145561635,88338,-,-
BAC123_B12,5,5q32,145475666,145561635,85969,-,-
BAC62_K01,5,5q32,145492600,145573435,80835,-,-
BAC149_J13,5,5q32,145574113,145696313,122200,-,-
BAC183_H23,5,5q32,145597071,145669752,72681,-,-
BAC194_I16,5,5q32,145601321,145696313,94992,-,-
BAC217_B09,5,5q32,145611418,145688696,77278,-,-
BAC53_H12,5,5q32,145611444,145699321,87877,-,-
BAC142_K06,5,5q32,145775275,145867939,92664,-,-
BAC142_J06,5,5q32,145775275,145867939,92664,-,-
BAC200_D20,5,5q32,145777460,145881398,103938,-,-
BAC40_G09,5,5q32,145794209,145905386,111177,-,-
BAC20_N07,5,5q32,145803583,145905386,101803,-,-
BAC58_D13,5,5q32,145835441,145946195,110754,-,-
BAC210_K15,5,5q32,145881400,145983131,101731,-,-
BAC185_H04,5,5q32,145926848,145986798,59950,-,-
BAC204_A22,5,5q32,146093491,146183524,90033,-,-
BAC186_K02,5,5q32,146118867,146203075,84208,-,-
BAC230_P18,5,5q32,146419589,146498063,78474,-,-
BAC140_J06,5,5q32,146534862,146625411,90549,-,-
BAC84_D18,5,5q32,146667450,146750887,83437,-,-
BAC83_O10,5,5q32,146758568,146859615,101047,-,-
BAC29_I07,5,5q32,146778536,146875083,96547,-,-
BAC97_O16,5,5q32,146870522,146958626,88104,-,-
BAC179_C23,5,5q32,146892803,146955615,62812,-,-
BAC186_G15,5,5q32,146970755,147044911,74156,-,-
BAC229_L08,5,5q32,146970759,147060401,89642,-,-
BAC155_N07,5,5q32,147044921,147146346,101425,-,-
BAC141_I07,5,5q32,147066658,147156406,89748,-,-
BAC75_L12,5,5q32,147085144,147193095,107951,-,-
BAC27_B04,5,5q33.1,147427739,147565341,137602,-,-
BAC109_I19,5,5q33.1,147546634,147668727,122093,-,-
BAC131_J04,5,5q33.1,147570634,147658995,88361,-,-
BAC95_C09,5,5q33.1,147807278,147903515,96237,-,-
BAC30_N03,5,5q33.1,148018747,148144960,126213,-,-
BAC178_P07,5,5q33.1,148022573,148120146,97573,-,-
BAC103_C04,5,5q33.1,148027177,148139986,112809,-,-
BAC155_M20,5,5q33.1,148199884,148337562,137678,-,-
BAC176_D21,5,5q33.1,148258326,148368437,110111,-,-
BAC127_O20,5,5q33.1,148366988,148461459,94471,-,-
BAC96_O05,5,5q33.1,148453567,148566522,112955,-,-
BAC33_E02,5,5q33.1,148453571,148581100,127529,-,-
BAC80_F17,5,5q33.1,148470392,148567911,97519,-,-
BAC82_G08,5,5q33.1,148472107,148560355,88248,-,-
BAC108_P19,5,5q33.1,148484006,148567908,83902,-,-
BAC30_I19,5,5q33.1,148513726,148619680,105954,-,-
BAC122_E09,5,5q33.1,148521732,148635727,113995,-,-
BAC95_C21,5,5q33.1,148560357,148679832,119475,-,-
BAC66_E22,5,5q33.1,148568196,148674031,105835,-,-
BAC41_N20,5,5q33.1,148603523,148712964,109441,-,-
BAC217_H02,5,5q33.1,148625136,148717480,92344,-,-
BAC217_E19,5,5q33.1,148626284,148727984,101700,-,-
BAC36_E20,5,5q33.1,148731606,148847232,115626,-,-
BAC115_I06,5,5q33.1,148753049,148847232,94183,-,-
BAC237_P21,5,5q33.1,148759078,148874729,115651,-,-
BAC198_L15,5,5q33.1,148767630,148847232,79602,-,-
BAC199_E12,5,5q33.1,148780748,148858266,77518,-,-
BAC89_O07,5,5q33.1,148826312,148923427,97115,-,-
BAC234_C21,5,5q33.1,148826312,148956707,130395,-,-
BAC248_G19,5,5q33.1,148836561,148939236,102675,-,-
BAC200_I12,5,5q33.1,148873126,148976657,103531,-,-
BAC60_O11,5,5q33.1,148883363,148976657,93294,-,-
BAC24_N02,5,5q33.1,148883363,148976654,93291,-,-
BAC200_I22,5,5q33.1,148981291,149085459,104168,-,-
BAC197_I03,5,5q33.1,148983097,149079654,96557,-,-
BAC57_F06,5,5q33.1,149025651,149104023,78372,-,-
BAC55_A17,5,5q33.1,149079653,149199078,119425,-,-
BAC215_D07,5,5q33.1,149127199,149234045,106846,-,-
BAC37_N07,5,5q33.1,149131687,149235611,103924,-,-
BAC151_C21,5,5q33.1,149219502,149306711,87209,-,-
BAC239_L12,5,5q33.1,149219502,149308278,88776,-,-
BAC141_J05,5,5q33.1,149220421,149311100,90679,-,-
BAC67_M24,5,5q33.1,149220421,149378217,157796,-,-
BAC122_G02,5,5q33.1,149283501,149381203,97702,-,-
BAC73_J09,5,5q33.1,149293500,149381200,87700,-,-
BAC58_D15,5,5q33.1,149304575,149393539,88964,-,-
BAC126_F14,5,5q33.1,149340330,149432652,92322,-,-
BAC60_O17,5,5q33.1,149350197,149468340,118143,-,-
BAC12_G03,5,5q33.1,149378229,149468049,89820,-,-
BAC46_A03,5,5q33.1,149378294,149516544,138250,-,-
BAC185_O13,5,5q33.1,149381289,149494253,112964,-,-
BAC46_J03,5,5q33.1,149383142,149474089,90947,-,-
BAC143_A21,5,5q33.1,149468051,149561414,93363,-,-
BAC40_B19,5,5q33.1,149528691,149695555,166864,-,-
BAC222_K15,5,5q33.1,149551648,149631439,79791,-,-
BAC148_D23,5,5q33.1,149559660,149666803,107143,-,-
BAC144_J12,5,5q33.1,149561415,149654758,93343,-,-
BAC181_A03,5,5q33.1,149581624,149663153,81529,-,-
BAC96_A01,5,5q33.1,149634656,149743694,109038,-,-
BAC71_E10,5,5q33.1,149634656,149743694,109038,-,-
BAC144_P09,5,5q33.1,149645866,149745853,99987,-,-
BAC56_C16,5,5q33.1,149671285,149779758,108473,-,-
BAC36_C06,5,5q33.1,149676633,149782761,106128,-,-
BAC41_J15,5,5q33.1,149700964,149825737,124773,yes,-
BAC67_C20,5,5q33.1,149743688,149856733,113045,yes,-
BAC64_L07,5,5q33.1,149749509,149842991,93482,yes,-
BAC15_I08,5,5q33.1,149749509,149866618,117109,yes,-
BAC133_D20,5,5q33.1,149761493,149884696,123203,yes,-
BAC179_E14,5,5q33.1,149763711,149859951,96240,yes,-
BAC69_P17,5,5q33.1,149780004,149888104,108100,yes,-
BAC202_M18,5,5q33.1,149826083,149939962,113879,yes,-
BAC159_J09,5,5q33.1,149856798,149992078,135280,-,-
BAC89_O09,5,5q33.1,149864663,150043941,179278,yes,-
BAC173_A09,5,5q33.1,149864709,149978531,113822,yes,-
BAC19_M21,5,5q33.1,149868798,149963407,94609,yes,-
BAC229_G03,5,5q33.1,149868836,149963407,94571,yes,-
BAC180_A04,5,5q33.1,149934471,150030132,95661,yes,-
BAC104_J07,5,5q33.1,150000582,150104450,103868,yes,-
BAC62_F19,5,5q33.1,150019601,150094902,75301,yes,-
BAC167_M16,5,5q33.1,150043732,150136887,93155,yes,-
BAC147_G02,5,5q33.1,150094897,150171373,76476,-,-
BAC134_L19,5,5q33.1,150167198,150229529,62331,yes,-
BAC109_I15,5,5q33.1,150171376,150271222,99846,yes,-
BAC141_C13,5,5q33.1,150255101,150341801,86700,-,-
BAC180_B16,5,5q33.1,150354733,150438521,83788,-,-
BAC109_I07,5,5q33.1,150355525,150442483,86958,-,-
BAC112_K06,5,5q33.1,150365578,150538003,172425,-,-
BAC83_K05,5,5q33.1,150365780,150532812,167032,-,-
BAC25_D08,5,5q33.1,150392348,150510101,117753,-,-
BAC53_E16,5,5q33.1,150442495,150532001,89506,-,-
BAC66_N24,5,5q33.1,150443734,150531985,88251,-,-
BAC75_F08,5,5q33.1,150501160,150606824,105664,-,-
BAC39_K21,5,5q33.1,150518019,150624351,106332,-,-
BAC107_O06,5,5q33.1,150531996,150681085,149089,-,-
BAC231_D15,5,5q33.1,150538030,150613600,75570,-,-
BAC165_H06,5,5q33.1,150541343,150638175,96832,-,-
BAC101_G16,5,5q33.1,150542021,150639512,97491,-,-
BAC43_G05,5,5q33.1,150552482,150753954,201472,-,-
BAC170_O02,5,5q33.1,150552728,150638176,85448,-,-
BAC141_L17,5,5q33.1,150562166,150639512,77346,-,-
BAC230_I12,5,5q33.1,150591385,150676015,84630,-,-
BAC196_M16,5,5q33.1,150638401,150753964,115563,-,-
BAC14_H09,5,5q33.1,150708460,150808053,99593,-,-
BAC33_F10,5,5q33.1,150708631,150813839,105208,-,-
BAC196_F04,5,5q33.1,150709075,150800689,91614,-,-
BAC124_N20,5,5q33.1,150722163,150841913,119750,-,-
BAC84_N10,5,5q33.1,150722163,150813597,91434,-,-
BAC160_N18,5,5q33.1,150813974,150904989,91015,-,-
BAC55_M17,5,5q33.1,150819988,150904481,84493,-,-
BAC71_H11,5,5q33.1,150838888,150928064,89176,-,-
BAC186_K13,5,5q33.1,150866557,150951523,84966,-,-
BAC158_P07,5,5q33.1,151006965,151114734,107769,-,-
BAC142_F14,5,5q33.1,151031813,151118622,86809,-,-
BAC155_F06,5,5q33.1,151048464,151166090,117626,-,-
BAC151_B02,5,5q33.1,151111461,151185665,74204,-,-
BAC144_H17,5,5q33.1,151133613,151226693,93080,-,-
BAC101_M17,5,5q33.1,151187481,151283717,96236,-,-
BAC65_G22,5,5q33.1,151192188,151349138,156950,-,-
BAC180_A17,5,5q33.1,151249757,151330870,81113,-,-
BAC86_A16,5,5q33.1,151319740,151462078,142338,-,-
BAC149_K14,5,5q33.1,151319740,151434039,114299,-,-
BAC221_G17,5,5q33.1,151405397,151507613,102216,-,-
BAC101_K01,5,5q33.1,151409029,151537048,128019,-,-
BAC59_C02,5,5q33.1,151486935,151582359,95424,-,-
BAC123_O05,5,5q33.1,151507677,151629257,121580,-,-
BAC45_D02,5,5q33.1,151695971,151783243,87272,-,-
BAC197_A01,5,5q33.1,151757802,151856818,99016,-,-
BAC81_M14,5,5q33.1-5q33.2,152081476,152200669,119193,-,-
BAC80_N23,5,5q33.2,152104344,152214834,110490,-,-
BAC105_I01,5,5q33.2,152126678,152254257,127579,-,-
BAC42_F12,5,5q33.2,152172316,152290467,118151,-,-
BAC148_G17,5,5q33.2,152221969,152316058,94089,-,-
BAC194_I14,5,5q33.2,152396386,152479368,82982,-,-
BAC168_F06,5,5q33.2,152493420,152585428,92008,-,-
BAC106_O10,5,5q33.2,152783741,152890138,106397,-,-
BAC100_M18,5,5q33.2,152950307,153052395,102088,-,-
BAC41_P12,5,5q33.2,152976340,153063186,86846,-,-
BAC241_P06,5,5q33.2,152985702,153069507,83805,-,-
BAC88_H12,5,5q33.2,152990340,153100541,110201,-,-
BAC227_C05,5,5q33.2,153042961,153137798,94837,-,-
BAC196_M10,5,5q33.2,153067585,153175983,108398,-,-
BAC28_D23,5,5q33.2,153082459,153209764,127305,-,-
BAC107_L07,5,5q33.2,153100745,153209812,109067,-,-
BAC150_E17,5,5q33.2,153175975,153253251,77276,-,-
BAC241_M17,5,5q33.2,153175976,153265142,89166,-,-
BAC63_B15,5,5q33.2,153250245,153351150,100905,-,-
BAC58_F01,5,5q33.2,153445284,153539664,94380,-,-
BAC96_F23,5,5q33.2,153472622,153587860,115238,-,-
BAC88_B06,5,5q33.2,153489097,153603754,114657,-,-
BAC61_I05,5,5q33.2,153557974,153678621,120647,-,-
BAC22_F03,5,5q33.2,153627014,153718215,91201,-,-
BAC237_H08,5,5q33.2,153708372,153771078,62706,-,-
BAC77_F02,5,5q33.2,153708492,153811091,102599,-,-
BAC83_D21,5,5q33.2,153771091,153868475,97384,-,-
BAC111_O07,5,5q33.2,153773869,153912694,138825,-,-
BAC52_D14,5,5q33.2,153819720,153912709,92989,-,-
BAC128_D24,5,5q33.2,153834119,154052227,218108,-,-
BAC176_E12,5,5q33.2,153850271,153939696,89425,-,-
BAC56_F15,5,5q33.2,153888867,154052238,163371,-,-
BAC124_H15,5,5q33.2,153888867,154003184,114317,-,-
BAC45_K10,5,5q33.2,153917106,154007667,90561,-,-
BAC196_H03,5,5q33.2,153966202,154073918,107716,-,-
BAC136_B07,5,5q33.2,153966202,154052245,86043,-,-
BAC196_G03,5,5q33.2,153966202,154073918,107716,-,-
BAC156_P22,5,5q33.2,154007988,154121034,113046,-,-
BAC102_K19,5,5q33.2,154056269,154141346,85077,-,-
BAC44_N12,5,5q33.2,154118484,154228349,109865,-,-
BAC139_G06,5,5q33.2,154141437,154228362,86925,-,-
BAC114_J11,5,5q33.2,154141442,154280895,139453,-,-
BAC91_C09,5,5q33.2,154169222,154276872,107650,-,-
BAC231_I21,5,5q33.2,154180447,154262204,81757,-,-
BAC201_L15,5,5q33.2,154180950,154262112,81162,-,-
BAC247_F19,5,5q33.2,154191985,154288510,96525,-,-
BAC24_H10,5,5q33.2,154232540,154346866,114326,yes,-
BAC234_J11,5,5q33.2,154263907,154345592,81685,-,-
BAC211_D02,5,5q33.2,154344817,154430272,85455,-,-
BAC81_G04,5,5q33.2,154346860,154433718,86858,-,-
BAC180_E23,5,5q33.2,154436890,154519693,82803,-,-
BAC196_O08,5,5q33.2,154462148,154555119,92971,-,-
BAC220_B23,5,5q33.2,154483470,154562924,79454,-,-
BAC44_P11,5,5q33.2,154525713,154618592,92879,-,-
BAC60_F20,5,5q33.2,154608520,154716693,108173,-,-
BAC226_A22,5,5q33.2,154614702,154678465,63763,-,-
BAC235_G03,5,5q33.2,154674188,154757442,83254,-,-
BAC133_M19,5,5q33.2,154678833,154786606,107773,-,-
BAC118_L21,5,5q33.2,154681294,154762319,81025,-,-
BAC24_G21,5,5q33.2,154809395,154956718,147323,-,-
BAC69_K08,5,5q33.2,154826405,154918530,92125,-,-
BAC38_F16,5,5q33.2,154855878,154956718,100840,-,-
BAC131_N12,5,5q33.2,154938115,155038743,100628,-,-
BAC184_O16,5,5q33.2,154960017,155060285,100268,-,-
BAC185_K14,5,5q33.2,155156429,155236205,79776,-,-
BAC13_B02,5,5q33.2,155199304,155291955,92651,-,-
BAC180_G24,5,5q33.2,155286032,155364673,78641,-,-
BAC60_M15,5,5q33.2,155369629,155455093,85464,-,-
BAC221_A11,5,5q33.2,155477849,155548253,70404,-,-
BAC27_L02,5,5q33.2-5q33.3,155523898,155624822,100924,-,-
BAC123_K15,5,5q33.2-5q33.3,155581630,155686247,104617,-,-
BAC223_I20,5,5q33.3,155766504,155779445,12941,-,-
BAC252_F24,5,5q33.3,155779484,155989913,210429,-,-
BAC103_D19,5,5q33.3,155847859,155949219,101360,-,-
BAC240_E08,5,5q33.3,155869449,155958935,89486,-,-
BAC101_N20,5,5q33.3,155894265,155978180,83915,-,-
BAC186_A04,5,5q33.3,155896211,155971067,74856,-,-
BAC72_O06,5,5q33.3,155956787,156072533,115746,-,-
BAC135_H12,5,5q33.3,155971127,156059065,87938,-,-
BAC141_L04,5,5q33.3,156118619,156202204,83585,-,-
BAC90_C05,5,5q33.3,156254288,156343994,89706,-,-
BAC100_B13,5,5q33.3,156285510,156380350,94840,-,-
BAC176_G19,5,5q33.3,156303663,156384901,81238,-,-
BAC107_M08,5,5q33.3,156325803,156476292,150489,-,-
BAC175_F09,5,5q33.3,156384900,156475295,90395,-,-
BAC111_L24,5,5q33.3,156454619,156622656,168037,-,-
BAC132_E02,5,5q33.3,156464671,156581167,116496,-,-
BAC66_J10,5,5q33.3,156468543,156553280,84737,-,-
BAC110_J17,5,5q33.3,156475289,156573872,98583,-,-
BAC39_H22,5,5q33.3,156496167,156578099,81932,-,-
BAC57_G23,5,5q33.3,156546305,156668693,122388,-,-
BAC61_E17,5,5q33.3,156578307,156740415,162108,-,-
BAC66_M05,5,5q33.3,156584973,156664942,79969,-,-
BAC106_L06,5,5q33.3,156598887,156712758,113871,-,-
BAC34_B21,5,5q33.3,156643116,156775225,132109,-,-
BAC34_B22,5,5q33.3,156643120,156775225,132105,-,-
BAC34_A22,5,5q33.3,156643120,156775220,132100,-,-
BAC39_G21,5,5q33.3,156648168,156740439,92271,-,-
BAC244_C03,5,5q33.3,156673350,156782480,109130,-,-
BAC28_J22,5,5q33.3,156743899,156866513,122614,-,-
BAC107_A05,5,5q33.3,156796865,156898170,101305,-,-
BAC20_D18,5,5q33.3,156806901,156936843,129942,-,-
BAC82_C23,5,5q33.3,156807038,156974123,167085,-,-
BAC56_H17,5,5q33.3,156844789,156936843,92054,-,-
BAC2_L12,5,5q33.3,156872349,156974102,101753,-,-
BAC15_O15,5,5q33.3,156914467,157081301,166834,-,-
BAC178_H12,5,5q33.3,157022827,157110137,87310,-,-
BAC178_G12,5,5q33.3,157022827,157110124,87297,-,-
BAC119_H20,5,5q33.3,157081994,157164203,82209,yes,-
BAC219_E13,5,5q33.3,157087864,157161320,73456,yes,-
BAC51_L08,5,5q33.3,157107615,157198814,91199,-,-
BAC197_A10,5,5q33.3,157207346,157290200,82854,-,-
BAC182_H17,5,5q33.3,157290288,157421713,131425,-,-
BAC62_C04,5,5q33.3,157318962,157410636,91674,-,-
BAC149_A17,5,5q33.3,157323559,157399537,75978,-,-
BAC237_C02,5,5q33.3,157323560,157400297,76737,-,-
BAC70_I02,5,5q33.3,157366884,157484311,117427,-,-
BAC35_M05,5,5q33.3,157369739,157468020,98281,-,-
BAC133_D06,5,5q33.3,157398540,157485169,86629,-,-
BAC196_P03,5,5q33.3,157399556,157499201,99645,-,-
BAC101_J03,5,5q33.3,157484434,157578923,94489,-,-
BAC244_G15,5,5q33.3,157484472,157571713,87241,-,-
BAC167_G14,5,5q33.3,157719402,157803060,83658,-,-
BAC158_D24,5,5q33.3,157795621,157881691,86070,-,-
BAC198_G06,5,5q33.3,157961746,158041454,79708,-,-
BAC186_L21,5,5q33.3,158095591,158197200,101609,-,-
BAC17_B23,5,5q33.3,158123625,158218675,95050,-,-
BAC126_B22,5,5q33.3,158124921,158210168,85247,-,-
BAC116_O16,5,5q33.3,158174706,158306136,131430,-,-
BAC234_H20,5,5q33.3,158256171,158372718,116547,-,-
BAC246_F13,5,5q33.3,158288920,158382675,93755,-,-
BAC52_O15,5,5q33.3,158382791,158500434,117643,-,-
BAC135_K20,5,5q33.3,158397431,158500493,103062,-,-
BAC101_K18,5,5q33.3,158485979,158594717,108738,-,-
BAC196_J01,5,5q33.3,158495211,158591660,96449,-,-
BAC118_B17,5,5q33.3,158523363,158612878,89515,-,-
BAC113_I14,5,5q33.3,158622349,158788647,166298,-,-
BAC131_C21,5,5q33.3,158632797,158720524,87727,-,-
BAC166_C02,5,5q33.3,158648049,158771396,123347,-,-
BAC137_H05,5,5q33.3,158703199,158796319,93120,-,-
BAC103_O23,5,5q33.3,158703201,158788647,85446,-,-
BAC61_J13,5,5q33.3,158752218,158910406,158188,-,-
BAC46_E15,5,5q33.3,158752335,158910384,158049,-,-
BAC247_N23,5,5q33.3,158820735,158908292,87557,-,-
BAC220_M06,5,5q33.3,158848923,158931563,82640,-,-
BAC199_P08,5,5q33.3,158988904,159084071,95167,-,-
BAC118_B12,5,5q33.3,159063293,159147238,83945,-,-
BAC218_O20,5,5q33.3,159083947,159173521,89574,-,-
BAC227_O21,5,5q33.3,159087574,159173509,85935,-,-
BAC55_O12,5,5q33.3,159115454,159204262,88808,-,-
BAC123_F20,5,5q33.3,159278066,159406127,128061,-,-
BAC247_J16,5,5q33.3,159288182,159380372,92190,-,-
BAC91_N15,5,5q33.3,159297559,159386965,89406,-,-
BAC206_F01,5,5q33.3,159304312,159390100,85788,-,-
BAC160_G03,5,5q33.3,159380883,159468935,88052,-,-
BAC180_L20,5,5q33.3,159487631,159592198,104567,-,-
BAC30_J12,5,5q33.3,159516202,159596298,80096,-,-
BAC56_J13,5,5q33.3,159547357,159645560,98203,-,-
BAC48_I10,5,5q33.3,159645555,159735741,90186,-,-
BAC56_M18,5,5q33.3,159645611,159789874,144263,-,-
BAC95_J02,5,5q33.3,159652400,159735741,83341,-,-
BAC126_L11,5,5q33.3-5q34,159699286,159909490,210204,-,-
BAC220_D10,5,5q33.3,159699288,159784151,84863,-,-
BAC73_O10,5,5q33.3-5q34,159784146,159912597,128451,-,-
BAC11_K18,5,5q33.3,159784390,159896517,112127,-,-
BAC191_P07,5,5q33.3-5q34,159793195,159910296,117101,-,-
BAC57_O24,5,5q34,159912592,160048575,135983,-,-
BAC59_N08,5,5q34,160026139,160135261,109122,-,-
BAC104_L21,5,5q34,160029515,160126704,97189,-,-
BAC73_F19,5,5q34,160107769,160199040,91271,-,-
BAC230_L23,5,5q34,160236758,160310760,74002,-,-
BAC63_A07,5,5q34,160438199,160559932,121733,-,-
BAC235_H05,5,5q34,160717521,160805763,88242,-,-
BAC27_H21,5,5q34,160742412,160838556,96144,-,-
BAC169_F12,5,5q34,160827841,160907807,79966,-,-
BAC161_P09,5,5q34,160838599,160953127,114528,-,-
BAC181_F20,5,5q34,160841336,160931125,89789,-,-
BAC19_A15,5,5q34,160929702,161017772,88070,-,-
BAC118_L14,5,5q34,160989979,161082026,92047,-,-
BAC203_M22,5,5q34,160990010,161086375,96365,-,-
BAC77_B07,5,5q34,161237169,161379762,142593,-,-
BAC125_C12,5,5q34,161243591,161340719,97128,-,-
BAC146_I02,5,5q34,161309954,161408160,98206,-,-
BAC19_B17,5,5q34,161335791,161431301,95510,-,-
BAC119_G16,5,5q34,161339907,161448059,108152,-,-
BAC128_P09,5,5q34,161339909,161448059,108150,-,-
BAC158_M17,5,5q34,161367339,161443663,76324,-,-
BAC197_M03,5,5q34,161450670,161548170,97500,-,-
BAC97_L16,5,5q34,161688736,161817573,128837,-,-
BAC96_L22,5,5q34,161696925,161798109,101184,-,-
BAC180_A14,5,5q34,161696997,161813844,116847,-,-
BAC248_C17,5,5q34,161981216,162037181,55965,-,-
BAC159_N08,5,5q34,162019783,162126364,106581,-,-
BAC45_C03,5,5q34,162071036,162167405,96369,-,-
BAC64_E05,5,5q34,162145721,162235174,89453,-,-
BAC134_M23,5,5q34,162310990,162401423,90433,-,-
BAC51_M06,5,5q34,162321493,162447202,125709,-,-
BAC118_I16,5,5q34,162522374,162636992,114618,-,-
BAC220_P11,5,5q34,162533398,162629051,95653,-,-
BAC54_B16,5,5q34,162561873,162666136,104263,-,-
BAC66_M02,5,5q34,162612398,162730275,117877,-,-
BAC123_O19,5,5q34,162618848,162723203,104355,-,-
BAC176_I10,5,5q34,162655325,162742922,87597,-,-
BAC223_O08,5,5q34,162675938,162768026,92088,-,-
BAC89_G06,5,5q34,162746542,162856701,110159,-,-
BAC184_P05,5,5q34,162768028,162840265,72237,-,-
BAC21_B14,5,5q34,162783083,162893012,109929,-,-
BAC146_O08,5,5q34,162872381,162992022,119641,-,-
BAC77_M12,5,5q34,162909252,162995683,86431,-,-
BAC13_G04,5,5q34,162911554,163057380,145826,-,-
BAC41_D20,5,5q34,163097563,163218974,121411,-,-
BAC247_M22,5,5q34,163148600,163294314,145714,-,-
BAC224_O02,5,5q34,163304282,163452228,147946,-,-
BAC54_M17,5,5q34,163533793,163629045,95252,-,-
BAC247_P17,5,5q34,163538111,163614963,76852,-,-
BAC186_N06,5,5q34,163621711,163696157,74446,-,-
BAC88_F07,5,5q34,163684608,163826833,142225,-,-
BAC241_M03,5,5q34,163734685,163793521,58836,-,-
BAC66_M03,5,5q34,163820626,163962968,142342,-,-
BAC70_K17,5,5q34,163860333,163970124,109791,-,-
BAC51_F04,5,5q34,163933642,164087570,153928,-,-
BAC171_O21,5,5q34,163956693,164053399,96706,-,-
BAC184_B08,5,5q34,163976402,164071038,94636,-,-
BAC233_G22,5,5q34,164056305,164180576,124271,-,-
BAC111_D04,5,5q34,164065333,164190824,125491,-,-
BAC28_B12,5,5q34,164066748,164180576,113828,-,-
BAC148_J17,5,5q34,164076898,164163543,86645,-,-
BAC14_C11,5,5q34,164087896,164192306,104410,-,-
BAC244_I07,5,5q34,164153515,164231583,78068,-,-
BAC236_E08,5,5q34,164310472,164395736,85264,-,-
BAC57_N21,5,5q34,164405389,164500096,94707,-,-
BAC115_D18,5,5q34,164405389,164482062,76673,-,-
BAC58_A04,5,5q34,164534592,164646833,112241,-,-
BAC231_D07,5,5q34,164666625,164799034,132409,-,-
BAC179_H23,5,5q34,164710630,164799023,88393,-,-
BAC192_C16,5,5q34,164788579,164895494,106915,-,-
BAC233_G01,5,5q34,164838624,164931897,93273,-,-
BAC123_B10,5,5q34,164908355,165022144,113789,-,-
BAC96_G10,5,5q34,164928803,165009445,80642,-,-
BAC78_C09,5,5q34,165033209,165140150,106941,-,-
BAC35_H17,5,5q34,165052878,165177136,124258,-,-
BAC102_K20,5,5q34,165181758,165276765,95007,-,-
BAC66_I01,5,5q34,165216692,165305085,88393,-,-
BAC162_I16,5,5q34,165282836,165366076,83240,-,-
BAC217_P19,5,5q34,165397137,165477131,79994,-,-
BAC78_O09,5,5q34,165422825,165548786,125961,-,-
BAC140_N05,5,5q34,165430162,165514304,84142,-,-
BAC28_M16,5,5q34,165503526,165527807,24281,-,-
BAC73_D06,5,5q34,165642938,165722243,79305,-,-
BAC23_I08,5,5q34,165738373,165824357,85984,-,-
BAC177_O04,5,5q34,165754954,165839432,84478,-,-
BAC141_I03,5,5q34,165789656,165884800,95144,-,-
BAC10_K19,5,5q34,165789656,165884940,95284,-,-
BAC139_O02,5,5q34,165827584,165895018,67434,-,-
BAC115_F01,5,5q34,165841938,165951297,109359,-,-
BAC72_P04,5,5q34,165993205,166093959,100754,-,-
BAC52_I17,5,5q34,166062204,166149468,87264,-,-
BAC152_H16,5,5q34,166093974,166195903,101929,-,-
BAC22_D18,5,5q34,166116033,166221894,105861,-,-
BAC64_L01,5,5q34,166124651,166221894,97243,-,-
BAC66_B20,5,5q34,166195932,166295672,99740,-,-
BAC27_C21,5,5q34,166249990,166361376,111386,-,-
BAC69_D19,5,5q34,166360569,166438439,77870,-,-
BAC33_P11,5,5q34,166423455,166501487,78032,-,-
BAC237_I16,5,5q34,166431687,166509921,78234,-,-
BAC76_D07,5,5q34,166647652,166761160,113508,-,-
BAC162_H19,5,5q34,166656733,166763375,106642,-,-
BAC116_D09,5,5q34,166692089,166808730,116641,-,-
BAC100_N24,5,5q34,166692089,166763375,71286,-,-
BAC49_M07,5,5q34,166769533,166876803,107270,-,-
BAC165_C23,5,5q34,166813512,166893578,80066,-,-
BAC200_O20,5,5q34,166813513,166893578,80065,-,-
BAC176_E04,5,5q34,166893571,166990752,97181,-,-
BAC238_E21,5,5q34,166902727,167015224,112497,-,-
BAC247_C07,5,5q34,166944479,167032155,87676,-,-
BAC151_H09,5,5q34,166970257,167102831,132574,-,-
BAC88_H06,5,5q34,166990046,167075381,85335,-,-
BAC136_H07,5,5q34,167255615,167366165,110550,-,-
BAC117_F02,5,5q34,167268668,167366591,97923,-,-
BAC32_I08,5,5q34-5q35.1,167334777,167434732,99955,-,-
BAC123_I13,5,5q34-5q35.1,167361736,167468236,106500,-,-
BAC177_A21,5,5q34-5q35.1,167395255,167508434,113179,-,-
BAC240_J03,5,5q35.1,167441810,167534401,92591,-,-
BAC180_E11,5,5q35.1,167441839,167571497,129658,-,-
BAC142_B02,5,5q35.1,167455622,167536332,80710,-,-
BAC163_H08,5,5q35.1,167498669,167629541,130872,-,-
BAC88_I15,5,5q35.1,167540629,167637098,96469,-,-
BAC146_F14,5,5q35.1,167547959,167656147,108188,-,-
BAC237_K22,5,5q35.1,167571494,167657613,86119,-,-
BAC165_L24,5,5q35.1,167589268,167690977,101709,-,-
BAC190_O13,5,5q35.1,167633940,167741260,107320,-,-
BAC97_B17,5,5q35.1,167666776,167773952,107176,-,-
BAC118_K03,5,5q35.1,167719500,167805585,86085,-,-
BAC217_J23,5,5q35.1,167760074,167833962,73888,-,-
BAC76_K19,5,5q35.1,167927587,168027365,99778,-,-
BAC186_F22,5,5q35.1,167945520,168027364,81844,-,-
BAC40_M07,5,5q35.1,167984166,168095111,110945,-,-
BAC139_D03,5,5q35.1,167991786,168103870,112084,-,-
BAC101_D10,5,5q35.1,167992213,168095244,103031,-,-
BAC157_G10,5,5q35.1,168007557,168097595,90038,-,-
BAC54_J12,5,5q35.1,168024666,168148610,123944,-,-
BAC249_O13,5,5q35.1,168095292,168219200,123908,-,-
BAC18_L21,5,5q35.1,168104362,168198852,94490,-,-
BAC221_H10,5,5q35.1,168114564,168198852,84288,-,-
BAC240_A22,5,5q35.1,168125521,168216349,90828,-,-
BAC190_F13,5,5q35.1,168125852,168216750,90898,-,-
BAC64_B22,5,5q35.1,168148606,168267163,118557,-,-
BAC139_L07,5,5q35.1,168213949,168282317,68368,-,-
BAC142_J07,5,5q35.1,168271019,168377328,106309,-,-
BAC89_H17,5,5q35.1,168327796,168431921,104125,-,-
BAC43_H10,5,5q35.1,168327796,168422639,94843,-,-
BAC161_K06,5,5q35.1,168327799,168415028,87229,-,-
BAC188_P02,5,5q35.1,168329472,168415030,85558,-,-
BAC204_P22,5,5q35.1,168415034,168493429,78395,-,-
BAC43_J08,5,5q35.1,168415099,168533065,117966,-,-
BAC229_F09,5,5q35.1,168418122,168549007,130885,-,-
BAC89_L09,5,5q35.1,168422740,168511575,88835,-,-
BAC219_K18,5,5q35.1,168463393,168559272,95879,-,-
BAC31_B07,5,5q35.1,168533070,168630371,97301,-,-
BAC79_C20,5,5q35.1,168533072,168645593,112521,-,-
BAC183_G07,5,5q35.1,168574742,168693505,118763,-,-
BAC131_C11,5,5q35.1,168645648,168788855,143207,-,-
BAC135_E11,5,5q35.1,168679035,168786396,107361,-,-
BAC31_C13,5,5q35.1,168703111,168822206,119095,-,-
BAC250_K16,5,5q35.1,168906651,168990835,84184,-,-
BAC177_B07,5,5q35.1,169143721,169247076,103355,-,-
BAC242_O04,5,5q35.1,169174285,169247076,72791,-,-
BAC76_D19,5,5q35.1,169187469,169313966,126497,-,-
BAC84_G18,5,5q35.1,169210771,169307078,96307,-,-
BAC69_I20,5,5q35.1,169214614,169313966,99352,-,-
BAC59_M21,5,5q35.1,169251097,169337769,86672,-,-
BAC24_B16,5,5q35.1,169333833,169468683,134850,-,-
BAC2_J19,5,5q35.1,169353745,169490162,136417,-,-
BAC231_A05,5,5q35.1,169359522,169456501,96979,-,-
BAC234_J03,5,5q35.1,169368321,169472888,104567,-,-
BAC54_O15,5,5q35.1,169368321,169521148,152827,-,-
BAC239_H02,5,5q35.1,169398653,169521148,122495,-,-
BAC71_E03,5,5q35.1,169436543,169528827,92284,-,-
BAC162_F21,5,5q35.1,169452729,169570580,117851,-,-
BAC107_L15,5,5q35.1,169463328,169568205,104877,-,-
BAC187_G08,5,5q35.1,169481530,169589355,107825,-,-
BAC143_J01,5,5q35.1,169490959,169642806,151847,-,-
BAC237_G23,5,5q35.1,169509845,169586257,76412,-,-
BAC63_O16,5,5q35.1,169521191,169594876,73685,-,-
BAC237_L20,5,5q35.1,169558724,169663936,105212,-,-
BAC70_L05,5,5q35.1,169558724,169656192,97468,-,-
BAC249_B05,5,5q35.1,169601733,169701768,100035,-,-
BAC244_O17,5,5q35.1,169616368,169732435,116067,-,-
BAC239_E23,5,5q35.1,169616368,169713489,97121,-,-
BAC171_B02,5,5q35.1,169670522,169751340,80818,-,-
BAC202_F18,5,5q35.1,169686489,169811161,124672,-,-
BAC55_I15,5,5q35.1,169686972,169861431,174459,-,-
BAC143_K07,5,5q35.1,169701759,169801533,99774,-,-
BAC252_N09,5,5q35.1,169751346,169854463,103117,-,-
BAC21_J22,5,5q35.1,169851179,170004788,153609,-,-
BAC105_E04,5,5q35.1,169890747,170004718,113971,-,-
BAC236_K20,5,5q35.1,169917294,170049774,132480,-,-
BAC136_G04,5,5q35.1,169957456,170069177,111721,-,-
BAC88_D19,5,5q35.1,169962925,170053255,90330,-,-
BAC102_K05,5,5q35.1,169985299,170069177,83878,-,-
BAC239_E06,5,5q35.1,170004787,170080136,75349,-,-
BAC148_K13,5,5q35.1,170042510,170145133,102623,-,-
BAC198_F07,5,5q35.1,170079631,170148765,69134,-,-
BAC1_O18,5,5q35.1,170148423,170262896,114473,-,-
BAC88_A16,5,5q35.1,170232512,170326790,94278,-,-
BAC232_K05,5,5q35.1,170281808,170390871,109063,-,-
BAC200_J06,5,5q35.1,170346295,170434713,88418,-,-
BAC133_O07,5,5q35.1,170372626,170464327,91701,-,-
BAC161_O13,5,5q35.1,170497842,170576893,79051,-,-
BAC86_E02,5,5q35.1,170651832,170798916,147084,-,-
BAC35_E13,5,5q35.1,170675757,170772276,96519,-,-
BAC139_K21,5,5q35.1,170679214,170790891,111677,-,-
BAC2_J11,5,5q35.1,170681589,170772637,91048,-,-
BAC176_O23,5,5q35.1,170831993,170936139,104146,-,-
BAC132_B20,5,5q35.1,170832005,170948680,116675,-,-
BAC200_M02,5,5q35.1,170864727,170948680,83953,-,-
BAC52_A23,5,5q35.1,170884979,170987610,102631,-,-
BAC149_J10,5,5q35.1,170940485,171046968,106483,-,-
BAC102_I14,5,5q35.1,170948674,171107117,158443,-,-
BAC125_K02,5,5q35.1,170985175,171065954,80779,-,-
BAC171_L21,5,5q35.1,170999110,171107117,108007,-,-
BAC126_L07,5,5q35.1,171034829,171194250,159421,-,-
BAC133_A20,5,5q35.1,171034832,171149941,115109,-,-
BAC78_G02,5,5q35.1,171066174,171173487,107313,-,-
BAC167_D13,5,5q35.1,171105282,171211570,106288,-,-
BAC139_N01,5,5q35.1,171107110,171205890,98780,-,-
BAC197_M17,5,5q35.1,171115596,171205962,90366,-,-
BAC168_J20,5,5q35.1,171116132,171211570,95438,-,-
BAC243_B09,5,5q35.1,171116132,171216639,100507,-,-
BAC63_C20,5,5q35.1,171173479,171260613,87134,-,-
BAC68_C05,5,5q35.1,171211785,171320478,108693,-,-
BAC139_D18,5,5q35.1,171344599,171423305,78706,-,-
BAC219_J09,5,5q35.1,171423308,171535899,112591,-,-
BAC143_D12,5,5q35.1,171513724,171619154,105430,-,-
BAC14_E03,5,5q35.1,171538010,171630634,92624,-,-
BAC162_H05,5,5q35.1,171548145,171639760,91615,-,-
BAC237_K14,5,5q35.1,171571645,171683977,112332,-,-
BAC150_I13,5,5q35.1,171631975,171714388,82413,-,-
BAC81_C15,5,5q35.1,171632803,171777831,145028,-,-
BAC31_J08,5,5q35.1,171648290,171760315,112025,-,-
BAC101_N16,5,5q35.1,171658103,171763219,105116,-,-
BAC53_G19,5,5q35.1,171661611,171774695,113084,-,-
BAC161_D22,5,5q35.1,171665060,171760234,95174,-,-
BAC31_M07,5,5q35.1,171679621,171793906,114285,-,-
BAC132_O16,5,5q35.1,171683971,171832179,148208,-,-
BAC172_P16,5,5q35.1,171689895,171772217,82322,-,-
BAC48_C01,5,5q35.1,171760318,171870897,110579,-,-
BAC67_H14,5,5q35.1,171763214,171844067,80853,-,-
BAC187_D11,5,5q35.1,171764915,171870918,106003,-,-
BAC97_H22,5,5q35.1,171881999,171972835,90836,-,-
BAC237_K15,5,5q35.1,171901253,171989381,88128,-,-
BAC137_K03,5,5q35.1,171941778,172035210,93432,-,-
BAC21_K03,5,5q35.1,171968661,172091337,122676,-,-
BAC82_C19,5,5q35.1,171973086,172169110,196024,-,-
BAC52_L24,5,5q35.1-5q35.2,172105606,172245989,140383,-,-
BAC130_N20,5,5q35.1-5q35.2,172138973,172236329,97356,-,-
BAC157_K10,5,5q35.1-5q35.2,172148210,172267480,119270,-,-
BAC211_F12,5,5q35.1-5q35.2,172148210,172260521,112311,-,-
BAC55_H19,5,5q35.1-5q35.2,172179378,172308828,129450,-,-
BAC77_N14,5,5q35.2,172219635,172309709,90074,-,-
BAC106_F16,5,5q35.2,172231779,172331001,99222,-,-
BAC154_J10,5,5q35.2,172260008,172331105,71097,-,-
BAC232_K09,5,5q35.2,172260017,172363737,103720,-,-
BAC129_D09,5,5q35.2,172285933,172376621,90688,-,-
BAC105_I12,5,5q35.2,172309976,172402060,92084,-,-
BAC23_G04,5,5q35.2,172341646,172495581,153935,-,-
BAC35_I14,5,5q35.2,172341652,172450964,109312,-,-
BAC76_O18,5,5q35.2,172366905,172523397,156492,-,-
BAC180_M22,5,5q35.2,172394678,172495536,100858,-,-
BAC211_C15,5,5q35.2,172405531,172491131,85600,-,-
BAC155_C16,5,5q35.2,172410709,172486376,75667,-,-
BAC17_A10,5,5q35.2,172423874,172521099,97225,-,-
BAC143_F03,5,5q35.2,172523446,172596049,72603,-,-
BAC228_A13,5,5q35.2,172596043,172695005,98962,-,-
BAC129_B03,5,5q35.2,172596043,172709524,113481,-,-
BAC84_B13,5,5q35.2,172639112,172739949,100837,-,-
BAC153_I06,5,5q35.2,172645919,172735307,89388,-,-
BAC117_C05,5,5q35.2,172735875,172862590,126715,-,-
BAC50_F11,5,5q35.2,172798678,172879751,81073,-,-
BAC190_J22,5,5q35.2,172815358,172908407,93049,-,-
BAC25_O24,5,5q35.2,172896190,173003802,107612,-,-
BAC28_N11,5,5q35.2,173000413,173107397,106984,-,-
BAC192_C05,5,5q35.2,173060216,173146361,86145,-,-
BAC140_L08,5,5q35.2,173074641,173158775,84134,-,-
BAC69_F09,5,5q35.2,173074656,173233514,158858,-,-
BAC106_C21,5,5q35.2,173080987,173192065,111078,-,-
BAC36_C13,5,5q35.2,173081035,173259591,178556,-,-
BAC179_K03,5,5q35.2,173087830,173162833,75003,-,-
BAC20_B21,5,5q35.2,173122230,173233481,111251,-,-
BAC175_N07,5,5q35.2,173228824,173344604,115780,-,-
BAC37_A19,5,5q35.2,173256287,173351496,95209,-,-
BAC104_B08,5,5q35.2,173391565,173552328,160763,-,-
BAC69_G14,5,5q35.2,173397200,173524507,127307,-,-
BAC82_C14,5,5q35.2,173406773,173533709,126936,-,-
BAC91_D14,5,5q35.2,173504090,173590822,86732,-,-
BAC233_M21,5,5q35.2,173533704,173597184,63480,-,-
BAC223_G14,5,5q35.2,173580202,173684235,104033,-,-
BAC196_M03,5,5q35.2,173604863,173706658,101795,-,-
BAC69_F17,5,5q35.2,173641643,173725888,84245,-,-
BAC241_C03,5,5q35.2,173708829,173795880,87051,-,-
BAC233_F02,5,5q35.2,173873106,173966213,93107,-,-
BAC132_E10,5,5q35.2,173873583,173966213,92630,-,-
BAC43_K03,5,5q35.2,173893168,174005974,112806,-,-
BAC27_D20,5,5q35.2,173918764,174021758,102994,-,-
BAC188_P03,5,5q35.2,173929773,174021758,91985,-,-
BAC181_M21,5,5q35.2,173937067,174005959,68892,-,-
BAC222_E06,5,5q35.2,174004624,174086485,81861,-,-
BAC64_I08,5,5q35.2,174021751,174096592,74841,-,-
BAC6_N09,5,5q35.2,174090783,174178215,87432,-,-
BAC2_K12,5,5q35.2,174207102,174300896,93794,-,-
BAC156_B10,5,5q35.2,174207105,174350384,143279,-,-
BAC78_M06,5,5q35.2,174233687,174350384,116697,-,-
BAC96_B04,5,5q35.2,174413724,174521556,107832,-,-
BAC109_D04,5,5q35.2,174525337,174647480,122143,-,-
BAC186_H08,5,5q35.2,174554019,174647319,93300,-,-
BAC218_D22,5,5q35.2,174639678,174724449,84771,-,-
BAC147_E22,5,5q35.2,174647718,174717190,69472,-,-
BAC168_P18,5,5q35.2,174701754,174802106,100352,-,-
BAC42_N08,5,5q35.2,174753105,174850559,97454,-,-
BAC123_O21,5,5q35.2,174794858,174871450,76592,-,-
BAC89_E10,5,5q35.2,174830216,174916824,86608,-,-
BAC36_P06,5,5q35.2,174886266,175001628,115362,-,-
BAC144_A05,5,5q35.2,174886279,175013547,127268,-,-
BAC142_M23,5,5q35.2,174970250,175061150,90900,-,-
BAC76_N21,5,5q35.2,174970250,175102832,132582,-,-
BAC170_L22,5,5q35.2,174988255,175078675,90420,-,-
BAC198_P16,5,5q35.2,175049415,175123610,74195,-,-
BAC34_D06,5,5q35.2,175066411,175266404,199993,-,-
BAC107_H13,5,5q35.2,175087867,175192195,104328,-,-
BAC108_G02,5,5q35.2,175087898,175208488,120590,-,-
BAC200_N15,5,5q35.2,175091321,175176837,85516,-,-
BAC68_H03,5,5q35.2,175098691,175192195,93504,-,-
BAC123_I02,5,5q35.2,175108128,175208488,100360,-,-
BAC69_F13,5,5q35.2,175139770,175224693,84923,-,-
BAC230_L12,5,5q35.2,175156149,175230813,74664,-,-
BAC116_N13,5,5q35.2,175207490,175345228,137738,-,-
BAC162_O20,5,5q35.2,175279321,175385243,105922,-,-
BAC36_C03,5,5q35.2,175344220,175477386,133166,-,-
BAC76_K11,5,5q35.2,175375264,175505269,130005,-,-
BAC21_C24,5,5q35.2,175426794,175521652,94858,-,-
BAC183_J06,5,5q35.2,175530827,175621002,90175,-,-
BAC241_L13,5,5q35.2,175590846,175699675,108829,-,-
BAC20_A21,5,5q35.2,175628777,175773894,145117,-,-
BAC213_I01,5,5q35.2,175843871,175923438,79567,-,-
BAC58_L05,5,5q35.2,175858445,175944777,86332,-,-
BAC118_J04,5,5q35.2,175886700,175980981,94281,yes,-
BAC92_I21,5,5q35.2,175896062,175980981,84919,yes,-
BAC32_N07,5,5q35.2,175944812,176047233,102421,yes,-
BAC196_I09,5,5q35.2,175966482,176083041,116559,yes,-
BAC200_P08,5,5q35.2,175967735,176109343,141608,yes,-
BAC241_O20,5,5q35.2,175972523,176066294,93771,yes,-
BAC189_H13,5,5q35.2,175985020,176116564,131544,-,-
BAC177_L03,5,5q35.2,175990562,176066308,75746,-,-
BAC12_K09,5,5q35.2,176055123,176162524,107401,-,-
BAC179_M04,5,5q35.2,176095678,176190759,95081,-,-
BAC199_J12,5,5q35.2,176116559,176245932,129373,-,-
BAC165_L22,5,5q35.2,176162519,176252881,90362,-,-
BAC135_A21,5,5q35.2,176162519,176259755,97236,yes,-
BAC193_A21,5,5q35.2,176185381,176297040,111659,yes,-
BAC236_C04,5,5q35.2,176340828,176418250,77422,-,-
BAC158_G12,5,5q35.2,176356658,176434610,77952,-,-
BAC182_J13,5,5q35.2,176397279,176495662,98383,yes,-
BAC109_F23,5,5q35.2-5q35.3,176431525,176513305,81780,yes,-
BAC75_N18,5,5q35.3,176513328,176615110,101782,-,-
BAC100_H14,5,5q35.3,176572264,176728249,155985,yes,-
BAC157_I02,5,5q35.3,176655952,176768199,112247,yes,-
BAC157_I21,5,5q35.3,176689742,176826169,136427,yes,-
BAC80_E07,5,5q35.3,176803257,176959382,156125,-,-
BAC189_E05,5,5q35.3,176805784,176911973,106189,yes,-
BAC172_O01,5,5q35.3,176805788,176913011,107223,yes,-
BAC42_H05,5,5q35.3,176807266,176904171,96905,yes,-
BAC52_C02,5,5q35.3,176807397,176913011,105614,yes,-
BAC132_C11,5,5q35.3,176818522,176912039,93517,yes,-
BAC180_B09,5,5q35.3,176826206,176932644,106438,yes,-
BAC220_N14,5,5q35.3,176970752,177052555,81803,-,-
BAC140_D04,5,5q35.3,176970752,177078911,108159,-,-
BAC25_N01,5,5q35.3,177093578,177245741,152163,yes,-
BAC218_C21,5,5q35.3,177261085,177334947,73862,-,-
BAC127_I12,5,5q35.3,177353186,177488927,135741,-,-
BAC226_M14,5,5q35.3,177373534,177486688,113154,-,-
BAC1_K06,5,5q35.3,177460075,177618931,158856,-,-
BAC120_G05,5,5q35.3,177465903,177623571,157668,-,-
BAC224_D07,5,5q35.3,177482494,177606127,123633,-,-
BAC232_P05,5,5q35.3,177618924,177728344,109420,-,-
BAC66_H04,5,5q35.3,177704676,177805940,101264,-,-
BAC162_N13,5,5q35.3,177728337,177840738,112401,-,-
BAC195_F19,5,5q35.3,177736359,177827232,90873,-,-
BAC160_C05,5,5q35.3,177738460,177840738,102278,-,-
BAC247_L24,5,5q35.3,177745666,177827227,81561,-,-
BAC192_H11,5,5q35.3,177745666,177834379,88713,-,-
BAC232_I02,5,5q35.3,177745666,177827232,81566,-,-
BAC247_I19,5,5q35.3,177812026,177921160,109134,-,-
BAC175_G18,5,5q35.3,177834361,177921160,86799,-,-
BAC160_H07,5,5q35.3,177835359,177951368,116009,-,-
BAC219_C14,5,5q35.3,177840780,177934265,93485,-,-
BAC244_M18,5,5q35.3,177943111,178083574,140463,yes,-
BAC53_A21,5,5q35.3,177978638,178087210,108572,yes,-
BAC163_K16,5,5q35.3,177983924,178087210,103286,yes,-
BAC161_I24,5,5q35.3,178104389,178215435,111046,-,-
BAC121_C19,5,5q35.3,178121348,178227829,106481,-,-
BAC144_J09,5,5q35.3,178142285,178225385,83100,-,-
BAC220_P03,5,5q35.3,178181064,178279574,98510,-,-
BAC139_B12,5,5q35.3,178288153,178386903,98750,-,-
BAC153_I02,5,5q35.3,178328029,178412468,84439,-,-
BAC92_M02,5,5q35.3,178412464,178513544,101080,-,-
BAC180_A09,5,5q35.3,178412559,178501258,88699,-,-
BAC64_G10,5,5q35.3,178440093,178538453,98360,-,-
BAC101_G05,5,5q35.3,178502384,178591234,88850,-,-
BAC171_C09,5,5q35.3,178513547,178612373,98826,-,-
BAC34_G10,5,5q35.3,178542906,178666366,123460,-,-
BAC73_M14,5,5q35.3,178573456,178658463,85007,-,-
BAC243_N11,5,5q35.3,178584601,178672506,87905,-,-
BAC171_K19,5,5q35.3,178620711,178711129,90418,-,-
BAC125_G22,5,5q35.3,178672125,178835526,163401,-,-
BAC73_M15,5,5q35.3,178743313,178825189,81876,-,-
BAC64_J18,5,5q35.3,178767644,178875374,107730,-,-
BAC189_L18,5,5q35.3,178809780,178899612,89832,-,-
BAC8_D10,5,5q35.3,178825355,178914970,89615,-,-
BAC196_M06,5,5q35.3,178860102,178956386,96284,-,-
BAC162_E17,5,5q35.3,178861012,178917420,56408,-,-
BAC44_L14,5,5q35.3,178875584,178990504,114920,-,-
BAC128_M09,5,5q35.3,178938949,179056230,117281,-,-
BAC129_L07,5,5q35.3,178978144,179056272,78128,-,-
BAC196_I16,5,5q35.3,178990658,179067130,76472,-,-
BAC161_B16,5,5q35.3,179067271,179101290,34019,-,-
BAC60_L17,5,5q35.3,179067458,179188771,121313,-,-
BAC96_B21,5,5q35.3,179089238,179243583,154345,-,-
BAC252_G11,5,5q35.3,179089247,179196231,106984,-,-
BAC125_L06,5,5q35.3,179108598,179220601,112003,-,-
BAC205_G24,5,5q35.3,179115390,179220611,105221,-,-
BAC230_E10,5,5q35.3,179115390,179213015,97625,-,-
BAC222_M23,5,5q35.3,179174253,179269049,94796,-,-
BAC148_K10,5,5q35.3,179220822,179315085,94263,-,-
BAC137_O17,5,5q35.3,179259226,179382569,123343,-,-
BAC134_O09,5,5q35.3,179259226,179351747,92521,-,-
BAC239_B19,5,5q35.3,179259247,179366145,106898,-,-
BAC33_K18,5,5q35.3,179276090,179399856,123766,-,-
BAC243_D05,5,5q35.3,179276811,179367594,90783,-,-
BAC215_A10,5,5q35.3,179304535,179381334,76799,-,-
BAC246_J09,5,5q35.3,179312374,179424322,111948,-,-
BAC124_L01,5,5q35.3,179380369,179513063,132694,-,-
BAC244_N19,5,5q35.3,179412128,179487924,75796,-,-
BAC167_G17,5,5q35.3,179424378,179513067,88689,-,-
BAC185_E17,5,5q35.3,179440824,179519560,78736,-,-
BAC171_M11,5,5q35.3,179445828,179540381,94553,-,-
BAC249_P13,5,5q35.3,179487917,179586053,98136,-,-
BAC235_E18,5,5q35.3,179487917,179562651,74734,-,-
BAC40_M20,5,5q35.3,179487917,179607381,119464,-,-
BAC76_C20,5,5q35.3,179487917,179574665,86748,-,-
BAC170_L15,5,5q35.3,179487919,179611127,123208,-,-
BAC21_I08,5,5q35.3,179487922,179585847,97925,-,-
BAC105_P06,5,5q35.3,179540374,179645119,104745,-,-
BAC58_D07,5,5q35.3,179540374,179645121,104747,-,-
BAC140_J15,5,5q35.3,179574687,179663768,89081,-,-
BAC128_H09,5,5q35.3,179596638,179739739,143101,-,-
BAC38_K18,5,5q35.3,179611120,179731456,120336,-,-
BAC8_C16,5,5q35.3,179650297,179736474,86177,-,-
BAC163_J21,5,5q35.3,179663762,179736455,72693,-,-
BAC86_M15,5,5q35.3,179742968,179826070,83102,-,-
BAC88_D11,5,5q35.3,179756543,179859173,102630,-,-
BAC250_D01,5,5q35.3,179789897,179921567,131670,-,-
BAC101_O21,5,5q35.3,179828220,179922477,94257,-,-
BAC158_L21,5,5q35.3,179828223,179909641,81418,-,-
BAC193_N13,5,5q35.3,179831215,179909552,78337,-,-
BAC143_F15,5,5q35.3,179973787,180113449,139662,-,-
BAC52_H22,5,5q35.3,179981893,180105759,123866,-,-
BAC181_H02,5,5q35.3,179984415,180074066,89651,-,-
BAC48_G16,5,5q35.3,179984461,180069238,84777,-,-
BAC144_E09,5,5q35.3,180014275,180113704,99429,-,-
BAC198_E07,5,5q35.3,180025037,180146013,120976,-,-
BAC32_M24,5,5q35.3,180113698,180225380,111682,-,-
BAC67_L07,5,5q35.3,180226632,180438795,212163,yes,-
BAC168_O21,5,5q35.3,180364147,180444139,79992,yes,-
BAC136_G09,5,5q35.3,180364159,180465074,100915,yes,-
BAC160_K16,5,5q35.3,180383831,180535138,151307,-,-
BAC124_M06,5,5q35.3,180386588,180484319,97731,yes,-
BAC91_P19,5,5q35.3,180424347,180542330,117983,yes,-
BAC53_N20,5,5q35.3,180428484,180559210,130726,yes,-
BAC196_A14,5,5q35.3,180466551,180542330,75779,yes,-
BAC202_E09,5,5q35.3,180467133,180558719,91586,yes,-
BAC149_C12,5,5q35.3,180480201,180599015,118814,yes,-
BAC238_O13,5,5q35.3,180484358,180579434,95076,yes,-
BAC57_D05,5,5q35.3,180500299,180640123,139824,yes,-
BAC224_P19,5,5q35.3,180535141,180660210,125069,-,-
BAC142_L09,5,5q35.3,180579428,180660319,80891,-,-
BAC101_K13,6,6p25.3,71609,202432,130823,-,-
BAC204_N05,6,6p25.3,78438,172117,93679,-,-
BAC120_N02,6,6p25.3,111764,204607,92843,-,-
BAC185_O09,6,6p25.3,129384,251738,122354,-,-
BAC72_H04,6,6p25.3,179703,277169,97466,-,-
BAC51_B17,6,6p25.3,202426,307945,105519,yes,-
BAC183_C21,6,6p25.3,204600,308757,104157,yes,-
BAC127_L01,6,6p25.3,318882,437946,119064,yes,-
BAC168_D07,6,6p25.3,320745,423736,102991,yes,-
BAC178_M23,6,6p25.3,328037,435191,107154,yes,-
BAC240_L13,6,6p25.3,334505,410976,76471,-,-
BAC112_A04,6,6p25.3,404854,483019,78165,-,-
BAC163_L03,6,6p25.3,444062,533767,89705,-,-
BAC243_J11,6,6p25.3,481808,565087,83279,-,-
BAC23_F12,6,6p25.3,494022,589704,95682,-,-
BAC244_F11,6,6p25.3,494035,589941,95906,-,-
BAC14_D23,6,6p25.3,499915,589941,90026,-,-
BAC101_O20,6,6p25.3,531278,667428,136150,-,-
BAC34_N21,6,6p25.3,533814,663597,129783,-,-
BAC31_E14,6,6p25.3,539599,709808,170209,-,-
BAC61_O03,6,6p25.3,539601,624281,84680,-,-
BAC46_M05,6,6p25.3,539604,634232,94628,-,-
BAC196_J02,6,6p25.3,565081,702912,137831,-,-
BAC61_C21,6,6p25.3,589935,677684,87749,-,-
BAC149_P12,6,6p25.3,663588,757774,94186,-,-
BAC63_K01,6,6p25.3,663594,775754,112160,-,-
BAC230_H06,6,6p25.3,691770,807587,115817,-,-
BAC42_A20,6,6p25.3,780212,923759,143547,-,-
BAC219_M15,6,6p25.3,807292,904234,96942,-,-
BAC102_H08,6,6p25.3,808650,897820,89170,-,-
BAC129_H02,6,6p25.3,915837,983915,68078,-,-
BAC165_N16,6,6p25.3,929726,1009524,79798,-,-
BAC10_L10,6,6p25.3,965865,1132483,166618,-,-
BAC84_E10,6,6p25.3,968631,1072901,104270,-,-
BAC76_B05,6,6p25.3,1030690,1128462,97772,-,-
BAC13_A05,6,6p25.3,1044157,1176801,132644,-,-
BAC97_A20,6,6p25.3,1057955,1154263,96308,-,-
BAC175_N04,6,6p25.3,1278433,1419529,141096,-,-
BAC181_P07,6,6p25.3,1317826,1410027,92201,-,-
BAC86_C17,6,6p25.3,1323386,1414326,90940,-,-
BAC60_F08,6,6p25.3,1331012,1438078,107066,-,-
BAC168_C10,6,6p25.3,1415016,1490434,75418,-,-
BAC144_N15,6,6p25.3,1429151,1535614,106463,-,-
BAC91_A17,6,6p25.3,1434652,1575203,140551,-,-
BAC195_E05,6,6p25.3,1464559,1547262,82703,-,-
BAC106_A19,6,6p25.3,1537680,1673837,136157,-,-
BAC209_E07,6,6p25.3,1547255,1631041,83786,-,-
BAC90_K08,6,6p25.3,1604556,1742019,137463,-,-
BAC225_L17,6,6p25.3,1619963,1714413,94450,-,-
BAC81_N21,6,6p25.3,1638845,1742019,103174,-,-
BAC23_J03,6,6p25.3,1669083,1772796,103713,-,-
BAC12_I11,6,6p25.3,1714954,1814301,99347,-,-
BAC66_C18,6,6p25.3,1747015,1843850,96835,-,-
BAC67_P09,6,6p25.3,1779807,1866249,86442,-,-
BAC82_P22,6,6p25.3,1797774,1888048,90274,-,-
BAC42_H09,6,6p25.3,1814301,1924118,109817,-,-
BAC106_D24,6,6p25.3,1911106,1993390,82284,-,-
BAC182_K15,6,6p25.3,1923096,1998178,75082,-,-
BAC65_G03,6,6p25.3,1932344,2035796,103452,-,-
BAC75_B13,6,6p25.3,1959377,2064061,104684,-,-
BAC225_N11,6,6p25.3,1977879,2057763,79884,-,-
BAC69_I10,6,6p25.3,1977913,2092924,115011,-,-
BAC60_J01,6,6p25.3,1996407,2106756,110349,-,-
BAC14_C02,6,6p25.3,2013488,2132634,119146,-,-
BAC244_J17,6,6p25.3,2051650,2137803,86153,-,-
BAC178_E24,6,6p25.3,2116405,2242910,126505,-,-
BAC165_A19,6,6p25.3,2116405,2232551,116146,-,-
BAC186_A16,6,6p25.3-6p25.2,2258461,2328776,70315,-,-
BAC120_D13,6,6p25.2,2310166,2405039,94873,-,-
BAC154_J12,6,6p25.2,2354770,2461032,106262,-,-
BAC100_G23,6,6p25.2,2365377,2475403,110026,-,-
BAC23_G02,6,6p25.2,2365413,2472594,107181,-,-
BAC146_E08,6,6p25.2,2379010,2469120,90110,-,-
BAC246_B20,6,6p25.2,2393425,2492090,98665,-,-
BAC37_F19,6,6p25.2,2393429,2605861,212432,-,-
BAC69_C01,6,6p25.2,2472799,2632745,159946,-,-
BAC66_G01,6,6p25.2,2516306,2618420,102114,-,-
BAC131_N05,6,6p25.2,2551802,2632745,80943,-,-
BAC74_J16,6,6p25.2,2557874,2654978,97104,-,-
BAC192_I23,6,6p25.2,2580479,2691329,110850,-,-
BAC78_B04,6,6p25.2,2737864,2836655,98791,-,-
BAC43_A16,6,6p25.2,2740597,2935634,195037,-,-
BAC120_K04,6,6p25.2,2771251,2895398,124147,-,-
BAC202_J24,6,6p25.2,2786117,2865781,79664,-,-
BAC83_J20,6,6p25.2,2880209,3004775,124566,-,-
BAC194_N14,6,6p25.2,2889314,2972279,82965,-,-
BAC81_J21,6,6p25.2,2889314,2983275,93961,-,-
BAC126_I17,6,6p25.2,2906462,2988894,82432,-,-
BAC220_N16,6,6p25.2,2961705,3050561,88856,-,-
BAC80_F06,6,6p25.2,2961717,3160301,198584,-,-
BAC142_J15,6,6p25.2,2962447,3051310,88863,-,-
BAC145_M09,6,6p25.2,2972277,3051314,79037,-,-
BAC91_F14,6,6p25.2,2983547,3096924,113377,-,-
BAC117_N12,6,6p25.2,2987174,3077532,90358,-,-
BAC168_F24,6,6p25.2,3160398,3288693,128295,-,-
BAC100_L23,6,6p25.2,3185630,3282679,97049,-,-
BAC41_D12,6,6p25.2,3201427,3295822,94395,-,-
BAC175_L02,6,6p25.2,3287282,3373819,86537,-,-
BAC194_C18,6,6p25.2,3288828,3377303,88475,-,-
BAC200_B14,6,6p25.2,3290020,3375525,85505,-,-
BAC175_M02,6,6p25.2,3297938,3436352,138414,-,-
BAC80_J07,6,6p25.2,3327886,3445711,117825,-,-
BAC102_E20,6,6p25.2,3345580,3445711,100131,-,-
BAC193_G17,6,6p25.2,3367890,3475537,107647,-,-
BAC165_O20,6,6p25.2,3407070,3481067,73997,-,-
BAC27_E15,6,6p25.2,3409502,3510797,101295,-,-
BAC247_P21,6,6p25.2,3439818,3533247,93429,-,-
BAC180_K15,6,6p25.2,3511034,3607706,96672,-,-
BAC116_C04,6,6p25.2,3614925,3700870,85945,-,-
BAC168_I07,6,6p25.2,3788840,3896983,108143,-,-
BAC40_O07,6,6p25.2,3807582,3886057,78475,-,-
BAC77_M10,6,6p25.2,3809903,3908909,99006,-,-
BAC120_M10,6,6p25.2,3930199,4021022,90823,-,-
BAC77_E23,6,6p25.2-6p25.1,4002430,4118996,116566,-,-
BAC221_I09,6,6p25.2-6p25.1,4053438,4140804,87366,-,-
BAC140_O10,6,6p25.2-6p25.1,4057171,4155693,98522,-,-
BAC41_H15,6,6p25.2-6p25.1,4060935,4141295,80360,-,-
BAC189_P20,6,6p25.1,4141910,4234176,92266,-,-
BAC65_F19,6,6p25.1,4155688,4306170,150482,-,-
BAC137_L20,6,6p25.1,4175602,4294851,119249,-,-
BAC175_C23,6,6p25.1,4202686,4307730,105044,-,-
BAC177_A13,6,6p25.1,4331858,4400614,68756,-,-
BAC76_B02,6,6p25.1,4396264,4512733,116469,-,-
BAC68_I08,6,6p25.1,4418611,4508439,89828,-,-
BAC178_I15,6,6p25.1,4422309,4499051,76742,-,-
BAC118_H04,6,6p25.1,4459447,4570723,111276,-,-
BAC204_N18,6,6p25.1,4459684,4559809,100125,-,-
BAC117_B08,6,6p25.1,4483533,4613544,130011,-,-
BAC183_O05,6,6p25.1,4504054,4580642,76588,-,-
BAC197_N04,6,6p25.1,4609662,4679897,70235,-,-
BAC150_C17,6,6p25.1,4614311,4707216,92905,-,-
BAC182_M03,6,6p25.1,4627057,4784645,157588,-,-
BAC120_H02,6,6p25.1,4680101,4820947,140846,-,-
BAC125_L13,6,6p25.1,4725817,4849062,123245,-,-
BAC144_H15,6,6p25.1,4779565,4908231,128666,-,-
BAC179_P22,6,6p25.1,4800955,4910940,109985,-,-
BAC166_J22,6,6p25.1,4803258,4925088,121830,-,-
BAC21_P24,6,6p25.1,4828627,4920207,91580,-,-
BAC42_A01,6,6p25.1,4849653,4951343,101690,-,-
BAC108_E18,6,6p25.1,4927237,5026289,99052,-,-
BAC193_O23,6,6p25.1,4964566,5059978,95412,-,-
BAC143_O08,6,6p25.1,5008430,5115601,107171,-,-
BAC10_M14,6,6p25.1,5047442,5141630,94188,-,-
BAC8_L03,6,6p25.1,5165242,5282881,117639,-,-
BAC51_A16,6,6p25.1,5192513,5280644,88131,-,-
BAC229_B15,6,6p25.1,5272580,5389700,117120,-,-
BAC78_N21,6,6p25.1,5315145,5426553,111408,-,-
BAC163_D05,6,6p25.1,5325424,5407951,82527,-,-
BAC186_I12,6,6p25.1,5440138,5517465,77327,-,-
BAC145_N23,6,6p25.1,5482047,5594674,112627,-,-
BAC241_L08,6,6p25.1,5484201,5558567,74366,-,-
BAC86_H12,6,6p25.1,5513933,5596258,82325,-,-
BAC45_J15,6,6p25.1,5517533,5662154,144621,-,-
BAC195_G01,6,6p25.1,5561910,5658221,96311,-,-
BAC50_D24,6,6p25.1,5573531,5665678,92147,-,-
BAC28_P14,6,6p25.1,5614621,5699294,84673,-,-
BAC96_G21,6,6p25.1,5640277,5730604,90327,-,-
BAC249_E24,6,6p25.1,5665041,5755918,90877,-,-
BAC60_C19,6,6p25.1,5673637,5783126,109489,-,-
BAC238_H10,6,6p25.1,5688971,5783129,94158,-,-
BAC14_I10,6,6p25.1,5738797,5825658,86861,-,-
BAC226_P07,6,6p25.1,5759299,5862939,103640,-,-
BAC211_E21,6,6p25.1,5783300,5862942,79642,-,-
BAC41_O12,6,6p25.1,5839806,6016753,176947,-,-
BAC20_C21,6,6p25.1,5982747,6073259,90512,-,-
BAC157_A04,6,6p25.1,6132926,6229839,96913,-,-
BAC70_J10,6,6p25.1,6208249,6300452,92203,-,-
BAC165_F21,6,6p25.1,6270101,6362206,92105,-,-
BAC160_O04,6,6p25.1,6345935,6446169,100234,-,-
BAC222_P19,6,6p25.1,6381726,6475926,94200,-,-
BAC37_G11,6,6p25.1,6560659,6685930,125271,-,-
BAC151_B04,6,6p25.1,6714553,6814498,99945,-,-
BAC37_H12,6,6p25.1,6770253,6939148,168895,-,-
BAC22_F07,6,6p25.1,6815735,6875401,59666,-,-
BAC43_F07,6,6p25.1,6856877,6988265,131388,-,-
BAC236_H16,6,6p25.1,6883607,6973425,89818,-,-
BAC96_C24,6,6p25.1-6p24.3,6939944,7059606,119662,-,-
BAC51_I08,6,6p24.3,7003433,7096386,92953,-,-
BAC65_K07,6,6p24.3,7003792,7126944,123152,-,-
BAC211_D20,6,6p24.3,7059599,7142151,82552,-,-
BAC96_E07,6,6p24.3,7127124,7257140,130016,-,-
BAC14_E06,6,6p24.3,7132533,7235160,102627,-,-
BAC100_C20,6,6p24.3,7142332,7248608,106276,-,-
BAC42_L21,6,6p24.3,7215093,7352884,137791,-,-
BAC217_D14,6,6p24.3,7244522,7331153,86631,-,-
BAC68_K07,6,6p24.3,7248843,7390721,141878,-,-
BAC181_K05,6,6p24.3,7384784,7479334,94550,-,-
BAC95_F17,6,6p24.3,7388436,7504061,115625,-,-
BAC75_J16,6,6p24.3,7425192,7519530,94338,-,-
BAC232_P10,6,6p24.3,7432085,7514316,82231,-,-
BAC178_B18,6,6p24.3,7515351,7605198,89847,-,-
BAC32_A21,6,6p24.3,7526534,7618097,91563,-,-
BAC86_N04,6,6p24.3,7612605,7755834,143229,-,-
BAC10_F20,6,6p24.3,7618117,7791014,172897,-,-
BAC160_J04,6,6p24.3,7644127,7744297,100170,-,-
BAC75_O14,6,6p24.3,7644127,7804139,160012,-,-
BAC81_B13,6,6p24.3,7645279,7775167,129888,-,-
BAC179_H03,6,6p24.3,7653679,7755859,102180,-,-
BAC126_F20,6,6p24.3,7653679,7744297,90618,-,-
BAC105_H13,6,6p24.3,7653679,7747442,93763,-,-
BAC73_B15,6,6p24.3,7703875,7804104,100229,-,-
BAC238_H14,6,6p24.3,7760946,7888307,127361,-,-
BAC150_O10,6,6p24.3,7787788,7871417,83629,-,-
BAC39_E17,6,6p24.3,7791038,7921459,130421,-,-
BAC118_N02,6,6p24.3,7835384,7960076,124692,-,-
BAC55_O05,6,6p24.3,7868563,7991735,123172,-,-
BAC250_N12,6,6p24.3,7887432,8013540,126108,-,-
BAC149_A03,6,6p24.3,7921452,8076063,154611,-,-
BAC43_F10,6,6p24.3,7955086,8050868,95782,-,-
BAC101_E06,6,6p24.3,7987882,8093922,106040,-,-
BAC125_P08,6,6p24.3,7991862,8099835,107973,-,-
BAC86_G12,6,6p24.3,8077092,8163416,86324,-,-
BAC175_D15,6,6p24.3,8107412,8202077,94665,-,-
BAC134_N23,6,6p24.3,8166300,8293695,127395,-,-
BAC172_D17,6,6p24.3,8195339,8293695,98356,-,-
BAC193_C05,6,6p24.3,8202269,8296934,94665,-,-
BAC42_J02,6,6p24.3,8238451,8354160,115709,-,-
BAC155_A03,6,6p24.3,8365289,8446335,81046,-,-
BAC115_G18,6,6p24.3,8365827,8381427,15600,-,-
BAC225_C17,6,6p24.3,8399036,8474777,75741,-,-
BAC55_J18,6,6p24.3,8721845,8829857,108012,-,-
BAC221_P03,6,6p24.3,8839105,8927189,88084,-,-
BAC83_B21,6,6p24.3,8839105,8959843,120738,-,-
BAC205_K10,6,6p24.3,8839252,8959894,120642,-,-
BAC145_H11,6,6p24.3,8918250,8983679,65429,-,-
BAC217_L19,6,6p24.3,8983908,9072471,88563,-,-
BAC232_I15,6,6p24.3,8996615,9090224,93609,-,-
BAC186_P02,6,6p24.3,9072464,9321221,248757,-,-
BAC2_D22,6,6p24.3,9166352,9445819,279467,-,-
BAC119_P04,6,6p24.3,9373925,9445830,71905,-,-
BAC54_O04,6,6p24.3,9840550,9935547,94997,-,-
BAC64_E06,6,6p24.3,9866826,9991880,125054,-,-
BAC84_P02,6,6p24.3,9930796,10023578,92782,-,-
BAC58_H02,6,6p24.3,9935580,10027934,92354,-,-
BAC28_D14,6,6p24.3,10028708,10125191,96483,-,-
BAC198_B04,6,6p24.3,10126530,10219526,92996,-,-
BAC151_K15,6,6p24.3,10154995,10256079,101084,-,-
BAC67_E15,6,6p24.3,10172107,10298524,126417,-,-
BAC97_L22,6,6p24.3,10207333,10299740,92407,-,-
BAC42_B02,6,6p24.3,10285310,10376361,91051,-,-
BAC25_K19,6,6p24.3,10303812,10378810,74998,-,-
BAC168_O14,6,6p24.3,10303812,10389956,86144,-,-
BAC250_L23,6,6p24.3,10342365,10426931,84566,-,-
BAC46_H11,6,6p24.3,10358736,10493364,134628,-,-
BAC239_H20,6,6p24.3,10365131,10465657,100526,-,-
BAC66_P19,6,6p24.3,10380998,10477449,96451,-,-
BAC181_N12,6,6p24.3,10397146,10468773,71627,-,-
BAC105_G03,6,6p24.3,10469003,10582096,113093,-,-
BAC247_B04,6,6p24.3-6p24.2,10510994,10613665,102671,-,-
BAC10_A16,6,6p24.3-6p24.2,10578327,10681569,103242,-,-
BAC124_G13,6,6p24.2,10636379,10776311,139932,yes,-
BAC168_K03,6,6p24.2,10681840,10783469,101629,-,-
BAC33_N23,6,6p24.2,10682460,10788030,105570,-,-
BAC170_P16,6,6p24.2,10688313,10776311,87998,-,-
BAC235_J20,6,6p24.2,10732063,10853043,120980,-,-
BAC100_F09,6,6p24.2,10784674,10865362,80688,-,-
BAC228_O22,6,6p24.2,10928509,11034485,105976,-,-
BAC209_G24,6,6p24.2,10928545,11034476,105931,-,-
BAC132_J18,6,6p24.2,10948734,11032843,84109,-,-
BAC84_A20,6,6p24.2,10959777,11009248,49471,-,-
BAC65_F04,6,6p24.2,10968789,11064978,96189,-,-
BAC90_D14,6,6p24.2,11020139,11161367,141228,-,-
BAC96_M02,6,6p24.2,11026122,11130951,104829,-,-
BAC14_G10,6,6p24.2,11034514,11130909,96395,-,-
BAC39_E08,6,6p24.2,11058272,11196411,138139,-,-
BAC79_H19,6,6p24.2,11077051,11161367,84316,-,-
BAC193_H03,6,6p24.2,11087661,11164842,77181,-,-
BAC62_C16,6,6p24.2-6p24.1,11131633,11208001,76368,-,-
BAC4_O04,6,6p24.2-6p24.1,11156291,11285925,129634,-,-
BAC157_N22,6,6p24.2-6p24.1,11184974,11288372,103398,-,-
BAC50_P23,6,6p24.2-6p24.1,11187610,11280098,92488,-,-
BAC162_J09,6,6p24.1,11207997,11285925,77928,-,-
BAC230_A14,6,6p24.1,11257231,11350204,92973,-,-
BAC114_I10,6,6p24.1,11277259,11362185,84926,-,-
BAC31_K22,6,6p24.1,11362183,11467497,105314,-,-
BAC183_J04,6,6p24.1,11370074,11464755,94681,-,-
BAC59_D03,6,6p24.1,11395960,11529038,133078,-,-
BAC74_O06,6,6p24.1,11432952,11536792,103840,-,-
BAC217_L06,6,6p24.1,11436338,11522915,86577,-,-
BAC113_O17,6,6p24.1,11438674,11522915,84241,-,-
BAC86_H08,6,6p24.1,11534402,11674821,140419,-,-
BAC219_E07,6,6p24.1,11604834,11678547,73713,-,-
BAC153_O05,6,6p24.1,11608208,11714400,106192,-,-
BAC63_C08,6,6p24.1,11669524,11763369,93845,-,-
BAC27_K14,6,6p24.1,11674815,11807825,133010,-,-
BAC58_B09,6,6p24.1,11714443,11810070,95627,-,-
BAC65_L12,6,6p24.1,11811232,11949206,137974,-,-
BAC43_O21,6,6p24.1,11838863,11987515,148652,-,-
BAC197_G22,6,6p24.1,11840075,11947322,107247,-,-
BAC15_E17,6,6p24.1,11920590,11999825,79235,-,-
BAC125_B02,6,6p24.1,11983790,12110697,126907,-,-
BAC230_J03,6,6p24.1,12046534,12128863,82329,-,-
BAC140_C23,6,6p24.1,12053664,12121834,68170,-,-
BAC178_J23,6,6p24.1,12074945,12166866,91921,-,-
BAC158_E20,6,6p24.1,12079763,12166977,87214,-,-
BAC109_D15,6,6p24.1,12100815,12204594,103779,-,-
BAC233_C19,6,6p24.1,12243452,12331717,88265,-,-
BAC151_N24,6,6p24.1,12248944,12336854,87910,-,-
BAC83_J05,6,6p24.1,12288228,12450284,162056,-,-
BAC120_L19,6,6p24.1,12302132,12395336,93204,-,-
BAC53_O21,6,6p24.1,12338669,12457649,118980,-,-
BAC248_A22,6,6p24.1,12434584,12512176,77592,-,-
BAC42_K08,6,6p24.1,12457693,12554223,96530,-,-
BAC169_M24,6,6p24.1,12522249,12608921,86672,-,-
BAC217_P01,6,6p24.1,12596463,12668916,72453,-,-
BAC53_A08,6,6p24.1,12653102,12797322,144220,-,-
BAC49_I03,6,6p24.1,12666010,12748638,82628,-,-
BAC129_A17,6,6p24.1,12811841,12901023,89182,-,-
BAC43_H17,6,6p24.1,12901077,13034277,133200,-,-
BAC32_M19,6,6p24.1,12936115,13029379,93264,-,-
BAC72_E10,6,6p24.1,12972918,13071978,99060,-,-
BAC76_L13,6,6p24.1,12973837,13056892,83055,-,-
BAC244_O03,6,6p24.1,13046874,13116204,69330,-,-
BAC29_E07,6,6p24.1,13109980,13218515,108535,-,-
BAC142_N22,6,6p24.1,13258064,13374845,116781,-,-
BAC181_A04,6,6p24.1,13295346,13391073,95727,-,-
BAC209_K18,6,6p24.1,13325935,13414613,88678,-,-
BAC198_H14,6,6p24.1,13327386,13419553,92167,-,-
BAC178_D01,6,6p24.1,13328788,13443493,114705,-,-
BAC220_H04,6,6p24.1,13374840,13480474,105634,-,-
BAC76_I05,6,6p24.1,13381252,13484242,102990,-,-
BAC146_A07,6,6p24.1-6p23,13456869,13540078,83209,-,-
BAC155_N23,6,6p23,13577784,13668010,90226,-,-
BAC132_K13,6,6p23,13593709,13668763,75054,-,-
BAC63_F20,6,6p23,13593739,13679893,86154,-,-
BAC185_P14,6,6p23,13670565,13776927,106362,-,-
BAC123_E06,6,6p23,13672126,13804170,132044,-,-
BAC188_A16,6,6p23,13710078,13811611,101533,-,-
BAC171_C11,6,6p23,13806472,13927201,120729,-,-
BAC113_P09,6,6p23,13808734,13979379,170645,-,-
BAC80_J06,6,6p23,13810193,13900117,89924,-,-
BAC175_K16,6,6p23,13810198,13927201,117003,-,-
BAC2_G04,6,6p23,13835815,13927199,91384,-,-
BAC130_I11,6,6p23,13913755,13991929,78174,-,-
BAC96_D05,6,6p23,13927193,14013327,86134,-,-
BAC45_J08,6,6p23,13992161,14091865,99704,-,-
BAC2_J04,6,6p23,14035387,14130796,95409,-,-
BAC252_P09,6,6p23,14092248,14172029,79781,-,-
BAC45_A02,6,6p23,14127116,14212187,85071,-,-
BAC217_I22,6,6p23,14249900,14348771,98871,-,-
BAC171_A18,6,6p23,14269684,14358805,89121,-,-
BAC219_I21,6,6p23,14291551,14407762,116211,-,-
BAC244_I16,6,6p23,14339626,14442715,103089,-,-
BAC203_N01,6,6p23,14339631,14416472,76841,-,-
BAC28_B02,6,6p23,14368366,14469458,101092,-,-
BAC178_N13,6,6p23,14390382,14470192,79810,-,-
BAC117_E12,6,6p23,14442708,14536867,94159,-,-
BAC113_N13,6,6p23,14454344,14577825,123481,-,-
BAC128_I22,6,6p23,14484825,14600690,115865,-,-
BAC37_B03,6,6p23,14518354,14630954,112600,-,-
BAC165_A01,6,6p23,14544058,14611585,67527,-,-
BAC32_E22,6,6p23,14680577,14769855,89278,-,-
BAC56_J12,6,6p23,14706070,14805811,99741,-,-
BAC43_N18,6,6p23,14706555,14769854,63299,-,-
BAC68_G05,6,6p23,14707722,14848756,141034,-,-
BAC155_E08,6,6p23,14721877,14819840,97963,-,-
BAC92_C10,6,6p23,14757065,14930524,173459,-,-
BAC58_H08,6,6p23,14855840,14941818,85978,-,-
BAC117_O10,6,6p23,14870664,14976807,106143,-,-
BAC58_F16,6,6p23,15047219,15170540,123321,-,-
BAC61_J21,6,6p23,15074177,15213957,139780,-,-
BAC162_A15,6,6p23,15100611,15213638,113027,-,-
BAC148_O15,6,6p23,15122492,15213949,91457,-,-
BAC34_N20,6,6p23,15128678,15249553,120875,-,-
BAC76_F03,6,6p23,15165343,15249553,84210,-,-
BAC182_C03,6,6p23,15233003,15400071,167068,-,-
BAC237_M18,6,6p23,15249863,15358445,108582,-,-
BAC88_O01,6,6p23,15249863,15360699,110836,-,-
BAC74_G01,6,6p23,15332426,15430374,97948,-,-
BAC185_P12,6,6p23,15369308,15453332,84024,-,-
BAC48_O07,6,6p23,15396291,15488086,91795,-,-
BAC223_P19,6,6p23,15400303,15488041,87738,-,-
BAC42_O17,6,6p23-6p22.3,15467241,15571093,103852,-,-
BAC125_G09,6,6p22.3,15531954,15630750,98796,-,-
BAC132_N07,6,6p22.3,15740172,15827266,87094,-,-
BAC156_O04,6,6p22.3,15790930,15888989,98059,-,-
BAC23_P16,6,6p22.3,15823881,15955531,131650,-,-
BAC124_I16,6,6p22.3,15827298,15955558,128260,-,-
BAC31_J02,6,6p22.3,15833191,15937206,104015,-,-
BAC110_O08,6,6p22.3,15844886,15972824,127938,-,-
BAC247_J22,6,6p22.3,15876191,15995054,118863,-,-
BAC59_D15,6,6p22.3,15880928,15981576,100648,-,-
BAC237_E17,6,6p22.3,15937201,16040838,103637,-,-
BAC53_A15,6,6p22.3,15939574,16004784,65210,-,-
BAC230_D18,6,6p22.3,16032199,16159207,127008,-,-
BAC123_H02,6,6p22.3,16056178,16140803,84625,-,-
BAC189_K05,6,6p22.3,16061876,16202663,140787,-,-
BAC36_H14,6,6p22.3,16127245,16240391,113146,-,-
BAC60_A20,6,6p22.3,16127246,16213612,86366,-,-
BAC110_A02,6,6p22.3,16197520,16286160,88640,-,-
BAC124_K07,6,6p22.3,16223705,16299354,75649,-,-
BAC221_K06,6,6p22.3,16271213,16365419,94206,-,-
BAC23_M02,6,6p22.3,16271213,16385112,113899,-,-
BAC224_L04,6,6p22.3,16299348,16376248,76900,-,-
BAC63_H18,6,6p22.3,16315436,16349312,33876,-,-
BAC52_I13,6,6p22.3,16364583,16460694,96111,-,-
BAC30_K03,6,6p22.3,16379092,16518919,139827,-,-
BAC35_F17,6,6p22.3,16383287,16506799,123512,-,-
BAC85_G21,6,6p22.3,16384368,16482335,97967,-,-
BAC92_C16,6,6p22.3,16400809,16500327,99518,-,-
BAC88_N20,6,6p22.3,16458802,16555932,97130,-,-
BAC247_M13,6,6p22.3,16465108,16549211,84103,-,-
BAC196_E02,6,6p22.3,16470515,16584602,114087,-,-
BAC248_L17,6,6p22.3,16520964,16624114,103150,-,-
BAC109_A14,6,6p22.3,16549251,16639833,90582,-,-
BAC97_H14,6,6p22.3,16577579,16703336,125757,-,-
BAC21_G17,6,6p22.3,16605960,16703278,97318,-,-
BAC247_G24,6,6p22.3,16619090,16703333,84243,-,-
BAC120_N05,6,6p22.3,16654960,16748892,93932,-,-
BAC143_K14,6,6p22.3,16668992,16796662,127670,-,-
BAC217_J20,6,6p22.3,16675763,16767176,91413,-,-
BAC83_J12,6,6p22.3,16675763,16776707,100944,-,-
BAC24_J09,6,6p22.3,16692535,16814329,121794,-,-
BAC78_I05,6,6p22.3,16814327,16924253,109926,-,-
BAC48_L03,6,6p22.3,16974549,17082586,108037,-,-
BAC149_F10,6,6p22.3,17014451,17105675,91224,-,-
BAC96_M06,6,6p22.3,17082890,17269566,186676,-,-
BAC117_A10,6,6p22.3,17175367,17269884,94517,-,-
BAC68_H16,6,6p22.3,17223605,17331627,108022,-,-
BAC59_I04,6,6p22.3,17404300,17499043,94743,-,-
BAC58_F11,6,6p22.3,17454318,17609886,155568,-,-
BAC55_L16,6,6p22.3,17498121,17645025,146904,-,-
BAC56_O21,6,6p22.3,17608802,17728799,119997,-,-
BAC34_G21,6,6p22.3,17609885,17781416,171531,-,-
BAC222_K10,6,6p22.3,17626371,17728723,102352,-,-
BAC237_C08,6,6p22.3,17626371,17698635,72264,-,-
BAC148_E11,6,6p22.3,17633703,17709811,76108,-,-
BAC196_I15,6,6p22.3,17642362,17728769,86407,-,-
BAC52_I09,6,6p22.3,17650394,17746021,95627,-,-
BAC165_N19,6,6p22.3,17728792,17818017,89225,-,-
BAC81_C14,6,6p22.3,17734685,17876505,141820,-,-
BAC144_L08,6,6p22.3,17739551,17826784,87233,-,-
BAC165_O04,6,6p22.3,17811880,17913021,101141,-,-
BAC247_M23,6,6p22.3,17816880,17913253,96373,-,-
BAC40_P19,6,6p22.3,17818011,17917636,99625,-,-
BAC83_I11,6,6p22.3,17857391,17981375,123984,-,-
BAC202_L22,6,6p22.3,17902559,17999352,96793,-,-
BAC92_E23,6,6p22.3,17912531,18053977,141446,-,-
BAC97_A22,6,6p22.3,17956852,18051577,94725,-,-
BAC39_E05,6,6p22.3,18011361,18051188,39827,-,-
BAC34_I13,6,6p22.3,18032807,18137288,104481,-,-
BAC236_I17,6,6p22.3,18066303,18155375,89072,-,-
BAC155_M06,6,6p22.3,18073388,18155952,82564,-,-
BAC157_P05,6,6p22.3,18126242,18223462,97220,-,-
BAC149_L15,6,6p22.3,18157689,18251580,93891,-,-
BAC97_C16,6,6p22.3,18170782,18323951,153169,-,-
BAC218_M06,6,6p22.3,18208580,18322575,113995,-,-
BAC115_I01,6,6p22.3,18226956,18251569,24613,-,-
BAC124_I02,6,6p22.3,18243274,18322575,79301,-,-
BAC33_F13,6,6p22.3,18315080,18450498,135418,-,-
BAC133_G12,6,6p22.3,18361388,18483647,122259,-,-
BAC86_A13,6,6p22.3,18382161,18497540,115379,-,-
BAC250_M02,6,6p22.3,18531250,18614081,82831,-,-
BAC27_N14,6,6p22.3,18581347,18667080,85733,-,-
BAC39_A02,6,6p22.3,18659154,18752620,93466,-,-
BAC157_C09,6,6p22.3,18686744,18763514,76770,-,-
BAC172_M02,6,6p22.3,18753241,18855373,102132,-,-
BAC128_N04,6,6p22.3,18811603,18900165,88562,-,-
BAC126_I09,6,6p22.3,18852145,18965657,113512,-,-
BAC101_P14,6,6p22.3,18858771,18964233,105462,-,-
BAC175_G14,6,6p22.3,18928036,19003805,75769,-,-
BAC200_N02,6,6p22.3,18960584,19040118,79534,-,-
BAC78_F18,6,6p22.3,19099952,19199482,99530,-,-
BAC37_J09,6,6p22.3,19124170,19231224,107054,-,-
BAC37_C03,6,6p22.3,19169806,19252791,82985,-,-
BAC61_B20,6,6p22.3,19307999,19323291,15292,-,-
BAC246_P02,6,6p22.3,19340038,19438688,98650,-,-
BAC243_H13,6,6p22.3,19379569,19457242,77673,-,-
BAC118_P05,6,6p22.3,19479345,19576615,97270,-,-
BAC140_B18,6,6p22.3,19492170,19605125,112955,-,-
BAC89_H10,6,6p22.3,19528023,19637401,109378,-,-
BAC96_K15,6,6p22.3,19535855,19633167,97312,-,-
BAC235_P01,6,6p22.3,19539387,19637401,98014,-,-
BAC38_O18,6,6p22.3,19601061,19708612,107551,-,-
BAC125_A05,6,6p22.3,19648357,19729687,81330,-,-
BAC170_A01,6,6p22.3,19701492,19820493,119001,-,-
BAC107_P08,6,6p22.3,19729746,19809135,79389,-,-
BAC234_N24,6,6p22.3,19730377,19830623,100246,-,-
BAC2_C15,6,6p22.3,19954137,20041615,87478,-,-
BAC168_D10,6,6p22.3,20040944,20122929,81985,-,-
BAC77_P08,6,6p22.3,20103889,20195214,91325,-,-
BAC72_D05,6,6p22.3,20140136,20232696,92560,-,-
BAC219_H02,6,6p22.3,20144337,20234217,89880,-,-
BAC235_J04,6,6p22.3,20167953,20289818,121865,-,-
BAC40_H07,6,6p22.3,20167953,20263910,95957,-,-
BAC117_H04,6,6p22.3,20520296,20610076,89780,-,-
BAC68_E17,6,6p22.3,20530771,20646645,115874,-,-
BAC58_J03,6,6p22.3,20542970,20639279,96309,-,-
BAC86_C01,6,6p22.3,20654782,20757151,102369,-,-
BAC43_A03,6,6p22.3,20714393,20845918,131525,-,-
BAC36_A08,6,6p22.3,20755552,20847829,92277,-,-
BAC75_A08,6,6p22.3,20837094,20981450,144356,-,-
BAC151_J13,6,6p22.3,20845423,20923045,77622,-,-
BAC69_O17,6,6p22.3,20942841,21030833,87992,-,-
BAC232_N04,6,6p22.3,20985275,21078850,93575,-,-
BAC213_B14,6,6p22.3,21088466,21197798,109332,-,-
BAC181_A12,6,6p22.3,21190692,21291139,100447,-,-
BAC125_K17,6,6p22.3,21197999,21305937,107938,-,-
BAC170_L18,6,6p22.3,21256384,21323084,66700,-,-
BAC68_E02,6,6p22.3,21258591,21343678,85087,-,-
BAC109_F08,6,6p22.3,21332286,21430867,98581,-,-
BAC11_A13,6,6p22.3,21378966,21409864,30898,-,-
BAC219_C05,6,6p22.3,21384558,21477219,92661,-,-
BAC2_A02,6,6p22.3,21384558,21537253,152695,-,-
BAC146_J07,6,6p22.3,21406990,21520800,113810,-,-
BAC48_M17,6,6p22.3,21406994,21505324,98330,-,-
BAC74_M16,6,6p22.3,21407062,21534588,127526,-,-
BAC235_K19,6,6p22.3,21484765,21579122,94357,-,-
BAC146_O17,6,6p22.3,21563521,21640398,76877,-,-
BAC119_M15,6,6p22.3,21579462,21758209,178747,-,-
BAC94_C08,6,6p22.3,21640928,21656128,15200,-,-
BAC231_A21,6,6p22.3,21811778,21896198,84420,-,-
BAC173_A23,6,6p22.3,21845226,21931160,85934,-,-
BAC224_P17,6,6p22.3,21870587,21949504,78917,-,-
BAC134_J04,6,6p22.3,21932172,21961187,29015,-,-
BAC144_K12,6,6p22.3,21971846,22048337,76491,-,-
BAC129_C24,6,6p22.3,22024496,22126096,101600,-,-
BAC51_A06,6,6p22.3,22071594,22176927,105333,-,-
BAC26_N02,6,6p22.3,22134658,22258678,124020,-,-
BAC141_H23,6,6p22.3,22167870,22254341,86471,-,-
BAC172_N08,6,6p22.3,22260325,22343543,83218,-,-
BAC71_D16,6,6p22.3,22411103,22520886,109783,-,-
BAC239_E12,6,6p22.3,22429273,22518323,89050,-,-
BAC210_E07,6,6p22.3,22463857,22560659,96802,-,-
BAC155_B01,6,6p22.3,22520879,22615721,94842,-,-
BAC177_M20,6,6p22.3,22570322,22647754,77432,-,-
BAC41_I13,6,6p22.3,22660845,22745497,84652,-,-
BAC109_B05,6,6p22.3,22715826,22796613,80787,-,-
BAC161_C14,6,6p22.3,22808004,22908688,100684,-,-
BAC43_K20,6,6p22.3,23064727,23162552,97825,-,-
BAC192_D10,6,6p22.3,23196788,23280123,83335,-,-
BAC100_K12,6,6p22.3,23244310,23355478,111168,-,-
BAC116_C09,6,6p22.3,23311473,23485349,173876,-,-
BAC151_M14,6,6p22.3-6p22.2,23462852,23568554,105702,-,-
BAC36_E09,6,6p22.3-6p22.2,23466803,23572482,105679,-,-
BAC234_M10,6,6p22.2,23697922,23793325,95403,-,-
BAC103_K17,6,6p22.2,23730215,23833830,103615,-,-
BAC63_O19,6,6p22.2,24052702,24188924,136222,-,-
BAC233_A18,6,6p22.2,24076951,24155898,78947,-,-
BAC80_J11,6,6p22.2,24109767,24197829,88062,-,-
BAC76_A21,6,6p22.2,24114781,24227927,113146,-,-
BAC153_M03,6,6p22.2,24179216,24273430,94214,-,-
BAC36_N03,6,6p22.2,24244763,24336263,91500,-,-
BAC123_D16,6,6p22.2,24389104,24501056,111952,-,-
BAC189_F22,6,6p22.2,24410516,24522276,111760,-,-
BAC110_B10,6,6p22.2,24426273,24539269,112996,-,-
BAC217_J08,6,6p22.2,24452696,24539267,86571,-,-
BAC169_B15,6,6p22.2,24452696,24552580,99884,-,-
BAC159_M06,6,6p22.2,24478268,24562598,84330,-,-
BAC150_G13,6,6p22.2,24497620,24574914,77294,-,-
BAC30_D13,6,6p22.2,24501404,24600380,98976,-,-
BAC37_K15,6,6p22.2,24539262,24654865,115603,-,-
BAC41_L24,6,6p22.2,24562750,24695472,132722,-,-
BAC189_J03,6,6p22.2,24572982,24683373,110391,-,-
BAC147_E14,6,6p22.2,24574908,24695472,120564,-,-
BAC20_H22,6,6p22.2,24585411,24694509,109098,-,-
BAC64_N02,6,6p22.2,24619955,24728869,108914,-,-
BAC3_F24,6,6p22.2,24654866,24744984,90118,-,-
BAC66_M04,6,6p22.2,24707161,24836005,128844,-,-
BAC18_L13,6,6p22.2,24758386,24880046,121660,-,-
BAC228_L07,6,6p22.2,24762966,24846946,83980,-,-
BAC186_P21,6,6p22.2,24762971,24846946,83975,-,-
BAC227_E19,6,6p22.2,24774040,24852892,78852,-,-
BAC184_P14,6,6p22.2,24785834,24855785,69951,-,-
BAC135_E09,6,6p22.2,24851122,24951183,100061,yes,-
BAC139_G02,6,6p22.2,24852886,24953456,100570,yes,-
BAC194_K11,6,6p22.2,24894585,24996945,102360,-,-
BAC141_A16,6,6p22.2,24984699,25086048,101349,-,-
BAC234_P17,6,6p22.2,24992953,25069831,76878,-,-
BAC167_H10,6,6p22.2,25196569,25280179,83610,-,-
BAC202_F20,6,6p22.2,25335977,25416887,80910,-,-
BAC82_N20,6,6p22.2,25465956,25589655,123699,-,-
BAC242_H13,6,6p22.2,25465956,25545131,79175,-,-
BAC91_O01,6,6p22.2,25466065,25558462,92397,-,-
BAC26_L06,6,6p22.2,25485276,25669694,184418,-,-
BAC68_H18,6,6p22.2,25545124,25641917,96793,-,-
BAC175_E22,6,6p22.2,25618280,25714016,95736,-,-
BAC167_M23,6,6p22.2,25669693,25760942,91249,-,-
BAC50_L03,6,6p22.2,25683754,25763981,80227,-,-
BAC101_O14,6,6p22.2,25761275,25859559,98284,-,-
BAC97_B22,6,6p22.2-6p22.1,25919350,26113358,194008,-,-
BAC32_J23,6,6p22.2,25920712,26017067,96355,-,-
BAC113_K09,6,6p22.2-6p22.1,26003843,26113335,109492,-,-
BAC40_A02,6,6p22.2-6p22.1,26003857,26124665,120808,-,-
BAC88_A21,6,6p22.2-6p22.1,26020796,26124662,103866,-,-
BAC114_F09,6,6p22.2-6p22.1,26048735,26142316,93581,-,-
BAC205_J17,6,6p22.1,26198679,26293452,94773,-,-
BAC147_A07,6,6p22.1,26198679,26293571,94892,-,-
BAC198_K23,6,6p22.1,26225702,26319514,93812,-,-
BAC45_D06,6,6p22.1,26225710,26313843,88133,-,-
BAC186_J12,6,6p22.1,26225723,26319505,93782,-,-
BAC224_N16,6,6p22.1,26246268,26342394,96126,-,-
BAC90_I22,6,6p22.1,26246268,26319505,73237,-,-
BAC241_K01,6,6p22.1,26248519,26345065,96546,-,-
BAC127_D10,6,6p22.1,26271554,26379025,107471,-,-
BAC50_J04,6,6p22.1,26346731,26479794,133063,-,-
BAC23_P05,6,6p22.1,26368145,26516856,148711,-,-
BAC105_B09,6,6p22.1,26368145,26556364,188219,-,-
BAC204_C16,6,6p22.1,26379048,26475445,96397,-,-
BAC156_N13,6,6p22.1,26393085,26470521,77436,-,-
BAC12_G24,6,6p22.1,26439286,26537624,98338,-,-
BAC84_L18,6,6p22.1,26476327,26583948,107621,-,-
BAC144_C23,6,6p22.1,26483305,26560825,77520,-,-
BAC144_D21,6,6p22.1,26516850,26584344,67494,-,-
BAC249_N02,6,6p22.1,26516853,26605821,88968,-,-
BAC90_H04,6,6p22.1,26584339,26692215,107876,-,-
BAC241_F02,6,6p22.1,26648896,26736925,88029,-,-
BAC20_B24,6,6p22.1,26648896,26736925,88029,-,-
BAC169_I15,6,6p22.1,26648896,26736925,88029,-,-
BAC61_G13,6,6p22.1,26652130,26757446,105316,-,-
BAC155_N04,6,6p22.1,26653564,26736925,83361,-,-
BAC149_D23,6,6p22.1,26721288,26858579,137291,-,-
BAC155_A04,6,6p22.1,26775668,26883079,107411,-,-
BAC124_L08,6,6p22.1,26954084,27016883,62799,-,-
BAC82_F08,6,6p22.1,27117878,27223508,105630,-,-
BAC44_B12,6,6p22.1,27126421,27214126,87705,-,-
BAC42_A19,6,6p22.1,27153723,27240692,86969,-,-
BAC95_N06,6,6p22.1,27172171,27272940,100769,-,-
BAC151_A21,6,6p22.1,27239700,27317226,77526,-,-
BAC107_H17,6,6p22.1,27240970,27344190,103220,-,-
BAC222_O05,6,6p22.1,27253571,27362189,108618,-,-
BAC102_J16,6,6p22.1,27253571,27344190,90619,-,-
BAC51_I22,6,6p22.1,27279612,27356215,76603,-,-
BAC205_I18,6,6p22.1,27393595,27474069,80474,-,-
BAC246_O07,6,6p22.1,27393730,27474065,80335,-,-
BAC96_I20,6,6p22.1,27435968,27553100,117132,-,-
BAC50_N22,6,6p22.1,27450864,27554967,104103,-,-
BAC61_G22,6,6p22.1,27450921,27555011,104090,-,-
BAC126_F13,6,6p22.1,27503850,27594647,90797,-,-
BAC106_G03,6,6p22.1,27505629,27617862,112233,-,-
BAC156_P23,6,6p22.1,27513252,27619583,106331,-,-
BAC223_N10,6,6p22.1,27580127,27680606,100479,-,-
BAC20_L13,6,6p22.1,27582381,27681466,99085,-,-
BAC33_E19,6,6p22.1,27594787,27759853,165066,-,-
BAC190_B01,6,6p22.1,27599122,27677660,78538,-,-
BAC37_M05,6,6p22.1,27600377,27801032,200655,-,-
BAC198_H12,6,6p22.1,27634887,27741592,106705,-,-
BAC112_N01,6,6p22.1,27741781,27834855,93074,-,-
BAC176_C17,6,6p22.1,27759934,27856911,96977,-,-
BAC224_M15,6,6p22.1,27778191,27884257,106066,-,-
BAC106_H12,6,6p22.1,27783492,27875125,91633,-,-
BAC175_C24,6,6p22.1,27945885,28038234,92349,-,-
BAC40_N06,6,6p22.1,27945885,28035120,89235,-,-
BAC191_D22,6,6p22.1,28038335,28129369,91034,-,-
BAC196_O05,6,6p22.1,28205802,28232518,26716,-,-
BAC239_B03,6,6p22.1,28214948,28295903,80955,-,-
BAC119_J23,6,6p22.1,28224626,28302550,77924,-,-
BAC141_K08,6,6p22.1,28240594,28321688,81094,-,-
BAC172_F04,6,6p22.1,28359547,28460068,100521,-,-
BAC194_C08,6,6p22.1,28362939,28456501,93562,-,-
BAC118_M15,6,6p22.1,28389497,28478405,88908,-,-
BAC53_K06,6,6p22.1,28417121,28590340,173219,-,-
BAC119_K21,6,6p22.1,28418726,28516480,97754,-,-
BAC248_J15,6,6p22.1,28462086,28548824,86738,-,-
BAC109_N08,6,6p22.1,28492547,28599132,106585,-,-
BAC239_P13,6,6p22.1,28570534,28651777,81243,-,-
BAC185_C23,6,6p22.1,28677178,28772615,95437,-,-
BAC193_D22,6,6p22.1,28792963,28871330,78367,-,-
BAC126_O05,6,6p22.1,28810209,28905659,95450,-,-
BAC236_E02,6,6p22.1,28852052,28928318,76266,-,-
BAC236_D23,6,6p22.1,28905653,28987756,82103,-,-
BAC131_E23,6,6p22.1,28939036,29029859,90823,-,-
BAC41_G14,6,6p22.1,28965090,29100229,135139,-,-
BAC17_P08,6,6p22.1,29058655,29158697,100042,-,-
BAC218_D04,6,6p22.1,29103780,29194780,91000,-,-
BAC169_D05,6,6p22.1,29189503,29305358,115855,-,-
BAC161_I23,6,6p22.1,29339080,29423688,84608,-,-
BAC172_A06,6,6p22.1,29357200,29458032,100832,-,-
BAC178_G22,6,6p22.1,29374642,29461814,87172,-,-
BAC127_J13,6,6p22.1,29451919,29558796,106877,-,-
BAC169_O10,6,6p22.1,29462004,29560364,98360,-,-
BAC180_G18,6,6p22.1,29560359,29658545,98186,yes,-
BAC64_O05,6,6p22.1,29669651,29802656,133005,-,-
BAC109_C07,6,6p22.1,29720368,29833680,113312,-,-
BAC86_J21,6,6p22.1-6p21.33,29811653,29916726,105073,-,-
BAC148_L14,6,6p22.1-6p21.33,29834692,29916481,81789,-,-
BAC55_C15,6,6p22.1-6p21.33,29866544,29962687,96143,-,-
BAC233_I21,6,6p21.33,29918347,30017739,99392,-,-
BAC195_G08,6,6p21.33,29962981,30038222,75241,yes,-
BAC249_P17,6,6p21.33,30022529,30086583,64054,yes,-
BAC195_J21,6,6p21.33,30137490,30243015,105525,-,-
BAC82_G20,6,6p21.33,30142013,30292187,150174,-,-
BAC193_A09,6,6p21.33,30158728,30243404,84676,-,-
BAC168_L13,6,6p21.33,30209958,30305033,95075,-,-
BAC65_B07,6,6p21.33,30306806,30393390,86584,-,-
BAC56_M01,6,6p21.33,30307318,30415438,108120,-,-
BAC238_B01,6,6p21.33,30310999,30393390,82391,-,-
BAC218_M08,6,6p21.33,30320412,30393388,72976,-,-
BAC183_A08,6,6p21.33,30320412,30404997,84585,-,-
BAC129_C20,6,6p21.33,30330690,30426785,96095,-,-
BAC60_C04,6,6p21.33,30355320,30448612,93292,-,-
BAC135_P20,6,6p21.33,30381593,30473797,92204,-,-
BAC155_I06,6,6p21.33,30393384,30507382,113998,-,-
BAC60_I24,6,6p21.33,30463782,30544872,81090,-,-
BAC78_F22,6,6p21.33,30620233,30735566,115333,-,-
BAC6_M19,6,6p21.33,30641071,30741432,100361,-,-
BAC67_G13,6,6p21.33,30689691,30869735,180044,-,-
BAC60_L15,6,6p21.33,30743573,30863956,120383,-,-
BAC123_G12,6,6p21.33,30790769,30899078,108309,-,-
BAC181_E06,6,6p21.33,30805633,30903572,97939,-,-
BAC84_A19,6,6p21.33,30805633,30903572,97939,-,-
BAC82_M14,6,6p21.33,30951270,31072451,121181,-,-
BAC165_A11,6,6p21.33,30971520,31055059,83539,-,-
BAC148_P09,6,6p21.33,30972595,31105696,133101,-,-
BAC84_F21,6,6p21.33,30972597,31083061,110464,-,-
BAC27_N19,6,6p21.33,30972614,31083061,110447,-,-
BAC248_L24,6,6p21.33,31085417,31293624,208207,yes,-
BAC16_G24,6,6p21.33,31105883,31226501,120618,-,-
BAC115_A16,6,6p21.33,31186556,31310589,124033,yes,-
BAC146_N16,6,6p21.33,31304249,31400753,96504,-,-
BAC96_P21,6,6p21.33,31325871,31456734,130863,-,-
BAC60_J07,6,6p21.33,31379324,31499683,120359,-,-
BAC230_L02,6,6p21.33,31380155,31456734,76579,-,-
BAC155_H01,6,6p21.33,31458770,31556214,97444,yes,-
BAC235_C21,6,6p21.33,31524433,31596473,72040,yes,-
BAC122_I14,6,6p21.33,31549815,31713937,164122,-,-
BAC191_B07,6,6p21.33,31557025,31653423,96398,-,-
BAC151_J08,6,6p21.33,31617698,31703100,85402,-,-
BAC169_A24,6,6p21.33,31619121,31724932,105811,-,-
BAC148_D06,6,6p21.33,31660632,31743443,82811,-,-
BAC96_P16,6,6p21.33,31701668,31821222,119554,-,-
BAC157_G20,6,6p21.33,31724947,31821199,96252,-,-
BAC192_J17,6,6p21.33,31737054,31828474,91420,-,-
BAC124_L03,6,6p21.33,31737054,31817032,79978,-,-
BAC50_O18,6,6p21.33,31737093,31828474,91381,-,-
BAC79_F22,6,6p21.33-6p21.32,31751312,31920030,168718,-,-
BAC219_C01,6,6p21.33,31766527,31837694,71167,-,-
BAC186_B18,6,6p21.33-6p21.32,31837771,31920106,82335,-,-
BAC194_K24,6,6p21.33-6p21.32,31845051,31938727,93676,-,-
BAC6_D03,6,6p21.33-6p21.32,31882234,31971384,89150,-,-
BAC178_D05,6,6p21.32,32004877,32069950,65073,yes,-
BAC125_D03,6,6p21.32,32030556,32138356,107800,yes,-
BAC158_O06,6,6p21.32,32030581,32138333,107752,yes,-
BAC100_M24,6,6p21.32,32202089,32297720,95631,-,-
BAC22_O21,6,6p21.32,32297769,32396409,98640,-,-
BAC97_I22,6,6p21.32,32364376,32485816,121440,-,-
BAC230_N18,6,6p21.32,32450170,32536528,86358,yes,-
BAC121_O11,6,6p21.32,32485390,32622018,136628,yes,-
BAC183_C17,6,6p21.32,32485390,32573068,87678,yes,-
BAC53_M17,6,6p21.32,32519843,32623283,103440,yes,-
BAC106_L11,6,6p21.32,32558634,32675736,117102,yes,-
BAC68_B01,6,6p21.32,32565801,32636979,71178,yes,-
BAC92_G06,6,6p21.32,32565874,32664268,98394,yes,-
BAC109_K17,6,6p21.32,32690695,32836966,146271,yes,-
BAC79_O19,6,6p21.32,32721645,32816328,94683,yes,-
BAC233_L19,6,6p21.32,32745207,32842648,97441,-,-
BAC53_A06,6,6p21.32,32745241,32847359,102118,-,-
BAC65_E16,6,6p21.32,32802985,32896939,93954,-,-
BAC88_N07,6,6p21.32,32875281,33033922,158641,-,-
BAC11_P15,6,6p21.32,32897064,32981556,84492,-,-
BAC46_I14,6,6p21.32,32917694,33013089,95395,-,-
BAC72_C14,6,6p21.32,32979801,33143221,163420,-,-
BAC55_D09,6,6p21.32,33027422,33131034,103612,-,-
BAC22_M03,6,6p21.32,33092887,33193983,101096,-,-
BAC97_H10,6,6p21.32,33212241,33348191,135950,-,-
BAC167_H01,6,6p21.32,33225297,33337795,112498,-,-
BAC206_E06,6,6p21.32,33348223,33459011,110788,-,-
BAC111_K14,6,6p21.32,33353381,33500954,147573,-,-
BAC160_F03,6,6p21.32,33377482,33459011,81529,-,-
BAC31_L08,6,6p21.32,33384427,33545239,160812,-,-
BAC101_G20,6,6p21.32,33458185,33591311,133126,-,-
BAC194_B11,6,6p21.32,33500260,33581534,81274,-,-
BAC218_G06,6,6p21.32,33512373,33598622,86249,-,-
BAC5_C05,6,6p21.32-6p21.31,33539089,33618571,79482,-,-
BAC135_A05,6,6p21.32-6p21.31,33579393,33662442,83049,-,-
BAC59_G08,6,6p21.32-6p21.31,33581545,33763531,181986,-,-
BAC107_N18,6,6p21.32-6p21.31,33598952,33720351,121399,-,-
BAC244_M12,6,6p21.31,33603456,33718154,114698,-,-
BAC32_F16,6,6p21.31,33650592,33839477,188885,yes,-
BAC37_A02,6,6p21.31,33678344,33787733,109389,yes,-
BAC80_O07,6,6p21.31,33727677,33917811,190134,-,-
BAC44_K18,6,6p21.31,33727689,33835916,108227,-,-
BAC182_E20,6,6p21.31,33763536,33871714,108178,-,-
BAC161_K13,6,6p21.31,33801824,33910129,108305,-,-
BAC137_M23,6,6p21.31,33937019,34022733,85714,-,-
BAC71_P11,6,6p21.31,33937019,34022744,85725,-,-
BAC168_E13,6,6p21.31,33967464,34072671,105207,-,-
BAC11_L09,6,6p21.31,34254445,34356051,101606,-,-
BAC146_H21,6,6p21.31,34386860,34400979,14119,-,-
BAC123_A03,6,6p21.31,34481264,34585907,104643,-,-
BAC247_I04,6,6p21.31,34519007,34664579,145572,-,-
BAC52_L11,6,6p21.31,34536237,34622889,86652,-,-
BAC50_K02,6,6p21.31,34544459,34649034,104575,-,-
BAC132_O03,6,6p21.31,34604019,34694270,90251,-,-
BAC134_F04,6,6p21.31,34649233,34733208,83975,-,-
BAC237_A09,6,6p21.31,34664976,34743876,78900,-,-
BAC80_D17,6,6p21.31,34667730,34760676,92946,-,-
BAC59_O18,6,6p21.31,34700628,34798023,97395,-,-
BAC59_N21,6,6p21.31,34733231,34840775,107544,-,-
BAC21_D18,6,6p21.31,34780468,34873211,92743,-,-
BAC82_F23,6,6p21.31,34784517,34888756,104239,-,-
BAC37_E13,6,6p21.31,34840796,35025666,184870,-,-
BAC88_G15,6,6p21.31,34881649,34972951,91302,-,-
BAC250_H05,6,6p21.31,34890157,35024818,134661,-,-
BAC203_P01,6,6p21.31,34890375,34972951,82576,-,-
BAC149_E13,6,6p21.31,35128413,35223318,94905,-,-
BAC5_G05,6,6p21.31,35128413,35223294,94881,-,-
BAC161_D11,6,6p21.31,35131692,35233767,102075,-,-
BAC58_D18,6,6p21.31,35254563,35361838,107275,-,-
BAC109_M14,6,6p21.31,35285459,35408199,122740,-,-
BAC63_G16,6,6p21.31,35292240,35443840,151600,-,-
BAC238_C20,6,6p21.31,35300878,35411498,110620,-,-
BAC42_D03,6,6p21.31,35316259,35401329,85070,-,-
BAC177_I13,6,6p21.31,35355767,35443374,87607,-,-
BAC238_E09,6,6p21.31,35361888,35448310,86422,-,-
BAC249_N16,6,6p21.31,35361888,35443841,81953,-,-
BAC90_M07,6,6p21.31,35444001,35546734,102733,-,-
BAC52_I02,6,6p21.31,35497110,35695778,198668,-,-
BAC60_N01,6,6p21.31,35588874,35677723,88849,-,-
BAC66_D03,6,6p21.31,35619682,35733354,113672,-,-
BAC203_N06,6,6p21.31,35672463,35757502,85039,-,-
BAC6_H09,6,6p21.31,35695815,35791166,95351,-,-
BAC27_B14,6,6p21.31,35704492,35823930,119438,-,-
BAC15_G17,6,6p21.31,35748898,35840550,91652,-,-
BAC59_K01,6,6p21.31,35757621,35872687,115066,-,-
BAC70_D11,6,6p21.31,35766361,35875098,108737,yes,-
BAC70_E17,6,6p21.31,35779850,35872687,92837,-,-
BAC150_G17,6,6p21.31,35791197,35901981,110784,yes,-
BAC152_L21,6,6p21.31,35794163,35887917,93754,-,-
BAC234_A23,6,6p21.31,35795547,35875098,79551,yes,-
BAC80_C20,6,6p21.31,35795549,35931890,136341,yes,-
BAC185_C10,6,6p21.31,35795552,35901981,106429,yes,-
BAC90_E24,6,6p21.31,35824168,35935099,110931,yes,-
BAC36_E16,6,6p21.31,35851370,35931885,80515,yes,-
BAC90_L14,6,6p21.31,35872900,35962284,89384,-,-
BAC56_F24,6,6p21.31,35872967,35964288,91321,-,-
BAC125_N07,6,6p21.31,35901974,35992814,90840,-,-
BAC40_H18,6,6p21.31,35932113,36018339,86226,-,-
BAC250_D06,6,6p21.31,35932113,36049306,117193,-,-
BAC52_K13,6,6p21.31,35972999,36065381,92382,-,-
BAC143_F08,6,6p21.31,35979787,36068911,89124,-,-
BAC175_P24,6,6p21.31,35992866,36072254,79388,-,-
BAC78_C17,6,6p21.31,36012636,36101873,89237,-,-
BAC37_P08,6,6p21.31,36018350,36118212,99862,-,-
BAC21_G10,6,6p21.31,36034900,36144266,109366,-,-
BAC219_K24,6,6p21.31,36034921,36120465,85544,-,-
BAC16_A24,6,6p21.31,36086843,36183479,96636,-,-
BAC162_O10,6,6p21.31,36155363,36231336,75973,-,-
BAC59_A03,6,6p21.31,36270585,36365367,94782,-,-
BAC16_F22,6,6p21.31,36309143,36376742,67599,-,-
BAC224_E20,6,6p21.31,36336873,36410917,74044,-,-
BAC55_N15,6,6p21.31,36379695,36457442,77747,-,-
BAC129_N01,6,6p21.31,36421948,36538661,116713,-,-
BAC189_D19,6,6p21.31,36462583,36561626,99043,-,-
BAC38_B21,6,6p21.31,36486644,36571654,85010,-,-
BAC125_B06,6,6p21.31,36596516,36687665,91149,-,-
BAC77_L20,6,6p21.31,36636056,36735677,99621,-,-
BAC103_E15,6,6p21.31,36666472,36760525,94053,-,-
BAC148_A21,6,6p21.31,36674144,36760525,86381,-,-
BAC127_L03,6,6p21.31,36674751,36767084,92333,-,-
BAC142_G08,6,6p21.31,36687896,36778048,90152,-,-
BAC112_C02,6,6p21.31-6p21.2,36735880,36843657,107777,-,-
BAC189_B13,6,6p21.31-6p21.2,36760519,36888444,127925,-,-
BAC198_D08,6,6p21.31-6p21.2,36789433,36888286,98853,-,-
BAC197_C07,6,6p21.2,36830328,36862915,32587,-,-
BAC106_I24,6,6p21.2,36921838,37013080,91242,-,-
BAC247_O06,6,6p21.2,36970743,37086495,115752,-,-
BAC12_C08,6,6p21.2,37014687,37126797,112110,-,-
BAC125_O11,6,6p21.2,37147204,37236900,89696,-,-
BAC146_F09,6,6p21.2,37162340,37286364,124024,-,-
BAC110_D03,6,6p21.2,37243226,37341659,98433,-,-
BAC229_O13,6,6p21.2,37304808,37380336,75528,-,-
BAC179_L03,6,6p21.2,37307746,37445724,137978,-,-
BAC192_O04,6,6p21.2,37317782,37434150,116368,-,-
BAC144_K02,6,6p21.2,37381590,37466256,84666,-,-
BAC116_G13,6,6p21.2,37401791,37518110,116319,-,-
BAC223_O23,6,6p21.2,37415813,37506142,90329,-,-
BAC203_P20,6,6p21.2,37452995,37529667,76672,-,-
BAC221_B21,6,6p21.2,37521324,37604963,83639,-,-
BAC92_I06,6,6p21.2,37575104,37693116,118012,-,-
BAC86_L17,6,6p21.2,37645965,37731794,85829,-,-
BAC89_H18,6,6p21.2,37652722,37748534,95812,-,-
BAC25_E10,6,6p21.2,37729822,37822883,93061,-,-
BAC59_N06,6,6p21.2,37830915,37936395,105480,-,-
BAC82_G11,6,6p21.2,37832987,37936391,103404,-,-
BAC143_H02,6,6p21.2,37832994,37913922,80928,-,-
BAC179_O02,6,6p21.2,37860696,37979078,118382,-,-
BAC235_E19,6,6p21.2,37875111,37985374,110263,-,-
BAC95_D08,6,6p21.2,37979244,38066664,87420,-,-
BAC84_B22,6,6p21.2,38150213,38261535,111322,-,-
BAC100_E06,6,6p21.2,38183002,38285960,102958,-,-
BAC33_E22,6,6p21.2,38223701,38346082,122381,-,-
BAC108_H11,6,6p21.2,38223710,38316802,93092,-,-
BAC234_L22,6,6p21.2,38232694,38382918,150224,-,-
BAC211_C21,6,6p21.2,38325923,38403475,77552,-,-
BAC59_K20,6,6p21.2,38329396,38422086,92690,-,-
BAC221_I17,6,6p21.2,38329396,38426847,97451,-,-
BAC92_I01,6,6p21.2,38403521,38485081,81560,-,-
BAC233_F13,6,6p21.2,38563465,38645314,81849,-,-
BAC92_P21,6,6p21.2,38673332,38761694,88362,-,-
BAC221_A06,6,6p21.2,38694177,38789891,95714,-,-
BAC155_J10,6,6p21.2,38722402,38836170,113768,-,-
BAC171_B22,6,6p21.2,38793644,38901071,107427,-,-
BAC56_G15,6,6p21.2,38998249,39101887,103638,-,-
BAC69_A05,6,6p21.2,39109124,39200626,91502,-,-
BAC248_H03,6,6p21.2,39176127,39258764,82637,-,-
BAC109_G04,6,6p21.2,39176194,39303240,127046,-,-
BAC2_P17,6,6p21.2,39200654,39319933,119279,-,-
BAC218_J17,6,6p21.2,39203102,39315048,111946,-,-
BAC237_N02,6,6p21.2,39247637,39330897,83260,-,-
BAC189_L07,6,6p21.2,39248934,39338381,89447,-,-
BAC195_F13,6,6p21.2,39253070,39358511,105441,-,-
BAC176_L16,6,6p21.2,39303235,39409378,106143,-,-
BAC81_A24,6,6p21.2,39320039,39440697,120658,-,-
BAC14_I09,6,6p21.2,39338384,39440697,102313,-,-
BAC57_I11,6,6p21.2,39339100,39440697,101597,-,-
BAC188_M22,6,6p21.2,39361094,39440695,79601,-,-
BAC41_N10,6,6p21.2,39391258,39529940,138682,-,-
BAC222_K19,6,6p21.2,39391281,39508672,117391,-,-
BAC21_F16,6,6p21.2,39394302,39482277,87975,-,-
BAC88_I12,6,6p21.2,39460830,39588449,127619,-,-
BAC193_M10,6,6p21.2,39463665,39585347,121682,-,-
BAC195_E11,6,6p21.2,39473739,39551968,78229,-,-
BAC88_C11,6,6p21.2,39493182,39576154,82972,-,-
BAC234_H18,6,6p21.2,39563770,39646270,82500,-,-
BAC29_P16,6,6p21.2,39588457,39660895,72438,-,-
BAC241_O01,6,6p21.2,39601989,39690791,88802,-,-
BAC11_G02,6,6p21.2,39678385,39768106,89721,-,-
BAC154_K21,6,6p21.2,39680082,39784414,104332,-,-
BAC36_E21,6,6p21.2,39690981,39784574,93593,-,-
BAC10_I12,6,6p21.2,39697030,39871980,174950,-,-
BAC10_K20,6,6p21.2,39739750,39850428,110678,-,-
BAC157_C07,6,6p21.2,39745335,39828055,82720,-,-
BAC84_L24,6,6p21.2,39750920,39862032,111112,-,-
BAC119_D06,6,6p21.2,39785136,39871984,86848,-,-
BAC157_H11,6,6p21.2,39956582,40063149,106567,-,-
BAC167_D18,6,6p21.2,39981662,40092161,110499,-,-
BAC160_P13,6,6p21.2,39982458,40070679,88221,-,-
BAC206_D17,6,6p21.2,39998066,40089263,91197,-,-
BAC167_G22,6,6p21.2,40035824,40118074,82250,-,-
BAC57_M01,6,6p21.2,40229423,40335802,106379,-,-
BAC142_F04,6,6p21.2,40245034,40328389,83355,-,-
BAC139_C08,6,6p21.2,40245034,40328389,83355,-,-
BAC19_C22,6,6p21.2,40266933,40399463,132530,-,-
BAC43_G13,6,6p21.2,40304811,40414608,109797,-,-
BAC218_J14,6,6p21.2,40400370,40521021,120651,-,-
BAC133_G24,6,6p21.2,40414630,40535121,120491,-,-
BAC121_P10,6,6p21.2,40415474,40521742,106268,-,-
BAC169_L01,6,6p21.2,40480642,40597884,117242,-,-
BAC137_P08,6,6p21.2,40490465,40599222,108757,-,-
BAC129_F19,6,6p21.2-6p21.1,40499907,40612668,112761,-,-
BAC31_H12,6,6p21.2,40499916,40597884,97968,-,-
BAC169_E07,6,6p21.2,40512433,40597884,85451,-,-
BAC160_B18,6,6p21.2-6p21.1,40546831,40627968,81137,-,-
BAC240_E18,6,6p21.2-6p21.1,40546847,40650486,103639,-,-
BAC89_L03,6,6p21.1,40636330,40718134,81804,-,-
BAC84_K19,6,6p21.1,40735665,40850878,115213,-,-
BAC55_E19,6,6p21.1,40740218,40864000,123782,-,-
BAC40_B11,6,6p21.1,40811755,40919125,107370,-,-
BAC145_F20,6,6p21.1,41020631,41037520,16889,-,-
BAC142_K04,6,6p21.1,41037510,41120123,82613,-,-
BAC152_F10,6,6p21.1,41045551,41134925,89374,-,-
BAC154_D09,6,6p21.1,41198075,41278365,80290,-,-
BAC52_H13,6,6p21.1,41297520,41429153,131633,-,-
BAC239_N05,6,6p21.1,41327908,41483492,155584,-,-
BAC96_K14,6,6p21.1,41333006,41435907,102901,-,-
BAC103_E05,6,6p21.1,41358353,41435907,77554,-,-
BAC142_E12,6,6p21.1,41372457,41459487,87030,-,-
BAC193_C04,6,6p21.1,41376649,41435907,59258,-,-
BAC40_H04,6,6p21.1,41387099,41537704,150605,-,-
BAC115_G05,6,6p21.1,41536824,41640134,103310,-,-
BAC217_L11,6,6p21.1,41564623,41640134,75511,-,-
BAC69_K19,6,6p21.1,41603004,41769188,166184,-,-
BAC25_E03,6,6p21.1,41648804,41769245,120441,-,-
BAC116_P04,6,6p21.1,41685949,41770158,84209,-,-
BAC63_O08,6,6p21.1,41686523,41833059,146536,-,-
BAC250_E04,6,6p21.1,41734973,41823684,88711,-,-
BAC218_P03,6,6p21.1,41740025,41825173,85148,-,-
BAC85_C13,6,6p21.1,41740025,41769248,29223,-,-
BAC145_J11,6,6p21.1,41860764,41968635,107871,-,-
BAC194_B01,6,6p21.1,41874835,41949796,74961,-,-
BAC114_F24,6,6p21.1,41917070,42044828,127758,-,-
BAC158_M19,6,6p21.1,42008887,42133319,124432,-,-
BAC136_E17,6,6p21.1,42036641,42133321,96680,-,-
BAC176_L11,6,6p21.1,42041924,42142268,100344,-,-
BAC66_I03,6,6p21.1,42044852,42142270,97418,-,-
BAC186_N12,6,6p21.1,42061385,42162608,101223,-,-
BAC24_F08,6,6p21.1,42067556,42178279,110723,-,-
BAC239_O08,6,6p21.1,42088535,42178478,89943,-,-
BAC37_I03,6,6p21.1,42205866,42301592,95726,-,-
BAC182_M07,6,6p21.1,42278718,42355876,77158,-,-
BAC92_M03,6,6p21.1,42301042,42402233,101191,-,-
BAC37_P20,6,6p21.1,42301586,42402302,100716,-,-
BAC17_H12,6,6p21.1,42311639,42426588,114949,-,-
BAC55_L21,6,6p21.1,42315761,42402289,86528,-,-
BAC193_A22,6,6p21.1,42368481,42457471,88990,-,-
BAC92_K16,6,6p21.1,42402419,42495339,92920,-,-
BAC84_O04,6,6p21.1,42416335,42559881,143546,-,-
BAC137_I10,6,6p21.1,42527327,42613955,86628,-,-
BAC40_D14,6,6p21.1,42584698,42684908,100210,-,-
BAC135_G01,6,6p21.1,42647948,42786096,138148,-,-
BAC243_P01,6,6p21.1,42684907,42786101,101194,-,-
BAC94_H14,6,6p21.1,42685029,42823821,138792,-,-
BAC41_P14,6,6p21.1,42713073,42867748,154675,-,-
BAC239_B05,6,6p21.1,42786094,42863293,77199,-,-
BAC126_A17,6,6p21.1,42788594,42896998,108404,-,-
BAC139_N20,6,6p21.1,42867955,42943384,75429,-,-
BAC218_P21,6,6p21.1,42906921,43034056,127135,-,-
BAC181_E14,6,6p21.1,42917757,43024718,106961,-,-
BAC29_D16,6,6p21.1,42927760,43004515,76755,-,-
BAC88_D09,6,6p21.1,42943393,43034056,90663,-,-
BAC31_A14,6,6p21.1,43110152,43258196,148044,-,-
BAC176_P11,6,6p21.1,43132350,43218830,86480,-,-
BAC241_E14,6,6p21.1,43139287,43218829,79542,-,-
BAC236_A07,6,6p21.1,43172705,43258196,85491,-,-
BAC186_D02,6,6p21.1,43183830,43258196,74366,-,-
BAC20_N15,6,6p21.1,43183830,43264494,80664,-,-
BAC229_K06,6,6p21.1,43200006,43280868,80862,-,-
BAC142_A05,6,6p21.1,43206235,43291350,85115,-,-
BAC113_E08,6,6p21.1,43280862,43409527,128665,-,-
BAC125_D02,6,6p21.1,43280880,43404384,123504,-,-
BAC71_C12,6,6p21.1,43424813,43538576,113763,-,-
BAC129_D08,6,6p21.1,43439105,43535912,96807,-,-
BAC184_L24,6,6p21.1,43459727,43538650,78923,-,-
BAC64_L24,6,6p21.1,43580427,43719916,139489,-,-
BAC178_H03,6,6p21.1,43597042,43671298,74256,-,-
BAC86_I01,6,6p21.1,43613172,43763791,150619,-,-
BAC189_B24,6,6p21.1,43623199,43746721,123522,-,-
BAC232_N17,6,6p21.1,43672849,43760396,87547,-,-
BAC75_A23,6,6p21.1,43688993,43780778,91785,-,-
BAC92_H18,6,6p21.1,43868341,43980405,112064,-,-
BAC159_J10,6,6p21.1,43914004,44011599,97595,-,-
BAC160_E22,6,6p21.1,43916577,44011638,95061,-,-
BAC31_F23,6,6p21.1,43978817,44086343,107526,-,-
BAC183_P10,6,6p21.1,44003921,44086343,82422,-,-
BAC66_F14,6,6p21.1,44055551,44143120,87569,-,-
BAC144_H09,6,6p21.1,44058090,44156935,98845,-,-
BAC220_D09,6,6p21.1,44089492,44192208,102716,-,-
BAC81_C08,6,6p21.1,44089494,44207145,117651,-,-
BAC117_P07,6,6p21.1,44165112,44256657,91545,-,-
BAC239_O01,6,6p21.1,44181613,44306557,124944,-,-
BAC25_O05,6,6p21.1,44207773,44308896,101123,-,-
BAC218_K10,6,6p21.1,44308908,44432790,123882,-,-
BAC59_I20,6,6p21.1,44415583,44539403,123820,-,-
BAC189_K20,6,6p21.1,44418162,44539403,121241,-,-
BAC89_I17,6,6p21.1,44421053,44505503,84450,-,-
BAC19_B23,6,6p21.1,44440532,44539390,98858,-,-
BAC247_A09,6,6p21.1,44639539,44752509,112970,-,-
BAC84_B12,6,6p21.1,44639541,44735600,96059,-,-
BAC145_N06,6,6p21.1,44662248,44728721,66473,-,-
BAC149_J06,6,6p21.1,44664139,44753469,89330,-,-
BAC122_H04,6,6p21.1,44902026,45102226,200200,-,-
BAC31_M20,6,6p21.1,44937535,44964121,26586,-,-
BAC27_H11,6,6p21.1,44992886,45076381,83495,-,-
BAC30_D07,6,6p21.1,45021699,45106724,85025,-,-
BAC84_H09,6,6p21.1-6p12.3,45155683,45321809,166126,-,-
BAC10_N08,6,6p21.1-6p12.3,45158396,45314539,156143,-,-
BAC131_N08,6,6p12.3,45209258,45321809,112551,-,-
BAC17_P22,6,6p12.3,45217863,45314725,96862,-,-
BAC15_A24,6,6p12.3,45345358,45358696,13338,-,-
BAC232_G03,6,6p12.3,45487614,45569111,81497,-,-
BAC171_H15,6,6p12.3,45569155,45666052,96897,-,-
BAC155_F23,6,6p12.3,45600161,45679262,79101,-,-
BAC140_A15,6,6p12.3,45617295,45715321,98026,-,-
BAC190_P17,6,6p12.3,45626574,45701440,74866,-,-
BAC129_H14,6,6p12.3,45725729,45847093,121364,-,-
BAC233_D22,6,6p12.3,45855567,45955631,100064,-,-
BAC192_M12,6,6p12.3,45875223,45970518,95295,-,-
BAC103_A08,6,6p12.3,45913260,46003358,90098,-,-
BAC2_A06,6,6p12.3,46044061,46157728,113667,-,-
BAC123_I15,6,6p12.3,46157966,46234814,76848,-,-
BAC143_B17,6,6p12.3,46377262,46464920,87658,-,-
BAC66_E03,6,6p12.3,46400274,46509477,109203,-,-
BAC196_B09,6,6p12.3,46417188,46505757,88569,-,-
BAC178_K18,6,6p12.3,46505911,46602721,96810,-,-
BAC16_K17,6,6p12.3,46509471,46601950,92479,-,-
BAC219_C06,6,6p12.3,46521603,46602642,81039,-,-
BAC237_H22,6,6p12.3,46560110,46645948,85838,-,-
BAC152_N01,6,6p12.3,46792750,46841454,48704,-,-
BAC218_A10,6,6p12.3,46903376,47011497,108121,-,-
BAC184_C08,6,6p12.3,46904080,46990916,86836,-,-
BAC156_C23,6,6p12.3,46908981,46997462,88481,-,-
BAC236_J17,6,6p12.3,46929346,47027904,98558,-,-
BAC247_F16,6,6p12.3,46991013,47054351,63338,-,-
BAC132_H18,6,6p12.3,47083569,47173731,90162,-,-
BAC189_N11,6,6p12.3,47102006,47173731,71725,-,-
BAC144_D16,6,6p12.3,47241994,47321858,79864,-,-
BAC151_K11,6,6p12.3,47303710,47382315,78605,-,-
BAC23_M16,6,6p12.3,47310064,47404891,94827,-,-
BAC134_E06,6,6p12.3,47312175,47434354,122179,-,-
BAC147_M13,6,6p12.3,47329241,47412764,83523,-,-
BAC2_N04,6,6p12.3,47349005,47505435,156430,-,-
BAC125_D09,6,6p12.3,47404885,47520367,115482,-,-
BAC71_J07,6,6p12.3,47419805,47527607,107802,-,-
BAC189_J04,6,6p12.3,47453376,47561069,107693,-,-
BAC179_I03,6,6p12.3,47520504,47650189,129685,-,-
BAC218_B10,6,6p12.3,47567142,47659926,92784,-,-
BAC58_J04,6,6p12.3,47784046,47871416,87370,-,-
BAC75_J09,6,6p12.3,47785965,47871416,85451,-,-
BAC241_K16,6,6p12.3,47789173,47867941,78768,-,-
BAC124_K10,6,6p12.3,47992539,48085186,92647,-,-
BAC57_L02,6,6p12.3,48076183,48234314,158131,-,-
BAC160_F16,6,6p12.3,48137341,48224986,87645,-,-
BAC129_I24,6,6p12.3,48246812,48341427,94615,-,-
BAC37_K07,6,6p12.3,48413330,48505224,91894,-,-
BAC110_K02,6,6p12.3,48495672,48653980,158308,-,-
BAC38_K19,6,6p12.3,48782951,48882678,99727,-,-
BAC76_L11,6,6p12.3,48878299,48972296,93997,-,-
BAC90_C20,6,6p12.3,48980817,49066497,85680,-,-
BAC185_A09,6,6p12.3,49059399,49146036,86637,-,-
BAC28_D13,6,6p12.3,49126925,49237235,110310,-,-
BAC33_C03,6,6p12.3,49263177,49346712,83535,-,-
BAC241_G03,6,6p12.3,49344283,49426485,82202,-,-
BAC144_J17,6,6p12.3,49410669,49507198,96529,-,-
BAC129_G14,6,6p12.3,49500305,49589502,89197,-,-
BAC166_M10,6,6p12.3,49537990,49655881,117891,-,-
BAC27_J15,6,6p12.3,49599410,49753430,154020,-,-
BAC2_I06,6,6p12.3,49607485,49710080,102595,-,-
BAC73_K17,6,6p12.3,49633347,49710080,76733,-,-
BAC219_B20,6,6p12.3,49816292,49887856,71564,-,-
BAC218_A05,6,6p12.3,49876533,49962422,85889,-,-
BAC139_M20,6,6p12.3,50233704,50354031,120327,-,-
BAC167_E15,6,6p12.3,50294523,50384841,90318,-,-
BAC195_D23,6,6p12.3,50435349,50540323,104974,-,-
BAC83_J24,6,6p12.3,50622496,50703918,81422,-,-
BAC90_A05,6,6p12.3,50753000,50908723,155723,-,-
BAC12_J22,6,6p12.3,50852787,50951360,98573,-,-
BAC71_O02,6,6p12.3,50857234,50952629,95395,-,-
BAC1_L22,6,6p12.3,50956097,51065791,109694,-,-
BAC67_B15,6,6p12.3,50980628,51088784,108156,-,-
BAC34_F19,6,6p12.3,50980967,51093884,112917,-,-
BAC51_D21,6,6p12.3-6p12.2,51042930,51173228,130298,-,-
BAC170_J08,6,6p12.2,51256843,51344453,87610,-,-
BAC243_K05,6,6p12.2,51362026,51457931,95905,-,-
BAC137_K15,6,6p12.2,51438883,51520982,82099,-,-
BAC149_I12,6,6p12.2,51463907,51572404,108497,-,-
BAC194_P07,6,6p12.2,51471624,51569886,98262,-,-
BAC197_L23,6,6p12.2,51475799,51569886,94087,-,-
BAC219_M10,6,6p12.2,51582588,51671257,88669,-,-
BAC53_I18,6,6p12.2,51627812,51735322,107510,-,-
BAC135_F15,6,6p12.2,51661892,51748646,86754,-,-
BAC217_A12,6,6p12.2,51741248,51834836,93588,-,-
BAC121_B12,6,6p12.2,51756618,51856540,99922,-,-
BAC95_H09,6,6p12.2,51786046,51876069,90023,-,-
BAC234_K13,6,6p12.2,51809089,51896978,87889,-,-
BAC126_I20,6,6p12.2,51816147,51920444,104297,-,-
BAC203_L17,6,6p12.2,51831342,51920563,89221,-,-
BAC141_F14,6,6p12.2,51985699,52087584,101885,-,-
BAC148_F13,6,6p12.2,52003231,52104720,101489,-,-
BAC8_B09,6,6p12.2,52089096,52235993,146897,-,-
BAC195_H17,6,6p12.2,52096496,52212346,115850,-,-
BAC130_D19,6,6p12.2,52142945,52235993,93048,-,-
BAC91_A18,6,6p12.2,52151869,52283967,132098,-,-
BAC186_O17,6,6p12.2,52152046,52253411,101365,-,-
BAC241_M15,6,6p12.2,52153225,52241640,88415,-,-
BAC57_F15,6,6p12.2,52207219,52310541,103322,-,-
BAC120_D06,6,6p12.2,52208972,52300961,91989,-,-
BAC64_D18,6,6p12.2,52211568,52325609,114041,-,-
BAC75_M17,6,6p12.2,52215404,52294597,79193,-,-
BAC5_E03,6,6p12.2,52236025,52339158,103133,-,-
BAC107_O15,6,6p12.2,52285790,52427392,141602,-,-
BAC243_F11,6,6p12.2,52301238,52378269,77031,-,-
BAC65_C11,6,6p12.2,52431390,52511833,80443,-,-
BAC101_K11,6,6p12.2-6p12.1,52519944,52606820,86876,-,-
BAC81_J11,6,6p12.2-6p12.1,52523060,52614642,91582,-,-
BAC57_I07,6,6p12.2-6p12.1,52523065,52636253,113188,-,-
BAC97_P16,6,6p12.2,52523326,52586730,63404,-,-
BAC242_H02,6,6p12.2-6p12.1,52524360,52601591,77231,-,-
BAC165_G15,6,6p12.2-6p12.1,52526704,52635242,108538,-,-
BAC91_A11,6,6p12.2-6p12.1,52565164,52670857,105693,-,-
BAC168_M04,6,6p12.1,52614530,52707544,93014,-,-
BAC218_A17,6,6p12.1,52703623,52823043,119420,-,-
BAC96_G09,6,6p12.1,52703623,52849725,146102,-,-
BAC192_A12,6,6p12.1,52703671,52822925,119254,-,-
BAC67_D19,6,6p12.1,52728285,52762276,33991,-,-
BAC180_M06,6,6p12.1,52746355,52831666,85311,-,-
BAC25_C03,6,6p12.1,52944942,53053432,108490,-,-
BAC246_N09,6,6p12.1,53098013,53217587,119574,-,-
BAC8_N11,6,6p12.1,53098412,53214979,116567,-,-
BAC72_G06,6,6p12.1,53109103,53231754,122651,-,-
BAC160_P10,6,6p12.1,53141968,53235111,93143,-,-
BAC97_O17,6,6p12.1,53162406,53247319,84913,-,-
BAC43_P04,6,6p12.1,53276054,53439330,163276,-,-
BAC162_B09,6,6p12.1,53299113,53402819,103706,-,-
BAC165_N18,6,6p12.1,53402139,53493185,91046,-,-
BAC6_H02,6,6p12.1,53552887,53668459,115572,-,-
BAC41_B18,6,6p12.1,53554625,53677232,122607,-,-
BAC67_H13,6,6p12.1,53622274,53709954,87680,-,-
BAC163_G08,6,6p12.1,53631888,53677240,45352,-,-
BAC231_M19,6,6p12.1,53640168,53729433,89265,-,-
BAC237_O16,6,6p12.1,53709965,53798954,88989,-,-
BAC112_I06,6,6p12.1,53723024,53800926,77902,-,-
BAC62_E05,6,6p12.1,53770048,53870017,99969,-,-
BAC185_L20,6,6p12.1,53774755,53890580,115825,-,-
BAC42_E03,6,6p12.1,53778189,53864747,86558,-,-
BAC31_A19,6,6p12.1,53826994,53940843,113849,-,-
BAC186_N02,6,6p12.1,53945751,54031614,85863,-,-
BAC178_I14,6,6p12.1,54036514,54115658,79144,-,-
BAC224_I01,6,6p12.1,54046341,54134935,88594,-,-
BAC79_P24,6,6p12.1,54165678,54269217,103539,-,-
BAC124_A03,6,6p12.1,54288791,54374258,85467,-,-
BAC60_H23,6,6p12.1,54496741,54580918,84177,-,-
BAC105_M08,6,6p12.1,54597534,54716944,119410,-,-
BAC157_O20,6,6p12.1,54662535,54740556,78021,-,-
BAC117_P08,6,6p12.1,54745352,54835625,90273,-,-
BAC46_L07,6,6p12.1,54823193,54922587,99394,-,-
BAC150_N04,6,6p12.1,54932326,55029806,97480,-,-
BAC141_A09,6,6p12.1,54977631,55069001,91370,-,-
BAC151_D08,6,6p12.1,54984487,55063166,78679,-,-
BAC179_P13,6,6p12.1,55059739,55130748,71009,-,-
BAC101_F03,6,6p12.1,55069235,55155409,86174,-,-
BAC126_L06,6,6p12.1,55108810,55210739,101929,-,-
BAC122_N05,6,6p12.1,55108810,55210739,101929,-,-
BAC63_M24,6,6p12.1,55130742,55230126,99384,-,-
BAC75_C12,6,6p12.1,55193759,55309934,116175,-,-
BAC227_K19,6,6p12.1,55217298,55324099,106801,-,-
BAC51_E02,6,6p12.1,55309993,55406613,96620,-,-
BAC248_K01,6,6p12.1,55393302,55472740,79438,-,-
BAC88_E08,6,6p12.1,55393372,55493635,100263,-,-
BAC134_H01,6,6p12.1,55817088,55930469,113381,-,-
BAC31_I22,6,6p12.1,55835561,55930475,94914,-,-
BAC163_L11,6,6p12.1,55884146,55978832,94686,-,-
BAC160_H19,6,6p12.1,56155056,56238639,83583,-,-
BAC162_J19,6,6p12.1,56323729,56441670,117941,-,-
BAC65_C23,6,6p12.1,56326191,56413552,87361,-,-
BAC186_J21,6,6p12.1,56358134,56439361,81227,-,-
BAC118_L24,6,6p12.1,56413559,56543355,129796,-,-
BAC24_P12,6,6p12.1,56485318,56604851,119533,-,-
BAC59_K18,6,6p12.1,56585978,56709951,123973,-,-
BAC240_A07,6,6p12.1,56651577,56742625,91048,-,-
BAC97_M04,6,6p12.1,56738903,56839681,100778,-,-
BAC53_E09,6,6p12.1,56837681,56936251,98570,-,-
BAC130_F13,6,6p12.1,56880081,56964718,84637,-,-
BAC155_J06,6,6p12.1,56908931,57011869,102938,-,-
BAC149_E15,6,6p12.1,56914394,56999004,84610,-,-
BAC165_O23,6,6p12.1,56999014,57072183,73169,-,-
BAC238_C16,6,6p12.1-6p11.2,57123241,57224537,101296,-,-
BAC132_A22,6,6p12.1-6p11.2,57176162,57258173,82011,-,-
BAC55_N23,6,6p11.2,57258188,57389294,131106,-,-
BAC115_D21,6,6p11.2,57261219,57347795,86576,-,-
BAC160_G02,6,6p11.2,57261964,57347892,85928,-,-
BAC81_E09,6,6p11.2,57314101,57432952,118851,-,-
BAC189_O17,6,6p11.2,57375471,57456957,81486,-,-
BAC149_E19,6,6p11.2,57396458,57487703,91245,-,-
BAC162_D05,6,6p11.2,57447572,57519790,72218,-,-
BAC110_O09,6,6p11.2,57447572,57630560,182988,-,-
BAC127_I02,6,6p11.2,57449155,57572234,123079,-,-
BAC104_F21,6,6p11.2,57459116,57575501,116385,-,-
BAC130_H09,6,6p11.2,57488468,57576538,88070,-,-
BAC145_B13,6,6p11.2,57522561,57649391,126830,-,-
BAC133_D10,6,6p11.2,57522561,57623835,101274,-,-
BAC169_J11,6,6p11.2,57524074,57600865,76791,-,-
BAC102_L20,6,6p11.2,57554513,57641009,86496,-,-
BAC139_G24,6,6p11.2,57563883,57643378,79495,-,-
BAC168_H08,6,6p11.2,57576532,57654844,78312,-,-
BAC60_J16,6,6p11.2,57580728,57670049,89321,-,-
BAC4_B20,6,6p11.2,57594644,57701016,106372,-,-
BAC181_B05,6,6p11.2,57600858,57701020,100162,-,-
BAC184_P10,6,6p11.2,57712596,57841381,128785,-,-
BAC71_O09,6,6p11.2,57788730,57872032,83302,-,-
BAC146_G10,6,6p11.2-6p11.1,58339886,58447644,107758,-,-
BAC71_N14,6,6p11.1,58452709,58603756,151047,-,-
BAC107_K18,6,6p11.1,58584417,58667958,83541,-,-
BAC85_E12,6,6p11.1,58754434,58849702,95268,-,-
BAC32_O19,6,6p11.1,58775837,58856973,81136,-,-
BAC81_H13,6,6q11.1,62389814,62475480,85666,-,-
BAC166_D12,6,6q11.1,62500289,62577491,77202,-,-
BAC40_L01,6,6q11.1,62508719,62602704,93985,-,-
BAC82_I07,6,6q11.1,62665183,62783861,118678,-,-
BAC198_N22,6,6q11.1,62918837,62998693,79856,-,-
BAC223_N21,6,6q11.1-6q11.2,63325257,63443021,117764,-,-
BAC116_F05,6,6q11.2-6q12,63418977,63520799,101822,-,-
BAC57_H06,6,6q12,63631911,63714659,82748,-,-
BAC222_C10,6,6q12,63742326,63829747,87421,-,-
BAC55_C23,6,6q12,63762777,63854319,91542,-,-
BAC222_D16,6,6q12,63936232,64037109,100877,-,-
BAC229_M19,6,6q12,63988977,64071139,82162,-,-
BAC229_M04,6,6q12,63999242,64090959,91717,-,-
BAC80_P02,6,6q12,64014579,64087435,72856,-,-
BAC101_G10,6,6q12,64029895,64133566,103671,-,-
BAC50_I21,6,6q12,64064378,64160368,95990,-,-
BAC105_K17,6,6q12,64090953,64229933,138980,-,-
BAC119_N24,6,6q12,64133590,64245078,111488,-,-
BAC118_N08,6,6q12,64246809,64333569,86760,-,-
BAC127_N20,6,6q12,64301048,64415765,114717,-,-
BAC133_M12,6,6q12,64301048,64401993,100945,-,-
BAC57_K01,6,6q12,64301048,64380008,78960,-,-
BAC177_N13,6,6q12,64313297,64402024,88727,-,-
BAC116_C01,6,6q12,64313297,64426095,112798,-,-
BAC105_E11,6,6q12,64380175,64486235,106060,-,-
BAC17_L18,6,6q12,64384820,64482170,97350,-,-
BAC25_M14,6,6q12,64402649,64561286,158637,-,-
BAC126_D14,6,6q12,64648579,64741986,93407,-,-
BAC171_N19,6,6q12,64656277,64761080,104803,-,-
BAC39_I19,6,6q12,64794492,64899054,104562,-,-
BAC82_O20,6,6q12,64814507,64895494,80987,-,-
BAC90_C03,6,6q12,64913741,65030877,117136,-,-
BAC118_N19,6,6q12,64971317,65081696,110379,-,-
BAC76_I03,6,6q12,65096234,65241136,144902,-,-
BAC58_N10,6,6q12,65508126,65590968,82842,-,-
BAC130_H21,6,6q12,66179526,66266064,86538,-,-
BAC184_K17,6,6q12,66293445,66378485,85040,-,-
BAC191_E07,6,6q12,66328844,66419100,90256,-,-
BAC44_E15,6,6q12,66574633,66668215,93582,-,-
BAC84_N14,6,6q12,66804979,66934481,129502,-,-
BAC217_N22,6,6q12,66953508,67042266,88758,-,-
BAC36_B07,6,6q12,66960195,67116119,155924,-,-
BAC132_M13,6,6q12,67063612,67169386,105774,-,-
BAC44_K04,6,6q12,67169381,67289700,120319,-,-
BAC24_D15,6,6q12,67330009,67423171,93162,-,-
BAC123_F12,6,6q12,67394161,67487527,93366,-,-
BAC180_F23,6,6q12,67625561,67712550,86989,-,-
BAC194_H18,6,6q12,67709106,67793399,84293,-,-
BAC37_A11,6,6q12,67783830,67891692,107862,-,-
BAC40_M14,6,6q12,67922479,68006868,84389,-,-
BAC10_G20,6,6q12,67929742,68063638,133896,-,-
BAC194_F12,6,6q12,67959239,68029115,69876,-,-
BAC88_D02,6,6q12,68221399,68312328,90929,-,-
BAC115_C06,6,6q12,68231152,68311731,80579,-,-
BAC122_I03,6,6q12,68308282,68400354,92072,-,-
BAC197_N15,6,6q12,68324355,68403874,79519,-,-
BAC230_O13,6,6q12,68400351,68490640,90289,-,-
BAC2_C02,6,6q12,68930395,69026882,96487,-,-
BAC152_E10,6,6q12,69311898,69398206,86308,-,-
BAC140_G18,6,6q12,69328737,69458455,129718,-,-
BAC126_C19,6,6q12,69518907,69648647,129740,-,-
BAC237_G11,6,6q12,69533942,69638165,104223,-,-
BAC76_L09,6,6q12,69547632,69636056,88424,-,-
BAC103_K12,6,6q12,69606548,69619967,13419,-,-
BAC26_J07,6,6q12,69616888,69702766,85878,-,-
BAC151_E23,6,6q12,69675300,69752514,77214,-,-
BAC17_B16,6,6q12,69727284,69829978,102694,-,-
BAC60_L19,6,6q12,69787061,69877797,90736,-,-
BAC181_M16,6,6q12,69829972,69906351,76379,-,-
BAC83_F05,6,6q12-6q13,69929451,70012961,83510,-,-
BAC132_G22,6,6q13,70053621,70141787,88166,-,-
BAC10_M12,6,6q13,70148283,70242371,94088,-,-
BAC227_J04,6,6q13,70208563,70308831,100268,-,-
BAC134_O21,6,6q13,70273690,70364214,90524,-,-
BAC113_D14,6,6q13,70340023,70436227,96204,-,-
BAC224_K06,6,6q13,70380278,70458488,78210,-,-
BAC131_I19,6,6q13,70389121,70496180,107059,-,-
BAC182_K04,6,6q13,70454572,70547830,93258,-,-
BAC82_N04,6,6q13,70643037,70728794,85757,-,-
BAC10_M08,6,6q13,70722745,70845225,122480,-,-
BAC120_A16,6,6q13,70762151,70871459,109308,-,-
BAC182_D22,6,6q13,70763669,70836853,73184,-,-
BAC197_I21,6,6q13,70817489,70887861,70372,-,-
BAC224_L02,6,6q13,70879268,70968408,89140,-,-
BAC76_A23,6,6q13,70921840,71025599,103759,-,-
BAC37_N09,6,6q13,71016880,71114458,97578,-,-
BAC71_D04,6,6q13,71133257,71274591,141334,-,-
BAC118_D21,6,6q13,71158589,71298234,139645,-,-
BAC71_N04,6,6q13,71161934,71251664,89730,-,-
BAC238_F19,6,6q13,71195198,71284424,89226,-,-
BAC169_H05,6,6q13,71317478,71410523,93045,-,-
BAC169_I14,6,6q13,71320477,71419204,98727,-,-
BAC5_J03,6,6q13,71332674,71435710,103036,-,-
BAC10_J09,6,6q13,71338511,71443563,105052,-,-
BAC171_J14,6,6q13,71372479,71460136,87657,-,-
BAC51_D06,6,6q13,71379021,71464963,85942,-,-
BAC177_C01,6,6q13,71419210,71566190,146980,-,-
BAC147_M20,6,6q13,71431128,71504881,73753,-,-
BAC68_I07,6,6q13,71469938,71566153,96215,-,-
BAC243_C14,6,6q13,71571726,71659008,87282,-,-
BAC73_C23,6,6q13,71695990,71826194,130204,-,-
BAC108_L04,6,6q13,71791715,71887605,95890,-,-
BAC252_G10,6,6q13,71858256,71951573,93317,-,-
BAC178_C04,6,6q13,71874414,71988328,113914,-,-
BAC152_L19,6,6q13,71876347,71957478,81131,-,-
BAC29_I05,6,6q13,71940245,72037970,97725,-,-
BAC235_O19,6,6q13,71988400,72111959,123559,-,-
BAC120_A24,6,6q13,72034767,72127570,92803,-,-
BAC91_G14,6,6q13,72101920,72180771,78851,-,-
BAC44_L17,6,6q13,72180817,72269596,88779,-,-
BAC21_B07,6,6q13,72285875,72393621,107746,-,-
BAC154_O20,6,6q13,72642266,72717669,75403,-,-
BAC128_B20,6,6q13,72681253,72829575,148322,-,-
BAC19_D06,6,6q13,72698296,72789547,91251,-,-
BAC151_F11,6,6q13,72790621,72872438,81817,-,-
BAC73_F14,6,6q13,72904179,72991256,87077,-,-
BAC247_M02,6,6q13,73186873,73288871,101998,-,-
BAC75_J21,6,6q13,73350487,73463268,112781,-,-
BAC221_E12,6,6q13,73525619,73607333,81714,-,-
BAC26_O16,6,6q13,73618676,73705220,86544,-,-
BAC63_I23,6,6q13,73631303,73731675,100372,-,-
BAC106_L22,6,6q13,73729807,73829843,100036,-,-
BAC40_L18,6,6q13,73782730,73876142,93412,-,-
BAC194_F19,6,6q13,73800369,73892931,92562,-,-
BAC73_O04,6,6q13,73800369,73880870,80501,-,-
BAC218_B16,6,6q13,73801764,73880899,79135,-,-
BAC67_C09,6,6q13,73893792,73996610,102818,-,-
BAC224_A02,6,6q13,73900775,73983755,82980,-,-
BAC6_F24,6,6q13,73911509,74002595,91086,-,-
BAC220_P17,6,6q13,73938356,74025382,87026,-,-
BAC117_B06,6,6q13,73947226,74025382,78156,-,-
BAC146_G16,6,6q13,74015598,74088057,72459,-,-
BAC67_E12,6,6q13,74030829,74134771,103942,-,-
BAC248_P21,6,6q13,74088235,74190188,101953,-,-
BAC191_B05,6,6q13,74098908,74176890,77982,-,-
BAC141_E08,6,6q13,74116015,74213701,97686,-,-
BAC91_J23,6,6q13,74132765,74216859,84094,-,-
BAC31_B18,6,6q13,74213789,74336336,122547,-,-
BAC82_O02,6,6q13,74295743,74416949,121206,-,-
BAC58_H21,6,6q13,74297546,74373127,75581,-,-
BAC51_G19,6,6q13,74347502,74428165,80663,-,-
BAC54_D06,6,6q13,74369598,74461869,92271,-,-
BAC237_O01,6,6q13,74450740,74539876,89136,-,-
BAC228_C17,6,6q13,74488657,74590050,101393,-,-
BAC59_N22,6,6q13,74585622,74684978,99356,-,-
BAC110_K12,6,6q13,74625339,74704330,78991,-,-
BAC187_K20,6,6q13,74631822,74717444,85622,-,-
BAC158_N06,6,6q13,74634183,74717433,83250,-,-
BAC125_I09,6,6q13,74641245,74760796,119551,-,-
BAC166_J09,6,6q13,74641251,74715798,74547,-,-
BAC41_G23,6,6q13,74670472,74756636,86164,-,-
BAC89_D03,6,6q13,74677251,74827294,150043,-,-
BAC228_O01,6,6q13,74685086,74775948,90862,-,-
BAC36_P14,6,6q13,74860017,74947759,87742,-,-
BAC17_L23,6,6q13,74871330,74936555,65225,-,-
BAC35_N03,6,6q13,74873141,74957026,83885,-,-
BAC10_C12,6,6q13,74878804,75040169,161365,-,-
BAC165_G08,6,6q13,74936608,75040184,103576,-,-
BAC179_B19,6,6q13,74949874,75023613,73739,-,-
BAC74_N13,6,6q13,75196659,75207216,10557,-,-
BAC198_I09,6,6q13,75208144,75280789,72645,-,-
BAC100_M22,6,6q13,75212001,75321487,109486,-,-
BAC81_O18,6,6q13,75385990,75470516,84526,-,-
BAC162_K12,6,6q13,75591221,75672084,80863,-,-
BAC2_O08,6,6q13,75655235,75746525,91290,-,-
BAC120_D20,6,6q13-6q14.1,75878297,76021978,143681,-,-
BAC153_B01,6,6q14.1,75945428,76021979,76551,-,-
BAC38_G08,6,6q14.1,76010519,76099370,88851,-,-
BAC194_P16,6,6q14.1,76096226,76194809,98583,-,-
BAC89_B04,6,6q14.1,76099664,76190638,90974,-,-
BAC27_F20,6,6q14.1,76270301,76387144,116843,-,-
BAC168_E16,6,6q14.1,76330771,76418765,87994,-,-
BAC107_L11,6,6q14.1,76377897,76463809,85912,-,-
BAC203_M17,6,6q14.1,76407365,76419855,12490,-,-
BAC219_I14,6,6q14.1,76524630,76634119,109489,-,-
BAC162_D08,6,6q14.1,76540066,76596224,56158,-,-
BAC177_B17,6,6q14.1,76552137,76642602,90465,-,-
BAC30_E13,6,6q14.1,76560842,76686039,125197,-,-
BAC219_M08,6,6q14.1,76561203,76660570,99367,-,-
BAC33_H14,6,6q14.1,76635923,76730069,94146,-,-
BAC110_P08,6,6q14.1,76752164,76884012,131848,-,-
BAC153_F11,6,6q14.1,76927119,76987788,60669,-,-
BAC144_I19,6,6q14.1,77014361,77188729,174368,-,-
BAC101_B03,6,6q14.1,77198637,77295918,97281,-,-
BAC114_O14,6,6q14.1,77380253,77461414,81161,-,-
BAC95_P23,6,6q14.1,77519922,77603212,83290,-,-
BAC172_J04,6,6q14.1,77669016,77749316,80300,-,-
BAC161_N17,6,6q14.1,77724792,77821433,96641,-,-
BAC128_F04,6,6q14.1,78019841,78130161,110320,-,-
BAC128_E02,6,6q14.1,78052091,78161921,109830,-,-
BAC141_L03,6,6q14.1,78191467,78271151,79684,-,-
BAC69_E06,6,6q14.1,78402382,78491732,89350,-,-
BAC126_M13,6,6q14.1,78553425,78676288,122863,-,-
BAC110_L13,6,6q14.1,78560458,78668122,107664,-,-
BAC36_K04,6,6q14.1,78572082,78722396,150314,-,-
BAC199_B24,6,6q14.1,78660321,78741284,80963,-,-
BAC182_O17,6,6q14.1,78733913,78821072,87159,-,-
BAC22_D20,6,6q14.1,78733917,78878686,144769,-,-
BAC35_F06,6,6q14.1,78785176,78885588,100412,-,-
BAC75_K15,6,6q14.1,78832224,78924561,92337,-,-
BAC152_L06,6,6q14.1,78864392,78948643,84251,-,-
BAC61_O01,6,6q14.1,78929983,79124747,194764,-,-
BAC125_K09,6,6q14.1,78968179,79128757,160578,-,-
BAC37_L22,6,6q14.1,78983962,79135403,151441,-,-
BAC86_B02,6,6q14.1,79140602,79240249,99647,-,-
BAC145_B06,6,6q14.1,79249498,79340169,90671,-,-
BAC44_K02,6,6q14.1,79292190,79410246,118056,-,-
BAC153_B10,6,6q14.1,79380531,79480419,99888,-,-
BAC140_J10,6,6q14.1,79506668,79619791,113123,-,-
BAC197_N07,6,6q14.1,79626776,79747019,120243,-,-
BAC62_C06,6,6q14.1,79645417,79799628,154211,-,-
BAC112_P06,6,6q14.1,79772397,79876592,104195,-,-
BAC202_O19,6,6q14.1,79793256,79875958,82702,-,-
BAC61_K12,6,6q14.1,79802582,79828909,26327,-,-
BAC134_B02,6,6q14.1,79876869,79958579,81710,-,-
BAC228_N06,6,6q14.1,79886465,79991890,105425,-,-
BAC42_E22,6,6q14.1,80059476,80201427,141951,-,-
BAC64_G20,6,6q14.1,80212250,80345449,133199,-,-
BAC229_E12,6,6q14.1,80301042,80393494,92452,-,-
BAC91_C13,6,6q14.1,80329595,80421106,91511,-,-
BAC75_K20,6,6q14.1,80352246,80485765,133519,-,-
BAC57_H13,6,6q14.1,80428886,80577491,148605,-,-
BAC15_I19,6,6q14.1,80578786,80689106,110320,-,-
BAC137_G11,6,6q14.1,80640091,80748504,108413,-,-
BAC65_H07,6,6q14.1,80726737,80838834,112097,-,-
BAC106_J08,6,6q14.1,80747957,80866121,118164,-,-
BAC167_G01,6,6q14.1,80752858,80838834,85976,-,-
BAC182_I14,6,6q14.1,80810679,80948906,138227,-,-
BAC144_N09,6,6q14.1,80845483,80938436,92953,-,-
BAC76_K14,6,6q14.1,80853874,80936028,82154,-,-
BAC26_F16,6,6q14.1,80924435,81042966,118531,-,-
BAC84_A07,6,6q14.1,81053916,81153983,100067,-,-
BAC137_D20,6,6q14.1,81408388,81481895,73507,-,-
BAC195_E09,6,6q14.1,81468701,81573613,104912,-,-
BAC29_K16,6,6q14.1,81492993,81585421,92428,-,-
BAC171_P19,6,6q14.1,81741077,81816509,75432,-,-
BAC103_O07,6,6q14.1,82126361,82240854,114493,-,-
BAC131_I03,6,6q14.1,82147348,82246354,99006,-,-
BAC236_P16,6,6q14.1,82163919,82246354,82435,-,-
BAC61_E18,6,6q14.1,82180862,82254376,73514,-,-
BAC237_C23,6,6q14.1,82792009,82888982,96973,-,-
BAC19_P03,6,6q14.1,82824473,82917825,93352,-,-
BAC147_I18,6,6q14.1,82833633,82929303,95670,-,-
BAC78_G19,6,6q14.1,82972785,83065023,92238,-,-
BAC91_B20,6,6q14.1,83008307,83083942,75635,-,-
BAC63_J21,6,6q14.1,83013129,83092062,78933,-,-
BAC177_B21,6,6q14.1,83059012,83149066,90054,-,-
BAC12_E03,6,6q14.1,83065290,83149066,83776,-,-
BAC66_K18,6,6q14.1,83089184,83259353,170169,-,-
BAC176_D12,6,6q14.1,83225923,83286739,60816,-,-
BAC132_N22,6,6q14.1,83286737,83368912,82175,-,-
BAC172_P05,6,6q14.1,83523832,83610484,86652,-,-
BAC118_A20,6,6q14.1,83528134,83611115,82981,-,-
BAC252_O15,6,6q14.1,83531759,83639328,107569,-,-
BAC170_C15,6,6q14.2,83936834,84044339,107505,-,-
BAC61_P09,6,6q14.2,84058358,84147836,89478,-,-
BAC81_O03,6,6q14.2,84076188,84164008,87820,-,-
BAC193_B23,6,6q14.2,84214956,84296810,81854,-,-
BAC52_L01,6,6q14.2,84497729,84576379,78650,-,-
BAC95_N14,6,6q14.2,84522735,84627337,104602,-,-
BAC81_P16,6,6q14.2-6q14.3,84689916,84856012,166096,-,-
BAC139_C20,6,6q14.3,84764256,84869066,104810,-,-
BAC119_N15,6,6q14.3,84765742,84856012,90270,-,-
BAC100_H18,6,6q14.3,84783423,84869069,85646,-,-
BAC86_L20,6,6q14.3,85037542,85137498,99956,-,-
BAC171_C16,6,6q14.3,85055246,85146408,91162,-,-
BAC14_A03,6,6q14.3,85282847,85384955,102108,-,-
BAC64_H12,6,6q14.3,85492866,85608341,115475,-,-
BAC157_M12,6,6q14.3,85823876,85927034,103158,-,-
BAC157_J12,6,6q14.3,85823876,85927229,103353,-,-
BAC83_M01,6,6q14.3,85826097,85938563,112466,-,-
BAC150_C13,6,6q14.3,85854469,85969794,115325,-,-
BAC147_J15,6,6q14.3,86145521,86242340,96819,-,-
BAC128_D10,6,6q14.3,86171721,86256237,84516,-,-
BAC118_G07,6,6q14.3,86224718,86359262,134544,-,-
BAC90_M13,6,6q14.3,86306418,86406962,100544,-,-
BAC176_I22,6,6q14.3,86348287,86431447,83160,-,-
BAC91_J09,6,6q14.3,86359557,86465875,106318,-,-
BAC130_O09,6,6q14.3,86502688,86581468,78780,-,-
BAC156_J15,6,6q14.3,86553914,86790279,236365,-,-
BAC222_I15,6,6q14.3,86626098,86709228,83130,-,-
BAC66_B18,6,6q14.3,86709224,86838568,129344,-,-
BAC35_D18,6,6q14.3,86739906,86833352,93446,-,-
BAC75_I06,6,6q14.3,86797091,86897605,100514,-,-
BAC178_O18,6,6q14.3,86833404,86908307,74903,-,-
BAC178_L18,6,6q14.3,86833408,86908307,74899,-,-
BAC206_H06,6,6q14.3,86897597,86981227,83630,-,-
BAC135_B23,6,6q14.3,86908498,87003054,94556,-,-
BAC250_D08,6,6q14.3,86910994,87003054,92060,-,-
BAC235_N17,6,6q14.3,86929565,87003054,73489,-,-
BAC240_O23,6,6q14.3,87077798,87150925,73127,-,-
BAC246_P11,6,6q14.3,87129134,87217702,88568,-,-
BAC199_L07,6,6q14.3,87218807,87314798,95991,-,-
BAC142_F20,6,6q14.3,87218807,87296612,77805,-,-
BAC152_D12,6,6q14.3-6q15,87448438,87533275,84837,-,-
BAC34_I18,6,6q15,87554064,87655398,101334,-,-
BAC120_M07,6,6q15,87558233,87655402,97169,-,-
BAC250_M08,6,6q15,87558371,87655402,97031,-,-
BAC102_B03,6,6q15,87611321,87683862,72541,-,-
BAC189_J12,6,6q15,87783749,87867881,84132,-,-
BAC123_F14,6,6q15,87783749,87865667,81918,-,-
BAC26_M02,6,6q15,87814313,87905801,91488,-,-
BAC37_A21,6,6q15,87868728,87965441,96713,-,-
BAC224_K03,6,6q15,88106544,88173352,66808,-,-
BAC115_D14,6,6q15,88224299,88327595,103296,-,-
BAC219_K04,6,6q15,88310119,88401915,91796,-,-
BAC198_N19,6,6q15,88351742,88514161,162419,-,-
BAC188_H09,6,6q15,88404064,88514161,110097,-,-
BAC4_N21,6,6q15,88428279,88514140,85861,-,-
BAC127_C20,6,6q15,88486611,88572803,86192,-,-
BAC54_M01,6,6q15,88548821,88714481,165660,-,-
BAC37_G18,6,6q15,88572801,88664971,92170,-,-
BAC60_J20,6,6q15,88593564,88729589,136025,-,-
BAC33_A18,6,6q15,88601927,88695792,93865,-,-
BAC224_E07,6,6q15,88613723,88695822,82099,-,-
BAC12_H19,6,6q15,88696010,88875733,179723,-,-
BAC53_C08,6,6q15,88766589,88842815,76226,-,-
BAC233_G19,6,6q15,88779792,88875733,95941,-,-
BAC188_P10,6,6q15,88800876,88886488,85612,-,-
BAC25_D22,6,6q15,88912364,89046486,134122,-,-
BAC80_E19,6,6q15,89031357,89114857,83500,-,-
BAC243_L01,6,6q15,89144234,89242347,98113,-,-
BAC70_P12,6,6q15,89150807,89284988,134181,-,-
BAC111_F19,6,6q15,89234387,89344169,109782,-,-
BAC179_B09,6,6q15,89245032,89325836,80804,-,-
BAC148_B07,6,6q15,89362328,89441540,79212,-,-
BAC116_N10,6,6q15,89433917,89541399,107482,-,-
BAC43_G07,6,6q15,89470316,89548447,78131,-,-
BAC31_O07,6,6q15,89518480,89687757,169277,-,-
BAC51_C17,6,6q15,89526387,89674616,148229,-,-
BAC18_D06,6,6q15,89583131,89684993,101862,-,-
BAC147_D15,6,6q15,89671127,89776032,104905,-,-
BAC151_A15,6,6q15,89685601,89763166,77565,-,-
BAC122_A10,6,6q15,89685613,89801514,115901,-,-
BAC37_H21,6,6q15,89796685,89929080,132395,-,-
BAC26_L03,6,6q15,89825920,89940100,114180,-,-
BAC137_E05,6,6q15,89832333,89926062,93729,-,-
BAC152_J17,6,6q15,89860377,89968216,107839,-,-
BAC115_B01,6,6q15,89901391,90023734,122343,-,-
BAC124_I18,6,6q15,89921151,90035080,113929,-,-
BAC127_O15,6,6q15,89937204,90023734,86530,-,-
BAC237_K06,6,6q15,89943762,90025770,82008,-,-
BAC132_E18,6,6q15,90013119,90275180,262061,-,-
BAC27_E20,6,6q15,90120991,90262814,141823,-,-
BAC239_A05,6,6q15,90122336,90200977,78641,-,-
BAC217_E15,6,6q15,90140554,90259421,118867,-,-
BAC77_M11,6,6q15,90216180,90328103,111923,-,-
BAC176_H22,6,6q15,90261025,90390615,129590,-,-
BAC167_H06,6,6q15,90274500,90377007,102507,-,-
BAC130_N21,6,6q15,90275197,90395617,120420,-,-
BAC248_J19,6,6q15,90277945,90375606,97661,-,-
BAC240_E09,6,6q15,90354901,90438480,83579,-,-
BAC236_P07,6,6q15,90497406,90586981,89575,-,-
BAC185_F07,6,6q15,90649405,90748045,98640,-,-
BAC82_L09,6,6q15,90802810,90906800,103990,-,-
BAC224_I09,6,6q15,90874783,90972265,97482,-,-
BAC37_C17,6,6q15,90890715,91056088,165373,-,-
BAC93_O19,6,6q15,90892794,90990448,97654,-,-
BAC232_G06,6,6q15,90906792,90990600,83808,-,-
BAC80_O01,6,6q15,90906797,91056088,149291,-,-
BAC31_O23,6,6q15,90943841,91044601,100760,-,-
BAC170_J04,6,6q15,91053926,91145974,92048,-,-
BAC231_G23,6,6q15,91058288,91187620,129332,-,-
BAC177_D22,6,6q15,91074345,91145975,71630,-,-
BAC177_N04,6,6q15,91074364,91145975,71611,-,-
BAC49_M18,6,6q15,91081641,91187442,105801,-,-
BAC219_F13,6,6q15,91082184,91164860,82676,-,-
BAC233_H24,6,6q15,91118818,91187620,68802,-,-
BAC54_M08,6,6q15,91128890,91222933,94043,-,-
BAC40_O02,6,6q15,91141744,91222923,81179,-,-
BAC115_D12,6,6q15,91198559,91301226,102667,-,-
BAC151_F24,6,6q15,91209001,91283606,74605,-,-
BAC40_M19,6,6q15,91222978,91307453,84475,-,-
BAC234_B15,6,6q15,91415426,91498054,82628,-,-
BAC134_F02,6,6q15,91431494,91503470,71976,-,-
BAC199_L04,6,6q15,91439035,91532943,93908,-,-
BAC71_I15,6,6q15,91520377,91611642,91265,-,-
BAC32_M04,6,6q15,91532950,91681599,148649,-,-
BAC238_P07,6,6q15,91594737,91682130,87393,-,-
BAC146_D13,6,6q15,91605095,91678339,73244,-,-
BAC117_N14,6,6q15,91854172,91964960,110788,-,-
BAC43_M14,6,6q15,91854172,91954978,100806,-,-
BAC28_K16,6,6q15,91878501,91957182,78681,-,-
BAC170_D04,6,6q15-6q16.1,92056453,92166125,109672,-,-
BAC106_F08,6,6q16.1,92154262,92247672,93410,-,-
BAC26_C08,6,6q16.1,92166145,92249376,83231,-,-
BAC226_E03,6,6q16.1,92505651,92585963,80312,-,-
BAC234_L14,6,6q16.1,92546719,92620820,74101,-,-
BAC161_G15,6,6q16.1,92559952,92639921,79969,-,-
BAC178_E19,6,6q16.1,92666258,92756091,89833,-,-
BAC83_L24,6,6q16.1,92712463,92846091,133628,-,-
BAC189_F06,6,6q16.1,92941900,93015918,74018,-,-
BAC195_M22,6,6q16.1,92959441,93054459,95018,-,-
BAC229_J12,6,6q16.1,93187664,93269337,81673,-,-
BAC149_K15,6,6q16.1,93188549,93276353,87804,-,-
BAC78_N17,6,6q16.1,93246614,93360858,114244,-,-
BAC48_L08,6,6q16.1,93296198,93371366,75168,-,-
BAC75_H17,6,6q16.1,93637096,93760568,123472,-,-
BAC236_A17,6,6q16.1,94065463,94148073,82610,-,-
BAC115_I18,6,6q16.1,94177271,94199604,22333,-,-
BAC41_M03,6,6q16.1,94248117,94355792,107675,-,-
BAC64_K10,6,6q16.1,94363479,94453087,89608,-,-
BAC68_E04,6,6q16.1,94415198,94533735,118537,-,-
BAC108_F02,6,6q16.1,94425047,94539043,113996,-,-
BAC157_O08,6,6q16.1,94504511,94595511,91000,-,-
BAC143_P17,6,6q16.1,94741049,94845834,104785,-,-
BAC30_H16,6,6q16.1,94895234,94993679,98445,-,-
BAC171_L20,6,6q16.1,94978619,95061244,82625,-,-
BAC58_D11,6,6q16.1,95112318,95216800,104482,-,-
BAC49_F22,6,6q16.1,95129722,95239466,109744,-,-
BAC178_O02,6,6q16.1,95242943,95324845,81902,-,-
BAC187_B11,6,6q16.1,95289456,95375848,86392,-,-
BAC16_C23,6,6q16.1,95540722,95627167,86445,-,-
BAC118_A15,6,6q16.1,95947479,96037506,90027,-,-
BAC18_P11,6,6q16.1,95948314,96042518,94204,-,-
BAC221_G06,6,6q16.1,96130161,96209613,79452,-,-
BAC117_F10,6,6q16.1,96134369,96211294,76925,-,-
BAC248_D03,6,6q16.1,96148298,96233189,84891,-,-
BAC133_B15,6,6q16.1,96247069,96331541,84472,-,-
BAC36_E05,6,6q16.1,96331555,96453744,122189,-,-
BAC187_K19,6,6q16.1,96568364,96650758,82394,-,-
BAC95_N05,6,6q16.1,96701523,96787271,85748,-,-
BAC83_D04,6,6q16.1,97120138,97221392,101254,-,-
BAC155_M04,6,6q16.1,97161468,97272081,110613,-,-
BAC130_F11,6,6q16.1,97289561,97379190,89629,-,-
BAC53_J08,6,6q16.1,97549235,97632567,83332,-,-
BAC2_L09,6,6q16.1,97681850,97773839,91989,-,-
BAC93_M23,6,6q16.1,97852953,97953386,100433,-,-
BAC185_N13,6,6q16.1,98101625,98209164,107539,-,-
BAC124_K22,6,6q16.1,98207124,98291984,84860,-,-
BAC53_F14,6,6q16.1,98369927,98461209,91282,-,-
BAC12_H23,6,6q16.2,98785663,98900035,114372,-,-
BAC30_D05,6,6q16.2,98791196,98895801,104605,-,-
BAC134_F09,6,6q16.2,98831377,98949102,117725,-,-
BAC142_J04,6,6q16.2,99054566,99143073,88507,-,-
BAC8_J01,6,6q16.2,99054566,99173867,119301,-,-
BAC201_G19,6,6q16.2,99247178,99330799,83621,-,-
BAC94_P08,6,6q16.2,99344964,99434539,89575,-,-
BAC56_K21,6,6q16.2,99423508,99504449,80941,-,-
BAC184_M02,6,6q16.2,99434735,99515825,81090,-,-
BAC31_M14,6,6q16.2,99444295,99547054,102759,-,-
BAC180_K09,6,6q16.2,99455677,99535434,79757,-,-
BAC71_L20,6,6q16.2,99536615,99623559,86944,-,-
BAC243_C02,6,6q16.2,99629893,99743584,113691,-,-
BAC167_F05,6,6q16.2,99645569,99739206,93637,-,-
BAC46_N22,6,6q16.2,99792197,99896383,104186,-,-
BAC128_N22,6,6q16.2-6q16.3,99870869,99967310,96441,-,-
BAC102_N02,6,6q16.2-6q16.3,99870869,99967288,96419,-,-
BAC72_I10,6,6q16.3,99905039,100000457,95418,-,-
BAC180_F16,6,6q16.3,100005444,100093144,87700,-,-
BAC121_N02,6,6q16.3,100037973,100120794,82821,-,-
BAC10_A15,6,6q16.3,100049747,100139524,89777,-,-
BAC145_H07,6,6q16.3,100052877,100143895,91018,-,-
BAC169_F23,6,6q16.3,100066910,100143895,76985,-,-
BAC14_E19,6,6q16.3,100230202,100362379,132177,-,-
BAC182_G21,6,6q16.3,100283568,100364786,81218,-,-
BAC63_O22,6,6q16.3,100298495,100378106,79611,-,-
BAC142_D05,6,6q16.3,100398918,100482777,83859,-,-
BAC198_I13,6,6q16.3,100476722,100597145,120423,-,-
BAC95_P12,6,6q16.3,100490785,100588249,97464,-,-
BAC193_D17,6,6q16.3,100520649,100599506,78857,-,-
BAC227_P09,6,6q16.3,100658573,100749041,90468,-,-
BAC238_N17,6,6q16.3,100677284,100776392,99108,-,-
BAC4_F16,6,6q16.3,100912961,101008241,95280,-,-
BAC227_A10,6,6q16.3,100987145,101104596,117451,-,-
BAC32_M05,6,6q16.3,101232764,101331433,98669,-,-
BAC91_E10,6,6q16.3,101419945,101499235,79290,-,-
BAC250_D20,6,6q16.3,101434322,101515822,81500,-,-
BAC70_C07,6,6q16.3,101513486,101606972,93486,-,-
BAC145_F12,6,6q16.3,101544655,101639364,94709,-,-
BAC206_L20,6,6q16.3,101586161,101677937,91776,-,-
BAC45_I03,6,6q16.3,101809049,101927011,117962,-,-
BAC75_L20,6,6q16.3,101927017,102072412,145395,-,-
BAC144_P22,6,6q16.3,101931586,102029225,97639,-,-
BAC233_E03,6,6q16.3,102011933,102114340,102407,-,-
BAC46_D16,6,6q16.3,102063111,102153035,89924,-,-
BAC187_C08,6,6q16.3,102072407,102146673,74266,-,-
BAC167_L21,6,6q16.3,102207435,102288177,80742,-,-
BAC97_H04,6,6q16.3,102540380,102673683,133303,-,-
BAC181_K02,6,6q16.3,102562168,102659890,97722,-,-
BAC56_P14,6,6q16.3,102640627,102735570,94943,-,-
BAC163_D19,6,6q16.3,102714243,102792990,78747,-,-
BAC236_L13,6,6q16.3,102908473,102972341,63868,-,-
BAC76_H12,6,6q16.3,103227942,103314400,86458,-,-
BAC117_C09,6,6q16.3,103245425,103377309,131884,-,-
BAC135_O17,6,6q16.3,103296404,103373148,76744,-,-
BAC53_C16,6,6q16.3,103299484,103408306,108822,-,-
BAC140_A18,6,6q16.3,103409382,103501052,91670,-,-
BAC56_A20,6,6q16.3,103694337,103720593,26256,-,-
BAC66_A15,6,6q16.3,103835360,103920127,84767,-,-
BAC252_J07,6,6q16.3,103837177,103919509,82332,-,-
BAC28_P13,6,6q16.3,103897000,103995322,98322,-,-
BAC67_I21,6,6q16.3,103912659,103995322,82663,-,-
BAC172_L22,6,6q16.3,104080245,104161682,81437,-,-
BAC240_O18,6,6q16.3,104103454,104179824,76370,-,-
BAC76_C11,6,6q16.3,104161878,104267252,105374,-,-
BAC137_C22,6,6q16.3,104607744,104698681,90937,-,-
BAC224_P22,6,6q16.3,104616377,104687519,71142,-,-
BAC22_E13,6,6q16.3,104653933,104781250,127317,-,-
BAC144_A08,6,6q16.3-6q21,104757280,104842562,85282,-,-
BAC57_F17,6,6q16.3-6q21,104763460,104850943,87483,-,-
BAC76_F07,6,6q21,104932957,105028939,95982,-,-
BAC186_M13,6,6q21,104955154,105064983,109829,-,-
BAC8_D14,6,6q21,105159782,105260248,100466,-,-
BAC89_L01,6,6q21,105185827,105355065,169238,-,-
BAC123_A17,6,6q21,105200754,105270217,69463,-,-
BAC223_O17,6,6q21,105257015,105344473,87458,-,-
BAC178_I18,6,6q21,105260285,105351188,90903,-,-
BAC61_N02,6,6q21,105393212,105466923,73711,-,-
BAC252_B15,6,6q21,105405418,105573100,167682,-,-
BAC155_O23,6,6q21,105467151,105547631,80480,-,-
BAC185_O20,6,6q21,105535835,105614219,78384,-,-
BAC46_K16,6,6q21,105614149,105701634,87485,-,-
BAC220_M10,6,6q21,105628042,105723513,95471,-,-
BAC236_F13,6,6q21,105635166,105717787,82621,-,-
BAC139_H23,6,6q21,105686553,105785468,98915,-,-
BAC232_B04,6,6q21,105708192,105845369,137177,-,-
BAC154_I05,6,6q21,105717781,105829908,112127,-,-
BAC194_K14,6,6q21,105724726,105827691,102965,-,-
BAC203_H01,6,6q21,105765396,105852004,86608,-,-
BAC73_G18,6,6q21,105768034,105849725,81691,-,-
BAC132_N15,6,6q21,105867293,105970349,103056,-,-
BAC191_M19,6,6q21,105942405,106067843,125438,-,-
BAC165_C20,6,6q21,105997815,106074101,76286,-,-
BAC166_H11,6,6q21,106105743,106179773,74030,-,-
BAC4_P24,6,6q21,106224440,106316527,92087,-,-
BAC200_H20,6,6q21,106246625,106326307,79682,-,-
BAC109_D10,6,6q21,106299443,106379694,80251,-,-
BAC197_E09,6,6q21,106313413,106395403,81990,-,-
BAC32_K05,6,6q21,106355291,106433186,77895,-,-
BAC61_K17,6,6q21,106411946,106513690,101744,-,-
BAC186_E21,6,6q21,106433216,106506838,73622,-,-
BAC149_P21,6,6q21,106439995,106513690,73695,-,-
BAC170_O10,6,6q21,106588482,106673168,84686,-,-
BAC104_K04,6,6q21,106827665,106922844,95179,-,-
BAC246_L18,6,6q21,106894590,106973748,79158,-,-
BAC66_G21,6,6q21,106925620,107015810,90190,-,-
BAC237_A03,6,6q21,107002577,107109741,107164,-,-
BAC31_G18,6,6q21,107002580,107125617,123037,-,-
BAC200_M23,6,6q21,107033292,107125416,92124,-,-
BAC131_G11,6,6q21,107047140,107125617,78477,-,-
BAC248_O16,6,6q21,107075531,107188776,113245,-,-
BAC111_J18,6,6q21,107107910,107200410,92500,-,-
BAC237_C18,6,6q21,107126438,107211374,84936,-,-
BAC121_E08,6,6q21,107136260,107214033,77773,-,-
BAC204_H03,6,6q21,107142845,107211374,68529,-,-
BAC102_J21,6,6q21,107164220,107304371,140151,-,-
BAC109_D17,6,6q21,107200410,107346687,146277,-,-
BAC113_I02,6,6q21,107231758,107391784,160026,-,-
BAC8_K01,6,6q21,107231764,107337346,105582,-,-
BAC21_D12,6,6q21,107299822,107402493,102671,-,-
BAC226_L24,6,6q21,107444864,107510085,65221,-,-
BAC162_A02,6,6q21,107510078,107597323,87245,-,-
BAC133_P18,6,6q21,107560520,107639275,78755,-,-
BAC66_I10,6,6q21,107566661,107638553,71892,-,-
BAC78_C22,6,6q21,107594743,107694283,99540,-,-
BAC25_P10,6,6q21,107674147,107794331,120184,-,-
BAC66_I13,6,6q21,107675759,107769650,93891,-,-
BAC55_L07,6,6q21,107680234,107790653,110419,-,-
BAC213_M14,6,6q21,107776995,107854143,77148,-,-
BAC123_J23,6,6q21,107829077,107962344,133267,-,-
BAC132_D13,6,6q21,107829077,108009847,180770,-,-
BAC57_N14,6,6q21,107871592,108011189,139597,-,-
BAC72_J06,6,6q21,107880084,107972286,92202,-,-
BAC159_K07,6,6q21,107890404,108019865,129461,-,-
BAC103_C15,6,6q21,107954298,108051930,97632,-,-
BAC100_E22,6,6q21,107959534,108079784,120250,-,-
BAC27_P17,6,6q21,107961222,108059168,97946,-,-
BAC240_E07,6,6q21,107972732,108051928,79196,-,-
BAC171_J09,6,6q21,107974263,108070534,96271,-,-
BAC56_N14,6,6q21,107992140,108084574,92434,-,-
BAC129_A13,6,6q21,108009851,108084574,74723,-,-
BAC23_F03,6,6q21,108056483,108134538,78055,-,-
BAC21_D04,6,6q21,108079636,108211881,132245,-,-
BAC228_H14,6,6q21,108084645,108186797,102152,-,-
BAC83_B06,6,6q21,108215088,108319830,104742,-,-
BAC68_O16,6,6q21,108216062,108292964,76902,-,-
BAC118_H18,6,6q21,108229844,108348264,118420,-,-
BAC160_O09,6,6q21,108333567,108427834,94267,-,-
BAC56_E04,6,6q21,108376859,108492297,115438,-,-
BAC93_L24,6,6q21,108394495,108484667,90172,-,-
BAC37_O07,6,6q21,108403941,108533005,129064,-,-
BAC82_C01,6,6q21,108433589,108541128,107539,-,-
BAC121_E11,6,6q21,108455791,108600063,144272,-,-
BAC180_J17,6,6q21,108489080,108589397,100317,-,-
BAC89_D08,6,6q21,108533000,108618342,85342,-,-
BAC233_O02,6,6q21,108541296,108628837,87541,-,-
BAC1_M14,6,6q21,108545511,108654895,109384,-,-
BAC246_A19,6,6q21,108569004,108658666,89662,-,-
BAC137_C04,6,6q21,108589391,108720594,131203,-,-
BAC24_K13,6,6q21,108618350,108740605,122255,-,-
BAC73_G12,6,6q21,108648046,108762423,114377,-,-
BAC129_K06,6,6q21,108762610,108840024,77414,-,-
BAC206_K15,6,6q21,108842457,108918590,76133,-,-
BAC181_C09,6,6q21,108872086,108966153,94067,-,-
BAC196_D12,6,6q21,108881453,108978554,97101,-,-
BAC196_C12,6,6q21,108881453,108978554,97101,-,-
BAC18_K20,6,6q21,108881461,109020536,139075,-,-
BAC55_K09,6,6q21,108975657,109036723,61066,-,-
BAC61_M19,6,6q21,109047425,109155632,108207,-,-
BAC61_I01,6,6q21,109052587,109161773,109186,-,-
BAC137_M22,6,6q21,109087663,109184291,96628,-,-
BAC88_M23,6,6q21,109132334,109232910,100576,-,-
BAC178_B01,6,6q21,109184283,109283965,99682,-,-
BAC36_H21,6,6q21,109184284,109302112,117828,-,-
BAC185_I05,6,6q21,109276092,109368024,91932,-,-
BAC197_J15,6,6q21,109351238,109448060,96822,-,-
BAC148_L23,6,6q21,109366121,109448074,81953,-,-
BAC122_L10,6,6q21,109368575,109479466,110891,-,-
BAC126_A06,6,6q21,109369007,109479466,110459,-,-
BAC44_G17,6,6q21,109442841,109523077,80236,-,-
BAC200_A18,6,6q21,109442841,109512166,69325,-,-
BAC103_H12,6,6q21,109446620,109543739,97119,-,-
BAC38_A09,6,6q21,109452236,109539794,87558,-,-
BAC181_C11,6,6q21,109523078,109605826,82748,-,-
BAC169_K07,6,6q21,109552666,109632132,79466,-,-
BAC46_H02,6,6q21,109605817,109723478,117661,-,-
BAC34_G13,6,6q21,109605822,109709833,104011,-,-
BAC24_F12,6,6q21,109605888,109713739,107851,-,-
BAC120_B07,6,6q21,109628769,109723510,94741,-,-
BAC247_H21,6,6q21,109632139,109724074,91935,-,-
BAC162_K21,6,6q21,109729816,109812150,82334,-,-
BAC242_D22,6,6q21,109788947,109891415,102468,-,-
BAC115_E06,6,6q21,109831677,109933411,101734,-,-
BAC109_J02,6,6q21,109831680,109933411,101731,-,-
BAC33_M06,6,6q21,109935263,110044976,109713,-,-
BAC229_I10,6,6q21,109962502,110030659,68157,-,-
BAC142_H02,6,6q21,110223032,110316086,93054,-,-
BAC58_J14,6,6q21,110233899,110345273,111374,-,-
BAC108_M08,6,6q21,110245480,110364921,119441,-,-
BAC32_C23,6,6q21,110274714,110364915,90201,-,-
BAC167_I20,6,6q21,110316078,110473197,157119,-,-
BAC76_H07,6,6q21,110348810,110433546,84736,-,-
BAC163_O15,6,6q21,110364919,110457406,92487,-,-
BAC230_A24,6,6q21,110365216,110443018,77802,-,-
BAC179_B24,6,6q21,110386305,110473189,86884,-,-
BAC154_O22,6,6q21,110391103,110472323,81220,-,-
BAC132_J15,6,6q21,110616572,110694918,78346,-,-
BAC250_D13,6,6q21,110631078,110722368,91290,-,-
BAC162_P18,6,6q21,110637525,110737758,100233,-,-
BAC26_A21,6,6q21,110695048,110798062,103014,-,-
BAC73_O11,6,6q21,110731359,110830002,98643,-,-
BAC69_P19,6,6q21,110731361,110830002,98641,-,-
BAC197_G14,6,6q21,110782058,110868904,86846,-,-
BAC46_C11,6,6q21,110828610,110844313,15703,-,-
BAC234_K09,6,6q21,110868900,110959204,90304,-,-
BAC72_M10,6,6q21,110898733,111014325,115592,-,-
BAC10_P19,6,6q21,110959548,111050580,91032,-,-
BAC160_I03,6,6q21,110984230,111098197,113967,-,-
BAC41_N01,6,6q21,110986446,111121970,135524,-,-
BAC146_I04,6,6q21,111033995,111115807,81812,-,-
BAC29_P05,6,6q21,111136865,111205745,68880,-,-
BAC103_L03,6,6q21,111205738,111293634,87896,-,-
BAC12_D05,6,6q21,111205738,111413131,207393,-,-
BAC108_L21,6,6q21,111205777,111303961,98184,-,-
BAC113_N11,6,6q21,111316866,111416758,99892,-,-
BAC71_D18,6,6q21,111329920,111438547,108627,-,-
BAC46_M02,6,6q21,111329948,111458245,128297,-,-
BAC57_K21,6,6q21,111413145,111536760,123615,-,-
BAC76_B17,6,6q21,111438541,111582356,143815,-,-
BAC197_L01,6,6q21,111602846,111687798,84952,-,-
BAC133_G04,6,6q21,111615534,111725009,109475,-,-
BAC115_E09,6,6q21,111659458,111758456,98998,-,-
BAC6_J03,6,6q21,111660272,111768308,108036,-,-
BAC158_P13,6,6q21,111768333,111854445,86112,-,-
BAC239_M20,6,6q21,111852410,111937083,84673,-,-
BAC220_G12,6,6q21,111858138,111945210,87072,-,-
BAC175_F15,6,6q21,111884199,111915352,31153,-,-
BAC145_P21,6,6q21,111948867,112028337,79470,-,-
BAC104_H06,6,6q21,112048253,112177401,129148,-,-
BAC65_D20,6,6q21,112057321,112172137,114816,-,-
BAC137_K16,6,6q21,112086658,112218586,131928,-,-
BAC189_O22,6,6q21,112175188,112290723,115535,-,-
BAC220_D13,6,6q21,112177400,112283129,105729,-,-
BAC121_F19,6,6q21,112179874,112291729,111855,-,-
BAC73_K14,6,6q21,112207484,112328481,120997,-,-
BAC57_B09,6,6q21,112242478,112376247,133769,-,-
BAC180_K24,6,6q21,112291723,112426182,134459,-,-
BAC39_N21,6,6q21,112291737,112376247,84510,-,-
BAC62_L22,6,6q21,112328476,112421800,93324,-,-
BAC67_C23,6,6q21,112328509,112419978,91469,-,-
BAC151_G07,6,6q21,112376236,112476662,100426,-,-
BAC131_P24,6,6q21,112381950,112494738,112788,-,-
BAC239_O14,6,6q21,112381952,112480164,98212,-,-
BAC232_O15,6,6q21,112456829,112538241,81412,-,-
BAC128_H02,6,6q21,112476866,112601481,124615,-,-
BAC163_P12,6,6q21,112476866,112554004,77138,-,-
BAC239_P04,6,6q21,112494876,112592338,97462,-,-
BAC56_I05,6,6q21,112504701,112601481,96780,-,-
BAC237_D12,6,6q21,112784450,112886021,101571,-,-
BAC39_M24,6,6q21,112966597,113083831,117234,-,-
BAC116_O17,6,6q21,113054836,113156802,101966,-,-
BAC162_N17,6,6q21,113108370,113227162,118792,-,-
BAC56_C19,6,6q21,113266836,113429343,162507,-,-
BAC92_M24,6,6q21,113291165,113405135,113970,-,-
BAC194_K17,6,6q21,113293910,113372238,78328,-,-
BAC119_A09,6,6q21,113472273,113561705,89432,-,-
BAC58_F18,6,6q21,113568071,113662710,94639,-,-
BAC141_I13,6,6q21,113683896,113768711,84815,-,-
BAC107_M10,6,6q21,113746370,113824229,77859,-,-
BAC92_G21,6,6q21-6q22.1,113858972,113944531,85559,-,-
BAC191_L16,6,6q21-6q22.1,113861538,113940385,78847,-,-
BAC246_M02,6,6q22.1,113903666,113985594,81928,-,-
BAC218_O16,6,6q22.1,113937519,114048989,111470,-,-
BAC176_C05,6,6q22.1,114074401,114168250,93849,-,-
BAC243_F08,6,6q22.1,114078740,114167120,88380,-,-
BAC195_I21,6,6q22.1,114101179,114233488,132309,-,-
BAC180_J20,6,6q22.1,114101225,114181375,80150,-,-
BAC145_H21,6,6q22.1,114140214,114234514,94300,-,-
BAC227_A16,6,6q22.1,114149982,114224089,74107,-,-
BAC179_E08,6,6q22.1,114167115,114246663,79548,-,-
BAC56_A16,6,6q22.1,114224093,114332685,108592,-,-
BAC235_L22,6,6q22.1,114250123,114332720,82597,-,-
BAC58_G04,6,6q22.1,114396613,114493581,96968,-,-
BAC155_B20,6,6q22.1,114396613,114481866,85253,-,-
BAC134_M13,6,6q22.1,114401488,114493581,92093,-,-
BAC68_F22,6,6q22.1,114406303,114487196,80893,-,-
BAC84_M06,6,6q22.1,114517938,114666967,149029,-,-
BAC105_J08,6,6q22.1,114534546,114654728,120182,-,-
BAC63_A12,6,6q22.1,114710687,114859654,148967,-,-
BAC63_C03,6,6q22.1,114890036,114997737,107701,-,-
BAC90_F02,6,6q22.1,114900335,115016357,116022,-,-
BAC154_C21,6,6q22.1,114946570,115044725,98155,-,-
BAC208_K16,6,6q22.1,114965553,115045552,79999,-,-
BAC32_L19,6,6q22.1,115010563,115120116,109553,-,-
BAC183_G21,6,6q22.1,115295718,115383773,88055,-,-
BAC34_N04,6,6q22.1,115384094,115467909,83815,-,-
BAC40_E21,6,6q22.1,115463111,115551001,87890,-,-
BAC194_B05,6,6q22.1,115463918,115538395,74477,-,-
BAC78_C06,6,6q22.1,115504683,115613398,108715,-,-
BAC228_L04,6,6q22.1,115526932,115617428,90496,-,-
BAC1_L02,6,6q22.1,115617433,115694529,77096,-,-
BAC177_J16,6,6q22.1,115687524,115809700,122176,-,-
BAC234_P12,6,6q22.1,115689100,115787006,97906,-,-
BAC51_N10,6,6q22.1,115760096,115907677,147581,-,-
BAC86_K18,6,6q22.1,116160975,116280436,119461,-,-
BAC144_B23,6,6q22.1,116172630,116265009,92379,-,-
BAC137_C02,6,6q22.1,116252574,116356632,104058,-,-
BAC152_O07,6,6q22.1,116280490,116362269,81779,-,-
BAC90_B18,6,6q22.1,116311905,116440025,128120,-,-
BAC16_I24,6,6q22.1,116344708,116444959,100251,-,-
BAC196_B22,6,6q22.1,116363541,116444967,81426,-,-
BAC1_H08,6,6q22.1,116494319,116605688,111369,-,-
BAC243_C05,6,6q22.1,116520965,116605688,84723,-,-
BAC32_K03,6,6q22.1,116663962,116794993,131031,-,-
BAC10_J12,6,6q22.1,116677738,116766612,88874,-,-
BAC84_I07,6,6q22.1,116677844,116774269,96425,-,-
BAC34_G08,6,6q22.1,116694619,116794993,100374,-,-
BAC233_J17,6,6q22.1,116744709,116834761,90052,-,-
BAC15_C10,6,6q22.1,116774264,116875963,101699,-,-
BAC88_A09,6,6q22.1-6q22.2,117030157,117113126,82969,-,-
BAC43_L02,6,6q22.1-6q22.2,117049356,117155706,106350,-,-
BAC33_C13,6,6q22.1-6q22.2,117096381,117197080,100699,-,-
BAC32_N05,6,6q22.1-6q22.2,117099449,117197306,97857,-,-
BAC234_D18,6,6q22.2,117113178,117183000,69822,-,-
BAC197_L12,6,6q22.2,117113178,117204980,91802,-,-
BAC243_D19,6,6q22.2,117183540,117290572,107032,-,-
BAC193_H10,6,6q22.2,117197621,117276350,78729,-,-
BAC157_E05,6,6q22.2,117276345,117350117,73772,-,-
BAC200_F02,6,6q22.2,117281244,117404789,123545,-,-
BAC64_J07,6,6q22.2,117298789,117319648,20859,-,-
BAC193_F06,6,6q22.2,117447115,117545147,98032,-,-
BAC170_C19,6,6q22.2,117447160,117527888,80728,-,-
BAC180_K04,6,6q22.2,117451168,117528780,77612,-,-
BAC43_N03,6,6q22.2,117528778,117612268,83490,-,-
BAC252_B18,6,6q22.2,117718200,117807138,88938,-,-
BAC103_P05,6,6q22.2,117848478,117948200,99722,-,-
BAC80_O04,6,6q22.2,117853479,117948893,95414,-,-
BAC37_D23,6,6q22.2,117853479,117953162,99683,-,-
BAC247_P07,6,6q22.2,117917044,118001421,84377,-,-
BAC81_K06,6,6q22.2,117923057,118007763,84706,-,-
BAC100_P23,6,6q22.2,118038796,118158977,120181,-,-
BAC151_P17,6,6q22.2,118220063,118324415,104352,-,-
BAC109_A06,6,6q22.2,118281913,118373617,91704,-,-
BAC148_J12,6,6q22.2,118308353,118419913,111560,-,-
BAC177_N02,6,6q22.2,118316423,118403256,86833,-,-
BAC68_B06,6,6q22.2,118352527,118371668,19141,-,-
BAC1_N23,6,6q22.2,118469623,118588188,118565,-,-
BAC57_K22,6,6q22.2-6q22.31,118529878,118671604,141726,-,-
BAC202_E11,6,6q22.31,118675402,118759708,84306,-,-
BAC118_C22,6,6q22.31,118825078,118913893,88815,-,-
BAC181_K09,6,6q22.31,118869572,118949490,79918,-,-
BAC190_D16,6,6q22.31,118882147,118968552,86405,-,-
BAC177_I19,6,6q22.31,118932483,119013528,81045,-,-
BAC191_B17,6,6q22.31,118939109,119045515,106406,-,-
BAC26_A24,6,6q22.31,118984929,119112149,127220,-,-
BAC69_M19,6,6q22.31,118994592,119194522,199930,-,-
BAC134_C08,6,6q22.31,119013529,119063270,49741,-,-
BAC241_L06,6,6q22.31,119030145,119147748,117603,-,-
BAC165_P04,6,6q22.31,119053798,119173329,119531,-,-
BAC66_I23,6,6q22.31,119064613,119192932,128319,-,-
BAC239_M09,6,6q22.31,119068852,119168049,99197,-,-
BAC156_P05,6,6q22.31,119119925,119195290,75365,-,-
BAC150_I09,6,6q22.31,119276221,119380064,103843,-,-
BAC151_L11,6,6q22.31,119279964,119349998,70034,-,-
BAC142_P24,6,6q22.31,119386863,119461977,75114,-,-
BAC38_M17,6,6q22.31,119437242,119539693,102451,-,-
BAC251_G10,6,6q22.31,119437263,119605077,167814,-,-
BAC107_D07,6,6q22.31,119580166,119707435,127269,-,-
BAC22_E09,6,6q22.31,119635753,119735085,99332,-,-
BAC125_M08,6,6q22.31,119673809,119779751,105942,-,-
BAC67_L24,6,6q22.31,119677163,119758985,81822,-,-
BAC101_H23,6,6q22.31,119714302,119812968,98666,-,-
BAC220_G22,6,6q22.31,119867095,119946392,79297,-,-
BAC165_O22,6,6q22.31,119868183,119955901,87718,-,-
BAC58_C24,6,6q22.31,119947764,120030251,82487,-,-
BAC66_E11,6,6q22.31,120028854,120112302,83448,-,-
BAC166_L10,6,6q22.31,120531883,120606505,74622,-,-
BAC250_K21,6,6q22.31,120827490,120900929,73439,-,-
BAC76_E21,6,6q22.31,121039882,121144194,104312,-,-
BAC139_P11,6,6q22.31,121144187,121226721,82534,-,-
BAC69_D16,6,6q22.31,121233892,121317253,83361,-,-
BAC82_O13,6,6q22.31,121408727,121503692,94965,-,-
BAC124_J19,6,6q22.31,121667602,121817223,149621,-,-
BAC102_M05,6,6q22.31,121667602,121851653,184051,-,-
BAC89_H02,6,6q22.31,121708456,121811357,102901,-,-
BAC228_A01,6,6q22.31,121741067,121851653,110586,-,-
BAC45_M02,6,6q22.31,121745589,121889454,143865,-,-
BAC190_D05,6,6q22.31,121795948,121924001,128053,-,-
BAC37_I23,6,6q22.31,121795948,121900897,104949,-,-
BAC182_P20,6,6q22.31,121795948,121900889,104941,-,-
BAC234_G15,6,6q22.31,121851276,121948110,96834,-,-
BAC244_E02,6,6q22.31,121871800,121956347,84547,-,-
BAC19_B11,6,6q22.31,121901022,122005111,104089,-,-
BAC96_E20,6,6q22.31,121902396,122034066,131670,-,-
BAC48_F18,6,6q22.31,121924200,122038472,114272,-,-
BAC190_P11,6,6q22.31,121933427,122038346,104919,-,-
BAC161_E11,6,6q22.31,121975553,121985643,10090,-,-
BAC150_D07,6,6q22.31,121986491,122067127,80636,-,-
BAC181_C16,6,6q22.31,122001461,122069569,68108,-,-
BAC197_P13,6,6q22.31,122086384,122163892,77508,-,-
BAC80_J22,6,6q22.31,122158336,122242767,84431,-,-
BAC61_I09,6,6q22.31,122158339,122297467,139128,-,-
BAC50_A15,6,6q22.31,122163990,122297467,133477,-,-
BAC115_A07,6,6q22.31,122264506,122376073,111567,-,-
BAC75_M13,6,6q22.31,122297464,122381351,83887,-,-
BAC240_D18,6,6q22.31,122304027,122376119,72092,-,-
BAC83_D20,6,6q22.31,122330276,122446251,115975,-,-
BAC183_H10,6,6q22.31,122375783,122473722,97939,-,-
BAC54_C01,6,6q22.31,122375812,122503408,127596,-,-
BAC76_D16,6,6q22.31,122473717,122586406,112689,-,-
BAC126_I07,6,6q22.31,122484744,122589653,104909,-,-
BAC26_J19,6,6q22.31,122812099,122898733,86634,-,-
BAC70_C08,6,6q22.31,123365552,123450591,85039,-,-
BAC192_L14,6,6q22.31,123387816,123462759,74943,-,-
BAC92_C04,6,6q22.31,123535557,123636403,100846,-,-
BAC22_L16,6,6q22.31,123682351,123794742,112391,-,-
BAC202_M12,6,6q22.31,123827783,123917779,89996,-,-
BAC143_L05,6,6q22.31,123955756,124040537,84781,-,-
BAC175_G11,6,6q22.31,123958850,124040536,81686,-,-
BAC226_P22,6,6q22.31,123986164,124069944,83780,-,-
BAC249_B09,6,6q22.31,124186435,124269469,83034,-,-
BAC134_O16,6,6q22.31,124365697,124442784,77087,-,-
BAC40_P01,6,6q22.31,124596659,124732284,135625,-,-
BAC178_J16,6,6q22.31,124608486,124696504,88018,-,-
BAC59_G05,6,6q22.31,124670447,124750139,79692,-,-
BAC242_C16,6,6q22.31,124672074,124746617,74543,-,-
BAC237_O04,6,6q22.31,124691390,124795303,103913,-,-
BAC106_I05,6,6q22.31,124691391,124772413,81022,-,-
BAC100_F07,6,6q22.31,124793750,124888765,95015,-,-
BAC233_O19,6,6q22.31,124825534,124919872,94338,-,-
BAC115_D19,6,6q22.31,124874664,124990277,115613,-,-
BAC100_B06,6,6q22.31,124927861,125031674,103813,-,-
BAC32_A04,6,6q22.31,124968249,125073939,105690,-,-
BAC50_D22,6,6q22.31,125148706,125254564,105858,-,-
BAC229_K09,6,6q22.31,125167325,125258253,90928,-,-
BAC192_P05,6,6q22.31,125215035,125316168,101133,-,-
BAC188_H08,6,6q22.31,125328043,125441575,113532,-,-
BAC81_H07,6,6q22.31,125379175,125476897,97722,-,-
BAC46_A21,6,6q22.31,125437966,125538878,100912,-,-
BAC162_O09,6,6q22.31,125674761,125760293,85532,-,-
BAC127_F06,6,6q22.31,125733245,125849938,116693,-,-
BAC243_C22,6,6q22.31,125850250,125965851,115601,-,-
BAC147_L21,6,6q22.31,125964279,126046769,82490,-,-
BAC194_G02,6,6q22.31,126092970,126187383,94413,-,-
BAC63_O07,6,6q22.31-6q22.32,126092970,126200912,107942,-,-
BAC191_H17,6,6q22.31-6q22.32,126183171,126277788,94617,-,-
BAC247_A06,6,6q22.32,126232544,126336763,104219,-,-
BAC193_P20,6,6q22.32,126277807,126369123,91316,-,-
BAC179_P12,6,6q22.32,126279345,126366012,86667,-,-
BAC222_F04,6,6q22.32,126373525,126459809,86284,-,-
BAC38_B04,6,6q22.32,126463339,126548449,85110,-,-
BAC140_N01,6,6q22.32,126521549,126600355,78806,-,-
BAC67_D06,6,6q22.32,126525342,126662400,137058,-,-
BAC247_K22,6,6q22.32,126600565,126707216,106651,-,-
BAC219_B05,6,6q22.32,126646696,126736014,89318,-,-
BAC135_F10,6,6q22.32,126669702,126736014,66312,-,-
BAC161_F12,6,6q22.32,126879152,126984305,105153,-,-
BAC142_P05,6,6q22.32,127178391,127260198,81807,-,-
BAC172_O20,6,6q22.32-6q22.33,127254394,127330866,76472,-,-
BAC82_M20,6,6q22.33,127593253,127679724,86471,-,-
BAC38_O05,6,6q22.33,127654502,127766755,112253,-,-
BAC146_F21,6,6q22.33,127729996,127807726,77730,-,-
BAC122_B24,6,6q22.33,127737295,127850530,113235,-,-
BAC108_B02,6,6q22.33,127808050,127898037,89987,-,-
BAC53_E02,6,6q22.33,127903173,128002334,99161,-,-
BAC190_C06,6,6q22.33,128143959,128200921,56962,-,-
BAC247_D17,6,6q22.33,128420486,128521502,101016,-,-
BAC192_N01,6,6q22.33,128459474,128551697,92223,-,-
BAC159_D05,6,6q22.33,128595510,128701920,106410,-,-
BAC83_I14,6,6q22.33,128607628,128710021,102393,-,-
BAC120_K19,6,6q22.33,128654560,128748671,94111,-,-
BAC110_J18,6,6q22.33,128671678,128753308,81630,-,-
BAC92_A08,6,6q22.33,128678075,128766944,88869,-,-
BAC83_D24,6,6q22.33,128748665,128852803,104138,-,-
BAC249_C22,6,6q22.33,128766940,128857779,90839,-,-
BAC69_F04,6,6q22.33,128770029,128852803,82774,-,-
BAC3_H06,6,6q22.33,128770224,128866680,96456,-,-
BAC26_J05,6,6q22.33,128777875,128882774,104899,-,-
BAC72_L10,6,6q22.33,128808390,128886551,78161,-,-
BAC177_H22,6,6q22.33,129013188,129135356,122168,-,-
BAC177_J04,6,6q22.33,129013188,129135670,122482,-,-
BAC88_B22,6,6q22.33,129022377,129129176,106799,-,-
BAC184_O02,6,6q22.33,129029351,129114053,84702,-,-
BAC38_N13,6,6q22.33,129046493,129193593,147100,-,-
BAC57_E11,6,6q22.33,129082427,129178476,96049,-,-
BAC30_B23,6,6q22.33,129287805,129425073,137268,-,-
BAC57_I04,6,6q22.33,129339307,129436491,97184,-,-
BAC36_K20,6,6q22.33,129377296,129487047,109751,-,-
BAC139_I21,6,6q22.33,129526503,129615672,89169,-,-
BAC62_B02,6,6q22.33,129669974,129763245,93271,-,-
BAC23_A17,6,6q22.33,129693068,129872186,179118,-,-
BAC147_F09,6,6q22.33,129750611,129856812,106201,-,-
BAC119_M07,6,6q22.33,129768726,129874563,105837,-,-
BAC247_H13,6,6q22.33,129800070,129887315,87245,-,-
BAC56_P05,6,6q22.33,129852196,129960638,108442,-,-
BAC73_F17,6,6q22.33,129993163,130120268,127105,-,-
BAC126_F15,6,6q22.33,130031250,130124787,93537,-,-
BAC25_E01,6,6q22.33,130130782,130215176,84394,-,-
BAC123_B14,6,6q22.33,130196504,130231929,35425,-,-
BAC1_F23,6,6q22.33,130207440,130315766,108326,-,-
BAC139_L06,6,6q22.33,130302354,130380983,78629,-,-
BAC240_A16,6,6q22.33-6q23.1,130343760,130414618,70858,-,-
BAC128_P10,6,6q22.33-6q23.1,130361428,130473744,112316,-,-
BAC30_E20,6,6q22.33-6q23.1,130366311,130463797,97486,-,-
BAC197_K24,6,6q22.33-6q23.1,130366311,130474043,107732,-,-
BAC77_B24,6,6q23.1,130410533,130547249,136716,-,-
BAC108_N14,6,6q23.1,130463937,130559552,95615,-,-
BAC185_A18,6,6q23.1,130463937,130547259,83322,-,-
BAC25_G01,6,6q23.1,130550507,130561494,10987,-,-
BAC51_O17,6,6q23.1,130663381,130763354,99973,-,-
BAC39_L02,6,6q23.1,130745390,130840245,94855,-,-
BAC244_E05,6,6q23.1,130768841,130855252,86411,-,-
BAC12_G05,6,6q23.1,130909033,131009160,100127,-,-
BAC83_D19,6,6q23.1,130926268,131063238,136970,-,-
BAC101_J04,6,6q23.1,130995653,131075521,79868,-,-
BAC162_F23,6,6q23.1,131053327,131158709,105382,-,-
BAC61_I18,6,6q23.1,131069460,131170092,100632,-,-
BAC234_O16,6,6q23.1,131105042,131243554,138512,-,-
BAC235_A22,6,6q23.1-6q23.2,131233670,131330532,96862,-,-
BAC18_D11,6,6q23.2,131341013,131424481,83468,-,-
BAC137_L15,6,6q23.2,131400045,131482638,82593,-,-
BAC122_F11,6,6q23.2,131507914,131589224,81310,-,-
BAC92_H10,6,6q23.2,131552791,131645273,92482,-,-
BAC91_I20,6,6q23.2,131552791,131643825,91034,-,-
BAC91_G05,6,6q23.2,131583862,131667551,83689,-,-
BAC190_H04,6,6q23.2,131672189,131757856,85667,-,-
BAC241_A01,6,6q23.2,131893823,131976733,82910,-,-
BAC52_A05,6,6q23.2,131894627,131989912,95285,-,-
BAC95_C04,6,6q23.2,131988006,132086350,98344,-,-
BAC76_L02,6,6q23.2,132094140,132169354,75214,-,-
BAC182_P12,6,6q23.2,132094179,132169336,75157,-,-
BAC162_O13,6,6q23.2,132096321,132180192,83871,-,-
BAC147_C18,6,6q23.2,132116413,132224278,107865,-,-
BAC90_D16,6,6q23.2,132142695,132246556,103861,-,-
BAC10_L14,6,6q23.2,132142695,132259906,117211,yes,-
BAC116_F03,6,6q23.2,132194300,132299311,105011,-,-
BAC219_A02,6,6q23.2,132361483,132442348,80865,-,-
BAC169_J12,6,6q23.2,132459269,132527296,68027,-,-
BAC251_P18,6,6q23.2,132479882,132589182,109300,-,-
BAC101_L18,6,6q23.2,132680798,132791380,110582,-,-
BAC249_M14,6,6q23.2,132680798,132793105,112307,-,-
BAC51_N06,6,6q23.2,132909221,133011539,102318,-,-
BAC76_I08,6,6q23.2,133030369,133164553,134184,-,-
BAC31_M16,6,6q23.2,133051581,133166067,114486,-,-
BAC124_P05,6,6q23.2,133058991,133142925,83934,-,-
BAC168_H11,6,6q23.2,133066617,133156706,90089,-,-
BAC215_P01,6,6q23.2,133066617,133150992,84375,-,-
BAC186_I15,6,6q23.2,133105424,133187415,81991,-,-
BAC252_M04,6,6q23.2,133160061,133256776,96715,-,-
BAC184_G22,6,6q23.2,133257924,133364808,106884,-,-
BAC26_E11,6,6q23.2,133258394,133337186,78792,-,-
BAC29_A06,6,6q23.2,133297269,133426680,129411,-,-
BAC168_M08,6,6q23.2,133348715,133438152,89437,-,-
BAC156_H23,6,6q23.2,133350399,133453125,102726,-,-
BAC84_G15,6,6q23.2,133451908,133538416,86508,-,-
BAC129_J17,6,6q23.2,133565861,133655672,89811,-,-
BAC44_N17,6,6q23.2,133777225,133894884,117659,-,-
BAC92_E08,6,6q23.2,133856443,133964728,108285,-,-
BAC63_D10,6,6q23.2,133892490,133985521,93031,-,-
BAC2_E04,6,6q23.2,133985633,134082975,97342,-,-
BAC43_H07,6,6q23.2,133995648,134124661,129013,-,-
BAC239_K16,6,6q23.2,134018509,134110513,92004,-,-
BAC80_C24,6,6q23.2,134094780,134187508,92728,-,-
BAC90_H10,6,6q23.2,134139947,134217328,77381,-,-
BAC21_I06,6,6q23.2,134208836,134317653,108817,-,-
BAC162_F16,6,6q23.2,134328580,134444422,115842,-,-
BAC53_E12,6,6q23.2,134345524,134439035,93511,-,-
BAC161_F15,6,6q23.2,134444417,134532947,88530,-,-
BAC130_A06,6,6q23.2,134444616,134527379,82763,-,-
BAC143_K09,6,6q23.2,134446549,134558617,112068,-,-
BAC41_L04,6,6q23.2,134473566,134560348,86782,-,-
BAC50_G22,6,6q23.2,134516354,134604819,88465,-,-
BAC31_P09,6,6q23.2,134558683,134662022,103339,-,-
BAC116_J11,6,6q23.2,134592754,134715396,122642,-,-
BAC170_B12,6,6q23.2,134612498,134689494,76996,-,-
BAC53_F13,6,6q23.2,134643957,134741298,97341,-,-
BAC161_H10,6,6q23.2,134669758,134758894,89136,-,-
BAC24_P05,6,6q23.2,134738074,134850772,112698,-,-
BAC250_O02,6,6q23.2,134798568,134887646,89078,-,-
BAC43_L11,6,6q23.2,134798577,134894812,96235,-,-
BAC252_H17,6,6q23.2,134920961,135028816,107855,-,-
BAC11_I13,6,6q23.2,134946541,135075049,128508,-,-
BAC36_J20,6,6q23.2,135075114,135188412,113298,-,-
BAC101_H03,6,6q23.2-6q23.3,135096854,135222972,126118,-,-
BAC184_N13,6,6q23.2,135096890,135186453,89563,-,-
BAC17_G12,6,6q23.2-6q23.3,135163580,135249446,85866,-,-
BAC83_M15,6,6q23.2-6q23.3,135183608,135298318,114710,-,-
BAC230_L17,6,6q23.2-6q23.3,135184187,135279554,95367,-,-
BAC167_K17,6,6q23.2-6q23.3,135188676,135271876,83200,-,-
BAC182_L14,6,6q23.2-6q23.3,135198078,135283121,85043,-,-
BAC169_F04,6,6q23.3,135210561,135299847,89286,-,-
BAC96_A17,6,6q23.3,135223037,135298318,75281,-,-
BAC50_M15,6,6q23.3,135371203,135474744,103541,-,-
BAC236_D20,6,6q23.3,135435133,135523250,88117,-,-
BAC236_B24,6,6q23.3,135525237,135601853,76616,-,-
BAC44_E08,6,6q23.3,135525241,135627617,102376,-,-
BAC169_M15,6,6q23.3,135643170,135731217,88047,-,-
BAC181_O02,6,6q23.3,136074588,136167822,93234,-,-
BAC194_E14,6,6q23.3,136077710,136181785,104075,-,-
BAC243_G01,6,6q23.3,136163433,136259798,96365,-,-
BAC221_F19,6,6q23.3,136192609,136299254,106645,-,-
BAC236_M07,6,6q23.3,136194454,136273048,78594,-,-
BAC233_F07,6,6q23.3,136299248,136379875,80627,-,-
BAC223_M23,6,6q23.3,136321713,136418678,96965,-,-
BAC68_H21,6,6q23.3,136349657,136475903,126246,-,-
BAC43_P21,6,6q23.3,136351719,136466819,115100,-,-
BAC191_D20,6,6q23.3,136422757,136504171,81414,-,-
BAC21_O17,6,6q23.3,136508527,136585617,77090,-,-
BAC67_H23,6,6q23.3,136606935,136692713,85778,-,-
BAC187_I11,6,6q23.3,136647598,136726706,79108,-,-
BAC179_D02,6,6q23.3,136732667,136824343,91676,-,-
BAC132_I22,6,6q23.3,136741643,136831457,89814,-,-
BAC49_H04,6,6q23.3,136784071,136922503,138432,-,-
BAC190_L20,6,6q23.3,136801098,136898529,97431,-,-
BAC222_K08,6,6q23.3,136837226,136936746,99520,-,-
BAC23_C15,6,6q23.3,136929628,137040509,110881,-,-
BAC86_F14,6,6q23.3,136932324,137092403,160079,-,-
BAC83_A08,6,6q23.3,137001529,137094153,92624,-,-
BAC70_A11,6,6q23.3,137011091,137097598,86507,-,-
BAC113_O10,6,6q23.3,137126386,137242955,116569,-,-
BAC234_P11,6,6q23.3,137183526,137265448,81922,-,-
BAC54_N16,6,6q23.3,137279826,137386466,106640,-,-
BAC63_J15,6,6q23.3,137307242,137391443,84201,-,-
BAC129_L16,6,6q23.3,137445568,137555135,109567,-,-
BAC46_A19,6,6q23.3,137555179,137661706,106527,-,-
BAC119_B22,6,6q23.3,137586131,137691836,105705,-,-
BAC193_M11,6,6q23.3,137644108,137733916,89808,-,-
BAC176_M13,6,6q23.3,137660421,137742847,82426,-,-
BAC135_A15,6,6q23.3,137660533,137763375,102842,-,-
BAC46_P22,6,6q23.3,137663740,137813978,150238,-,-
BAC83_I08,6,6q23.3,137667015,137804288,137273,-,-
BAC237_L09,6,6q23.3,137685028,137816357,131329,-,-
BAC136_C06,6,6q23.3,137691852,137783046,91194,-,-
BAC52_N12,6,6q23.3,137931184,138038823,107639,-,-
BAC190_N17,6,6q23.3,137953170,138038870,85700,-,-
BAC21_F02,6,6q23.3,137979932,138123576,143644,-,-
BAC10_C08,6,6q23.3,138015164,138112178,97014,-,-
BAC246_M18,6,6q23.3,138038865,138122687,83822,-,-
BAC143_C22,6,6q23.3,138108982,138191633,82651,-,-
BAC68_C07,6,6q23.3,138123054,138228552,105498,-,-
BAC140_F13,6,6q23.3,138228544,138312567,84023,-,-
BAC43_J16,6,6q23.3,138244356,138351756,107400,-,-
BAC168_I11,6,6q23.3,138264270,138351686,87416,-,-
BAC135_D19,6,6q23.3,138310545,138404086,93541,-,-
BAC179_F11,6,6q23.3,138486629,138585202,98573,-,-
BAC101_M04,6,6q23.3,138540130,138646539,106409,-,-
BAC248_B11,6,6q23.3,138571767,138647300,75533,-,-
BAC168_P03,6,6q23.3,138585200,138694399,109199,-,-
BAC72_N16,6,6q23.3,138585200,138676828,91628,-,-
BAC148_K14,6,6q23.3,138585220,138694399,109179,-,-
BAC217_J04,6,6q23.3,138601722,138707324,105602,-,-
BAC90_O21,6,6q23.3,138675109,138780130,105021,-,-
BAC59_L22,6,6q23.3,138694412,138780132,85720,-,-
BAC38_H10,6,6q23.3,138708435,138792739,84304,-,-
BAC194_M02,6,6q23.3,138708979,138786645,77666,-,-
BAC175_O07,6,6q23.3,138746003,138855199,109196,-,-
BAC153_E16,6,6q23.3,139011198,139091356,80158,-,-
BAC162_H10,6,6q23.3,139017789,139085989,68200,-,-
BAC64_J19,6,6q23.3-6q24.1,139041904,139145334,103430,-,-
BAC25_I06,6,6q23.3-6q24.1,139091642,139209535,117893,-,-
BAC50_K24,6,6q24.1,139112816,139204489,91673,-,-
BAC193_A07,6,6q24.1,139114370,139184168,69798,-,-
BAC120_G16,6,6q24.1,139158866,139250432,91566,-,-
BAC81_J18,6,6q24.1,139163417,139266419,103002,-,-
BAC86_C02,6,6q24.1,139164088,139250432,86344,-,-
BAC105_G08,6,6q24.1,139170012,139257673,87661,-,-
BAC54_M10,6,6q24.1,139170012,139312836,142824,-,-
BAC197_I12,6,6q24.1,139171575,139257673,86098,-,-
BAC125_H04,6,6q24.1,139175178,139268973,93795,-,-
BAC26_P04,6,6q24.1,139185009,139266655,81646,-,-
BAC227_O15,6,6q24.1,139193115,139265768,72653,-,-
BAC55_D01,6,6q24.1,139196923,139336397,139474,-,-
BAC59_C13,6,6q24.1,139209590,139302660,93070,-,-
BAC116_I16,6,6q24.1,139266668,139352087,85419,-,-
BAC109_P14,6,6q24.1,139286305,139373823,87518,-,-
BAC25_G09,6,6q24.1,139336393,139505911,169518,-,-
BAC156_L22,6,6q24.1,139451510,139539906,88396,-,-
BAC178_N08,6,6q24.1,139472279,139555792,83513,-,-
BAC31_N11,6,6q24.1,139502652,139619848,117196,-,-
BAC34_E14,6,6q24.1,139509927,139594991,85064,-,-
BAC36_G08,6,6q24.1,139532926,139619852,86926,-,-
BAC232_K10,6,6q24.1,139542547,139656309,113762,yes,-
BAC104_N05,6,6q24.1,139567691,139665439,97748,yes,-
BAC127_M20,6,6q24.1,139633885,139732954,99069,-,-
BAC170_H13,6,6q24.1,139681791,139792210,110419,-,-
BAC10_K21,6,6q24.1,139746723,139836206,89483,-,-
BAC34_J17,6,6q24.1,139790350,139951374,161024,-,-
BAC146_A18,6,6q24.1,139843550,139923224,79674,-,-
BAC39_N24,6,6q24.1,139983754,140070011,86257,-,-
BAC114_K12,6,6q24.1,139984012,140088724,104712,-,-
BAC144_A23,6,6q24.1,140117219,140220070,102851,-,-
BAC61_M15,6,6q24.1,140167363,140258306,90943,-,-
BAC139_F01,6,6q24.1,140193276,140274871,81595,-,-
BAC195_B15,6,6q24.1,140286419,140392929,106510,-,-
BAC100_A03,6,6q24.1,140315326,140426016,110690,-,-
BAC30_B19,6,6q24.1,140513996,140539102,25106,-,-
BAC179_K21,6,6q24.1,140582779,140678306,95527,-,-
BAC224_C17,6,6q24.1,140618837,140702831,83994,-,-
BAC34_M23,6,6q24.1,140619702,140701363,81661,-,-
BAC82_D08,6,6q24.1,141036645,141119575,82930,-,-
BAC83_P02,6,6q24.1,141324805,141432794,107989,-,-
BAC80_P07,6,6q24.1,141645531,141757266,111735,-,-
BAC113_P13,6,6q24.1,141749454,141856326,106872,-,-
BAC130_B02,6,6q24.1,141811428,141913403,101975,-,-
BAC92_H03,6,6q24.1,141814706,141967632,152926,-,-
BAC102_C01,6,6q24.1,141915315,142001686,86371,-,-
BAC108_P10,6,6q24.1,141955420,142035795,80375,-,-
BAC107_K09,6,6q24.1,142128557,142213314,84757,-,-
BAC37_G06,6,6q24.1,142253627,142476373,222746,-,-
BAC114_G11,6,6q24.1,142278364,142386169,107805,-,-
BAC73_E03,6,6q24.1,142300838,142399044,98206,-,-
BAC105_A10,6,6q24.1,142505513,142596105,90592,-,-
BAC102_M23,6,6q24.1,142584307,142703619,119312,-,-
BAC83_P24,6,6q24.1,142626473,142714371,87898,-,-
BAC51_D17,6,6q24.1-6q24.2,142788370,142901505,113135,-,-
BAC228_K22,6,6q24.1-6q24.2,142811833,142901505,89672,-,-
BAC127_A08,6,6q24.1-6q24.2,142845551,142985306,139755,-,-
BAC225_I18,6,6q24.2,142901509,142983749,82240,-,-
BAC65_M09,6,6q24.2,142912329,142992958,80629,-,-
BAC244_N24,6,6q24.2,142947848,143044304,96456,-,-
BAC217_J05,6,6q24.2,143137649,143220033,82384,-,-
BAC75_G06,6,6q24.2,143150532,143267758,117226,-,-
BAC224_P11,6,6q24.2,143375301,143455589,80288,-,-
BAC160_I11,6,6q24.2,143488624,143589718,101094,-,-
BAC43_O22,6,6q24.2,143523438,143619824,96386,-,-
BAC165_D18,6,6q24.2,143820604,143966926,146322,-,-
BAC132_P07,6,6q24.2,143917552,143988937,71385,-,-
BAC119_E23,6,6q24.2,143927150,144004661,77511,-,-
BAC8_M02,6,6q24.2,143931589,144042110,110521,-,-
BAC50_M23,6,6q24.2,143938965,144027323,88358,-,-
BAC185_G12,6,6q24.2,143938989,144041438,102449,-,-
BAC81_M12,6,6q24.2,144002518,144107999,105481,-,-
BAC21_E18,6,6q24.2,144026744,144158717,131973,-,-
BAC158_O16,6,6q24.2,144070746,144153018,82272,-,-
BAC116_P13,6,6q24.2,144152596,144271501,118905,-,-
BAC42_J13,6,6q24.2,144155762,144265050,109288,-,-
BAC51_A08,6,6q24.2,144192041,144302914,110873,-,-
BAC64_N13,6,6q24.2,144219634,144321412,101778,-,-
BAC24_F23,6,6q24.2,144229868,144302914,73046,-,-
BAC148_A08,6,6q24.2,144296744,144427698,130954,-,-
BAC28_F24,6,6q24.2,144306929,144408281,101352,-,-
BAC97_N18,6,6q24.2,144328822,144412369,83547,-,-
BAC180_A20,6,6q24.2,144328826,144412369,83543,-,-
BAC76_H19,6,6q24.2,144375612,144484150,108538,-,-
BAC184_L11,6,6q24.2,144427855,144518210,90355,-,-
BAC129_J16,6,6q24.2,144556776,144642923,86147,-,-
BAC86_N07,6,6q24.2,144569778,144741134,171356,-,-
BAC19_K17,6,6q24.2,144658331,144741093,82762,-,-
BAC30_D17,6,6q24.2,144691429,144783432,92003,-,-
BAC125_C21,6,6q24.2,144741129,144821826,80697,-,-
BAC41_K10,6,6q24.2,144745114,144855957,110843,-,-
BAC227_F17,6,6q24.2,144839335,144913875,74540,-,-
BAC156_E23,6,6q24.2,144857337,144963114,105777,-,-
BAC80_O13,6,6q24.2,144882679,145023662,140983,-,-
BAC25_G13,6,6q24.2,144882880,144986121,103241,-,-
BAC130_C08,6,6q24.2,144892742,144988755,96013,-,-
BAC135_M20,6,6q24.2,144988773,145066115,77342,-,-
BAC43_D06,6,6q24.2,145066137,145225209,159072,-,-
BAC90_F08,6,6q24.2,145084822,145186048,101226,-,-
BAC143_B20,6,6q24.2,145283643,145360550,76907,-,-
BAC184_P11,6,6q24.2,145306609,145394525,87916,-,-
BAC75_M09,6,6q24.2,145306609,145419927,113318,-,-
BAC192_G04,6,6q24.2,145360550,145449809,89259,-,-
BAC152_B22,6,6q24.2,145437385,145524296,86911,-,-
BAC39_G12,6,6q24.2,145450713,145568346,117633,-,-
BAC63_E18,6,6q24.2,145492008,145585954,93946,-,-
BAC150_E20,6,6q24.2-6q24.3,145650865,145757319,106454,-,-
BAC24_C19,6,6q24.2,145671831,145686516,14685,-,-
BAC202_N16,6,6q24.3,145813800,145893753,79953,-,-
BAC64_H02,6,6q24.3,145893754,145995736,101982,-,-
BAC29_A22,6,6q24.3,145901417,146004296,102879,-,-
BAC105_K19,6,6q24.3,145907048,146013714,106666,-,-
BAC116_F07,6,6q24.3,145907753,146008778,101025,-,-
BAC107_C18,6,6q24.3,145964677,146064222,99545,-,-
BAC60_G08,6,6q24.3,145968618,146061202,92584,-,-
BAC136_M08,6,6q24.3,146028632,146148809,120177,-,-
BAC135_J07,6,6q24.3,146066587,146164123,97536,-,-
BAC131_L01,6,6q24.3,146076042,146161526,85484,-,-
BAC110_M10,6,6q24.3,146105575,146206079,100504,-,-
BAC157_D18,6,6q24.3,146172423,146274489,102066,-,-
BAC157_C18,6,6q24.3,146172423,146274489,102066,-,-
BAC103_C11,6,6q24.3,146172457,146277862,105405,-,-
BAC139_C22,6,6q24.3,146210792,146273188,62396,-,-
BAC37_N04,6,6q24.3,146260761,146383881,123120,-,-
BAC115_H10,6,6q24.3,146305730,146444312,138582,-,-
BAC33_O13,6,6q24.3,146553996,146710331,156335,-,-
BAC170_H23,6,6q24.3,146587392,146704583,117191,-,-
BAC237_C11,6,6q24.3,146640763,146749810,109047,-,-
BAC31_G02,6,6q24.3,146642545,146874117,231572,-,-
BAC63_G05,6,6q24.3,146673571,146762549,88978,-,-
BAC66_P15,6,6q24.3,146683162,146813516,130354,-,-
BAC183_B12,6,6q24.3,146889210,146983305,94095,-,-
BAC210_H05,6,6q24.3,146921586,147022247,100661,-,-
BAC175_D21,6,6q24.3,147077998,147175174,97176,-,-
BAC81_O08,6,6q24.3,147108401,147243201,134800,-,-
BAC10_E10,6,6q24.3,147125592,147212524,86932,-,-
BAC115_D07,6,6q24.3,147132466,147214021,81555,-,-
BAC76_M20,6,6q24.3,147210490,147319961,109471,-,-
BAC90_I03,6,6q24.3,147331375,147441027,109652,-,-
BAC82_N18,6,6q24.3,147446828,147552721,105893,-,-
BAC200_N16,6,6q24.3,147479494,147561045,81551,-,-
BAC231_N13,6,6q24.3,147487054,147585620,98566,-,-
BAC71_L10,6,6q24.3,147634988,147715971,80983,-,-
BAC91_N14,6,6q24.3,147641621,147765918,124297,-,-
BAC202_I12,6,6q24.3,147645918,147759015,113097,-,-
BAC14_M20,6,6q24.3,147772930,147910091,137161,-,-
BAC210_B06,6,6q24.3,147841630,147932506,90876,-,-
BAC168_F13,6,6q24.3,147860312,147958116,97804,-,-
BAC191_N23,6,6q24.3,147924563,148012092,87529,-,-
BAC122_P02,6,6q24.3,147940857,148022870,82013,-,-
BAC36_O01,6,6q24.3,147940857,148095315,154458,-,-
BAC63_E21,6,6q24.3,147940874,148029741,88867,-,-
BAC182_A12,6,6q24.3,147988897,148078279,89382,-,-
BAC120_H07,6,6q24.3,148438905,148622700,183795,-,-
BAC132_O22,6,6q24.3,148450387,148564237,113850,-,-
BAC81_K23,6,6q24.3,148486335,148564237,77902,-,-
BAC219_G03,6,6q24.3,148496686,148611064,114378,-,-
BAC233_C17,6,6q24.3,148517989,148596043,78054,-,-
BAC65_B08,6,6q24.3,148517989,148625702,107713,-,-
BAC31_N14,6,6q24.3,148528157,148622700,94543,-,-
BAC27_K20,6,6q24.3,148611189,148709317,98128,-,-
BAC56_E15,6,6q24.3,148637536,148791458,153922,-,-
BAC135_F21,6,6q24.3,148653368,148730964,77596,-,-
BAC97_D08,6,6q24.3,148675699,148772113,96414,-,-
BAC228_E20,6,6q24.3,148767917,148887660,119743,-,-
BAC63_D02,6,6q24.3,148790499,148891960,101461,-,-
BAC151_P03,6,6q24.3,148800087,148877076,76989,-,-
BAC71_B07,6,6q24.3,148892155,148978293,86138,-,-
BAC162_I15,6,6q24.3,148905786,148988455,82669,-,-
BAC120_D19,6,6q24.3,148909802,148993985,84183,-,-
BAC224_C02,6,6q24.3,148976923,149081830,104907,-,-
BAC143_P09,6,6q24.3,148978980,149064868,85888,-,-
BAC41_A23,6,6q24.3-6q25.1,149026583,149119446,92863,-,-
BAC84_F07,6,6q25.1,149162772,149264930,102158,-,-
BAC101_B22,6,6q25.1,149164606,149246309,81703,-,-
BAC151_L21,6,6q25.1,149263554,149356665,93111,-,-
BAC39_G11,6,6q25.1,149343566,149436667,93101,-,-
BAC195_D10,6,6q25.1,149367846,149452707,84861,-,-
BAC158_G10,6,6q25.1,149452870,149534754,81884,-,-
BAC131_J02,6,6q25.1,149553940,149640834,86894,-,-
BAC153_E10,6,6q25.1,149591162,149708073,116911,-,-
BAC82_J11,6,6q25.1,149778714,149865699,86985,-,-
BAC59_P08,6,6q25.1,149852570,149956185,103615,-,-
BAC127_D02,6,6q25.1,149868195,149963599,95404,-,-
BAC214_J08,6,6q25.1,149898922,149998884,99962,-,-
BAC42_F13,6,6q25.1,149900595,150054506,153911,-,-
BAC51_A03,6,6q25.1,149914114,150024996,110882,-,-
BAC82_P12,6,6q25.1,149933331,150025012,91681,-,-
BAC154_B05,6,6q25.1,149977459,150094019,116560,-,-
BAC58_L20,6,6q25.1,149977459,150064280,86821,-,-
BAC241_G17,6,6q25.1,150044322,150184477,140155,yes,-
BAC148_F17,6,6q25.1,150046157,150184503,138346,yes,-
BAC119_D19,6,6q25.1,150049367,150145210,95843,yes,-
BAC79_C23,6,6q25.1,150049383,150134102,84719,yes,-
BAC155_E07,6,6q25.1,150084497,150173924,89427,yes,-
BAC86_H04,6,6q25.1,150094012,150221581,127569,-,-
BAC137_P22,6,6q25.1,150113251,150210653,97402,-,-
BAC62_A19,6,6q25.1,150134138,150219158,85020,-,-
BAC90_N11,6,6q25.1,150145235,150257963,112728,-,-
BAC88_L09,6,6q25.1,150160038,150243305,83267,-,-
BAC183_A10,6,6q25.1,150160357,150239259,78902,-,-
BAC247_L04,6,6q25.1,150256900,150386688,129788,-,-
BAC178_F08,6,6q25.1,150256900,150358717,101817,-,-
BAC100_P16,6,6q25.1,150257958,150358717,100759,-,-
BAC151_B13,6,6q25.1,150271641,150396750,125109,-,-
BAC67_G04,6,6q25.1,150307370,150438806,131436,-,-
BAC8_E06,6,6q25.1,150325180,150433658,108478,-,-
BAC199_J17,6,6q25.1,150351204,150457592,106388,-,-
BAC151_E21,6,6q25.1,150536858,150619935,83077,-,-
BAC56_M09,6,6q25.1,150588632,150770410,181778,-,-
BAC67_L10,6,6q25.1,150605672,150720019,114347,-,-
BAC53_J21,6,6q25.1,150620128,150752555,132427,-,-
BAC182_M17,6,6q25.1,150634314,150725003,90689,-,-
BAC35_M18,6,6q25.1,150752765,150848180,95415,-,-
BAC166_L04,6,6q25.1,150770403,150904704,134301,-,-
BAC235_F05,6,6q25.1,150791666,150886781,95115,-,-
BAC230_K13,6,6q25.1,150801050,150914200,113150,-,-
BAC180_E24,6,6q25.1,150818531,150914198,95667,-,-
BAC26_B19,6,6q25.1,150896317,150985848,89531,-,-
BAC103_K03,6,6q25.1,150914306,151034449,120143,-,-
BAC151_F12,6,6q25.1,151030717,151131704,100987,-,-
BAC61_D06,6,6q25.1,151034456,151176820,142364,-,-
BAC25_O06,6,6q25.1,151049499,151142093,92594,-,-
BAC163_M11,6,6q25.1,151049501,151138944,89443,-,-
BAC95_F24,6,6q25.1,151082136,151189077,106941,-,-
BAC115_O19,6,6q25.1,151129665,151245528,115863,-,-
BAC92_E13,6,6q25.1,151195167,151289870,94703,-,-
BAC240_G03,6,6q25.1,151289997,151369080,79083,-,-
BAC56_D08,6,6q25.1,151295868,151408846,112978,-,-
BAC147_K09,6,6q25.1,151373095,151459426,86331,-,-
BAC155_H06,6,6q25.1,151506877,151607355,100478,-,-
BAC111_B08,6,6q25.1,151537912,151644501,106589,-,-
BAC249_P14,6,6q25.1,151554386,151644743,90357,-,-
BAC179_L19,6,6q25.1,151572482,151664559,92077,-,-
BAC141_M24,6,6q25.1,151604865,151680347,75482,-,-
BAC67_H03,6,6q25.1,151674031,151755610,81579,-,-
BAC154_B06,6,6q25.1,151712798,151801935,89137,-,-
BAC241_D13,6,6q25.1,151830092,151935282,105190,-,-
BAC127_P14,6,6q25.1,151917288,152012917,95629,-,-
BAC83_F09,6,6q25.1,151953056,152065171,112115,-,-
BAC187_P20,6,6q25.1,151963089,152048892,85803,-,-
BAC116_O18,6,6q25.1,152083434,152187690,104256,-,-
BAC73_M13,6,6q25.1,152111604,152223706,112102,-,-
BAC158_D05,6,6q25.1,152174273,152265454,91181,-,-
BAC158_C05,6,6q25.1,152174275,152265499,91224,-,-
BAC146_N09,6,6q25.1,152245034,152320486,75452,-,-
BAC45_D10,6,6q25.1,152245034,152353513,108479,-,-
BAC184_H06,6,6q25.1,152265559,152353524,87965,-,-
BAC66_N03,6,6q25.1,152338719,152440535,101816,-,-
BAC165_P12,6,6q25.1,152441769,152530522,88753,-,-
BAC168_O04,6,6q25.1,152473712,152561391,87679,-,-
BAC252_J04,6,6q25.1,152479770,152573340,93570,-,-
BAC77_O14,6,6q25.1,152479818,152573327,93509,-,-
BAC83_H19,6,6q25.1,152486026,152597997,111971,-,-
BAC146_K10,6,6q25.1,152506646,152586449,79803,-,-
BAC26_M11,6,6q25.1-6q25.2,152515539,152607210,91671,-,-
BAC82_C03,6,6q25.1-6q25.2,152530574,152693793,163219,-,-
BAC170_G12,6,6q25.1-6q25.2,152573453,152656195,82742,-,-
BAC62_G13,6,6q25.1-6q25.2,152585311,152688045,102734,-,-
BAC193_K01,6,6q25.2,152612567,152690601,78034,-,-
BAC44_M17,6,6q25.2,152612685,152714145,101460,-,-
BAC194_P17,6,6q25.2,152718166,152808930,90764,-,-
BAC189_A19,6,6q25.2,152725271,152808908,83637,-,-
BAC42_J08,6,6q25.2,152760902,152871598,110696,-,-
BAC13_D02,6,6q25.2,152866769,152986647,119878,-,-
BAC145_O01,6,6q25.2,152918673,153026641,107968,-,-
BAC227_M20,6,6q25.2,152980884,153081944,101060,-,-
BAC52_C20,6,6q25.2,153033557,153146767,113210,-,-
BAC120_H10,6,6q25.2,153246828,153387623,140795,-,-
BAC238_P14,6,6q25.2,153344771,153435802,91031,-,-
BAC204_E13,6,6q25.2,153515994,153601329,85335,-,-
BAC155_M08,6,6q25.2,153604239,153714510,110271,-,-
BAC52_A08,6,6q25.2,153703896,153831069,127173,-,-
BAC248_C04,6,6q25.2,153981577,154060991,79414,-,-
BAC116_A13,6,6q25.2,154040386,154149067,108681,-,-
BAC189_E16,6,6q25.2,154060989,154165591,104602,-,-
BAC250_E16,6,6q25.2,154104944,154221419,116475,-,-
BAC60_N15,6,6q25.2,154173866,154366549,192683,-,-
BAC152_N22,6,6q25.2,154181080,154281922,100842,-,-
BAC71_P16,6,6q25.2,154264830,154339495,74665,-,-
BAC59_N20,6,6q25.2,154339506,154435162,95656,-,-
BAC100_M03,6,6q25.2,154396966,154426136,29170,-,-
BAC222_C24,6,6q25.2,154478393,154557306,78913,-,-
BAC64_G08,6,6q25.2,154548736,154719577,170841,-,-
BAC1_F04,6,6q25.2,154584235,154686225,101990,-,-
BAC177_D21,6,6q25.2,154590915,154704425,113510,-,-
BAC180_H14,6,6q25.2,154591205,154679838,88633,-,-
BAC119_B04,6,6q25.2,154597882,154695659,97777,-,-
BAC234_F08,6,6q25.2,154618371,154708232,89861,-,-
BAC82_L13,6,6q25.2,154627214,154816024,188810,-,-
BAC160_N06,6,6q25.2,154652802,154679838,27036,-,-
BAC11_L13,6,6q25.2,154678666,154756453,77787,-,-
BAC28_P22,6,6q25.2,154686219,154781663,95444,-,-
BAC123_G01,6,6q25.2,154695861,154714563,18702,-,-
BAC75_P03,6,6q25.2,154705067,154868764,163697,-,-
BAC191_D05,6,6q25.2,154708244,154838333,130089,-,-
BAC76_J08,6,6q25.2,154750540,154840537,89997,-,-
BAC192_H14,6,6q25.2,154756475,154857870,101395,-,-
BAC33_D04,6,6q25.2,154757940,154865583,107643,-,-
BAC186_M14,6,6q25.2,154757941,154838333,80392,-,-
BAC144_H11,6,6q25.2,154830103,154945611,115508,-,-
BAC79_E24,6,6q25.2,154838370,155006148,167778,-,-
BAC38_M07,6,6q25.2,154866852,154955643,88791,-,-
BAC118_H03,6,6q25.2,154920049,155038726,118677,-,-
BAC71_H09,6,6q25.2,154921562,155003244,81682,-,-
BAC118_M08,6,6q25.2,154961157,155054330,93173,-,-
BAC127_D20,6,6q25.2,155005096,155124318,119222,-,-
BAC191_N05,6,6q25.2,155019234,155108650,89416,-,-
BAC105_B02,6,6q25.2,155145507,155248483,102976,-,-
BAC249_O19,6,6q25.2,155145542,155235284,89742,-,-
BAC55_K15,6,6q25.2,155248592,155348834,100242,-,-
BAC26_J13,6,6q25.2,155250438,155385615,135177,-,-
BAC63_D20,6,6q25.2,155271250,155456238,184988,-,-
BAC175_N20,6,6q25.2,155355063,155456282,101219,-,-
BAC75_G12,6,6q25.2,155412325,155505680,93355,-,-
BAC132_E17,6,6q25.2,155434838,155533021,98183,-,-
BAC48_B09,6,6q25.2,155451534,155593308,141774,-,-
BAC14_B23,6,6q25.2-6q25.3,155525950,155651150,125200,-,-
BAC68_F10,6,6q25.2-6q25.3,155564799,155657051,92252,-,-
BAC125_P05,6,6q25.2-6q25.3,155567358,155666729,99371,-,-
BAC200_M20,6,6q25.3,155826985,155899497,72512,-,-
BAC137_F21,6,6q25.3,155837182,155918932,81750,-,-
BAC57_M20,6,6q25.3,156194265,156310721,116456,-,-
BAC34_A17,6,6q25.3,156218062,156334053,115991,-,-
BAC26_P06,6,6q25.3,156249097,156334053,84956,-,-
BAC156_L15,6,6q25.3,156253696,156350220,96524,-,-
BAC163_C17,6,6q25.3,156257935,156344280,86345,-,-
BAC148_N20,6,6q25.3,156266449,156344281,77832,-,-
BAC155_A07,6,6q25.3,156359164,156445575,86411,-,-
BAC105_O08,6,6q25.3,156425030,156512398,87368,-,-
BAC161_C23,6,6q25.3,156484124,156541032,56908,-,-
BAC2_C17,6,6q25.3,156561990,156667307,105317,-,-
BAC118_D17,6,6q25.3,156601005,156716861,115856,-,-
BAC114_P17,6,6q25.3,156616137,156756361,140224,-,-
BAC160_B11,6,6q25.3,156697133,156777716,80583,-,-
BAC143_H20,6,6q25.3,156777951,156882461,104510,-,-
BAC96_J12,6,6q25.3,156796744,156886076,89332,-,-
BAC124_J08,6,6q25.3,156805572,156948808,143236,-,-
BAC146_M02,6,6q25.3,156849936,156948808,98872,-,-
BAC135_J13,6,6q25.3,156877137,156954006,76869,-,-
BAC200_M04,6,6q25.3,156954207,157132501,178294,-,-
BAC119_J17,6,6q25.3,156971289,157118059,146770,-,-
BAC128_P02,6,6q25.3,157002840,157116463,113623,-,-
BAC86_A12,6,6q25.3,157012233,157118071,105838,-,-
BAC177_G03,6,6q25.3,157084101,157165151,81050,-,-
BAC242_L02,6,6q25.3,157116279,157215167,98888,-,-
BAC39_G10,6,6q25.3,157132593,157239002,106409,-,-
BAC8_I09,6,6q25.3,157132621,157243150,110529,-,-
BAC198_J22,6,6q25.3,157238158,157344852,106694,-,-
BAC177_K09,6,6q25.3,157260509,157352754,92245,-,-
BAC85_E19,6,6q25.3,157265600,157358967,93367,-,-
BAC25_A15,6,6q25.3,157302308,157397400,95092,-,-
BAC118_M18,6,6q25.3,157302386,157406286,103900,-,-
BAC231_L21,6,6q25.3,157339481,157444977,105496,-,-
BAC23_J04,6,6q25.3,157351475,157482749,131274,-,-
BAC59_M06,6,6q25.3,157352749,157488120,135371,-,-
BAC203_K10,6,6q25.3,157395416,157479055,83639,-,-
BAC54_F16,6,6q25.3,157398974,157410543,11569,-,-
BAC64_H20,6,6q25.3,157422597,157535248,112651,-,-
BAC86_N23,6,6q25.3,157739255,157834926,95671,-,-
BAC18_J04,6,6q25.3,157755372,157849151,93779,-,-
BAC42_G23,6,6q25.3,157910928,158021972,111044,-,-
BAC196_B05,6,6q25.3,157915784,157997718,81934,-,-
BAC148_L10,6,6q25.3,157921931,157997354,75423,-,-
BAC199_J23,6,6q25.3,158053246,158139718,86472,-,-
BAC19_P09,6,6q25.3,158178618,158271668,93050,-,-
BAC90_G18,6,6q25.3,158204845,158312780,107935,-,-
BAC67_P16,6,6q25.3,158209555,158315085,105530,-,-
BAC75_N05,6,6q25.3,158238972,158335689,96717,-,-
BAC143_C04,6,6q25.3,158255513,158351540,96027,-,-
BAC89_O14,6,6q25.3,158271664,158349410,77746,-,-
BAC172_P22,6,6q25.3,158271668,158351540,79872,-,-
BAC42_K22,6,6q25.3,158302932,158373273,70341,-,-
BAC233_J04,6,6q25.3,158403998,158501029,97031,-,-
BAC148_M15,6,6q25.3,158473727,158577225,103498,-,-
BAC154_F10,6,6q25.3,158491682,158577225,85543,-,-
BAC120_M04,6,6q25.3,158611717,158721160,109443,-,-
BAC70_J17,6,6q25.3,158614213,158712079,97866,-,-
BAC195_A18,6,6q25.3,158688688,158776193,87505,-,-
BAC238_F12,6,6q25.3,158688688,158777808,89120,-,-
BAC186_G07,6,6q25.3,158760952,158893804,132852,-,-
BAC59_F22,6,6q25.3,158800781,158896978,96197,-,-
BAC116_L12,6,6q25.3,158809184,158943385,134201,-,-
BAC153_E14,6,6q25.3,158867529,158979873,112344,-,-
BAC48_B14,6,6q25.3,158896995,158979871,82876,-,-
BAC97_O01,6,6q25.3,158969337,159106783,137446,-,-
BAC75_P15,6,6q25.3,158971920,159083587,111667,-,-
BAC250_M03,6,6q25.3,158979878,159104002,124124,-,-
BAC200_D16,6,6q25.3,158983719,159083589,99870,-,-
BAC238_M07,6,6q25.3,159044525,159121752,77227,-,-
BAC84_F01,6,6q25.3,159083951,159249242,165291,-,-
BAC62_C14,6,6q25.3,159085879,159188113,102234,-,-
BAC186_N13,6,6q25.3,159125431,159209414,83983,-,-
BAC34_I02,6,6q25.3,159134907,159249238,114331,-,-
BAC173_P17,6,6q25.3,159142156,159244059,101903,-,-
BAC172_M05,6,6q25.3,159248988,159350186,101198,-,-
BAC69_K09,6,6q25.3,159249234,159345448,96214,-,-
BAC7_A18,6,6q25.3,159249234,159350186,100952,-,-
BAC198_H07,6,6q25.3,159249236,159345448,96212,-,-
BAC42_I13,6,6q25.3,159300063,159417891,117828,-,-
BAC101_P02,6,6q25.3,159311753,159445797,134044,-,-
BAC160_N10,6,6q25.3,159359415,159448737,89322,-,-
BAC20_A18,6,6q25.3,159381176,159496898,115722,-,-
BAC162_P15,6,6q25.3,159404412,159560640,156228,-,-
BAC52_C13,6,6q25.3,159419176,159576753,157577,-,-
BAC205_K09,6,6q25.3,159419176,159511466,92290,-,-
BAC244_I14,6,6q25.3,159422571,159546771,124200,-,-
BAC97_K07,6,6q25.3,159448777,159540525,91748,-,-
BAC51_O15,6,6q25.3,159452182,159560640,108458,-,-
BAC49_K08,6,6q25.3,159612550,159716664,104114,-,-
BAC39_I14,6,6q25.3,159622861,159790606,167745,-,-
BAC248_F07,6,6q25.3,159637658,159784284,146626,-,-
BAC72_E08,6,6q25.3,159653989,159722055,68066,-,-
BAC110_G10,6,6q25.3,159668609,159775116,106507,-,-
BAC153_N18,6,6q25.3,159680480,159812182,131702,-,-
BAC132_I19,6,6q25.3,159695308,159785640,90332,-,-
BAC39_P23,6,6q25.3,159749243,159833907,84664,-,-
BAC168_G11,6,6q25.3,159780089,159886621,106532,-,-
BAC74_L12,6,6q25.3,159780092,159905252,125160,-,-
BAC66_C17,6,6q25.3,159829908,159935812,105904,-,-
BAC156_P07,6,6q25.3,159841588,159989132,147544,-,-
BAC105_C04,6,6q25.3,159913371,159979791,66420,-,-
BAC196_K02,6,6q25.3,159951860,160046510,94650,-,-
BAC197_B23,6,6q25.3,160013514,160102213,88699,-,-
BAC233_E18,6,6q25.3,160021155,160122794,101639,-,-
BAC66_A13,6,6q25.3,160022666,160124128,101462,-,-
BAC41_P01,6,6q25.3,160137172,160250503,113331,-,-
BAC122_J18,6,6q25.3,160151659,160267597,115938,-,-
BAC51_G16,6,6q25.3,160165347,160289351,124004,-,-
BAC169_M12,6,6q25.3,160174732,160267615,92883,-,-
BAC52_I14,6,6q25.3,160250519,160357558,107039,-,-
BAC117_C04,6,6q25.3,160265664,160345967,80303,-,-
BAC217_E09,6,6q25.3,160365537,160454476,88939,-,-
BAC185_L14,6,6q25.3,160366191,160461751,95560,-,-
BAC53_E22,6,6q25.3,160373269,160464417,91148,-,-
BAC218_L06,6,6q25.3,160381407,160468658,87251,-,-
BAC43_H18,6,6q25.3,160381421,160468658,87237,-,-
BAC231_D05,6,6q25.3,160411279,160503232,91953,yes,-
BAC126_O07,6,6q25.3,160412849,160498885,86036,-,-
BAC43_D16,6,6q25.3,160587496,160719431,131935,-,-
BAC148_G07,6,6q25.3,160613199,160694459,81260,-,-
BAC34_H21,6,6q25.3,160619550,160735324,115774,-,-
BAC30_A05,6,6q25.3,160629959,160758172,128213,-,-
BAC118_C03,6,6q25.3,160680659,160783285,102626,-,-
BAC137_H07,6,6q25.3,160710642,160807218,96576,-,-
BAC57_I19,6,6q25.3,160744195,160825912,81717,-,-
BAC243_D01,6,6q26,160923188,160958200,35012,-,-
BAC158_G03,6,6q26,160953617,160991408,37791,-,-
BAC113_L15,6,6q26,160958193,161051089,92896,-,-
BAC100_G04,6,6q26,160958193,161102806,144613,yes,-
BAC192_H17,6,6q26,161075349,161140736,65387,-,-
BAC165_J22,6,6q26,161075351,161140736,65385,-,-
BAC92_L18,6,6q26,161092462,161172978,80516,-,-
BAC220_B08,6,6q26,161092465,161217941,125476,-,-
BAC204_M06,6,6q26,161179100,161246132,67032,-,-
BAC177_A12,6,6q26,161359550,161438698,79148,-,-
BAC2_C19,6,6q26,161385802,161469603,83801,-,-
BAC15_K22,6,6q26,161385874,161469698,83824,-,-
BAC186_A08,6,6q26,161390771,161474808,84037,-,-
BAC132_F02,6,6q26,161422701,161505577,82876,-,-
BAC226_C14,6,6q26,161422701,161503541,80840,-,-
BAC124_L21,6,6q26,161474383,161598829,124446,-,-
BAC158_A03,6,6q26,161474407,161588457,114050,-,-
BAC172_B08,6,6q26,161503538,161595768,92230,-,-
BAC53_E03,6,6q26,161519310,161612465,93155,-,-
BAC64_B12,6,6q26,161536351,161623673,87322,-,-
BAC107_B04,6,6q26,161598880,161725855,126975,-,-
BAC69_C23,6,6q26,161600357,161718478,118121,-,-
BAC115_E12,6,6q26,161635330,161723738,88408,-,-
BAC168_J17,6,6q26,161699165,161799810,100645,-,-
BAC144_P06,6,6q26,161723750,161826659,102909,-,-
BAC242_B13,6,6q26,161723856,161799772,75916,-,-
BAC55_O15,6,6q26,161777955,161874337,96382,-,-
BAC147_C16,6,6q26,161860435,161968058,107623,-,-
BAC198_P11,6,6q26,161874426,161954389,79963,-,-
BAC91_J07,6,6q26,161974038,162110776,136738,-,-
BAC179_N12,6,6q26,161982831,162089918,107087,-,-
BAC2_M13,6,6q26,162104250,162206440,102190,-,-
BAC127_D03,6,6q26,162110770,162206440,95670,-,-
BAC52_P15,6,6q26,162226175,162325672,99497,-,-
BAC160_H21,6,6q26,162276980,162382895,105915,-,-
BAC122_I22,6,6q26,162390907,162536366,145459,-,-
BAC70_J15,6,6q26,162390907,162504412,113505,-,-
BAC117_O04,6,6q26,162395716,162493352,97636,-,-
BAC97_L12,6,6q26,162395717,162504412,108695,-,-
BAC95_F03,6,6q26,162552109,162655241,103132,-,-
BAC167_O17,6,6q26,162565597,162669643,104046,-,-
BAC71_B02,6,6q26,162593890,162710102,116212,-,-
BAC152_F08,6,6q26,162632263,162720986,88723,-,-
BAC165_E08,6,6q26,162635396,162739058,103662,-,-
BAC165_A18,6,6q26,162693005,162780302,87297,-,-
BAC126_O14,6,6q26,162699401,162788420,89019,-,-
BAC124_I05,6,6q26,162793142,162914301,121159,-,-
BAC97_D04,6,6q26,162822878,162894561,71683,-,-
BAC162_M22,6,6q26,162833152,162914301,81149,-,-
BAC178_A22,6,6q26,162894872,162988971,94099,-,-
BAC42_M23,6,6q26,162903983,162984794,80811,-,-
BAC19_O23,6,6q26,162904361,163003078,98717,-,-
BAC50_N05,6,6q26,162962074,163073202,111128,-,-
BAC228_B23,6,6q26,162962131,163063993,101862,-,-
BAC232_N18,6,6q26,162981880,163117731,135851,-,-
BAC235_L17,6,6q26,163144126,163203686,59560,-,-
BAC226_D04,6,6q26,163251018,163388351,137333,-,-
BAC227_H22,6,6q26,163350353,163417507,67154,-,-
BAC146_L11,6,6q26,163430912,163515361,84449,-,-
BAC75_B19,6,6q26,163540876,163638628,97752,-,-
BAC233_E16,6,6q26,163562055,163639835,77780,-,-
BAC185_N06,6,6q26,163610379,163711842,101463,-,-
BAC158_J18,6,6q26,163610379,163695356,84977,-,-
BAC48_H03,6,6q26,163610383,163621776,11393,-,-
BAC53_G14,6,6q26,163638871,163757389,118518,-,-
BAC115_A19,6,6q26,163813964,163926840,112876,-,-
BAC170_J14,6,6q26,163835956,163926531,90575,-,-
BAC139_M15,6,6q26,163913553,163998557,85004,-,-
BAC39_B16,6,6q26,163940687,164134362,193675,-,-
BAC90_F21,6,6q26,163941376,164055989,114613,-,-
BAC38_M20,6,6q26,163941547,164045957,104410,-,-
BAC150_D24,6,6q26,163941547,164060448,118901,-,-
BAC106_E06,6,6q26,163961061,164050741,89680,-,-
BAC204_N07,6,6q26,163991824,164050739,58915,-,-
BAC220_O08,6,6q26,164011541,164092060,80519,-,-
BAC114_A08,6,6q26,164110793,164212341,101548,-,-
BAC157_J03,6,6q26,164166618,164260782,94164,-,-
BAC175_O13,6,6q26,164172991,164275264,102273,-,-
BAC24_A09,6,6q26-6q27,164280216,164449112,168896,-,-
BAC175_O10,6,6q26,164299561,164384881,85320,-,-
BAC151_K10,6,6q26-6q27,164350123,164449117,98994,-,-
BAC144_A19,6,6q26-6q27,164385105,164485724,100619,-,-
BAC51_H09,6,6q27,164410714,164506179,95465,-,-
BAC244_B14,6,6q27,164410956,164518107,107151,-,-
BAC217_D03,6,6q27,164412666,164497765,85099,-,-
BAC143_H18,6,6q27,164413720,164506179,92459,-,-
BAC242_E05,6,6q27,164551935,164660474,108539,-,-
BAC127_E18,6,6q27,164567033,164655681,88648,-,-
BAC86_C24,6,6q27,164668698,164775182,106484,-,-
BAC22_B09,6,6q27,164720628,164836384,115756,-,-
BAC41_H06,6,6q27,164818049,164901085,83036,-,-
BAC46_K23,6,6q27,164844775,164922956,78181,-,-
BAC123_C22,6,6q27,164860986,164951406,90420,-,-
BAC89_E08,6,6q27,164960094,165046094,86000,-,-
BAC177_F19,6,6q27,165063149,165144830,81681,-,-
BAC27_A22,6,6q27,165088261,165212139,123878,-,-
BAC240_L05,6,6q27,165217929,165296614,78685,-,-
BAC45_C08,6,6q27,165299952,165387305,87353,-,-
BAC150_B22,6,6q27,165495873,165589409,93536,-,-
BAC33_I17,6,6q27,165516362,165601260,84898,-,-
BAC38_F06,6,6q27,165577290,165725860,148570,-,-
BAC198_F09,6,6q27,165667236,165759248,92012,-,-
BAC187_I23,6,6q27,165718665,165796823,78158,-,-
BAC237_D21,6,6q27,165880531,165980122,99591,-,-
BAC66_I05,6,6q27,165898696,165986338,87642,-,-
BAC237_J10,6,6q27,165898696,165982641,83945,-,-
BAC53_J09,6,6q27,165916527,166008284,91757,-,-
BAC21_G03,6,6q27,165957606,166065037,107431,-,-
BAC125_E16,6,6q27,166060793,166146011,85218,-,-
BAC175_M17,6,6q27,166079765,166171536,91771,-,-
BAC108_P01,6,6q27,166079765,166171527,91762,-,-
BAC57_O21,6,6q27,166178722,166335573,156851,-,-
BAC66_K22,6,6q27,166179415,166304818,125403,-,-
BAC163_P09,6,6q27,166294682,166403553,108871,-,-
BAC190_I04,6,6q27,166300505,166411287,110782,-,-
BAC219_F15,6,6q27,166392643,166478773,86130,-,-
BAC14_O19,6,6q27,166394373,166475763,81390,-,-
BAC237_O11,6,6q27,166404290,166493252,88962,-,-
BAC240_J22,6,6q27,166415536,166545965,130429,-,-
BAC5_P05,6,6q27,166426699,166539254,112555,-,-
BAC167_K15,6,6q27,166436525,166560394,123869,-,-
BAC63_L22,6,6q27,166451079,166567385,116306,-,-
BAC129_L03,6,6q27,166497175,166593100,95925,-,-
BAC248_F06,6,6q27,166497178,166589890,92712,-,-
BAC86_F08,6,6q27,166567382,166656580,89198,-,-
BAC166_M19,6,6q27,166633757,166744581,110824,-,-
BAC33_J03,6,6q27,166633763,166776490,142727,-,-
BAC88_G13,6,6q27,166664438,166807286,142848,-,-
BAC27_F07,6,6q27,166686343,166765437,79094,-,-
BAC116_E06,6,6q27,166725987,166835931,109944,-,-
BAC77_M21,6,6q27,166765430,166846679,81249,-,-
BAC78_N12,6,6q27,166765795,166897702,131907,-,-
BAC24_M01,6,6q27,166866362,166963852,97490,-,-
BAC143_I14,6,6q27,166869414,166956340,86926,-,-
BAC24_C10,6,6q27,166907225,167010633,103408,-,-
BAC146_I21,6,6q27,166969730,167069259,99529,-,-
BAC65_E20,6,6q27,166979882,167099884,120002,-,-
BAC32_H05,6,6q27,166979887,167078335,98448,-,-
BAC206_L16,6,6q27,167060286,167176873,116587,-,-
BAC56_N18,6,6q27,167115289,167217325,102036,-,-
BAC43_P20,6,6q27,167134839,167215768,80929,-,-
BAC152_C11,6,6q27,167134839,167219657,84818,-,-
BAC80_O14,6,6q27,167143465,167256706,113241,-,-
BAC182_I16,6,6q27,167176882,167305628,128746,-,-
BAC21_J20,6,6q27,167252721,167373248,120527,-,-
BAC147_G10,6,6q27,167305621,167373248,67627,-,-
BAC69_A23,6,6q27,167305621,167402542,96921,yes,-
BAC161_F19,6,6q27,167339157,167414308,75151,-,-
BAC238_P09,6,6q27,167345960,167425602,79642,-,-
BAC95_C20,6,6q27,167375651,167472406,96755,-,-
BAC51_A15,6,6q27,167416826,167578827,162001,-,-
BAC147_O16,6,6q27,167425597,167499454,73857,-,-
BAC195_D15,6,6q27,167425597,167524165,98568,-,-
BAC221_P04,6,6q27,167457769,167603044,145275,-,-
BAC139_I19,6,6q27,167489057,167576684,87627,-,-
BAC102_N19,6,6q27,167504640,167715926,211286,-,-
BAC78_P16,6,6q27,167507085,167623814,116729,-,-
BAC35_G15,6,6q27,167519232,167613164,93932,-,-
BAC61_H02,6,6q27,167837260,167923800,86540,-,-
BAC38_F10,6,6q27,167845057,167935056,89999,-,-
BAC101_O05,6,6q27,167854006,167949992,95986,-,-
BAC66_D24,6,6q27,167886763,167968855,82092,-,-
BAC39_B05,6,6q27,167926304,168023980,97676,-,-
BAC247_A13,6,6q27,167949985,168040438,90453,-,-
BAC32_P06,6,6q27,167949988,168023980,73992,-,-
BAC167_E22,6,6q27,167983959,168076442,92483,-,-
BAC197_C14,6,6q27,168029081,168115689,86608,-,-
BAC155_O13,6,6q27,168054243,168138846,84603,-,-
BAC195_C08,6,6q27,168128222,168207366,79144,-,-
BAC31_F07,6,6q27,168159489,168265278,105789,-,-
BAC185_J07,6,6q27,168176244,168265278,89034,-,-
BAC39_B11,6,6q27,168176503,168339856,163353,-,-
BAC184_H05,6,6q27,168199825,168312017,112192,-,-
BAC26_A20,6,6q27,168312053,168401962,89909,-,-
BAC221_F13,6,6q27,168314219,168401962,87743,-,-
BAC238_M16,6,6q27,168360505,168423445,62940,-,-
BAC130_K22,6,6q27,168401956,168497561,95605,-,-
BAC176_E19,6,6q27,168431711,168527565,95854,-,-
BAC92_E09,6,6q27,168444144,168563262,119118,-,-
BAC151_O09,6,6q27,168563256,168639588,76332,-,-
BAC39_F01,6,6q27,168573434,168806467,233033,-,-
BAC29_H10,6,6q27,168639583,168740330,100747,-,-
BAC172_J02,6,6q27,168644222,168774215,129993,-,-
BAC237_G19,6,6q27,168654325,168726158,71833,-,-
BAC242_L03,6,6q27,168726935,168805918,78983,-,-
BAC190_A01,6,6q27,168726942,168816761,89819,-,-
BAC145_H22,6,6q27,168740324,168846328,106004,-,-
BAC62_M03,6,6q27,168751449,168831545,80096,-,-
BAC148_I07,6,6q27,168772520,168853631,81111,-,-
BAC61_A01,6,6q27,168959479,169070032,110553,-,-
BAC143_M02,6,6q27,168959720,169040547,80827,-,-
BAC143_J19,6,6q27,168974831,169069069,94238,-,-
BAC106_C05,6,6q27,168974847,169101150,126303,-,-
BAC161_K10,6,6q27,168974847,169101150,126303,-,-
BAC226_P13,6,6q27,168979554,169060545,80991,-,-
BAC167_E23,6,6q27,168991779,169099124,107345,-,-
BAC92_O19,6,6q27,168995088,169101148,106060,-,-
BAC106_E22,6,6q27,169007560,169099129,91569,-,-
BAC18_L01,6,6q27,169007760,169104598,96838,-,-
BAC10_L21,6,6q27,169050782,169176363,125581,-,-
BAC33_I10,6,6q27,169050980,169161677,110697,-,-
BAC84_C08,6,6q27,169070047,169171537,101490,-,-
BAC250_B03,6,6q27,169216849,169301601,84752,-,-
BAC184_K04,6,6q27,169231137,169340875,109738,-,-
BAC161_K21,6,6q27,169235457,169340875,105418,-,-
BAC170_E10,6,6q27,169261283,169329827,68544,-,-
BAC90_O14,6,6q27,169319611,169417105,97494,-,-
BAC181_N19,6,6q27,169341787,169423862,82075,-,-
BAC7_E24,6,6q27,169342884,169466070,123186,-,-
BAC227_B17,6,6q27,169392205,169502055,109850,-,-
BAC221_M23,6,6q27,169418675,169495256,76581,-,-
BAC205_D22,6,6q27,169418806,169494151,75345,-,-
BAC140_L21,6,6q27,169528215,169612880,84665,-,-
BAC160_G21,6,6q27,169528220,169611948,83728,-,-
BAC25_F14,6,6q27,169553244,169700683,147439,-,-
BAC104_C05,6,6q27,169588746,169671768,83022,-,-
BAC161_L19,6,6q27,169594939,169711048,116109,-,-
BAC119_L14,6,6q27,169595641,169711048,115407,-,-
BAC119_K19,6,6q27,169605478,169700681,95203,-,-
BAC92_L10,6,6q27,169700674,169834343,133669,-,-
BAC167_D12,6,6q27,169767993,169856138,88145,-,-
BAC15_K01,6,6q27,169816907,169940655,123748,-,-
BAC66_P22,6,6q27,169919806,169996653,76847,-,-
BAC219_H01,6,6q27,170175560,170187992,12432,-,-
BAC156_G04,6,6q27,170187273,170281643,94370,-,-
BAC168_P24,6,6q27,170260012,170349825,89813,-,-
BAC74_N10,6,6q27,170268464,170362483,94019,-,-
BAC86_D17,6,6q27,170301264,170409110,107846,-,-
BAC161_M21,6,6q27,170345514,170425834,80320,-,-
BAC121_P18,6,6q27,170411066,170524620,113554,-,-
BAC165_D14,6,6q27,170482250,170598949,116699,-,-
BAC56_O10,6,6q27,170536185,170689711,153526,-,-
BAC62_K03,6,6q27,170536200,170660991,124791,-,-
BAC150_L19,6,6q27,170541175,170648721,107546,-,-
BAC91_C11,6,6q27,170568359,170692727,124368,-,-
BAC247_O08,6,6q27,170576757,170660992,84235,-,-
BAC80_A16,6,6q27,170581858,170689711,107853,-,-
BAC115_P06,6,6q27,170598944,170678915,79971,-,-
BAC129_O21,6,6q27,170648715,170734755,86040,-,-
BAC12_F16,6,6q27,170655302,170747359,92057,-,-
BAC153_E08,6,6q27,170668414,170747359,78945,-,-
BAC234_K19,6,6q27,170753622,170847673,94051,-,-
BAC86_E15,7,7p22.3,103323,245586,142263,-,-
BAC146_F11,7,7p22.3,108386,227620,119234,-,-
BAC44_K16,7,7p22.3,120512,232149,111637,-,-
BAC244_J19,7,7p22.3,142555,223018,80463,-,-
BAC153_F12,7,7p22.3,148729,243297,94568,-,-
BAC33_E17,7,7p22.3,153063,243141,90078,-,-
BAC97_B23,7,7p22.3,215091,309923,94832,-,-
BAC79_J22,7,7p22.3,504512,706689,202177,-,-
BAC153_N14,7,7p22.3,570600,657219,86619,-,-
BAC130_G18,7,7p22.3,632303,706581,74278,-,-
BAC95_J07,7,7p22.3,706893,823769,116876,-,-
BAC188_B14,7,7p22.3,706894,793924,87030,-,-
BAC184_E05,7,7p22.3,737779,846642,108863,-,-
BAC105_L20,7,7p22.3,793969,898233,104264,-,-
BAC66_E04,7,7p22.3,793969,946492,152523,-,-
BAC246_I12,7,7p22.3,823814,901065,77251,-,-
BAC166_M11,7,7p22.3,849367,970524,121157,yes,-
BAC143_D23,7,7p22.3,970762,1064993,94231,-,-
BAC52_P21,7,7p22.3,978296,1159916,181620,-,-
BAC137_N14,7,7p22.3,1032120,1180388,148268,-,-
BAC170_A22,7,7p22.3,1053941,1138039,84098,-,-
BAC192_P06,7,7p22.3,1240688,1341291,100603,-,-
BAC10_H11,7,7p22.3,1322209,1405954,83745,-,-
BAC91_A13,7,7p22.3,1322209,1428300,106091,-,-
BAC81_E21,7,7p22.3,1327505,1455463,127958,-,-
BAC178_C09,7,7p22.3,1330673,1405957,75284,-,-
BAC102_H17,7,7p22.3,1360361,1518070,157709,-,-
BAC11_A17,7,7p22.3,1518104,1652008,133904,yes,-
BAC31_E01,7,7p22.3,1599377,1733401,134024,-,-
BAC67_L06,7,7p22.3,1604813,1721284,116471,-,-
BAC126_H21,7,7p22.3,1641553,1739018,97465,-,-
BAC110_P02,7,7p22.3,1721281,1843654,122373,-,-
BAC169_J20,7,7p22.3,1721317,1844535,123218,-,-
BAC149_E17,7,7p22.3,1739081,1832474,93393,-,-
BAC150_M12,7,7p22.3,1740128,1844535,104407,-,-
BAC162_G10,7,7p22.3,1776215,1854617,78402,-,-
BAC151_H10,7,7p22.3,1776245,1854614,78369,-,-
BAC248_D16,7,7p22.3,1838499,1918989,80490,-,-
BAC147_B17,7,7p22.3,1843644,1929418,85774,-,-
BAC142_O10,7,7p22.3-7p22.2,2012962,2157771,144809,-,-
BAC169_G16,7,7p22.3-7p22.2,2046120,2137113,90993,-,-
BAC39_H08,7,7p22.2,2199114,2332873,133759,-,-
BAC31_O04,7,7p22.2,2207792,2306561,98769,-,-
BAC35_D19,7,7p22.2,2207845,2304197,96352,-,-
BAC170_P10,7,7p22.2,2214345,2310704,96359,-,-
BAC167_N21,7,7p22.2,2258418,2368880,110462,-,-
BAC181_G05,7,7p22.2,2325623,2430667,105044,-,-
BAC217_C07,7,7p22.2,2372055,2494859,122804,-,-
BAC220_F20,7,7p22.2,2431876,2517925,86049,-,-
BAC65_F03,7,7p22.2,2499886,2579694,79808,-,-
BAC208_J15,7,7p22.2,2503022,2584908,81886,-,-
BAC39_G19,7,7p22.2,2598470,2768571,170101,-,-
BAC76_F20,7,7p22.2,2618139,2705156,87017,-,-
BAC137_D14,7,7p22.2,2796217,2880634,84417,-,-
BAC205_C18,7,7p22.2,2796302,2870682,74380,-,-
BAC41_H11,7,7p22.2,2809989,2933327,123338,-,-
BAC193_M20,7,7p22.2,2820826,2933347,112521,-,-
BAC208_I01,7,7p22.2,2821007,2901758,80751,-,-
BAC55_A19,7,7p22.2,2851657,3002175,150518,-,-
BAC135_J23,7,7p22.2,2872068,2947699,75631,-,-
BAC91_G13,7,7p22.2,2947740,3099423,151683,-,-
BAC103_P17,7,7p22.2,2953086,3073380,120294,-,-
BAC32_L23,7,7p22.2,2995108,3082903,87795,-,-
BAC86_K20,7,7p22.2,3002169,3113271,111102,-,-
BAC96_J14,7,7p22.2,3093884,3201596,107712,-,-
BAC8_O07,7,7p22.2,3139269,3272381,133112,-,-
BAC10_O12,7,7p22.2,3140377,3226290,85913,-,-
BAC30_J08,7,7p22.2,3189543,3326820,137277,-,-
BAC126_D22,7,7p22.2,3272407,3374425,102018,-,-
BAC95_A23,7,7p22.2,3288812,3383608,94796,-,-
BAC101_A20,7,7p22.2,3331111,3442523,111412,-,-
BAC176_M15,7,7p22.2,3390185,3469425,79240,-,-
BAC92_D10,7,7p22.2,3398158,3552014,153856,-,-
BAC158_N23,7,7p22.2,3426173,3508194,82021,-,-
BAC156_D02,7,7p22.2,3435410,3529263,93853,-,-
BAC103_L13,7,7p22.2,3442760,3552179,109419,-,-
BAC168_P21,7,7p22.2,3444034,3549220,105186,-,-
BAC43_C05,7,7p22.2,3488157,3618748,130591,-,-
BAC220_L01,7,7p22.2,3543742,3649030,105288,-,-
BAC109_N24,7,7p22.2,3549200,3666068,116868,-,-
BAC242_J05,7,7p22.2,3549214,3645952,96738,-,-
BAC180_L11,7,7p22.2,3626291,3720861,94570,-,-
BAC168_G20,7,7p22.2,3719159,3830900,111741,-,-
BAC1_G10,7,7p22.2,3719159,3815298,96139,-,-
BAC60_B22,7,7p22.2,3719162,3825458,106296,-,-
BAC39_K09,7,7p22.2,3852857,3935370,82513,-,-
BAC220_J04,7,7p22.2,3852860,3941417,88557,-,-
BAC25_K17,7,7p22.2,3864644,3962060,97416,-,-
BAC109_G05,7,7p22.2,3908374,4007352,98978,-,-
BAC144_J02,7,7p22.2,3936153,4036965,100812,-,-
BAC211_N17,7,7p22.2,3941597,4053765,112168,-,-
BAC25_I11,7,7p22.2,3964718,4130306,165588,-,-
BAC44_G16,7,7p22.2,3976734,4123079,146345,-,-
BAC25_N05,7,7p22.2,4012709,4098380,85671,-,-
BAC233_A21,7,7p22.2,4023513,4095690,72177,-,-
BAC217_I11,7,7p22.2,4056525,4190927,134402,-,-
BAC11_K02,7,7p22.2,4077535,4174045,96510,-,-
BAC39_N17,7,7p22.2,4095683,4194837,99154,-,-
BAC238_D14,7,7p22.2,4098371,4190360,91989,-,-
BAC35_L04,7,7p22.2,4174146,4261192,87046,-,-
BAC145_F17,7,7p22.2,4226075,4317785,91710,-,-
BAC238_D13,7,7p22.2,4284114,4361373,77259,-,-
BAC201_P18,7,7p22.2,4309618,4343334,33716,-,-
BAC193_F19,7,7p22.2,4329292,4424535,95243,-,-
BAC14_G21,7,7p22.2-7p22.1,4416294,4513908,97614,-,-
BAC192_B01,7,7p22.2-7p22.1,4437769,4537415,99646,-,-
BAC217_O13,7,7p22.1,4504159,4608780,104621,-,-
BAC233_N13,7,7p22.1,4645990,4734285,88295,-,-
BAC156_O09,7,7p22.1,4645990,4730859,84869,-,-
BAC227_E07,7,7p22.1,4702434,4794683,92249,-,-
BAC31_C06,7,7p22.1,4702435,4873776,171341,-,-
BAC81_J03,7,7p22.1,4702438,4794683,92245,-,-
BAC1_J22,7,7p22.1,4709037,4794683,85646,-,-
BAC222_J05,7,7p22.1,4740858,4887880,147022,-,-
BAC145_C20,7,7p22.1,4916097,4993319,77222,-,-
BAC111_B11,7,7p22.1,4916462,4997610,81148,-,-
BAC100_B19,7,7p22.1,4937688,5037870,100182,-,-
BAC175_N01,7,7p22.1,4974681,5054728,80047,-,-
BAC25_J15,7,7p22.1,4995615,5142775,147160,-,-
BAC170_P02,7,7p22.1,4995756,5095391,99635,-,-
BAC190_C13,7,7p22.1,5037359,5127857,90498,-,-
BAC94_E10,7,7p22.1,5075640,5227386,151746,-,-
BAC52_N06,7,7p22.1,5085274,5231774,146500,-,-
BAC192_N05,7,7p22.1,5089931,5187050,97119,-,-
BAC100_K15,7,7p22.1,5089931,5231582,141651,-,-
BAC196_D03,7,7p22.1,5089949,5187050,97101,-,-
BAC151_J07,7,7p22.1,5095389,5202853,107464,-,-
BAC196_K09,7,7p22.1,5095389,5231774,136385,-,-
BAC34_I20,7,7p22.1,5110942,5231772,120830,-,-
BAC131_H04,7,7p22.1,5163924,5237906,73982,-,-
BAC10_L04,7,7p22.1,5231587,5348585,116998,-,-
BAC169_L21,7,7p22.1,5238188,5348876,110688,-,-
BAC199_J22,7,7p22.1,5253400,5353003,99603,-,-
BAC126_I11,7,7p22.1,5277036,5367300,90264,-,-
BAC197_I15,7,7p22.1,5281074,5387103,106029,-,-
BAC134_N05,7,7p22.1,5348934,5437155,88221,-,-
BAC100_B14,7,7p22.1,5352995,5437155,84160,-,-
BAC237_M14,7,7p22.1,5567016,5689023,122007,-,-
BAC188_E07,7,7p22.1,5630323,5706683,76360,-,-
BAC143_I12,7,7p22.1,5692825,5781965,89140,-,-
BAC234_K07,7,7p22.1,5726178,5829647,103469,-,-
BAC74_B18,7,7p22.1,5731197,5808559,77362,-,-
BAC222_O12,7,7p22.1,5733467,5808575,75108,-,-
BAC78_H07,7,7p22.1,5782043,5865789,83746,-,-
BAC143_L13,7,7p22.1,5808849,5908868,100019,-,-
BAC59_I03,7,7p22.1,5817696,5898180,80484,-,-
BAC158_M23,7,7p22.1,5862010,5944024,82014,-,-
BAC97_B11,7,7p22.1,5925095,6045331,120236,-,-
BAC65_D13,7,7p22.1,5951946,6038746,86800,-,-
BAC167_J16,7,7p22.1,5952122,6038746,86624,-,-
BAC117_B20,7,7p22.1,5953359,6060671,107312,-,-
BAC247_I12,7,7p22.1,5953361,6033834,80473,-,-
BAC222_B08,7,7p22.1,5962028,6041948,79920,-,-
BAC15_A13,7,7p22.1,5983706,6072044,88338,-,-
BAC235_C17,7,7p22.1,6154232,6239479,85247,-,-
BAC59_H21,7,7p22.1,6187635,6271473,83838,-,-
BAC51_M02,7,7p22.1,6187635,6276111,88476,-,-
BAC190_G06,7,7p22.1,6187638,6316489,128851,-,-
BAC141_K03,7,7p22.1,6193966,6348810,154844,-,-
BAC168_L11,7,7p22.1,6215478,6316489,101011,-,-
BAC187_A16,7,7p22.1,6234474,6316489,82015,-,-
BAC170_M06,7,7p22.1,6254418,6375783,121365,-,-
BAC155_B13,7,7p22.1,6268929,6374291,105362,-,-
BAC136_O04,7,7p22.1,6324335,6413760,89425,-,-
BAC64_N22,7,7p22.1,6409464,6505247,95783,-,-
BAC89_O16,7,7p22.1,6451508,6583688,132180,-,-
BAC217_P05,7,7p22.1,6460141,6574226,114085,-,-
BAC182_K17,7,7p22.1,6510572,6636288,125716,-,-
BAC41_O22,7,7p22.1,6553276,6636207,82931,-,-
BAC147_N09,7,7p22.1,6554000,6660703,106703,-,-
BAC57_A13,7,7p22.1,6583682,6698532,114850,-,-
BAC219_N12,7,7p22.1,6600901,6698533,97632,-,-
BAC236_J10,7,7p22.1,6753398,6864232,110834,-,-
BAC34_G15,7,7p22.1,6785326,6938271,152945,-,-
BAC125_M22,7,7p22.1,6834588,6919085,84497,-,-
BAC60_I02,7,7p22.1,6850251,6952574,102323,-,-
BAC116_P21,7,7p22.1,6897500,7016635,119135,-,-
BAC235_J01,7,7p22.1,6919504,6987739,68235,-,-
BAC50_D15,7,7p22.1,6919504,7111465,191961,-,-
BAC60_N13,7,7p22.1,6919504,7037163,117659,-,-
BAC213_I03,7,7p22.1,6920988,7006408,85420,-,-
BAC37_J18,7,7p22.1,7038651,7139003,100352,-,-
BAC122_C07,7,7p22.1,7044996,7133795,88799,-,-
BAC2_F24,7,7p22.1,7045048,7179484,134436,-,-
BAC50_P03,7,7p22.1-7p21.3,7179478,7283252,103774,-,-
BAC161_M22,7,7p21.3,7231360,7320462,89102,-,-
BAC77_E01,7,7p21.3,7292357,7398397,106040,-,-
BAC34_J19,7,7p21.3,7423363,7585802,162439,-,-
BAC66_N20,7,7p21.3,7443342,7548937,105595,-,-
BAC181_P21,7,7p21.3,7498361,7585802,87441,-,-
BAC63_N09,7,7p21.3,7527713,7632191,104478,-,-
BAC20_D11,7,7p21.3,7632208,7726664,94456,-,-
BAC104_M22,7,7p21.3,7703299,7798676,95377,-,-
BAC171_K18,7,7p21.3,7745600,7829783,84183,-,-
BAC132_E20,7,7p21.3,7748614,7827714,79100,-,-
BAC100_K13,7,7p21.3,7794050,7901590,107540,-,-
BAC224_K11,7,7p21.3,7854723,7879685,24962,-,-
BAC179_F15,7,7p21.3,7864162,8008254,144092,-,-
BAC247_F17,7,7p21.3,7875394,7969192,93798,-,-
BAC65_I02,7,7p21.3,7982144,8077733,95589,-,-
BAC235_P05,7,7p21.3,8153884,8246284,92400,-,-
BAC231_L03,7,7p21.3,8392407,8510938,118531,-,-
BAC167_L12,7,7p21.3,8437166,8524098,86932,-,-
BAC83_M09,7,7p21.3,8684216,8789332,105116,-,-
BAC127_L10,7,7p21.3,8775489,8879036,103547,-,-
BAC36_L01,7,7p21.3,8978914,9124805,145891,-,-
BAC229_A17,7,7p21.3,8996775,9118392,121617,-,-
BAC220_O10,7,7p21.3,9073413,9156092,82679,-,-
BAC165_E23,7,7p21.3,9422594,9532101,109507,-,-
BAC222_G24,7,7p21.3,9595313,9671133,75820,-,-
BAC149_I14,7,7p21.3,10046959,10126388,79429,-,-
BAC90_H21,7,7p21.3,10105625,10220699,115074,-,-
BAC190_O16,7,7p21.3,10523018,10651792,128774,-,-
BAC10_G15,7,7p21.3,10540810,10625871,85061,-,-
BAC56_G16,7,7p21.3,10664235,10774650,110415,-,-
BAC14_E13,7,7p21.3,10703926,10817714,113788,-,-
BAC124_J20,7,7p21.3,10770109,10875244,105135,-,-
BAC29_K15,7,7p21.3,10774679,10948089,173410,-,-
BAC44_E06,7,7p21.3,10778556,10858578,80022,-,-
BAC72_H19,7,7p21.3,10875237,10970967,95730,-,-
BAC176_H15,7,7p21.3,10875237,10966104,90867,-,-
BAC220_B10,7,7p21.3,10953251,11043225,89974,-,-
BAC234_J12,7,7p21.3,10979442,11067906,88464,-,-
BAC120_F16,7,7p21.3,11008088,11124203,116115,-,-
BAC172_K19,7,7p21.3,11012810,11089443,76633,-,-
BAC223_B14,7,7p21.3,11012875,11099892,87017,-,-
BAC173_H07,7,7p21.3,11112694,11199838,87144,-,-
BAC53_C06,7,7p21.3,11190712,11281147,90435,-,-
BAC173_E18,7,7p21.3,11324919,11421641,96722,-,-
BAC100_D12,7,7p21.3,11457256,11543647,86391,-,-
BAC252_A24,7,7p21.3,11527656,11635557,107901,-,-
BAC46_J02,7,7p21.3,11582234,11695273,113039,-,-
BAC192_M22,7,7p21.3,11680841,11775857,95016,-,-
BAC75_E09,7,7p21.3,11811710,11892001,80291,-,-
BAC228_M18,7,7p21.3,11915574,11969249,53675,-,-
BAC132_I21,7,7p21.3,11915576,12032554,116978,-,-
BAC15_O21,7,7p21.3,11969244,12079850,110606,-,-
BAC249_B03,7,7p21.3,11993096,12083262,90166,-,-
BAC46_F04,7,7p21.3,12113472,12250679,137207,-,-
BAC44_O06,7,7p21.3,12193694,12383471,189777,-,-
BAC235_K04,7,7p21.3,12225191,12290003,64812,-,-
BAC199_I10,7,7p21.3,12321600,12400175,78575,-,-
BAC80_H07,7,7p21.3,12557030,12682409,125379,-,-
BAC193_F13,7,7p21.3,12606150,12688201,82051,-,-
BAC151_I11,7,7p21.3,12609922,12714890,104968,-,-
BAC152_E22,7,7p21.3,12639171,12753578,114407,-,-
BAC95_B08,7,7p21.3,12652292,12758998,106706,-,-
BAC100_C13,7,7p21.3,12696960,12784991,88031,-,-
BAC103_C05,7,7p21.3,12753574,12881173,127599,-,-
BAC26_P11,7,7p21.3,12824289,12979111,154822,-,-
BAC30_H10,7,7p21.3,12840241,12945017,104776,-,-
BAC184_D19,7,7p21.3,12882785,12979119,96334,-,-
BAC70_O09,7,7p21.3,12963369,13067555,104186,-,-
BAC64_E12,7,7p21.3,13023246,13118483,95237,-,-
BAC124_O19,7,7p21.3,13077543,13168477,90934,-,-
BAC34_P15,7,7p21.3,13110568,13263737,153169,-,-
BAC217_L16,7,7p21.2,13564452,13660664,96212,-,-
BAC102_D20,7,7p21.2,13776698,13870238,93540,-,-
BAC252_F21,7,7p21.2,13842394,13971603,129209,-,-
BAC139_D05,7,7p21.2,13883774,13971640,87866,-,-
BAC240_N16,7,7p21.2,13947232,14047983,100751,-,-
BAC126_A07,7,7p21.2,13961403,14104560,143157,-,-
BAC122_K14,7,7p21.2,13961403,14104560,143157,-,-
BAC5_G23,7,7p21.2,13971634,14062402,90768,-,-
BAC127_G14,7,7p21.2,14055711,14172130,116419,-,-
BAC109_K09,7,7p21.2,14055823,14172130,116307,-,-
BAC45_N16,7,7p21.2,14132526,14288802,156276,-,-
BAC146_I17,7,7p21.2,14216058,14297756,81698,-,-
BAC10_M13,7,7p21.2,14359566,14450896,91330,-,-
BAC57_C15,7,7p21.2,14502086,14594573,92487,-,-
BAC169_F20,7,7p21.2,14596478,14697509,101031,-,-
BAC148_G23,7,7p21.2,14645925,14738782,92857,-,-
BAC128_L12,7,7p21.2,14878997,15007779,128782,-,-
BAC68_F02,7,7p21.2-7p21.1,15130363,15221040,90677,-,-
BAC103_B04,7,7p21.2-7p21.1,15187782,15314177,126395,-,-
BAC24_N01,7,7p21.2-7p21.1,15194190,15285619,91429,-,-
BAC239_N15,7,7p21.1,15348952,15425824,76872,-,-
BAC100_N18,7,7p21.1,15366400,15473053,106653,-,-
BAC65_K10,7,7p21.1,15600136,15690797,90661,-,-
BAC66_J20,7,7p21.1,15824227,15910270,86043,-,-
BAC95_J13,7,7p21.1,15829227,15945422,116195,-,-
BAC21_A10,7,7p21.1,16169930,16275271,105341,-,-
BAC153_G14,7,7p21.1,16255674,16374286,118612,-,-
BAC223_G04,7,7p21.1,16263591,16357934,94343,-,-
BAC109_D16,7,7p21.1,16296958,16398357,101399,-,-
BAC92_P02,7,7p21.1,16446472,16554516,108044,-,-
BAC75_O12,7,7p21.1,16467625,16569492,101867,-,-
BAC180_B21,7,7p21.1,16554647,16641617,86970,-,-
BAC247_L08,7,7p21.1,16629929,16737200,107271,-,-
BAC53_M18,7,7p21.1,16721211,16825195,103984,-,-
BAC142_F15,7,7p21.1,16863919,16947119,83200,-,-
BAC59_B20,7,7p21.1,16962224,17099333,137109,-,-
BAC49_M19,7,7p21.1,16999206,17101587,102381,-,-
BAC51_K16,7,7p21.1,17169838,17287097,117259,-,-
BAC113_E07,7,7p21.1,17233931,17315877,81946,-,-
BAC6_L07,7,7p21.1,17248885,17397681,148796,-,-
BAC116_D24,7,7p21.1,17337086,17435014,97928,-,-
BAC141_N10,7,7p21.1,17474450,17576486,102036,-,-
BAC148_C14,7,7p21.1,17576480,17661996,85516,-,-
BAC140_L09,7,7p21.1,17576480,17661997,85517,-,-
BAC176_G21,7,7p21.1,17592473,17689781,97308,-,-
BAC82_L17,7,7p21.1,17592473,17703514,111041,-,-
BAC56_D16,7,7p21.1,17636242,17733082,96840,-,-
BAC153_M06,7,7p21.1,17689771,17776437,86666,-,-
BAC142_C08,7,7p21.1,17914416,18021131,106715,-,-
BAC2_E24,7,7p21.1,17926369,18068744,142375,-,-
BAC89_F13,7,7p21.1,18033597,18132323,98726,-,-
BAC26_I11,7,7p21.1,18081023,18180403,99380,-,-
BAC88_D21,7,7p21.1,18192429,18287544,95115,-,-
BAC36_J21,7,7p21.1,18192429,18318789,126360,-,-
BAC150_C01,7,7p21.1,18465669,18544157,78488,-,-
BAC95_J09,7,7p21.1,18654131,18745215,91084,-,-
BAC208_B12,7,7p21.1,18810349,18931112,120763,-,-
BAC69_K15,7,7p21.1,18965098,19052644,87546,-,-
BAC62_N06,7,7p21.1-7p15.3,19388786,19503730,114944,-,-
BAC14_D07,7,7p15.3,19600402,19611760,11358,-,-
BAC68_H06,7,7p15.3,19722152,19799740,77588,-,-
BAC142_F03,7,7p15.3,19760831,19846717,85886,-,-
BAC78_M17,7,7p15.3,19786134,19872532,86398,-,-
BAC112_K01,7,7p15.3,19892481,19978169,85688,-,-
BAC239_D04,7,7p15.3,19965743,19982737,16994,-,-
BAC239_A03,7,7p15.3,20065219,20150402,85183,-,-
BAC232_J05,7,7p15.3,20162462,20258872,96410,-,-
BAC242_H10,7,7p15.3,20319362,20398670,79308,-,-
BAC148_A02,7,7p15.3,20319362,20404942,85580,-,-
BAC106_N02,7,7p15.3,20404373,20570593,166220,-,-
BAC58_A10,7,7p15.3,20565901,20699510,133609,-,-
BAC217_I17,7,7p15.3,20606054,20706078,100024,-,-
BAC65_J12,7,7p15.3,20622027,20730064,108037,-,-
BAC28_N24,7,7p15.3,20684798,20781684,96886,-,-
BAC50_D18,7,7p15.3,20684842,20774733,89891,-,-
BAC32_P23,7,7p15.3,20787968,20889128,101160,-,-
BAC64_H09,7,7p15.3,20879153,20977561,98408,-,-
BAC141_M12,7,7p15.3,20889147,20975874,86727,-,-
BAC81_F15,7,7p15.3,20968767,21073708,104941,-,-
BAC72_O15,7,7p15.3,20979643,21088715,109072,-,-
BAC147_G21,7,7p15.3,21088738,21210718,121980,-,-
BAC97_F24,7,7p15.3,21150017,21257604,107587,-,-
BAC76_I02,7,7p15.3,21163955,21259882,95927,-,-
BAC101_K05,7,7p15.3,21163955,21260444,96489,-,-
BAC224_D02,7,7p15.3,21210764,21298202,87438,-,-
BAC59_L23,7,7p15.3,21234721,21359565,124844,-,-
BAC118_D03,7,7p15.3,21236914,21352273,115359,-,-
BAC156_I16,7,7p15.3,21289979,21415482,125503,-,-
BAC17_A24,7,7p15.3,21447669,21551417,103748,-,-
BAC75_K23,7,7p15.3,21503562,21596082,92520,-,-
BAC219_E17,7,7p15.3,21578296,21658400,80104,-,-
BAC106_B18,7,7p15.3,21599481,21684206,84725,-,-
BAC59_P13,7,7p15.3,21607215,21699315,92100,-,-
BAC69_H20,7,7p15.3,21658099,21759915,101816,-,-
BAC116_P18,7,7p15.3,21658099,21755344,97245,-,-
BAC64_K14,7,7p15.3,21759896,21884658,124762,-,-
BAC129_O13,7,7p15.3,21846083,21953334,107251,-,-
BAC145_D02,7,7p15.3,21953322,22031295,77973,-,-
BAC56_N22,7,7p15.3,21982965,22090980,108015,-,-
BAC24_L03,7,7p15.3,22074113,22184903,110790,-,-
BAC244_M05,7,7p15.3,22075608,22165292,89684,-,-
BAC79_A23,7,7p15.3,22098177,22347018,248841,-,-
BAC66_C09,7,7p15.3,22160347,22180917,20570,-,-
BAC19_O12,7,7p15.3,22165783,22299396,133613,-,-
BAC243_G14,7,7p15.3,22193193,22314539,121346,-,-
BAC124_N18,7,7p15.3,22222936,22364218,141282,-,-
BAC113_B10,7,7p15.3,22243634,22348327,104693,-,-
BAC149_O21,7,7p15.3,22348321,22446861,98540,-,-
BAC238_A05,7,7p15.3,22364244,22456269,92025,-,-
BAC60_J06,7,7p15.3,22379932,22538100,158168,-,-
BAC70_F14,7,7p15.3,22400988,22540867,139879,-,-
BAC183_N17,7,7p15.3,22466823,22577086,110263,-,-
BAC140_J16,7,7p15.3,22502356,22594134,91778,-,-
BAC23_A03,7,7p15.3,22609817,22701832,92015,-,-
BAC91_M22,7,7p15.3,22631096,22721403,90307,-,-
BAC199_B07,7,7p15.3,22668951,22762803,93852,-,-
BAC200_E21,7,7p15.3,22712039,22811353,99314,-,-
BAC105_O04,7,7p15.3,22716662,22811353,94691,-,-
BAC176_M02,7,7p15.3,22743750,22861677,117927,-,-
BAC50_J02,7,7p15.3,22762966,22874444,111478,-,-
BAC38_B15,7,7p15.3,22785296,22906396,121100,-,-
BAC158_G02,7,7p15.3,22790002,22879444,89442,-,-
BAC158_H02,7,7p15.3,22790015,22879445,89430,-,-
BAC136_M20,7,7p15.3,22866664,22942275,75611,-,-
BAC56_J09,7,7p15.3,22874438,22957567,83129,-,-
BAC149_P07,7,7p15.3,22889068,23001220,112152,-,-
BAC153_A03,7,7p15.3,23001214,23081409,80195,-,-
BAC39_A04,7,7p15.3,23001222,23088758,87536,-,-
BAC79_L19,7,7p15.3,23010968,23043640,32672,-,-
BAC39_B03,7,7p15.3,23030823,23129593,98770,-,-
BAC120_J20,7,7p15.3,23181100,23278350,97250,-,-
BAC78_M21,7,7p15.3,23189404,23288447,99043,-,-
BAC135_P01,7,7p15.3,23207330,23301027,93697,-,-
BAC195_I13,7,7p15.3,23248481,23336429,87948,-,-
BAC123_J21,7,7p15.3,23291142,23413294,122152,-,-
BAC110_N08,7,7p15.3,23297274,23413294,116020,-,-
BAC104_A21,7,7p15.3,23330875,23415284,84409,-,-
BAC78_B22,7,7p15.3,23339353,23416901,77548,-,-
BAC122_H07,7,7p15.3,23343562,23440235,96673,-,-
BAC75_P08,7,7p15.3,23359881,23440230,80349,-,-
BAC115_A14,7,7p15.3,23443823,23532510,88687,-,-
BAC27_B02,7,7p15.3,23511221,23663922,152701,-,-
BAC239_G04,7,7p15.3,23534374,23614523,80149,-,-
BAC84_D04,7,7p15.3,23539290,23663994,124704,-,-
BAC36_L16,7,7p15.3,23544199,23656877,112678,-,-
BAC52_P20,7,7p15.3,23604331,23714749,110418,-,-
BAC193_A17,7,7p15.3,23715034,23819904,104870,-,-
BAC200_B18,7,7p15.3,23728885,23808656,79771,-,-
BAC241_B12,7,7p15.3,23737589,23868350,130761,-,-
BAC42_B12,7,7p15.3,23737589,23904091,166502,-,-
BAC242_F05,7,7p15.3,23928885,24039511,110626,-,-
BAC63_C21,7,7p15.3,23947845,24062394,114549,-,-
BAC27_A07,7,7p15.3,24123857,24242813,118956,-,-
BAC196_A06,7,7p15.3,24138782,24234405,95623,-,-
BAC143_N08,7,7p15.3,24147431,24233095,85664,-,-
BAC162_B14,7,7p15.3,24207290,24283932,76642,-,-
BAC189_P24,7,7p15.3,24242805,24328094,85289,-,-
BAC65_O05,7,7p15.3,24258166,24345367,87201,-,-
BAC61_K05,7,7p15.3,24358852,24443513,84661,-,-
BAC187_G17,7,7p15.3,24710886,24789675,78789,-,-
BAC29_A03,7,7p15.3-7p15.2,24789687,24935985,146298,-,-
BAC233_D13,7,7p15.3-7p15.2,24806051,24900780,94729,-,-
BAC101_H05,7,7p15.3-7p15.2,24821697,24931927,110230,-,-
BAC131_G08,7,7p15.3-7p15.2,24833807,24923062,89255,-,-
BAC194_E02,7,7p15.2,24900795,24991095,90300,-,-
BAC194_J12,7,7p15.2,24913419,24987888,74469,-,-
BAC42_P18,7,7p15.2,24956893,25059778,102885,-,-
BAC75_H08,7,7p15.2,24979966,25072714,92748,-,-
BAC124_C17,7,7p15.2,24998519,25016720,18201,-,-
BAC150_C03,7,7p15.2,25019513,25104119,84606,-,-
BAC78_O08,7,7p15.2,25060169,25158482,98313,-,-
BAC63_B08,7,7p15.2,25109835,25233333,123498,-,-
BAC211_E10,7,7p15.2,25115211,25205205,89994,-,-
BAC251_L05,7,7p15.2,25131012,25214369,83357,-,-
BAC240_F08,7,7p15.2,25131012,25206293,75281,-,-
BAC40_E18,7,7p15.2,25138454,25259815,121361,-,-
BAC58_J16,7,7p15.2,25258389,25378792,120403,-,-
BAC42_E11,7,7p15.2,25259817,25354362,94545,-,-
BAC140_D07,7,7p15.2,25354418,25460005,105587,-,-
BAC10_G03,7,7p15.2,25369319,25454844,85525,-,-
BAC21_P06,7,7p15.2,25369479,25454844,85365,-,-
BAC54_C05,7,7p15.2,25369979,25476014,106035,-,-
BAC8_O15,7,7p15.2,25378798,25483400,104602,-,-
BAC41_C15,7,7p15.2,25400658,25509605,108947,-,-
BAC118_L02,7,7p15.2,25425487,25538938,113451,-,-
BAC29_B16,7,7p15.2,25497098,25593717,96619,-,-
BAC252_C08,7,7p15.2,25510251,25617965,107714,-,-
BAC92_P09,7,7p15.2,25593338,25694813,101475,-,-
BAC67_D15,7,7p15.2,25607516,25707811,100295,-,-
BAC200_H19,7,7p15.2,25622195,25714339,92144,-,-
BAC252_I03,7,7p15.2,25666042,25802093,136051,-,-
BAC22_H04,7,7p15.2,25694868,25829167,134299,-,-
BAC106_C11,7,7p15.2,25706030,25797027,90997,-,-
BAC191_O22,7,7p15.2,25769585,25851421,81836,-,-
BAC242_B09,7,7p15.2,25840208,25920853,80645,-,-
BAC69_C10,7,7p15.2,25875719,25974575,98856,-,-
BAC177_B20,7,7p15.2,25928869,26020570,91701,-,-
BAC154_D10,7,7p15.2,26020574,26101521,80947,-,-
BAC129_I17,7,7p15.2,26034772,26135296,100524,-,-
BAC40_H22,7,7p15.2,26065251,26167480,102229,-,-
BAC181_D12,7,7p15.2,26115260,26197344,82084,-,-
BAC196_P13,7,7p15.2,26137812,26251301,113489,-,-
BAC169_G15,7,7p15.2,26180960,26265977,85017,-,-
BAC37_A06,7,7p15.2,26310720,26480895,170175,-,-
BAC181_K13,7,7p15.2,26316128,26411497,95369,-,-
BAC182_E19,7,7p15.2,26335627,26428782,93155,-,-
BAC84_M05,7,7p15.2,26411754,26575737,163983,-,-
BAC88_H04,7,7p15.2,26421617,26528905,107288,-,-
BAC240_N03,7,7p15.2,26441279,26536857,95578,-,-
BAC31_C02,7,7p15.2,26446814,26541101,94287,-,-
BAC221_G05,7,7p15.2,26634687,26729274,94587,-,-
BAC8_C12,7,7p15.2,26634687,26729269,94582,-,-
BAC15_E04,7,7p15.2,26634687,26729258,94571,-,-
BAC113_L16,7,7p15.2,26779974,26907250,127276,-,-
BAC30_L03,7,7p15.2,26801507,26898410,96903,-,-
BAC38_G24,7,7p15.2,26801507,26915694,114187,-,-
BAC11_D14,7,7p15.2,26838815,26915698,76883,-,-
BAC126_J21,7,7p15.2,26928748,27014252,85504,-,-
BAC122_O22,7,7p15.2,26928748,27014251,85503,-,-
BAC229_G04,7,7p15.2,26928779,27010963,82184,-,-
BAC155_A15,7,7p15.2,26981833,26992004,10171,-,-
BAC218_N01,7,7p15.2,27134934,27246285,111351,-,-
BAC188_P15,7,7p15.2,27187926,27270150,82224,-,-
BAC109_F05,7,7p15.2,27334833,27431879,97046,-,-
BAC144_P07,7,7p15.2,27348941,27442136,93195,-,-
BAC55_I13,7,7p15.2,27417642,27505997,88355,-,-
BAC6_P23,7,7p15.2,27435957,27523635,87678,-,-
BAC130_B09,7,7p15.2,27442165,27525394,83229,-,-
BAC169_P17,7,7p15.2,27447268,27527393,80125,-,-
BAC237_B14,7,7p15.2,27470133,27553885,83752,-,-
BAC60_A04,7,7p15.2,27470133,27633838,163705,-,-
BAC227_O02,7,7p15.2,27473417,27563849,90432,-,-
BAC141_K04,7,7p15.2,27520283,27607047,86764,-,-
BAC19_C15,7,7p15.2,27580682,27705440,124758,-,-
BAC236_F04,7,7p15.2,27654069,27749165,95096,-,-
BAC37_N11,7,7p15.2,27732577,27862148,129571,-,-
BAC80_E05,7,7p15.2,27756700,27914554,157854,-,-
BAC89_K14,7,7p15.2,27769255,27862151,92896,-,-
BAC167_I03,7,7p15.2,27827795,27901805,74010,-,-
BAC97_I03,7,7p15.2-7p15.1,27916796,28031117,114321,-,-
BAC226_P09,7,7p15.2-7p15.1,27921354,28011175,89821,-,-
BAC234_F01,7,7p15.1,28021416,28134771,113355,-,-
BAC109_J10,7,7p15.1,28133238,28213633,80395,-,-
BAC80_P21,7,7p15.1,28338656,28435077,96421,-,-
BAC230_N15,7,7p15.1,28344146,28479302,135156,-,-
BAC173_O12,7,7p15.1,28485153,28561215,76062,-,-
BAC242_B11,7,7p15.1,28493815,28600098,106283,-,-
BAC144_L13,7,7p15.1,28524174,28646528,122354,-,-
BAC158_D11,7,7p15.1,28556390,28623024,66634,-,-
BAC158_C11,7,7p15.1,28556390,28623093,66703,-,-
BAC31_P14,7,7p15.1,28579808,28733756,153948,-,-
BAC120_K15,7,7p15.1,28582979,28720005,137026,-,-
BAC161_I08,7,7p15.1,28779499,28885609,106110,-,-
BAC169_J02,7,7p15.1,28797876,28886587,88711,-,-
BAC126_N10,7,7p15.1,28903382,29018997,115615,-,-
BAC122_L20,7,7p15.1,28903385,29018978,115593,-,-
BAC126_G10,7,7p15.1,28903410,29018990,115580,-,-
BAC117_I15,7,7p15.1,28916824,28994125,77301,-,-
BAC27_C23,7,7p15.1,28968023,29125403,157380,-,-
BAC221_H14,7,7p15.1,28999907,29081656,81749,-,-
BAC53_A03,7,7p15.1,29026947,29125424,98477,-,-
BAC104_N20,7,7p15.1,29066161,29154167,88006,-,-
BAC160_N20,7,7p15.1,29079430,29191938,112508,-,-
BAC222_M17,7,7p15.1,29124234,29223032,98798,-,-
BAC68_H10,7,7p15.1,29191931,29296477,104546,-,-
BAC150_I24,7,7p15.1,29297856,29386801,88945,-,-
BAC32_B20,7,7p15.1,29307531,29423836,116305,-,-
BAC163_L17,7,7p15.1,29319390,29403631,84241,-,-
BAC68_O03,7,7p15.1,29377524,29450187,72663,-,-
BAC44_N10,7,7p15.1,29386826,29513938,127112,-,-
BAC249_F09,7,7p15.1,29403337,29473887,70550,-,-
BAC168_H16,7,7p15.1,29429809,29522792,92983,-,-
BAC139_K10,7,7p15.1,29514064,29615151,101087,-,-
BAC232_O13,7,7p15.1,29560345,29656969,96624,-,-
BAC67_L23,7,7p15.1,29593334,29682723,89389,-,-
BAC105_H15,7,7p15.1,29615145,29748515,133370,-,-
BAC218_F09,7,7p15.1,29656964,29737531,80567,-,-
BAC43_N06,7,7p15.1,29753613,29851783,98170,-,-
BAC240_P02,7,7p15.1,29851776,29935878,84102,-,-
BAC252_L14,7,7p15.1,29868808,29982845,114037,-,-
BAC135_N17,7,7p15.1,29942043,30026143,84100,-,-
BAC100_E09,7,7p15.1,29957285,30084790,127505,-,-
BAC21_A20,7,7p15.1,30037051,30154153,117102,-,-
BAC183_O04,7,7p15.1,30069232,30148863,79631,-,-
BAC140_J22,7,7p15.1,30069232,30145206,75974,-,-
BAC249_F21,7,7p15.1,30070181,30145206,75025,-,-
BAC169_H07,7,7p15.1,30122616,30197834,75218,-,-
BAC240_B20,7,7p15.1,30185954,30315338,129384,-,-
BAC122_A03,7,7p15.1,30197858,30341516,143658,-,-
BAC160_N14,7,7p15.1,30228425,30329449,101024,-,-
BAC60_H04,7,7p15.1,30230072,30331376,101304,-,-
BAC181_K04,7,7p15.1,30257953,30346218,88265,-,-
BAC135_B15,7,7p15.1,30311637,30394979,83342,-,-
BAC25_G22,7,7p15.1,30429019,30576791,147772,-,-
BAC197_A02,7,7p15.1,30455974,30550524,94550,-,-
BAC175_M14,7,7p15.1,30455974,30544982,89008,-,-
BAC157_A19,7,7p15.1,30457191,30544977,87786,-,-
BAC21_D16,7,7p15.1,30475583,30567833,92250,-,-
BAC203_J05,7,7p15.1,30584902,30660731,75829,-,-
BAC231_F05,7,7p15.1,30618446,30721587,103141,-,-
BAC153_A18,7,7p15.1,30624990,30706965,81975,-,-
BAC243_E02,7,7p15.1,30629861,30778258,148397,-,-
BAC91_P14,7,7p15.1,30630261,30704984,74723,-,-
BAC140_H13,7,7p15.1,30651094,30746576,95482,-,-
BAC39_K20,7,7p15.1,30687004,30831370,144366,-,-
BAC75_F23,7,7p15.1,30704996,30798024,93028,-,-
BAC19_N05,7,7p15.1,30708736,30820382,111646,-,-
BAC118_J16,7,7p15.1,30751288,30891318,140030,-,-
BAC91_B24,7,7p15.1,30751288,30879267,127979,-,-
BAC59_N14,7,7p15.1,30798308,30934378,136070,-,-
BAC182_E23,7,7p15.1,30837241,30940049,102808,-,-
BAC32_J21,7,7p15.1,30923922,31032135,108213,-,-
BAC45_G06,7,7p15.1,30941502,31075977,134475,-,-
BAC45_B13,7,7p15.1,30950874,31044442,93568,-,-
BAC33_F21,7,7p15.1,30952563,31063276,110713,-,-
BAC28_F17,7,7p15.1,30965070,31063276,98206,-,-
BAC247_L09,7,7p15.1,30965985,31063276,97291,-,-
BAC163_K07,7,7p15.1,30965998,31082622,116624,-,-
BAC180_A16,7,7p15.1,31063351,31142712,79361,-,-
BAC168_N07,7,7p15.1,31101695,31191598,89903,-,-
BAC106_J13,7,7p15.1,31119927,31215899,95972,-,-
BAC235_F06,7,7p15.1,31171061,31250135,79074,-,-
BAC67_B05,7,7p15.1,31261519,31350060,88541,-,-
BAC28_L16,7,7p15.1,31278366,31388416,110050,-,-
BAC157_E09,7,7p15.1,31356258,31471349,115091,-,-
BAC84_B21,7,7p15.1,31359226,31457147,97921,-,-
BAC210_O14,7,7p15.1,31518729,31603836,85107,-,-
BAC166_C07,7,7p15.1,31608989,31700391,91402,-,-
BAC230_K16,7,7p15.1-7p14.3,31681294,31806112,124818,-,-
BAC90_O12,7,7p15.1-7p14.3,31690492,31801702,111210,-,-
BAC195_I07,7,7p15.1,31713064,31797387,84323,-,-
BAC161_H20,7,7p15.1-7p14.3,31755250,31854580,99330,-,-
BAC143_E14,7,7p15.1-7p14.3,31768901,31852133,83232,-,-
BAC243_H12,7,7p15.1-7p14.3,31797381,31881926,84545,-,-
BAC44_C01,7,7p14.3,31950423,32054976,104553,-,-
BAC247_G03,7,7p14.3,32155036,32236133,81097,-,-
BAC82_P21,7,7p14.3,32155056,32261909,106853,-,-
BAC106_C08,7,7p14.3,32172202,32275422,103220,-,-
BAC191_J14,7,7p14.3,32172202,32275997,103795,-,-
BAC121_D09,7,7p14.3,32236251,32335967,99716,-,-
BAC191_B04,7,7p14.3,32244784,32336421,91637,-,-
BAC167_M10,7,7p14.3,32262318,32335974,73656,-,-
BAC231_A15,7,7p14.3,32425445,32524618,99173,-,-
BAC156_C03,7,7p14.3,32442080,32524671,82591,-,-
BAC120_N14,7,7p14.3,32442214,32524671,82457,-,-
BAC81_A14,7,7p14.3,32524667,32600037,75370,-,-
BAC82_E06,7,7p14.3,32525115,32618671,93556,-,-
BAC75_F12,7,7p14.3,32531592,32618108,86516,-,-
BAC160_P05,7,7p14.3,32546717,32643246,96529,-,-
BAC25_I02,7,7p14.3,32647362,32729485,82123,-,-
BAC237_F19,7,7p14.3,32647372,32728408,81036,-,-
BAC101_D01,7,7p14.3,32750530,32835868,85338,-,-
BAC38_D13,7,7p14.3,32750530,32847118,96588,-,-
BAC77_O24,7,7p14.3,32750539,32842902,92363,-,-
BAC51_M04,7,7p14.3,32889234,32974417,85183,-,-
BAC25_L17,7,7p14.3,32894190,33046639,152449,-,-
BAC25_H14,7,7p14.3,32953891,33058900,105009,-,-
BAC200_M10,7,7p14.3,32980872,33066138,85266,-,-
BAC145_L22,7,7p14.3,32980872,33051897,71025,-,-
BAC10_G22,7,7p14.3,32980876,33097437,116561,-,-
BAC36_I12,7,7p14.3,33025824,33151240,125416,-,-
BAC124_O15,7,7p14.3,33046633,33197113,150480,-,-
BAC69_N07,7,7p14.3,33058906,33154009,95103,-,-
BAC240_C09,7,7p14.3,33058908,33151238,92330,-,-
BAC200_G16,7,7p14.3,33060933,33144326,83393,-,-
BAC14_A19,7,7p14.3,33077572,33159605,82033,-,-
BAC5_P12,7,7p14.3,33199631,33300728,101097,-,-
BAC126_G18,7,7p14.3,33200890,33331364,130474,-,-
BAC122_J07,7,7p14.3,33200890,33331364,130474,-,-
BAC186_N07,7,7p14.3,33392813,33486178,93365,-,-
BAC114_K21,7,7p14.3,33495909,33585218,89309,-,-
BAC181_G23,7,7p14.3,33503877,33584799,80922,-,-
BAC31_L12,7,7p14.3,33585211,33698722,113511,-,-
BAC224_L14,7,7p14.3,33634967,33755215,120248,-,-
BAC43_P10,7,7p14.3,33666688,33796629,129941,-,-
BAC67_P07,7,7p14.3,33676481,33795263,118782,-,-
BAC118_C14,7,7p14.3,33716740,33812963,96223,-,-
BAC134_M21,7,7p14.3,33733593,33809083,75490,-,-
BAC125_M14,7,7p14.3,33828007,33968865,140858,-,-
BAC122_B10,7,7p14.3,33843223,33922405,79182,-,-
BAC241_I05,7,7p14.3,33851573,33932447,80874,-,-
BAC92_K08,7,7p14.3,33858448,33963704,105256,-,-
BAC252_F17,7,7p14.3,33893803,34024513,130710,-,-
BAC108_A18,7,7p14.3,33922563,34045349,122786,-,-
BAC50_I23,7,7p14.3,33968385,34057784,89399,-,-
BAC52_F05,7,7p14.3,33977605,34061552,83947,-,-
BAC127_P18,7,7p14.3,33978839,34067930,89091,-,-
BAC6_B01,7,7p14.3,33987570,34103691,116121,-,-
BAC53_M11,7,7p14.3,34104844,34120216,15372,-,-
BAC136_K14,7,7p14.3,34162804,34266919,104115,-,-
BAC149_P20,7,7p14.3,34175331,34253375,78044,-,-
BAC115_D13,7,7p14.3,34201723,34326453,124730,-,-
BAC57_F23,7,7p14.3,34313068,34438817,125749,-,-
BAC10_E11,7,7p14.3,34313451,34463649,150198,-,-
BAC153_P01,7,7p14.3,34342466,34427164,84698,-,-
BAC105_M12,7,7p14.3,34372707,34451475,78768,-,-
BAC78_L04,7,7p14.3,34382784,34463659,80875,-,-
BAC82_I20,7,7p14.3,34393197,34481777,88580,-,-
BAC30_E03,7,7p14.3,34571619,34677807,106188,-,-
BAC170_K08,7,7p14.3,34577020,34657877,80857,-,-
BAC66_G02,7,7p14.3,34606346,34717038,110692,-,-
BAC74_E23,7,7p14.3,34674935,34779643,104708,-,-
BAC163_D10,7,7p14.3,34740650,34817886,77236,-,-
BAC120_E08,7,7p14.3,34803149,34897971,94822,-,-
BAC75_J03,7,7p14.3,34848249,34944931,96682,-,-
BAC233_O18,7,7p14.3,34848334,34945239,96905,-,-
BAC234_J02,7,7p14.3,34864835,34955564,90729,-,-
BAC99_E24,7,7p14.3,34979986,35120025,140039,-,-
BAC172_B22,7,7p14.3,35001537,35087642,86105,-,-
BAC240_C02,7,7p14.3,35161722,35248751,87029,-,-
BAC249_A10,7,7p14.3,35225030,35314504,89474,-,-
BAC7_K22,7,7p14.3,35301451,35392099,90648,-,-
BAC23_L06,7,7p14.3,35392115,35514807,122692,-,-
BAC217_D08,7,7p14.3,35407994,35502471,94477,-,-
BAC179_C04,7,7p14.3,35412755,35508142,95387,-,-
BAC176_M19,7,7p14.3-7p14.2,35582448,35672931,90483,-,-
BAC19_L18,7,7p14.2,35627711,35709945,82234,-,-
BAC222_M13,7,7p14.2,35714343,35809529,95186,-,-
BAC102_K08,7,7p14.2,35812327,35941333,129006,-,-
BAC89_K07,7,7p14.2,35831411,35913426,82015,-,-
BAC250_P13,7,7p14.2,35874075,35968704,94629,-,-
BAC12_H22,7,7p14.2,35983936,36071359,87423,-,-
BAC169_A11,7,7p14.2,35998557,36096773,98216,-,-
BAC65_A15,7,7p14.2,36027852,36122328,94476,-,-
BAC197_A12,7,7p14.2,36032430,36116250,83820,-,-
BAC169_O02,7,7p14.2,36032430,36126847,94417,-,-
BAC43_I05,7,7p14.2,36071356,36193312,121956,-,-
BAC29_B05,7,7p14.2,36076379,36155259,78880,-,-
BAC102_B11,7,7p14.2,36076411,36229768,153357,-,-
BAC133_D16,7,7p14.2,36096767,36188772,92005,-,-
BAC243_F14,7,7p14.2,36096767,36167481,70714,-,-
BAC116_H06,7,7p14.2,36096768,36193278,96510,-,-
BAC107_D01,7,7p14.2,36109266,36208219,98953,-,-
BAC102_H10,7,7p14.2,36116245,36252956,136711,-,-
BAC26_C14,7,7p14.2,36118369,36256961,138592,-,-
BAC150_B17,7,7p14.2,36138809,36224945,86136,-,-
BAC65_I04,7,7p14.2,36188766,36270379,81613,-,-
BAC236_A11,7,7p14.2,36188791,36290226,101435,-,-
BAC89_C11,7,7p14.2,36211123,36314382,103259,-,-
BAC113_B09,7,7p14.2,36229762,36346914,117152,-,-
BAC156_E03,7,7p14.2,36230308,36320753,90445,-,-
BAC193_M17,7,7p14.2,36252948,36348315,95367,-,-
BAC140_H12,7,7p14.2,36252952,36333942,80990,-,-
BAC24_A20,7,7p14.2,36256857,36365641,108784,-,-
BAC114_B15,7,7p14.2,36270372,36365688,95316,-,-
BAC13_E01,7,7p14.2,36270417,36362649,92232,-,-
BAC250_I04,7,7p14.2,36384643,36505562,120919,-,-
BAC46_O14,7,7p14.2,36391012,36495798,104786,-,-
BAC57_D19,7,7p14.2,36514637,36617045,102408,-,-
BAC170_D08,7,7p14.2,36585073,36687395,102322,-,-
BAC172_M16,7,7p14.2,36605433,36683601,78168,-,-
BAC118_K04,7,7p14.2,36608393,36698888,90495,-,-
BAC224_M03,7,7p14.2,36647151,36751711,104560,-,-
BAC213_C02,7,7p14.2,36714994,36798664,83670,-,-
BAC179_D01,7,7p14.2,36763541,36839997,76456,-,-
BAC68_M17,7,7p14.2,36797944,36964006,166062,-,-
BAC152_N06,7,7p14.2,36888102,36964006,75904,-,-
BAC252_I15,7,7p14.2,36915043,37136216,221173,-,-
BAC33_D02,7,7p14.2,36921407,37018293,96886,-,-
BAC227_F09,7,7p14.2,37061236,37160658,99422,-,-
BAC8_A04,7,7p14.2,37138041,37247886,109845,-,-
BAC161_L15,7,7p14.2,37191707,37291181,99474,-,-
BAC188_F05,7,7p14.2,37202005,37292167,90162,-,-
BAC226_H20,7,7p14.2,37278052,37399239,121187,-,-
BAC141_O22,7,7p14.2,37292383,37399248,106865,-,-
BAC23_F11,7,7p14.2,37366210,37499720,133510,-,-
BAC44_K11,7,7p14.2-7p14.1,37490528,37587152,96624,-,-
BAC62_A03,7,7p14.1,37545561,37675163,129602,-,-
BAC29_B22,7,7p14.1,37559611,37644764,85153,-,-
BAC92_O13,7,7p14.1,37574227,37698401,124174,-,-
BAC169_E12,7,7p14.1,37644332,37743281,98949,-,-
BAC171_G13,7,7p14.1,37769517,37842756,73239,-,-
BAC54_P12,7,7p14.1,37828515,37954469,125954,yes,-
BAC244_B06,7,7p14.1,37842767,37907106,64339,yes,-
BAC135_N18,7,7p14.1,37966630,38043061,76431,-,-
BAC48_C16,7,7p14.1,38227470,38332487,105017,-,-
BAC183_C18,7,7p14.1,38259706,38357671,97965,-,-
BAC137_F15,7,7p14.1,38281162,38361982,80820,-,-
BAC193_L03,7,7p14.1,38282456,38357195,74739,-,-
BAC196_E12,7,7p14.1,38309109,38401349,92240,-,-
BAC150_B05,7,7p14.1,38362022,38452059,90037,-,-
BAC165_E24,7,7p14.1,38366883,38456875,89992,-,-
BAC69_K03,7,7p14.1,38371152,38452059,80907,-,-
BAC106_I03,7,7p14.1,38403099,38521022,117923,-,-
BAC155_A17,7,7p14.1,38452183,38555149,102966,-,-
BAC20_G01,7,7p14.1,38452205,38543573,91368,-,-
BAC166_B01,7,7p14.1,38521030,38615076,94046,-,-
BAC195_N20,7,7p14.1,38543568,38651844,108276,-,-
BAC76_K06,7,7p14.1,38582989,38678784,95795,-,-
BAC109_P03,7,7p14.1,38647994,38755856,107862,-,-
BAC80_M14,7,7p14.1,38667429,38824799,157370,-,-
BAC162_D12,7,7p14.1,38764969,38880791,115822,-,-
BAC46_B23,7,7p14.1,38858929,38880995,22066,-,-
BAC168_K11,7,7p14.1,38880993,38938576,57583,-,-
BAC116_O19,7,7p14.1,38939595,39025486,85891,-,-
BAC148_A11,7,7p14.1,39028850,39148552,119702,-,-
BAC123_O17,7,7p14.1,39046320,39190747,144427,-,-
BAC102_N24,7,7p14.1,39108412,39235413,127001,-,-
BAC127_A09,7,7p14.1,39152149,39242670,90521,-,-
BAC246_N11,7,7p14.1,39232714,39248048,15334,-,-
BAC122_B09,7,7p14.1,39286797,39380123,93326,-,-
BAC166_A02,7,7p14.1,39294237,39380394,86157,-,-
BAC86_A14,7,7p14.1,39297632,39380398,82766,-,-
BAC43_J11,7,7p14.1,39340153,39438524,98371,-,-
BAC61_N23,7,7p14.1,39344801,39493528,148727,-,-
BAC184_D12,7,7p14.1,39368524,39460527,92003,-,-
BAC68_P10,7,7p14.1,39380391,39466739,86348,-,-
BAC59_B11,7,7p14.1,39466734,39553575,86841,-,-
BAC64_O04,7,7p14.1,39479910,39567406,87496,-,-
BAC105_G05,7,7p14.1,39535377,39618184,82807,-,-
BAC67_I23,7,7p14.1,39535378,39690840,155462,-,-
BAC73_N10,7,7p14.1,39541514,39621512,79998,-,-
BAC113_B12,7,7p14.1,39561187,39690836,129649,-,-
BAC95_I09,7,7p14.1,39577417,39661680,84263,-,-
BAC33_D16,7,7p14.1,39594322,39690836,96514,-,-
BAC40_G16,7,7p14.1,39618178,39764311,146133,-,-
BAC58_K10,7,7p14.1,39656211,39788678,132467,-,-
BAC67_O06,7,7p14.1,39807187,39898916,91729,-,-
BAC238_L02,7,7p14.1,39807378,39898919,91541,-,-
BAC118_J06,7,7p14.1,39964101,40095822,131721,-,-
BAC224_A10,7,7p14.1,39970113,40059140,89027,-,-
BAC243_C19,7,7p14.1,39984157,40068379,84222,-,-
BAC147_E11,7,7p14.1,39990035,40072447,82412,-,-
BAC180_G17,7,7p14.1,40009904,40123906,114002,-,-
BAC41_B02,7,7p14.1,40009961,40123926,113965,-,-
BAC10_D01,7,7p14.1,40409443,40500211,90768,-,-
BAC84_C18,7,7p14.1,40538928,40632320,93392,-,-
BAC122_A02,7,7p14.1,40660533,40775679,115146,-,-
BAC144_J06,7,7p14.1,40698568,40775679,77111,-,-
BAC83_B14,7,7p14.1,40769902,40854252,84350,-,-
BAC171_A16,7,7p14.1,40931176,41009384,78208,-,-
BAC249_D11,7,7p14.1,40999382,41090947,91565,-,-
BAC249_D05,7,7p14.1,41016448,41109976,93528,-,-
BAC34_G12,7,7p14.1,41030400,41104464,74064,-,-
BAC193_I03,7,7p14.1,41042052,41123681,81629,-,-
BAC244_K14,7,7p14.1,41046624,41144375,97751,-,-
BAC34_H18,7,7p14.1,41110672,41221099,110427,-,-
BAC209_O15,7,7p14.1,41123679,41208940,85261,-,-
BAC18_D10,7,7p14.1,41172740,41267244,94504,-,-
BAC163_L07,7,7p14.1,41209318,41309358,100040,-,-
BAC50_G11,7,7p14.1,41236262,41342820,106558,-,-
BAC146_K15,7,7p14.1,41258235,41378121,119886,-,-
BAC66_B11,7,7p14.1,41267327,41359599,92272,-,-
BAC76_I23,7,7p14.1,41306094,41441389,135295,-,-
BAC36_G07,7,7p14.1,41356100,41446974,90874,-,-
BAC122_F23,7,7p14.1,41359803,41459363,99560,-,-
BAC35_P03,7,7p14.1,41374145,41460884,86739,-,-
BAC25_F07,7,7p14.1,41571217,41675538,104321,-,-
BAC148_J07,7,7p14.1,41599164,41688090,88926,-,-
BAC145_G20,7,7p14.1,41630307,41688092,57785,-,-
BAC36_J11,7,7p14.1,41657680,41788137,130457,-,-
BAC191_H14,7,7p14.1,41760686,41834190,73504,-,-
BAC31_D18,7,7p14.1,41793242,41971072,177830,-,-
BAC10_D06,7,7p14.1,41848712,41971072,122360,-,-
BAC175_H22,7,7p14.1,41881070,41988273,107203,-,-
BAC81_D09,7,7p14.1,41934229,42051178,116949,-,-
BAC5_A09,7,7p14.1,41971065,42072309,101244,-,-
BAC78_C15,7,7p14.1,41988262,42072325,84063,-,-
BAC102_C15,7,7p14.1,41988267,42153544,165277,-,-
BAC36_G18,7,7p14.1,42001626,42109050,107424,-,-
BAC97_E06,7,7p14.1,42170293,42317010,146717,-,-
BAC234_H02,7,7p14.1,42233783,42316836,83053,-,-
BAC63_B01,7,7p14.1,42250933,42359444,108511,-,-
BAC232_L04,7,7p14.1,42255545,42373899,118354,-,-
BAC23_B17,7,7p14.1,42288196,42407681,119485,-,-
BAC124_K03,7,7p14.1,42335582,42414144,78562,-,-
BAC116_L17,7,7p14.1,42375804,42403878,28074,-,-
BAC200_H10,7,7p14.1,42612478,42722099,109621,-,-
BAC213_M03,7,7p14.1,42620042,42700178,80136,-,-
BAC70_K16,7,7p14.1,42636405,42725238,88833,-,-
BAC117_I10,7,7p14.1,42753192,42836121,82929,-,-
BAC67_I13,7,7p14.1,42803610,42889039,85429,-,-
BAC145_N19,7,7p14.1,42858540,42939873,81333,-,-
BAC96_M07,7,7p14.1,42858540,42941248,82708,-,-
BAC25_I16,7,7p14.1,42940984,43019460,78476,-,-
BAC69_A01,7,7p14.1,42961639,43051211,89572,-,-
BAC228_C12,7,7p14.1,42973613,43049471,75858,-,-
BAC153_M20,7,7p14.1,42995291,43082352,87061,-,-
BAC153_J08,7,7p14.1,42995656,43082352,86696,-,-
BAC196_H22,7,7p14.1,43068874,43163001,94127,-,-
BAC6_P09,7,7p14.1,43092285,43183300,91015,-,-
BAC69_J16,7,7p14.1,43102270,43180738,78468,-,-
BAC56_G07,7,7p14.1,43105454,43248635,143181,-,-
BAC193_J15,7,7p14.1,43146255,43228770,82515,-,-
BAC96_E17,7,7p14.1-7p13,43249116,43346069,96953,-,-
BAC39_C13,7,7p14.1-7p13,43251675,43346069,94394,-,-
BAC60_B10,7,7p14.1-7p13,43283471,43491392,207921,-,-
BAC71_J10,7,7p13,43307117,43405957,98840,-,-
BAC170_B10,7,7p13,43331005,43415691,84686,-,-
BAC178_N02,7,7p13,43415686,43503132,87446,-,-
BAC241_M14,7,7p13,43431468,43499240,67772,-,-
BAC56_E14,7,7p13,43462765,43552740,89975,-,-
BAC195_N17,7,7p13,43503173,43585284,82111,-,-
BAC219_C07,7,7p13,43514740,43610414,95674,-,-
BAC119_M13,7,7p13,43558950,43726999,168049,-,-
BAC139_M02,7,7p13,43654130,43813160,159030,-,-
BAC82_J20,7,7p13,43724423,43826798,102375,-,-
BAC213_O11,7,7p13,43736459,43839083,102624,-,-
BAC69_L07,7,7p13,43798791,43914895,116104,-,-
BAC71_D06,7,7p13,43805144,43922579,117435,-,-
BAC45_E15,7,7p13,43814488,43887552,73064,-,-
BAC132_B24,7,7p13,43826791,43914852,88061,-,-
BAC179_I02,7,7p13,43851202,43968476,117274,-,-
BAC234_O13,7,7p13,43914889,43990668,75779,-,-
BAC117_K22,7,7p13,43968469,44074970,106501,yes,-
BAC58_F20,7,7p13,43968496,44103701,135205,yes,-
BAC167_B03,7,7p13,43995078,44074970,79892,yes,-
BAC127_G18,7,7p13,44020063,44118339,98276,yes,-
BAC161_M17,7,7p13,44070232,44150702,80470,yes,-
BAC132_C08,7,7p13,44074964,44163322,88358,yes,-
BAC42_O14,7,7p13,44103718,44199671,95953,-,-
BAC14_C09,7,7p13,44169644,44253622,83978,-,-
BAC154_O12,7,7p13,44348543,44438700,90157,-,-
BAC14_I07,7,7p13,44360719,44459886,99167,-,-
BAC151_A17,7,7p13,44402758,44497742,94984,-,-
BAC34_E12,7,7p13,44438692,44566974,128282,-,-
BAC100_I24,7,7p13,44562706,44575035,12329,-,-
BAC238_F03,7,7p13,44581399,44674732,93333,-,-
BAC61_F05,7,7p13,44674726,44778502,103776,-,-
BAC158_E15,7,7p13,44674741,44751957,77216,-,-
BAC45_P08,7,7p13,44674742,44774805,100063,-,-
BAC41_H16,7,7p13,44851191,44973357,122166,-,-
BAC194_H06,7,7p13,44857914,44943395,85481,-,-
BAC158_D16,7,7p13,44904510,44980849,76339,-,-
BAC171_K12,7,7p13,44913829,45001768,87939,-,-
BAC226_F24,7,7p13,44921186,45004258,83072,-,-
BAC46_P02,7,7p13,45078211,45169931,91720,-,-
BAC147_P05,7,7p13,45103798,45217540,113742,-,-
BAC24_D08,7,7p13,45119616,45209027,89411,-,-
BAC231_I01,7,7p13,45141484,45235999,94515,-,-
BAC81_O10,7,7p13,45217556,45320357,102801,-,-
BAC53_D20,7,7p13,45306604,45473387,166783,-,-
BAC238_J05,7,7p13,45320361,45439893,119532,-,-
BAC135_N06,7,7p13,45320627,45408938,88311,-,-
BAC67_L18,7,7p13,45338263,45424173,85910,-,-
BAC100_L10,7,7p13,45358047,45460877,102830,-,-
BAC2_I15,7,7p13,45429088,45502170,73082,-,-
BAC127_K20,7,7p13,45446458,45546269,99811,-,-
BAC239_N20,7,7p13,45505649,45595914,90265,-,-
BAC157_O03,7,7p13,45539212,45634333,95121,-,-
BAC105_E07,7,7p13,45539893,45658969,119076,-,-
BAC80_B06,7,7p13,45546264,45690923,144659,-,-
BAC66_I15,7,7p13,45641299,45738191,96892,-,-
BAC103_J06,7,7p13,45650119,45780270,130151,-,-
BAC92_K23,7,7p13,45663049,45780272,117223,-,-
BAC86_E06,7,7p13,45690917,45812257,121340,-,-
BAC63_N17,7,7p13,45690960,45792380,101420,-,-
BAC236_M12,7,7p13,45699327,45793514,94187,-,-
BAC31_E21,7,7p13,45780270,45868487,88217,-,-
BAC27_C08,7,7p13,45812256,45905785,93529,-,-
BAC49_N16,7,7p13,45812372,45931313,118941,-,-
BAC26_I20,7,7p13,45934563,46061061,126498,-,-
BAC241_H19,7,7p13,45952038,46047231,95193,-,-
BAC24_L21,7,7p13,45953554,46120535,166981,-,-
BAC106_E10,7,7p13,45960083,46067578,107495,-,-
BAC38_G17,7,7p13,46027995,46146008,118013,-,-
BAC131_G15,7,7p13,46047225,46146092,98867,-,-
BAC221_F17,7,7p13,46061110,46147730,86620,-,-
BAC97_N21,7,7p13,46076738,46255404,178666,-,-
BAC53_J11,7,7p13,46154361,46300624,146263,-,-
BAC250_N08,7,7p13,46277937,46373720,95783,-,-
BAC176_L18,7,7p12.3,46779429,46863724,84295,-,-
BAC250_O11,7,7p12.3,46815745,46934976,119231,-,-
BAC53_F04,7,7p12.3,46865808,46975261,109453,-,-
BAC117_N23,7,7p12.3,46895468,46980531,85063,-,-
BAC244_P13,7,7p12.3,46998806,47092174,93368,-,-
BAC246_J19,7,7p12.3,47092165,47207115,114950,-,-
BAC220_D01,7,7p12.3,47240267,47324740,84473,-,-
BAC108_O02,7,7p12.3,47294218,47327634,33416,-,-
BAC125_H20,7,7p12.3,47297934,47396856,98922,-,-
BAC243_B23,7,7p12.3,47432238,47533555,101317,-,-
BAC31_J21,7,7p12.3,47554883,47676203,121320,-,-
BAC61_F23,7,7p12.3,47565051,47658794,93743,-,-
BAC150_B03,7,7p12.3,47590864,47676203,85339,-,-
BAC81_A03,7,7p12.3,47638215,47721656,83441,-,-
BAC163_M22,7,7p12.3,47715537,47821059,105522,-,-
BAC66_I16,7,7p12.3,47727095,47838938,111843,-,-
BAC247_N08,7,7p12.3,47741390,47867960,126570,-,-
BAC60_P05,7,7p12.3,47760793,47893085,132292,-,-
BAC193_K19,7,7p12.3,47822030,47893088,71058,-,-
BAC210_O04,7,7p12.3,47849297,47936933,87636,-,-
BAC230_N17,7,7p12.3,47905229,48000145,94916,-,-
BAC157_N08,7,7p12.3,47960463,48036293,75830,-,-
BAC24_P21,7,7p12.3,47990468,48093393,102925,-,-
BAC60_O09,7,7p12.3,48018749,48144577,125828,-,-
BAC232_D07,7,7p12.3,48035222,48110887,75665,-,-
BAC241_P12,7,7p12.3,48044543,48125117,80574,-,-
BAC64_F17,7,7p12.3,48299055,48434035,134980,-,-
BAC61_J01,7,7p12.3,48330370,48483464,153094,-,-
BAC88_A20,7,7p12.3,48382157,48518383,136226,-,-
BAC97_A08,7,7p12.3,48449385,48567135,117750,-,-
BAC195_H22,7,7p12.3,48474411,48598713,124302,-,-
BAC120_E07,7,7p12.3,48490444,48613745,123301,-,-
BAC32_K22,7,7p12.3,48619542,48714762,95220,-,-
BAC132_O08,7,7p12.3,48691062,48768521,77459,-,-
BAC175_E21,7,7p12.3,48753534,48851385,97851,-,-
BAC84_N07,7,7p12.3,48794809,48897740,102931,-,-
BAC31_G03,7,7p12.3,48931027,49008184,77157,-,-
BAC223_I09,7,7p12.3,49002984,49028814,25830,-,-
BAC118_N17,7,7p12.3,49104238,49198594,94356,-,-
BAC199_J10,7,7p12.3,49122412,49235414,113002,-,-
BAC160_J05,7,7p12.3,49122423,49235416,112993,-,-
BAC252_B19,7,7p12.3,49135668,49239300,103632,-,-
BAC33_A13,7,7p12.3,49210421,49299819,89398,-,-
BAC33_G04,7,7p12.3,49227762,49313105,85343,-,-
BAC171_K13,7,7p12.3,49286669,49428000,141331,-,-
BAC106_L18,7,7p12.3,49381661,49480521,98860,-,-
BAC193_I24,7,7p12.3,49427995,49513380,85385,-,-
BAC26_D14,7,7p12.3,49471125,49612458,141333,-,-
BAC42_B13,7,7p12.3,49536383,49638413,102030,-,-
BAC100_J06,7,7p12.3,49584935,49672041,87106,-,-
BAC181_C23,7,7p12.3,49604415,49699525,95110,-,-
BAC51_K05,7,7p12.3,49604415,49724056,119641,-,-
BAC150_C04,7,7p12.3,49672036,49759858,87822,-,-
BAC46_L20,7,7p12.3-7p12.2,49725448,49856651,131203,-,-
BAC136_H21,7,7p12.2,49819200,49907937,88737,-,-
BAC131_F11,7,7p12.2,49865127,49942680,77553,-,-
BAC80_D08,7,7p12.2,49942761,50073736,130975,-,-
BAC163_N09,7,7p12.2,49977171,50076929,99758,-,-
BAC52_L13,7,7p12.2,50145853,50261812,115959,-,-
BAC5_H24,7,7p12.2,50200124,50296901,96777,-,-
BAC243_P16,7,7p12.2,50382635,50536028,153393,-,-
BAC90_K17,7,7p12.2,50405352,50532044,126692,-,-
BAC42_E23,7,7p12.2,50405493,50513752,108259,-,-
BAC69_K11,7,7p12.2,50443473,50569340,125867,-,-
BAC195_D04,7,7p12.2,50467153,50595488,128335,-,-
BAC78_K05,7,7p12.2,50472605,50599765,127160,-,-
BAC41_B14,7,7p12.2,50477989,50624854,146865,-,-
BAC246_J15,7,7p12.2,50480769,50608394,127625,-,-
BAC163_G03,7,7p12.2,50503822,50595488,91666,-,-
BAC197_K18,7,7p12.2,50550169,50654911,104742,-,-
BAC25_N13,7,7p12.2,50624986,50738511,113525,-,-
BAC23_I06,7,7p12.2,50626556,50718107,91551,-,-
BAC122_H21,7,7p12.2,50667042,50752637,85595,-,-
BAC156_F13,7,7p12.2,50754036,50849553,95517,-,-
BAC37_C12,7,7p12.2,50773698,50869811,96113,-,-
BAC234_D16,7,7p12.2-7p12.1,50787301,50904023,116722,-,-
BAC196_C01,7,7p12.2-7p12.1,50849548,50923409,73861,-,-
BAC57_I01,7,7p12.1,51034221,51131580,97359,-,-
BAC200_I21,7,7p12.1,51052135,51175175,123040,-,-
BAC226_G04,7,7p12.1,51084168,51180562,96394,-,-
BAC194_F01,7,7p12.1,51100415,51194990,94575,-,-
BAC244_B19,7,7p12.1,51107398,51203277,95879,-,-
BAC219_O04,7,7p12.1,51125538,51233460,107922,-,-
BAC15_M15,7,7p12.1,51173048,51272717,99669,-,-
BAC200_C03,7,7p12.1,51263752,51340083,76331,-,-
BAC156_K10,7,7p12.1,51311754,51414813,103059,-,-
BAC34_L05,7,7p12.1,51322604,51428047,105443,-,-
BAC58_N06,7,7p12.1,51326669,51429289,102620,-,-
BAC139_M07,7,7p12.1,51331686,51414813,83127,-,-
BAC171_N11,7,7p12.1,51345872,51428047,82175,-,-
BAC37_P17,7,7p12.1,51414802,51525455,110653,-,-
BAC196_N16,7,7p12.1,51451833,51525459,73626,-,-
BAC123_K06,7,7p12.1,51479125,51589701,110576,-,-
BAC52_J05,7,7p12.1,51481550,51589668,108118,-,-
BAC244_E09,7,7p12.1,51501052,51574144,73092,-,-
BAC249_P08,7,7p12.1,51501241,51591589,90348,-,-
BAC247_E23,7,7p12.1,51501283,51592011,90728,-,-
BAC96_G18,7,7p12.1,51502055,51603155,101100,-,-
BAC240_O22,7,7p12.1,51502056,51589701,87645,-,-
BAC97_O06,7,7p12.1,51502068,51643161,141093,-,-
BAC247_O20,7,7p12.1,51603158,51692095,88937,-,-
BAC128_F03,7,7p12.1,51724729,51811428,86699,-,-
BAC80_I11,7,7p12.1,51797705,51918512,120807,-,-
BAC107_N08,7,7p12.1,51813026,51920726,107700,-,-
BAC157_O07,7,7p12.1,51826474,51928753,102279,-,-
BAC246_B10,7,7p12.1,51932178,52015593,83415,-,-
BAC160_M18,7,7p12.1,51945005,52050240,105235,-,-
BAC147_N03,7,7p12.1,52005446,52096660,91214,-,-
BAC56_P09,7,7p12.1,52015588,52137208,121620,-,-
BAC96_D09,7,7p12.1,52054528,52124949,70421,-,-
BAC91_M19,7,7p12.1,52064503,52151540,87037,-,-
BAC193_K09,7,7p12.1,52182301,52255735,73434,-,-
BAC80_N04,7,7p12.1,52182301,52267088,84787,-,-
BAC240_N07,7,7p12.1,52200983,52296891,95908,-,-
BAC236_N19,7,7p12.1,52210763,52286888,76125,-,-
BAC86_B16,7,7p12.1,52210763,52320877,110114,-,-
BAC161_D19,7,7p12.1,52244257,52332031,87774,-,-
BAC21_I22,7,7p12.1,52262510,52391683,129173,-,-
BAC68_P23,7,7p12.1,52267082,52378399,111317,-,-
BAC160_L04,7,7p12.1,52273118,52395891,122773,-,-
BAC34_B20,7,7p12.1,52275784,52395891,120107,-,-
BAC34_A20,7,7p12.1,52275802,52395891,120089,-,-
BAC128_A02,7,7p12.1,52331983,52454337,122354,-,-
BAC40_F04,7,7p12.1,52481664,52609388,127724,-,-
BAC170_I20,7,7p12.1,52487042,52609388,122346,-,-
BAC48_A08,7,7p12.1,52501492,52622444,120952,-,-
BAC90_H18,7,7p12.1,52551547,52658339,106792,-,-
BAC17_L12,7,7p12.1,52698165,52790012,91847,-,-
BAC51_K08,7,7p12.1,52743477,52870795,127318,-,-
BAC226_M12,7,7p12.1,52777149,52893560,116411,-,-
BAC64_N06,7,7p12.1,52779193,52794211,15018,-,-
BAC44_O08,7,7p12.1,52800205,52927019,126814,-,-
BAC115_L18,7,7p12.1,52816765,52936986,120221,-,-
BAC57_A21,7,7p12.1,52904901,53004474,99573,-,-
BAC41_C11,7,7p12.1,53021941,53122790,100849,-,-
BAC90_D04,7,7p12.1,53181541,53277247,95706,-,-
BAC128_M08,7,7p12.1,53250475,53329586,79111,-,-
BAC67_L08,7,7p12.1,53258140,53381679,123539,-,-
BAC49_G03,7,7p12.1,53258180,53371377,113197,-,-
BAC208_G03,7,7p12.1,53309074,53419352,110278,-,-
BAC43_M13,7,7p12.1,53337777,53430832,93055,-,-
BAC248_J11,7,7p12.1,53365547,53452669,87122,-,-
BAC237_H21,7,7p12.1,53387158,53459548,72390,-,-
BAC140_E08,7,7p12.1,53517994,53604743,86749,-,-
BAC97_C20,7,7p12.1,53711766,53835429,123663,-,-
BAC249_C14,7,7p12.1,53726950,53799237,72287,-,-
BAC236_A13,7,7p12.1,53744358,53815535,71177,-,-
BAC76_I15,7,7p12.1-7p11.2,53839376,53997921,158545,-,-
BAC180_C11,7,7p12.1-7p11.2,53855322,53916516,61194,-,-
BAC14_G11,7,7p11.2,53900273,53994232,93959,-,-
BAC220_L11,7,7p11.2,53991977,54072985,81008,-,-
BAC252_K05,7,7p11.2,54071723,54181009,109286,-,-
BAC31_I05,7,7p11.2,54072977,54181005,108028,-,-
BAC84_I13,7,7p11.2,54075292,54200668,125376,-,-
BAC178_O13,7,7p11.2,54084324,54177100,92776,-,-
BAC247_K14,7,7p11.2,54084797,54177097,92300,-,-
BAC233_L20,7,7p11.2,54155525,54236645,81120,-,-
BAC107_L14,7,7p11.2,54275613,54440762,165149,-,-
BAC161_N11,7,7p11.2,54486321,54579548,93227,-,-
BAC172_M11,7,7p11.2,54487456,54577909,90453,-,-
BAC67_B23,7,7p11.2,54499906,54588678,88772,-,-
BAC201_P24,7,7p11.2,54536295,54632380,96085,-,-
BAC158_P01,7,7p11.2,54588704,54674872,86168,-,-
BAC86_P20,7,7p11.2,54608819,54684371,75552,-,-
BAC57_O13,7,7p11.2,54705667,54804049,98382,-,-
BAC94_J20,7,7p11.2,54706031,54810363,104332,-,-
BAC217_I10,7,7p11.2,54716245,54812016,95771,-,-
BAC247_E14,7,7p11.2,54792399,54901698,109299,-,-
BAC163_K10,7,7p11.2,54837018,54938246,101228,-,-
BAC15_B08,7,7p11.2,55002043,55101944,99901,-,-
BAC29_K05,7,7p11.2,55007767,55119785,112018,-,-
BAC147_E03,7,7p11.2,55073947,55162990,89043,-,-
BAC131_P17,7,7p11.2,55111326,55209686,98360,-,-
BAC81_N03,7,7p11.2,55111336,55230465,119129,-,-
BAC170_M16,7,7p11.2,55122494,55230463,107969,-,-
BAC31_N21,7,7p11.2,55128400,55230444,102044,-,-
BAC15_C19,7,7p11.2,55185396,55309989,124593,-,-
BAC20_N23,7,7p11.2,55209677,55301080,91403,-,-
BAC155_M19,7,7p11.2,55209677,55309945,100268,-,-
BAC135_H13,7,7p11.2,55233457,55309989,76532,-,-
BAC1_I06,7,7p11.2,55243516,55359450,115934,-,-
BAC73_A02,7,7p11.2,55291881,55406968,115087,-,-
BAC249_H16,7,7p11.2,55318230,55407676,89446,-,-
BAC111_F22,7,7p11.2,55423875,55542138,118263,-,-
BAC180_K22,7,7p11.2,55443987,55583204,139217,-,-
BAC252_I09,7,7p11.2,55500842,55617076,116234,-,-
BAC190_E15,7,7p11.2,55521455,55610401,88946,-,-
BAC96_E16,7,7p11.2,55541843,55617746,75903,-,-
BAC125_C04,7,7p11.2,55591856,55690311,98455,-,-
BAC80_C23,7,7p11.2,55618917,55793418,174501,-,-
BAC91_L10,7,7p11.2,55665541,55765758,100217,-,-
BAC200_G08,7,7p11.2,55670811,55781633,110822,-,-
BAC189_P04,7,7p11.2,55783389,55847693,64304,-,-
BAC88_I01,7,7p11.2,55784613,55883765,99152,-,-
BAC51_E17,7,7p11.2,55793458,55858678,65220,-,-
BAC46_N11,7,7p11.2,55915941,56016465,100524,-,-
BAC43_P13,7,7p11.2,55915988,56016465,100477,-,-
BAC35_A04,7,7p11.2,55933485,56050451,116966,-,-
BAC125_I19,7,7p11.2,55974907,56064982,90075,-,-
BAC67_F18,7,7p11.2,56005296,56089281,83985,-,-
BAC131_O03,7,7p11.2,56050776,56160693,109917,-,-
BAC148_C08,7,7p11.2,56077859,56171379,93520,-,-
BAC119_N18,7,7p11.2,56128298,56258499,130201,-,-
BAC248_F18,7,7p11.2,56136422,56225646,89224,-,-
BAC150_B04,7,7p11.2,56244439,56343155,98716,-,-
BAC240_O06,7,7p11.2,56257933,56350293,92360,-,-
BAC182_H03,7,7p11.2,56262414,56341925,79511,-,-
BAC186_I14,7,7p11.2,56262452,56379735,117283,-,-
BAC78_K13,7,7p11.2,56275544,56325723,50179,-,-
BAC191_E02,7,7p11.2,56317086,56396178,79092,-,-
BAC129_M13,7,7p11.2,56379729,56436965,57236,-,-
BAC186_J11,7,7p11.2,56388382,56444814,56432,-,-
BAC43_P24,7,7p11.2,56418687,56526443,107756,-,-
BAC143_E20,7,7p11.2,56472485,56564898,92413,-,-
BAC180_A10,7,7p11.2,56517115,56612426,95311,-,-
BAC88_L16,7,7p11.2,56672540,56788096,115556,-,-
BAC179_N09,7,7p11.2,56684365,56776287,91922,-,-
BAC243_D07,7,7p11.2,56695021,56781957,86936,-,-
BAC88_M05,7,7p11.2,56722000,56817372,95372,-,-
BAC252_M24,7,7p11.2,56776284,56867302,91018,-,-
BAC87_B07,7,7p11.2,56790829,56867001,76172,-,-
BAC23_A05,7,7p11.2,56817557,56875969,58412,-,-
BAC65_B18,7,7p11.2,56869533,56950864,81331,-,-
BAC152_K22,7,7p11.2,57038718,57134340,95622,-,-
BAC80_D13,7,7p11.2,57133682,57236086,102404,-,-
BAC42_H01,7,7p11.2,57164420,57239441,75021,-,-
BAC198_M22,7,7p11.2,57246325,57335185,88860,-,-
BAC240_K01,7,7p11.2-7p11.1,57309275,57400397,91122,-,-
BAC203_I12,7,7p11.1,57441724,57561422,119698,-,-
BAC119_E15,7,7p11.1,57494891,57634388,139497,-,-
BAC221_K21,7,7p11.1,57641664,57723346,81682,-,-
BAC91_N07,7,7p11.1,57707538,57792146,84608,-,-
BAC130_L10,7,7p11.1,57741126,57822179,81053,-,-
BAC107_H08,7,7p11.1,57774634,57864294,89660,-,-
BAC242_B03,7,7p11.1,57856808,57874832,18024,-,-
BAC142_D03,7,7p11.1,57887302,57965952,78650,-,-
BAC167_B14,7,7q11.21,61403083,61481104,78021,-,-
BAC127_E03,7,7q11.21,62123509,62272672,149163,-,-
BAC31_J17,7,7q11.21,62124742,62238617,113875,-,-
BAC230_H11,7,7q11.21,62132682,62231989,99307,-,-
BAC200_E19,7,7q11.21,62161687,62261641,99954,-,-
BAC44_D09,7,7q11.21,62164054,62267936,103882,-,-
BAC7_C09,7,7q11.21,62185870,62315121,129251,-,-
BAC219_N06,7,7q11.21,62229445,62312681,83236,-,-
BAC125_M01,7,7q11.21,62232092,62315121,83029,-,-
BAC79_J10,7,7q11.21,62232094,62315066,82972,-,-
BAC232_I06,7,7q11.21,62238662,62333286,94624,-,-
BAC48_O03,7,7q11.21,62249019,62441691,192672,-,-
BAC63_N10,7,7q11.21,62330076,62424298,94222,-,-
BAC22_L02,7,7q11.21,62330076,62434227,104151,-,-
BAC100_L18,7,7q11.21,62406495,62506443,99948,-,-
BAC146_C03,7,7q11.21,62784594,62918018,133424,-,-
BAC197_C09,7,7q11.21,62843003,62935378,92375,-,-
BAC177_O21,7,7q11.21,62893822,63005228,111406,-,-
BAC46_C20,7,7q11.21,62918298,62936623,18325,-,-
BAC119_P24,7,7q11.21,62961456,63052459,91003,-,-
BAC157_O15,7,7q11.21,63176071,63259352,83281,-,-
BAC124_B19,7,7q11.21,63260212,63385985,125773,-,-
BAC230_E11,7,7q11.21,63281334,63389769,108435,-,-
BAC82_I06,7,7q11.21,63315409,63403312,87903,-,-
BAC69_J02,7,7q11.21,63369470,63459796,90326,-,-
BAC46_M19,7,7q11.21,63439845,63526153,86308,-,-
BAC69_D08,7,7q11.21,63567967,63685877,117910,-,-
BAC90_A10,7,7q11.21,63585776,63696294,110518,-,-
BAC12_G07,7,7q11.21,63619513,63797873,178360,-,-
BAC198_P18,7,7q11.21,63623231,63716042,92811,-,-
BAC51_G10,7,7q11.21,63696390,63806128,109738,-,-
BAC238_P05,7,7q11.21,63787175,63865593,78418,-,-
BAC53_G18,7,7q11.21,63887251,63983562,96311,-,-
BAC123_F15,7,7q11.21,63945924,64043568,97644,-,-
BAC237_F05,7,7q11.21,64037567,64132514,94947,-,-
BAC153_D02,7,7q11.21,64068689,64157892,89203,-,-
BAC191_G16,7,7q11.21,64091035,64181462,90427,-,-
BAC42_F20,7,7q11.21,64091035,64197887,106852,-,-
BAC81_I18,7,7q11.21,64198530,64342036,143506,-,-
BAC84_I14,7,7q11.21,64208821,64342413,133592,-,-
BAC148_E09,7,7q11.21,64342407,64457235,114828,-,-
BAC57_N19,7,7q11.21,64343472,64434254,90782,-,-
BAC232_H16,7,7q11.21,64359664,64438033,78369,-,-
BAC238_K05,7,7q11.21,64364950,64462555,97605,-,-
BAC46_K09,7,7q11.21,64364971,64493471,128500,-,-
BAC187_J19,7,7q11.21,64367865,64457162,89297,-,-
BAC168_C11,7,7q11.21,64398212,64438058,39846,-,-
BAC192_I03,7,7q11.21,64586414,64665635,79221,-,-
BAC242_C06,7,7q11.21,64612407,64687334,74927,-,-
BAC73_G22,7,7q11.21,64657451,64729205,71754,-,-
BAC58_B12,7,7q11.21,64692356,64801234,108878,-,-
BAC126_I06,7,7q11.21,64917489,65001982,84493,-,-
BAC125_B19,7,7q11.21,64930041,65028886,98845,-,-
BAC146_M01,7,7q11.21,65058833,65156936,98103,-,-
BAC144_H06,7,7q11.21,65071416,65152705,81289,-,-
BAC132_K23,7,7q11.21,65071416,65152705,81289,-,-
BAC46_D05,7,7q11.21,65071659,65155225,83566,-,-
BAC36_G09,7,7q11.21,65085806,65184217,98411,-,-
BAC76_D12,7,7q11.21,65085806,65209854,124048,-,-
BAC36_D03,7,7q11.21,65173474,65277087,103613,-,-
BAC97_F16,7,7q11.21,65273046,65366733,93687,-,-
BAC67_K01,7,7q11.21,65277369,65372819,95450,-,-
BAC161_J18,7,7q11.21,65349287,65444785,95498,-,-
BAC208_N14,7,7q11.21,65540797,65640890,100093,-,-
BAC193_M02,7,7q11.21,65546749,65625833,79084,-,-
BAC165_N08,7,7q11.21,65547419,65649858,102439,-,-
BAC117_G15,7,7q11.21,65553187,65649858,96671,-,-
BAC61_A07,7,7q11.21,65561558,65656525,94967,-,-
BAC217_M14,7,7q11.21,65565282,65656525,91243,-,-
BAC168_D23,7,7q11.21,65568244,65697369,129125,-,-
BAC148_M14,7,7q11.21,65649851,65752248,102397,-,-
BAC83_P10,7,7q11.21,65709028,65827727,118699,-,-
BAC69_M13,7,7q11.21,65723172,65807632,84460,-,-
BAC96_O17,7,7q11.21,65779433,65888802,109369,-,-
BAC83_J02,7,7q11.21,65857098,65946282,89184,-,-
BAC40_L06,7,7q11.21,65887157,65969498,82341,-,-
BAC51_E12,7,7q11.21,65891434,65992214,100780,-,-
BAC227_L03,7,7q11.21,65908800,65992219,83419,-,-
BAC160_B04,7,7q11.21,65913316,66009509,96193,-,-
BAC64_N17,7,7q11.21,65913316,66009509,96193,-,-
BAC51_F07,7,7q11.21,65919818,65987425,67607,-,-
BAC117_P20,7,7q11.21-7q11.22,66009503,66127788,118285,-,-
BAC251_D14,7,7q11.21-7q11.22,66052653,66199588,146935,-,-
BAC33_O12,7,7q11.22,66199838,66311832,111994,-,-
BAC250_B05,7,7q11.22,66200605,66309044,108439,-,-
BAC120_H09,7,7q11.22,66237745,66337210,99465,-,-
BAC215_P15,7,7q11.22,66237745,66331409,93664,-,-
BAC76_F19,7,7q11.22,66237748,66331474,93726,-,-
BAC222_C15,7,7q11.22,66284651,66416972,132321,-,-
BAC148_L06,7,7q11.22,66287653,66357540,69887,-,-
BAC57_L05,7,7q11.22,66298721,66389455,90734,-,-
BAC228_B08,7,7q11.22,66331489,66417051,85562,-,-
BAC65_J08,7,7q11.22,66400074,66510948,110874,-,-
BAC188_G06,7,7q11.22,66410315,66491112,80797,-,-
BAC8_H16,7,7q11.22,66446555,66571087,124532,-,-
BAC78_E05,7,7q11.22,66607071,66700554,93483,-,-
BAC128_D08,7,7q11.22,66611268,66724183,112915,-,-
BAC139_E14,7,7q11.22,66645251,66745494,100243,-,-
BAC107_N11,7,7q11.22,66651886,66745476,93590,-,-
BAC119_C18,7,7q11.22,66652813,66778440,125627,-,-
BAC161_L18,7,7q11.22,66654563,66773570,119007,-,-
BAC128_J19,7,7q11.22,66708549,66745497,36948,-,-
BAC82_O01,7,7q11.22,66764109,66875618,111509,-,-
BAC133_O21,7,7q11.22,66773562,66875618,102056,-,-
BAC42_F23,7,7q11.22,66778439,66887299,108860,-,-
BAC169_F07,7,7q11.22,66793652,66879214,85562,-,-
BAC158_L15,7,7q11.22,66793655,66878384,84729,-,-
BAC236_L05,7,7q11.22,66797365,66901466,104101,-,-
BAC218_O12,7,7q11.22,66797365,66901441,104076,-,-
BAC90_G14,7,7q11.22,66797365,66897657,100292,-,-
BAC67_H15,7,7q11.22,66797392,66887282,89890,-,-
BAC20_H23,7,7q11.22,66875663,67000031,124368,-,-
BAC137_C21,7,7q11.22,66901597,67008475,106878,-,-
BAC8_M13,7,7q11.22,66901726,66980637,78911,-,-
BAC218_J15,7,7q11.22,66905728,67007597,101869,-,-
BAC143_J14,7,7q11.22,66905728,66967025,61297,-,-
BAC46_C16,7,7q11.22,66907599,67008724,101125,-,-
BAC6_P01,7,7q11.22,67005084,67096072,90988,-,-
BAC125_N03,7,7q11.22,67007594,67189879,182285,-,-
BAC65_P16,7,7q11.22,67011891,67128271,116380,-,-
BAC196_F09,7,7q11.22,67032222,67139747,107525,-,-
BAC179_A04,7,7q11.22,67078382,67187006,108624,-,-
BAC106_D06,7,7q11.22,67135058,67249765,114707,-,-
BAC102_M12,7,7q11.22,67221944,67308652,86708,-,-
BAC183_D14,7,7q11.22,67254116,67362057,107941,-,-
BAC142_I04,7,7q11.22,67322672,67441371,118699,-,-
BAC187_G12,7,7q11.22,67322672,67408174,85502,-,-
BAC10_G24,7,7q11.22,67322672,67414244,91572,-,-
BAC8_O09,7,7q11.22,67322672,67412843,90171,-,-
BAC5_H21,7,7q11.22,67322681,67417549,94868,-,-
BAC150_J10,7,7q11.22,67334332,67440790,106458,-,-
BAC105_G18,7,7q11.22,67402487,67494286,91799,-,-
BAC11_N14,7,7q11.22,67414255,67513266,99011,-,-
BAC15_K14,7,7q11.22,67422419,67510309,87890,-,-
BAC163_N06,7,7q11.22,67465838,67550335,84497,-,-
BAC112_A03,7,7q11.22,67550336,67640258,89922,-,-
BAC145_I01,7,7q11.22,67585840,67678699,92859,-,-
BAC59_I15,7,7q11.22,67585842,67727753,141911,-,-
BAC241_N17,7,7q11.22,67586057,67686447,100390,-,-
BAC155_E02,7,7q11.22,67623226,67704797,81571,-,-
BAC60_C01,7,7q11.22,67645686,67780203,134517,-,-
BAC181_C20,7,7q11.22,67676394,67780203,103809,-,-
BAC115_A06,7,7q11.22,67678693,67766530,87837,-,-
BAC91_G02,7,7q11.22,67811902,67941458,129556,-,-
BAC128_K21,7,7q11.22,67819797,67917861,98064,-,-
BAC97_O08,7,7q11.22,67840556,67958252,117696,-,-
BAC77_J12,7,7q11.22,67844712,67984672,139960,-,-
BAC109_F03,7,7q11.22,67844718,67926760,82042,-,-
BAC220_B16,7,7q11.22,67877906,67976210,98304,-,-
BAC168_J05,7,7q11.22,67877906,67965948,88042,-,-
BAC176_G04,7,7q11.22,67930595,68012525,81930,-,-
BAC145_L15,7,7q11.22,67990826,68075829,85003,-,-
BAC179_H12,7,7q11.22,68069303,68160235,90932,-,-
BAC197_E11,7,7q11.22,68088211,68178624,90413,-,-
BAC55_N01,7,7q11.22,68107527,68242673,135146,-,-
BAC231_H05,7,7q11.22,68109209,68223916,114707,-,-
BAC229_E01,7,7q11.22,68256318,68334300,77982,-,-
BAC75_E21,7,7q11.22,68293813,68383438,89625,-,-
BAC150_O19,7,7q11.22,68301851,68417959,116108,-,-
BAC121_D21,7,7q11.22,68324811,68487436,162625,-,-
BAC149_J07,7,7q11.22,68412540,68503530,90990,-,-
BAC142_F05,7,7q11.22,68418546,68547323,128777,-,-
BAC141_C14,7,7q11.22,68471246,68577120,105874,-,-
BAC26_B01,7,7q11.22,68487430,68627815,140385,-,-
BAC248_N10,7,7q11.22,68487435,68593198,105763,-,-
BAC70_M08,7,7q11.22,68582165,68716590,134425,-,-
BAC27_K23,7,7q11.22,68621527,68712222,90695,-,-
BAC204_C09,7,7q11.22,68636965,68750604,113639,-,-
BAC229_J11,7,7q11.22,68809829,68896654,86825,-,-
BAC151_F05,7,7q11.22,68842405,68929717,87312,-,-
BAC190_H05,7,7q11.22,68856406,68941049,84643,-,-
BAC250_I08,7,7q11.22,68980195,69063731,83536,-,-
BAC186_P01,7,7q11.22,68987575,69072735,85160,-,-
BAC237_B12,7,7q11.22,69101638,69180424,78786,-,-
BAC57_M19,7,7q11.22,69113847,69197817,83970,-,-
BAC26_L02,7,7q11.22,69117331,69217108,99777,-,-
BAC228_C20,7,7q11.22,69129791,69231489,101698,-,-
BAC8_K08,7,7q11.22,69175191,69274999,99808,-,-
BAC134_D18,7,7q11.22,69231483,69308783,77300,-,-
BAC247_N11,7,7q11.22,69291721,69394618,102897,-,-
BAC134_I17,7,7q11.22,69291721,69391866,100145,-,-
BAC92_M10,7,7q11.22,69328034,69434438,106404,-,-
BAC124_P19,7,7q11.22,69415420,69536088,120668,-,-
BAC149_C07,7,7q11.22,69447969,69555021,107052,-,-
BAC119_K16,7,7q11.22,69481854,69594033,112179,-,-
BAC5_I07,7,7q11.22,69484657,69580705,96048,-,-
BAC144_M09,7,7q11.22,69491477,69588893,97416,-,-
BAC36_K10,7,7q11.22,69506904,69597122,90218,-,-
BAC152_A19,7,7q11.22,69580697,69652480,71783,-,-
BAC127_B02,7,7q11.22,69593833,69686090,92257,-,-
BAC161_C16,7,7q11.22,69682568,69762217,79649,-,-
BAC121_P11,7,7q11.22,69710641,69827291,116650,-,-
BAC146_N11,7,7q11.22,69731511,69817694,86183,-,-
BAC33_D12,7,7q11.22,69846416,70009620,163204,-,-
BAC197_O10,7,7q11.22,69887429,69996690,109261,-,-
BAC219_J03,7,7q11.22,69922481,70026617,104136,-,-
BAC88_O22,7,7q11.22,69956846,70036870,80024,-,-
BAC80_D02,7,7q11.22,69984450,70089513,105063,-,-
BAC24_C16,7,7q11.22,69996681,70103335,106654,-,-
BAC13_P23,7,7q11.22,70204099,70317999,113900,-,-
BAC45_A14,7,7q11.22,70204103,70298970,94867,-,-
BAC241_B22,7,7q11.22,70210678,70396701,186023,-,-
BAC73_I10,7,7q11.22,70262282,70396701,134419,-,-
BAC67_M22,7,7q11.22,70273617,70408766,135149,-,-
BAC116_F24,7,7q11.22,70299079,70397869,98790,-,-
BAC118_I21,7,7q11.22,70299079,70386260,87181,-,-
BAC36_C22,7,7q11.22,70349885,70538408,188523,-,-
BAC210_H07,7,7q11.22,70396694,70474058,77364,-,-
BAC110_N02,7,7q11.22,70407083,70506074,98991,-,-
BAC38_P24,7,7q11.22,70407087,70512287,105200,-,-
BAC220_A08,7,7q11.22,70529305,70618328,89023,-,-
BAC13_H20,7,7q11.22,70545676,70641367,95691,-,-
BAC175_B13,7,7q11.22,70582317,70696795,114478,-,-
BAC88_E11,7,7q11.22,70582326,70660250,77924,-,-
BAC140_A08,7,7q11.22,70610822,70696796,85974,-,-
BAC127_L05,7,7q11.22,70669993,70732378,62385,-,-
BAC150_H21,7,7q11.22,70753131,70838313,85182,-,-
BAC195_E21,7,7q11.22,70775813,70884773,108960,-,-
BAC192_B09,7,7q11.22,70785526,70899795,114269,-,-
BAC76_D15,7,7q11.22,70785526,70884776,99250,-,-
BAC167_H24,7,7q11.22,70785526,70871187,85661,-,-
BAC168_L12,7,7q11.22,70792175,70889298,97123,-,-
BAC106_C16,7,7q11.22,70871216,70999975,128759,-,-
BAC35_K16,7,7q11.22,70871224,71006506,135282,-,-
BAC100_L06,7,7q11.22,70889820,70989160,99340,-,-
BAC125_P12,7,7q11.22,70899788,71000843,101055,-,-
BAC40_E19,7,7q11.22,71022980,71135907,112927,-,-
BAC248_E16,7,7q11.22,71029171,71102235,73064,-,-
BAC41_A17,7,7q11.22,71036020,71160099,124079,-,-
BAC148_J15,7,7q11.22,71080009,71175908,95899,-,-
BAC84_O12,7,7q11.22,71085758,71206663,120905,-,-
BAC57_K15,7,7q11.22,71135917,71241396,105479,-,-
BAC162_C10,7,7q11.22,71160326,71246258,85932,-,-
BAC26_B04,7,7q11.22,71181069,71292351,111282,-,-
BAC168_L23,7,7q11.22,71185518,71269058,83540,-,-
BAC185_H16,7,7q11.22,71246384,71313198,66814,-,-
BAC33_H06,7,7q11.22,71330605,71424555,93950,-,-
BAC140_M05,7,7q11.22,71336130,71409514,73384,-,-
BAC53_K11,7,7q11.22,71467424,71661059,193635,-,-
BAC104_O23,7,7q11.22,71492427,71606466,114039,-,-
BAC173_B21,7,7q11.22,71606468,71697977,91509,-,-
BAC73_E21,7,7q11.22,71636679,71773859,137180,-,-
BAC248_G16,7,7q11.22,71662773,71779953,117180,-,-
BAC38_A17,7,7q11.22-7q11.23,71707633,71808202,100569,-,-
BAC82_A21,7,7q11.22-7q11.23,71780251,71889848,109597,-,-
BAC127_E09,7,7q11.23,71845975,71934192,88217,-,-
BAC52_G13,7,7q11.23,71883405,71990517,107112,-,-
BAC147_P19,7,7q11.23,71934348,72018477,84129,-,-
BAC194_B21,7,7q11.23,71994667,72101757,107090,-,-
BAC86_I11,7,7q11.23,72075262,72136852,61590,-,-
BAC191_H07,7,7q11.23,72089609,74018722,1929113,-,-
BAC132_O13,7,7q11.23,72089611,72273271,183660,-,-
BAC155_C14,7,7q11.23,72126781,72273280,146499,-,-
BAC248_H17,7,7q11.23,72126781,72206545,79764,-,-
BAC40_K09,7,7q11.23,72126781,72227821,101040,-,-
BAC37_B02,7,7q11.23,72126786,72227825,101039,-,-
BAC116_O12,7,7q11.23,72126799,72256171,129372,-,-
BAC132_F13,7,7q11.23,72130150,72241855,111705,-,-
BAC103_F20,7,7q11.23,72228100,72334298,106198,-,-
BAC43_D03,7,7q11.23,72228100,73904438,1676338,-,-
BAC84_B05,7,7q11.23,72228100,72344080,115980,-,-
BAC53_K19,7,7q11.23,72241944,73941080,1699136,-,-
BAC80_J15,7,7q11.23,72254153,72382060,127907,-,-
BAC178_P10,7,7q11.23,72254294,73904438,1650144,-,-
BAC58_K22,7,7q11.23,72254294,72386390,132096,-,-
BAC171_G23,7,7q11.23,72254305,73912056,1657751,-,-
BAC249_J16,7,7q11.23,72256223,73904438,1648215,-,-
BAC151_L08,7,7q11.23,72259313,72344080,84767,-,-
BAC33_P15,7,7q11.23,72259320,73904438,1645118,-,-
BAC106_L23,7,7q11.23,72273343,73956829,1683486,-,-
BAC201_A03,7,7q11.23,72290254,72381970,91716,-,-
BAC190_P19,7,7q11.23,72290254,73956933,1666679,-,-
BAC208_B07,7,7q11.23,72392877,72501519,108642,-,-
BAC205_J04,7,7q11.23,72392879,72488983,96104,-,-
BAC128_M22,7,7q11.23,72402302,72499486,97184,-,-
BAC170_F12,7,7q11.23,72410614,72506816,96202,-,-
BAC173_M16,7,7q11.23,72410650,72506816,96166,-,-
BAC117_C10,7,7q11.23,72419855,72506807,86952,-,-
BAC176_F03,7,7q11.23,72419859,72506816,86957,-,-
BAC186_C15,7,7q11.23,72428489,72515491,87002,-,-
BAC217_N14,7,7q11.23,72428489,72499483,70994,-,-
BAC143_O02,7,7q11.23,72428489,72515491,87002,-,-
BAC95_E13,7,7q11.23,72488977,72568433,79456,-,-
BAC198_K24,7,7q11.23,72673559,72698206,24647,-,-
BAC247_M06,7,7q11.23,72685629,72803410,117781,-,-
BAC151_H05,7,7q11.23,72727845,72803410,75565,-,-
BAC143_M09,7,7q11.23,72727846,72809113,81267,-,-
BAC45_F05,7,7q11.23,72749788,72886063,136275,-,-
BAC172_C11,7,7q11.23,72803403,72901656,98253,-,-
BAC167_I04,7,7q11.23,72873884,73004825,130941,-,-
BAC142_O19,7,7q11.23,72880430,73004888,124458,-,-
BAC184_A15,7,7q11.23,72901724,72998545,96821,-,-
BAC218_M18,7,7q11.23,72913565,72999374,85809,-,-
BAC158_M12,7,7q11.23,72950679,73048195,97516,-,-
BAC69_O08,7,7q11.23,72999634,73099848,100214,-,-
BAC66_N22,7,7q11.23,73117049,73203244,86195,-,-
BAC67_C05,7,7q11.23,73215245,73346881,131636,-,-
BAC183_A12,7,7q11.23,73343227,73447186,103959,-,-
BAC123_D05,7,7q11.23,73347015,73426987,79972,-,-
BAC67_M07,7,7q11.23,73365970,73492216,126246,-,-
BAC128_E24,7,7q11.23,73470386,73612419,142033,-,-
BAC237_P11,7,7q11.23,73541445,73635435,93990,-,-
BAC39_G01,7,7q11.23,73580404,73747084,166680,-,-
BAC143_M17,7,7q11.23,73618418,73747084,128666,-,-
BAC56_G17,7,7q11.23,73790739,73912056,121317,-,-
BAC151_M20,7,7q11.23,73912168,74008350,96182,-,-
BAC86_K17,7,7q11.23,73912179,74035701,123522,-,-
BAC234_M13,7,7q11.23,74015345,74096100,80755,-,-
BAC176_E21,7,7q11.23,74055186,74139937,84751,-,-
BAC214_K20,7,7q11.23,74776151,74851169,75018,-,-
BAC41_K08,7,7q11.23,74847473,74950934,103461,-,-
BAC230_N13,7,7q11.23,74884599,74979869,95270,-,-
BAC242_M21,7,7q11.23,74894999,74985244,90245,-,-
BAC34_G23,7,7q11.23,74895060,74992404,97344,-,-
BAC132_A16,7,7q11.23,74943820,75047104,103284,-,-
BAC178_O12,7,7q11.23,74980282,75064663,84381,-,-
BAC120_N24,7,7q11.23,74980282,75064663,84381,-,-
BAC243_K17,7,7q11.23,75014354,75104335,89981,-,-
BAC2_H21,7,7q11.23,75014355,75104563,90208,-,-
BAC61_P24,7,7q11.23,75065012,75172182,107170,-,-
BAC221_N02,7,7q11.23,75093361,75177826,84465,-,-
BAC180_G20,7,7q11.23,75104597,75222934,118337,-,-
BAC152_A07,7,7q11.23,75136838,75222920,86082,-,-
BAC59_L19,7,7q11.23,75136841,75222938,86097,-,-
BAC65_N09,7,7q11.23,75139965,75222938,82973,-,-
BAC48_L04,7,7q11.23,75297270,75516214,218944,yes,-
BAC171_K05,7,7q11.23,75315606,75415001,99395,-,-
BAC78_I13,7,7q11.23,75373511,75471091,97580,yes,-
BAC182_I23,7,7q11.23,75417921,75555872,137951,yes,-
BAC58_P18,7,7q11.23,75535817,75617023,81206,-,-
BAC234_B11,7,7q11.23,75563820,75673127,109307,-,-
BAC235_N07,7,7q11.23,75605066,75690566,85500,-,-
BAC175_J10,7,7q11.23,75708776,75820384,111608,yes,-
BAC31_M21,7,7q11.23,75750325,75906060,155735,yes,-
BAC238_M17,7,7q11.23,75782216,75888546,106330,yes,-
BAC181_C12,7,7q11.23,75806289,75888535,82246,yes,-
BAC179_H21,7,7q11.23,75806475,75906075,99600,yes,-
BAC241_O09,7,7q11.23,75830121,75942052,111931,yes,-
BAC89_L08,7,7q11.23,75906071,76052133,146062,yes,-
BAC241_F15,7,7q11.23,75915212,76019244,104032,yes,-
BAC106_B03,7,7q11.23,76024326,76139796,115470,-,-
BAC123_J16,7,7q11.23,76258313,76346897,88584,-,-
BAC78_E10,7,7q11.23,76352349,76461608,109259,-,-
BAC155_M16,7,7q11.23,76461422,76614410,152988,-,-
BAC182_E12,7,7q11.23,76461603,76558203,96600,-,-
BAC224_M13,7,7q11.23,76558199,76644446,86247,-,-
BAC81_F13,7,7q11.23,76559006,76741068,182062,-,-
BAC176_A19,7,7q11.23,76671383,76772576,101193,-,-
BAC230_I02,7,7q11.23,76693362,76811230,117868,-,-
BAC53_O03,7,7q11.23,76725823,76824879,99056,-,-
BAC119_A21,7,7q11.23,76754334,76883055,128721,-,-
BAC51_L17,7,7q11.23,76885282,77012856,127574,-,-
BAC34_E03,7,7q11.23,76895918,76981977,86059,-,-
BAC142_B06,7,7q11.23,77019567,77113523,93956,-,-
BAC77_A14,7,7q11.23,77113529,77225106,111577,-,-
BAC228_O11,7,7q11.23,77163059,77261110,98051,-,-
BAC54_E04,7,7q11.23,77165462,77257680,92218,-,-
BAC184_E09,7,7q11.23,77225103,77321431,96328,-,-
BAC197_O22,7,7q11.23,77247794,77339172,91378,-,-
BAC33_L11,7,7q11.23,77257883,77367891,110008,-,-
BAC211_L19,7,7q11.23,77259732,77372150,112418,-,-
BAC2_A10,7,7q11.23,77279861,77378628,98767,-,-
BAC139_K08,7,7q11.23,77279861,77372242,92381,-,-
BAC116_B11,7,7q11.23-7q21.11,77308071,77427445,119374,-,-
BAC78_P07,7,7q11.23-7q21.11,77399911,77520794,120883,-,-
BAC28_H01,7,7q21.11,77411631,77502098,90467,-,-
BAC6_P05,7,7q21.11,77422337,77548266,125929,-,-
BAC116_O20,7,7q21.11,77427439,77510873,83434,-,-
BAC24_B22,7,7q21.11,77804264,77905134,100870,-,-
BAC151_M08,7,7q21.11,77815527,77914040,98513,-,-
BAC62_M10,7,7q21.11,77974324,78061419,87095,-,-
BAC76_J04,7,7q21.11,78070278,78167663,97385,-,-
BAC65_N16,7,7q21.11,78139547,78258036,118489,-,-
BAC188_F23,7,7q21.11,78480041,78566373,86332,-,-
BAC202_I02,7,7q21.11,78568591,78666286,97695,-,-
BAC43_N15,7,7q21.11,78593116,78685204,92088,-,-
BAC26_K07,7,7q21.11,78593351,78669939,76588,-,-
BAC127_D23,7,7q21.11,78647197,78733072,85875,-,-
BAC86_D10,7,7q21.11,78663919,78811164,147245,-,-
BAC142_B13,7,7q21.11,78675613,78777785,102172,-,-
BAC84_P10,7,7q21.11,78693919,78811164,117245,-,-
BAC130_B12,7,7q21.11,78949870,79027996,78126,-,-
BAC191_O10,7,7q21.11,79241661,79319652,77991,-,-
BAC101_G07,7,7q21.11,79460085,79533474,73389,-,-
BAC63_P14,7,7q21.11,79482558,79570225,87667,-,-
BAC35_B09,7,7q21.11,79491187,79586639,95452,-,-
BAC156_G22,7,7q21.11,79494118,79610706,116588,-,-
BAC112_C04,7,7q21.11,79502199,79595521,93322,-,-
BAC102_G02,7,7q21.11,79508880,79595350,86470,-,-
BAC165_N20,7,7q21.11,79509483,79595378,85895,-,-
BAC44_I14,7,7q21.11,79513868,79613526,99658,-,-
BAC39_E21,7,7q21.11,79519792,79603645,83853,-,-
BAC155_J13,7,7q21.11,79726593,79855313,128720,-,-
BAC74_G16,7,7q21.11,79757786,79856306,98520,-,-
BAC190_C09,7,7q21.11,79830788,79935462,104674,-,-
BAC248_I22,7,7q21.11,79891094,79976114,85020,-,-
BAC171_K20,7,7q21.11,79927266,80018146,90880,-,-
BAC226_H09,7,7q21.11,80018138,80087266,69128,-,-
BAC63_F24,7,7q21.11,80074656,80160033,85377,-,-
BAC60_J22,7,7q21.11,80087594,80184018,96424,-,-
BAC246_C11,7,7q21.11,80132249,80208698,76449,-,-
BAC54_M04,7,7q21.11,80310158,80417725,107567,-,-
BAC32_K04,7,7q21.11,80426180,80524240,98060,-,-
BAC241_I17,7,7q21.11,80429171,80512784,83613,-,-
BAC136_K13,7,7q21.11,80437142,80535505,98363,-,-
BAC75_O19,7,7q21.11,80437209,80519761,82552,-,-
BAC177_A16,7,7q21.11,80444511,80516303,71792,-,-
BAC218_E15,7,7q21.11,80452299,80573290,120991,-,-
BAC191_D09,7,7q21.11,80502429,80584875,82446,-,-
BAC96_B10,7,7q21.11,80552484,80675152,122668,-,-
BAC230_N11,7,7q21.11,80573302,80654749,81447,-,-
BAC120_G02,7,7q21.11,80595481,80732650,137169,-,-
BAC91_D23,7,7q21.11,80605033,80707862,102829,-,-
BAC235_P09,7,7q21.11,80649204,80756533,107329,-,-
BAC127_J18,7,7q21.11,80675163,80828248,153085,-,-
BAC109_H01,7,7q21.11,80820380,80959343,138963,-,-
BAC196_H02,7,7q21.11,81046903,81162175,115272,-,-
BAC246_N24,7,7q21.11,81296670,81387147,90477,-,-
BAC149_M02,7,7q21.11,81381300,81463507,82207,-,-
BAC67_H11,7,7q21.11,81478623,81590552,111929,-,-
BAC96_O04,7,7q21.11,81593969,81686006,92037,-,-
BAC248_P06,7,7q21.11,81669117,81775391,106274,-,-
BAC110_A07,7,7q21.11,81725048,81898813,173765,-,-
BAC146_A04,7,7q21.11,81763683,81839523,75840,-,-
BAC160_M21,7,7q21.11,81839626,81927543,87917,-,-
BAC193_C18,7,7q21.11,81913093,81999667,86574,-,-
BAC51_B24,7,7q21.11,81989071,82075497,86426,-,-
BAC252_D15,7,7q21.11,81995329,82119878,124549,-,-
BAC39_E06,7,7q21.11,82028093,82133602,105509,-,-
BAC48_I08,7,7q21.11,82169734,82276706,106972,-,-
BAC118_E24,7,7q21.11,82180760,82276816,96056,-,-
BAC214_P03,7,7q21.11,82180760,82256217,75457,-,-
BAC124_A23,7,7q21.11,82188323,82267845,79522,-,-
BAC14_K17,7,7q21.11,82301168,82393853,92685,-,-
BAC1_P18,7,7q21.11,82433424,82530473,97049,-,-
BAC76_B23,7,7q21.11,82535709,82620411,84702,-,-
BAC75_I18,7,7q21.11,82535989,82669317,133328,-,-
BAC128_D07,7,7q21.11,82566658,82661458,94800,-,-
BAC240_L01,7,7q21.11,82788622,82879353,90731,-,-
BAC240_F11,7,7q21.11,82957012,83034192,77180,-,-
BAC57_E21,7,7q21.11,82981736,83087893,106157,-,-
BAC151_K01,7,7q21.11,82987229,83059393,72164,-,-
BAC150_P09,7,7q21.11,83034191,83129968,95777,-,-
BAC14_M03,7,7q21.11,83034193,83114471,80278,-,-
BAC86_L02,7,7q21.11,83129723,83220514,90791,-,-
BAC124_J16,7,7q21.11,83350537,83473999,123462,-,-
BAC139_L22,7,7q21.11,83383040,83481357,98317,-,-
BAC71_K08,7,7q21.11,83390842,83470893,80051,-,-
BAC123_M19,7,7q21.11,83394203,83488516,94313,-,-
BAC144_M08,7,7q21.11,83509757,83582801,73044,-,-
BAC90_B04,7,7q21.11,83586562,83671721,85159,-,-
BAC117_J23,7,7q21.11,83737169,83835413,98244,-,-
BAC60_B01,7,7q21.11,83784237,83873947,89710,-,-
BAC153_B12,7,7q21.11,83857237,83949285,92048,-,-
BAC162_M17,7,7q21.11,83961588,84069878,108290,-,-
BAC250_H09,7,7q21.11,83963175,84047653,84478,-,-
BAC243_E11,7,7q21.11,84066909,84151446,84537,-,-
BAC56_E24,7,7q21.11,84151440,84237865,86425,-,-
BAC237_I13,7,7q21.11,84200456,84283468,83012,-,-
BAC108_L06,7,7q21.11,84308368,84421022,112654,-,-
BAC204_N11,7,7q21.11,84315065,84387421,72356,-,-
BAC147_K01,7,7q21.11,84361341,84440512,79171,-,-
BAC59_B23,7,7q21.11,84399051,84487710,88659,-,-
BAC78_B05,7,7q21.11,84553223,84633905,80682,-,-
BAC246_G22,7,7q21.11,84682393,84772627,90234,-,-
BAC24_K07,7,7q21.11,85168409,85265858,97449,-,-
BAC38_B20,7,7q21.11,85350449,85501309,150860,-,-
BAC196_E19,7,7q21.11,85413659,85501317,87658,-,-
BAC193_H23,7,7q21.11,85584065,85669369,85304,-,-
BAC151_N07,7,7q21.11,85584065,85669369,85304,-,-
BAC227_N19,7,7q21.11,85584628,85677211,92583,-,-
BAC126_G16,7,7q21.11,85584640,85739423,154783,-,-
BAC12_B06,7,7q21.11,85586380,85683567,97187,-,-
BAC242_E09,7,7q21.11,85635505,85726336,90831,-,-
BAC137_J02,7,7q21.11,85786715,85887400,100685,-,-
BAC197_I10,7,7q21.11,86046152,86139836,93684,-,-
BAC57_L08,7,7q21.11-7q21.12,86144050,86308456,164406,-,-
BAC6_N04,7,7q21.11-7q21.12,86158094,86256747,98653,-,-
BAC235_I18,7,7q21.11-7q21.12,86176338,86296738,120400,-,-
BAC97_J01,7,7q21.12,86379083,86478983,99900,-,-
BAC53_I12,7,7q21.12,86379091,86478972,99881,-,-
BAC144_I21,7,7q21.12,86390053,86471026,80973,-,-
BAC101_A24,7,7q21.12,86415909,86502257,86348,-,-
BAC186_B10,7,7q21.12,86470029,86576058,106029,-,-
BAC43_M03,7,7q21.12,86528998,86629819,100821,-,-
BAC208_P13,7,7q21.12,86696692,86767781,71089,-,-
BAC26_A01,7,7q21.12,86698482,86786587,88105,-,-
BAC106_A09,7,7q21.12,86794917,86877170,82253,-,-
BAC155_I17,7,7q21.12,86794955,86896684,101729,-,-
BAC43_L24,7,7q21.12,86950537,87132122,181585,-,-
BAC75_G13,7,7q21.12,87031984,87150853,118869,-,-
BAC176_P12,7,7q21.12,87132136,87208965,76829,-,-
BAC249_J11,7,7q21.12,87363033,87445563,82530,-,-
BAC146_E10,7,7q21.12,87387628,87492618,104990,-,-
BAC170_C01,7,7q21.12,87411614,87494436,82822,-,-
BAC25_E20,7,7q21.12,87526027,87603883,77856,-,-
BAC2_K16,7,7q21.12,87539250,87619682,80432,-,-
BAC157_M10,7,7q21.12,87571922,87653800,81878,-,-
BAC236_F07,7,7q21.12,87679323,87743495,64172,-,-
BAC143_J23,7,7q21.12,87791527,87909031,117504,-,-
BAC192_J22,7,7q21.12,87797628,87874303,76675,-,-
BAC158_F18,7,7q21.12,87797633,87895146,97513,-,-
BAC177_K15,7,7q21.12,87837869,87925135,87266,-,-
BAC135_D24,7,7q21.13,88628568,88736044,107476,-,-
BAC194_N05,7,7q21.13,88628577,88705922,77345,-,-
BAC250_B01,7,7q21.13,88703482,88794173,90691,-,-
BAC44_J18,7,7q21.13,88842590,88934823,92233,-,-
BAC59_N16,7,7q21.13,89229950,89329631,99681,-,-
BAC162_D14,7,7q21.13,89237779,89336111,98332,-,-
BAC72_P16,7,7q21.13,89708451,89796439,87988,-,-
BAC72_D19,7,7q21.13,89783826,89906078,122252,-,-
BAC70_D15,7,7q21.13,89786843,89857368,70525,-,-
BAC64_L10,7,7q21.13,89898478,89987524,89046,-,-
BAC40_C02,7,7q21.13,89928208,90001310,73102,-,-
BAC103_P07,7,7q21.13,89956820,90039238,82418,-,-
BAC59_P19,7,7q21.13,89973498,90061016,87518,-,-
BAC242_L06,7,7q21.13,90039635,90136902,97267,-,-
BAC29_K23,7,7q21.13,90060549,90146624,86075,-,-
BAC74_G20,7,7q21.13,90060552,90160620,100068,-,-
BAC190_O08,7,7q21.13,90061010,90136912,75902,-,-
BAC145_P17,7,7q21.13,90217688,90307869,90181,-,-
BAC204_B06,7,7q21.13,90224206,90325422,101216,-,-
BAC12_M05,7,7q21.13,90319550,90457752,138202,-,-
BAC84_H17,7,7q21.13,90471665,90579081,107416,-,-
BAC60_F14,7,7q21.13,90675940,90806177,130237,-,-
BAC135_N11,7,7q21.13,90694677,90774219,79542,-,-
BAC239_K19,7,7q21.13,90789739,90899322,109583,-,-
BAC46_D17,7,7q21.13-7q21.2,90825131,90910854,85723,-,-
BAC129_A03,7,7q21.2,91024818,91121899,97081,-,-
BAC91_L08,7,7q21.2,91121904,91222734,100830,-,-
BAC235_E13,7,7q21.2,91197257,91289148,91891,-,-
BAC33_I02,7,7q21.2,91296173,91419417,123244,-,-
BAC107_E11,7,7q21.2,91296177,91419436,123259,-,-
BAC53_M03,7,7q21.2,91334502,91483530,149028,-,-
BAC249_B04,7,7q21.2,91536185,91633455,97270,-,-
BAC105_F06,7,7q21.2,91575614,91663431,87817,-,-
BAC37_J20,7,7q21.2,91575988,91660855,84867,-,-
BAC97_E10,7,7q21.2,91730657,91814430,83773,-,-
BAC74_C11,7,7q21.2,91730664,91814373,83709,-,-
BAC126_B04,7,7q21.2,91876940,91976303,99363,-,-
BAC10_C13,7,7q21.2,91876943,91984313,107370,-,-
BAC66_L02,7,7q21.2,91883173,91984286,101113,-,-
BAC217_E08,7,7q21.2,91883177,91973359,90182,-,-
BAC64_L22,7,7q21.2,91890070,91984313,94243,-,-
BAC40_P06,7,7q21.2,91991108,92124556,133448,-,-
BAC191_H19,7,7q21.2,92072927,92168653,95726,-,-
BAC232_M12,7,7q21.2,92083812,92166459,82647,-,-
BAC197_O13,7,7q21.2,92137344,92255131,117787,-,-
BAC48_L11,7,7q21.2,92268435,92411793,143358,-,-
BAC43_P17,7,7q21.2,92343338,92453929,110591,-,-
BAC242_O12,7,7q21.2,92406095,92537119,131024,-,-
BAC115_A12,7,7q21.2,92505941,92585019,79078,-,-
BAC91_E23,7,7q21.3,93083453,93171216,87763,-,-
BAC82_O21,7,7q21.3,93130069,93231160,101091,-,-
BAC69_C03,7,7q21.3,93189753,93302756,113003,-,-
BAC61_E03,7,7q21.3,93223127,93302760,79633,-,-
BAC75_L19,7,7q21.3,93329834,93418453,88619,-,-
BAC88_G17,7,7q21.3,93534888,93614555,79667,-,-
BAC154_E05,7,7q21.3,93566834,93659096,92262,-,-
BAC163_O20,7,7q21.3,93647871,93715990,68119,-,-
BAC82_F20,7,7q21.3,93750308,93864138,113830,-,-
BAC133_G01,7,7q21.3,93757118,93871866,114748,-,-
BAC169_J07,7,7q21.3,93791873,93879778,87905,-,-
BAC53_E17,7,7q21.3,93980635,94155656,175021,-,-
BAC179_F06,7,7q21.3,94044923,94135101,90178,-,-
BAC130_M12,7,7q21.3,94050653,94134368,83715,-,-
BAC60_N21,7,7q21.3,94103496,94192497,89001,-,-
BAC180_L22,7,7q21.3,94114418,94192280,77862,-,-
BAC30_M24,7,7q21.3,94155671,94251106,95435,-,-
BAC48_H02,7,7q21.3,94192310,94299505,107195,-,-
BAC230_L22,7,7q21.3,94244881,94328225,83344,-,-
BAC43_P23,7,7q21.3,94299533,94401965,102432,-,-
BAC10_H22,7,7q21.3,94299654,94410858,111204,-,-
BAC202_G20,7,7q21.3,94348594,94447430,98836,-,-
BAC44_N07,7,7q21.3,94427433,94604179,176746,-,-
BAC51_K15,7,7q21.3,94447556,94557460,109904,-,-
BAC252_D21,7,7q21.3,94448387,94561361,112974,-,-
BAC96_K12,7,7q21.3,94462891,94571763,108872,-,-
BAC23_E09,7,7q21.3,94470345,94573437,103092,-,-
BAC117_O23,7,7q21.3,94494186,94576310,82124,-,-
BAC38_H13,7,7q21.3,94503332,94607031,103699,-,-
BAC59_A20,7,7q21.3,94531578,94616790,85212,-,-
BAC27_G17,7,7q21.3,94995626,95080326,84700,-,-
BAC243_D09,7,7q21.3,95164109,95270332,106223,-,-
BAC195_G04,7,7q21.3,95193773,95289753,95980,-,-
BAC32_L14,7,7q21.3,95275207,95363486,88279,-,-
BAC184_I24,7,7q21.3,95295534,95396701,101167,-,-
BAC185_E15,7,7q21.3,95415249,95504519,89270,-,-
BAC19_D01,7,7q21.3,95550597,95647381,96784,-,-
BAC219_D24,7,7q21.3,95565710,95652974,87264,-,-
BAC90_D08,7,7q21.3,95670174,95833421,163247,-,-
BAC97_P09,7,7q21.3,95712713,95782576,69863,-,-
BAC46_D23,7,7q21.3,95714560,95833410,118850,-,-
BAC233_N02,7,7q21.3,95778642,95863623,84981,-,-
BAC70_L04,7,7q21.3,95782570,95900669,118099,-,-
BAC231_P13,7,7q21.3,95863913,95946392,82479,-,-
BAC84_M15,7,7q21.3,95883053,96000027,116974,-,-
BAC26_C02,7,7q21.3,95908181,96061645,153464,-,-
BAC215_F05,7,7q21.3,96031323,96121561,90238,-,-
BAC209_G01,7,7q21.3,96049589,96121704,72115,-,-
BAC181_A21,7,7q21.3,96082119,96173067,90948,-,-
BAC230_E22,7,7q21.3,96144578,96242783,98205,-,-
BAC27_A19,7,7q21.3,96280818,96410363,129545,-,-
BAC51_H02,7,7q21.3,96338697,96432243,93546,-,-
BAC57_I05,7,7q21.3,96349426,96457605,108179,-,-
BAC10_D22,7,7q21.3,96377990,96528073,150083,-,-
BAC96_F02,7,7q21.3,96395369,96489640,94271,-,-
BAC45_H02,7,7q21.3,96443176,96540386,97210,-,-
BAC64_F05,7,7q21.3,96491598,96584591,92993,-,-
BAC149_M18,7,7q21.3,96549683,96652699,103016,-,-
BAC135_E23,7,7q21.3,96699423,96775585,76162,-,-
BAC45_N13,7,7q21.3,96740810,96843900,103090,-,-
BAC165_G06,7,7q21.3,96794291,96874243,79952,-,-
BAC74_J21,7,7q21.3,96809404,96896932,87528,-,-
BAC59_J24,7,7q21.3,96841247,96959109,117862,-,-
BAC34_M17,7,7q21.3,96939405,97013199,73794,-,-
BAC102_E15,7,7q21.3,96981807,97100718,118911,-,-
BAC200_P22,7,7q21.3,97039176,97112580,73404,-,-
BAC106_M07,7,7q21.3,97045440,97125615,80175,-,-
BAC39_I08,7,7q21.3,97117649,97285814,168165,-,-
BAC142_A17,7,7q21.3,97153798,97247027,93229,-,-
BAC5_H03,7,7q21.3,97229051,97324182,95131,-,-
BAC72_N02,7,7q21.3,97281402,97386854,105452,-,-
BAC66_B05,7,7q21.3,97284731,97376342,91611,-,-
BAC145_H10,7,7q21.3,97314620,97405929,91309,-,-
BAC73_F13,7,7q21.3,97324396,97418904,94508,-,-
BAC217_G14,7,7q21.3,97405924,97501440,95516,-,-
BAC105_D21,7,7q21.3,97412165,97499929,87764,-,-
BAC186_B20,7,7q21.3,97451994,97530610,78616,-,-
BAC151_A01,7,7q21.3,97551327,97640554,89227,-,-
BAC86_F19,7,7q21.3,97551327,97650107,98780,-,-
BAC43_C07,7,7q21.3,97602480,97736001,133521,-,-
BAC180_D13,7,7q21.3,97677052,97760674,83622,-,-
BAC180_A05,7,7q21.3,97723554,97804213,80659,-,-
BAC197_J12,7,7q21.3,97728486,97849730,121244,-,-
BAC247_G16,7,7q21.3,97736005,97830796,94791,-,-
BAC66_B17,7,7q21.3,97758582,97849730,91148,-,-
BAC132_F01,7,7q21.3,97781650,97865002,83352,-,-
BAC53_J07,7,7q21.3-7q22.1,97796839,97924483,127644,-,-
BAC237_P05,7,7q21.3-7q22.1,97842043,97930605,88562,-,-
BAC132_H08,7,7q21.3-7q22.1,97864995,97963257,98262,-,-
BAC163_H03,7,7q21.3-7q22.1,97885747,97963257,77510,-,-
BAC36_B23,7,7q22.1,97925328,98007278,81950,-,-
BAC237_J08,7,7q22.1,98007274,98091180,83906,-,-
BAC193_A10,7,7q22.1,98069303,98161001,91698,-,-
BAC197_F09,7,7q22.1,98105191,98188950,83759,-,-
BAC56_H10,7,7q22.1,98111147,98211759,100612,-,-
BAC166_I01,7,7q22.1,98303943,98433710,129767,-,-
BAC42_D19,7,7q22.1,98346143,98434876,88733,-,-
BAC195_L04,7,7q22.1,98357511,98470703,113192,-,-
BAC152_P19,7,7q22.1,98417830,98501188,83358,-,-
BAC126_P10,7,7q22.1,98423389,98560014,136625,-,-
BAC191_A09,7,7q22.1,98423389,98527781,104392,-,-
BAC126_G15,7,7q22.1,98423399,98560014,136615,-,-
BAC56_C12,7,7q22.1,98433791,98529418,95627,-,-
BAC126_G01,7,7q22.1,98459356,98532748,73392,-,-
BAC77_D24,7,7q22.1,98470707,98559995,89288,-,-
BAC127_M11,7,7q22.1,98532743,98627868,95125,-,-
BAC34_F21,7,7q22.1,98664667,98780811,116144,-,-
BAC33_P01,7,7q22.1,98696700,98808532,111832,-,-
BAC154_J21,7,7q22.1,98750311,98825928,75617,-,-
BAC233_K07,7,7q22.1,98775101,98858223,83122,-,-
BAC25_B15,7,7q22.1,98834557,98929595,95038,-,-
BAC144_G04,7,7q22.1,98838599,98914031,75432,-,-
BAC175_P15,7,7q22.1,98882845,98962948,80103,-,-
BAC147_B22,7,7q22.1,98953561,98991123,37562,-,-
BAC117_A15,7,7q22.1,98976656,99079466,102810,-,-
BAC108_E02,7,7q22.1,99003199,99103942,100743,-,-
BAC192_E09,7,7q22.1,99010732,99106482,95750,-,-
BAC60_I04,7,7q22.1,99066967,99204545,137578,-,-
BAC34_L15,7,7q22.1,99158024,99168280,10256,-,-
BAC160_P18,7,7q22.1,99291529,99371312,79783,-,-
BAC218_N18,7,7q22.1,99351835,99453511,101676,yes,-
BAC129_A07,7,7q22.1,99351835,99453498,101663,yes,-
BAC124_F08,7,7q22.1,99353008,99431514,78506,-,-
BAC102_G17,7,7q22.1,99370242,99455921,85679,yes,-
BAC153_M08,7,7q22.1,99370242,99455923,85681,yes,-
BAC227_N22,7,7q22.1,99379899,99466694,86795,yes,-
BAC125_A24,7,7q22.1,99379899,99473938,94039,yes,-
BAC69_J04,7,7q22.1,99379899,99475646,95747,yes,-
BAC155_N18,7,7q22.1,99380165,99468566,88401,yes,-
BAC152_L13,7,7q22.1,99380241,99484474,104233,yes,-
BAC134_B13,7,7q22.1,99431509,99531143,99634,-,-
BAC141_P01,7,7q22.1,99434037,99522692,88655,-,-
BAC249_K04,7,7q22.1,99469142,99560310,91168,-,-
BAC38_M16,7,7q22.1,99473146,99553287,80141,-,-
BAC161_G07,7,7q22.1,99522686,99623202,100516,-,-
BAC79_I10,7,7q22.1,99522711,99635125,112414,-,-
BAC146_O13,7,7q22.1,99585827,99663127,77300,-,-
BAC81_B17,7,7q22.1,99619134,99743025,123891,-,-
BAC200_G20,7,7q22.1,99626122,99743025,116903,-,-
BAC113_O01,7,7q22.1,99635155,99766103,130948,-,-
BAC12_C10,7,7q22.1,99674135,99783265,109130,-,-
BAC63_L17,7,7q22.1,99679067,99783421,104354,-,-
BAC250_H03,7,7q22.1,99693685,99783475,89790,-,-
BAC41_M13,7,7q22.1,99711691,99849279,137588,-,-
BAC197_F14,7,7q22.1,99743019,99847635,104616,-,-
BAC146_A22,7,7q22.1,99759351,99847615,88264,-,-
BAC39_E07,7,7q22.1,99764960,99849283,84323,-,-
BAC129_K20,7,7q22.1,99766098,99879521,113423,-,-
BAC127_H08,7,7q22.1,99783257,99896423,113166,-,-
BAC240_J04,7,7q22.1,99806924,99984799,177875,-,-
BAC62_I05,7,7q22.1,99879905,99973530,93625,-,-
BAC63_P06,7,7q22.1,99883504,100000443,116939,-,-
BAC101_A08,7,7q22.1,100080645,100200897,120252,-,-
BAC141_K19,7,7q22.1,100150741,100283324,132583,yes,-
BAC66_A21,7,7q22.1,100201227,100316307,115080,yes,-
BAC149_O15,7,7q22.1,100251812,100356266,104454,yes,-
BAC141_O24,7,7q22.1,100263606,100365360,101754,yes,-
BAC123_J17,7,7q22.1,100388636,100480128,91492,yes,-
BAC247_E05,7,7q22.1,100407386,100480130,72744,-,-
BAC240_L07,7,7q22.1,100407386,100482779,75393,yes,-
BAC204_K07,7,7q22.1,100411600,100480083,68483,yes,-
BAC83_P07,7,7q22.1,100411886,100480130,68244,yes,-
BAC105_A17,7,7q22.1,100480412,100606898,126486,-,-
BAC217_H09,7,7q22.1,100480412,100587347,106935,-,-
BAC211_C08,7,7q22.1,100482777,100606798,124021,-,-
BAC237_A13,7,7q22.1,100489255,100587347,98092,-,-
BAC109_M06,7,7q22.1,100558011,100703726,145715,-,-
BAC53_A14,7,7q22.1,100587339,100684773,97434,-,-
BAC176_H17,7,7q22.1,100716375,100812775,96400,-,-
BAC148_J11,7,7q22.1,100804680,100900447,95767,-,-
BAC179_A05,7,7q22.1,100897968,101044212,146244,-,-
BAC198_D18,7,7q22.1,100949881,101062110,112229,-,-
BAC20_J05,7,7q22.1,101007447,101154940,147493,-,-
BAC139_I17,7,7q22.1,101098669,101177752,79083,-,-
BAC143_B10,7,7q22.1,101102306,101177779,75473,-,-
BAC198_C02,7,7q22.1,101177344,101270159,92815,-,-
BAC21_P09,7,7q22.1,101177344,101325399,148055,-,-
BAC144_D07,7,7q22.1,101177772,101270159,92387,-,-
BAC237_L21,7,7q22.1,101177772,101270160,92388,-,-
BAC52_F18,7,7q22.1,101177795,101289262,111467,-,-
BAC27_C05,7,7q22.1,101263597,101386950,123353,-,-
BAC165_L12,7,7q22.1,101376603,101461365,84762,-,-
BAC73_L01,7,7q22.1,101376603,101457511,80908,-,-
BAC48_A14,7,7q22.1,101413644,101443519,29875,-,-
BAC42_A05,7,7q22.1,101467370,101565170,97800,-,-
BAC226_N13,7,7q22.1,101523246,101672159,148913,-,-
BAC175_O17,7,7q22.1,101523246,101623244,99998,-,-
BAC193_K15,7,7q22.1,101530965,101635062,104097,-,-
BAC117_L11,7,7q22.1,101623239,101721226,97987,-,-
BAC124_P03,7,7q22.1,101666691,101764178,97487,yes,-
BAC165_A14,7,7q22.1,101672228,101793713,121485,yes,-
BAC114_K09,7,7q22.1,101721229,101811786,90557,-,-
BAC226_J11,7,7q22.1,101734495,101840085,105590,-,-
BAC239_H13,7,7q22.1,101811955,101924675,112720,yes,-
BAC100_F10,7,7q22.1,101811955,101895333,83378,yes,-
BAC226_B05,7,7q22.1,101876388,101969826,93438,yes,-
BAC196_N19,7,7q22.1,101912162,102001314,89152,-,-
BAC158_B11,7,7q22.1,101924723,102167551,242828,yes,-
BAC130_D01,7,7q22.1,101924734,102101895,177161,yes,-
BAC82_G18,7,7q22.1,101942907,101965978,23071,-,-
BAC220_I16,7,7q22.1,101969821,102151580,181759,yes,-
BAC220_F23,7,7q22.1,101971874,102177867,205993,yes,-
BAC148_E15,7,7q22.1,102251279,102354835,103556,-,-
BAC152_C08,7,7q22.1,102370678,102487313,116635,-,-
BAC184_B03,7,7q22.1,102400917,102503371,102454,-,-
BAC44_L16,7,7q22.1,102422181,102520358,98177,-,-
BAC152_A12,7,7q22.1,102482444,102577913,95469,yes,-
BAC232_P20,7,7q22.1,102509076,102592140,83064,yes,-
BAC34_H17,7,7q22.1,102520361,102641982,121621,-,-
BAC221_B22,7,7q22.1,102561347,102645848,84501,-,-
BAC48_E08,7,7q22.1,102622276,102735056,112780,-,-
BAC200_F10,7,7q22.1,102676054,102782441,106387,-,-
BAC86_F01,7,7q22.1,102685621,102782441,96820,-,-
BAC201_C04,7,7q22.1,102719366,102795737,76371,-,-
BAC168_C03,7,7q22.1,102884001,102964209,80208,-,-
BAC20_H17,7,7q22.1,102884001,102984950,100949,-,-
BAC219_D01,7,7q22.1,102927381,103020898,93517,-,-
BAC108_G20,7,7q22.1,102956831,103050877,94046,-,-
BAC90_G17,7,7q22.1,103079949,103176592,96643,-,-
BAC50_G12,7,7q22.1,103162969,103268131,105162,-,-
BAC126_E17,7,7q22.1,103367491,103474021,106530,-,-
BAC96_K03,7,7q22.1,103461880,103577554,115674,-,-
BAC67_H22,7,7q22.1,103542698,103641210,98512,-,-
BAC77_J02,7,7q22.1,103588888,103701526,112638,-,-
BAC147_N07,7,7q22.1,103607449,103701526,94077,-,-
BAC28_H05,7,7q22.1,103628279,103738543,110264,-,-
BAC18_N24,7,7q22.1,103639324,103734123,94799,-,-
BAC88_K07,7,7q22.1,103680765,103797851,117086,-,-
BAC52_H07,7,7q22.1,103718492,103839489,120997,-,-
BAC235_F08,7,7q22.1,103778323,103860698,82375,-,-
BAC53_N11,7,7q22.1,103854081,103972724,118643,-,-
BAC76_I16,7,7q22.1,103932756,104037355,104599,-,-
BAC101_B14,7,7q22.1,104058847,104180395,121548,-,-
BAC19_L11,7,7q22.1,104079735,104180368,100633,-,-
BAC59_N18,7,7q22.1,104207743,104330363,122620,-,-
BAC74_D16,7,7q22.1-7q22.2,104312213,104411132,98919,-,-
BAC60_B16,7,7q22.2,104414812,104528550,113738,-,-
BAC110_C18,7,7q22.2,104506836,104596889,90053,-,-
BAC187_B17,7,7q22.2,104581583,104666377,84794,-,-
BAC156_D13,7,7q22.2,104612306,104690663,78357,-,-
BAC102_K21,7,7q22.2,104632395,104734977,102582,-,-
BAC11_L15,7,7q22.2,104679362,104780881,101519,-,-
BAC96_A11,7,7q22.2,104682949,104837431,154482,-,-
BAC102_A04,7,7q22.2,104736322,104857726,121404,-,-
BAC208_H05,7,7q22.2,104770780,104863152,92372,-,-
BAC140_N03,7,7q22.2,104854925,104940877,85952,-,-
BAC157_K03,7,7q22.2,104913547,105001514,87967,-,-
BAC143_P06,7,7q22.2,104913732,105025939,112207,-,-
BAC161_B20,7,7q22.2,104932991,105025939,92948,-,-
BAC64_J04,7,7q22.2,104945302,105045368,100066,-,-
BAC29_N11,7,7q22.2,104998283,105131563,133280,-,-
BAC67_K04,7,7q22.2,105023183,105117282,94099,-,-
BAC179_K05,7,7q22.2,105041510,105118520,77010,-,-
BAC219_H10,7,7q22.2,105097273,105188948,91675,-,-
BAC167_P20,7,7q22.2,105169098,105254525,85427,-,-
BAC105_M16,7,7q22.2,105170413,105328420,158007,-,-
BAC97_M22,7,7q22.2,105177490,105254527,77037,-,-
BAC146_E09,7,7q22.2,105236527,105351789,115262,-,-
BAC240_H10,7,7q22.2,105328458,105406580,78122,-,-
BAC217_J22,7,7q22.2,105359872,105450716,90844,-,-
BAC170_P09,7,7q22.2,105362725,105458288,95563,-,-
BAC248_J07,7,7q22.2,105510888,105624451,113563,-,-
BAC121_E15,7,7q22.2,105518377,105581765,63388,-,-
BAC189_L15,7,7q22.2,105749275,105829992,80717,-,-
BAC124_B23,7,7q22.2,105749275,105858055,108780,-,-
BAC92_G09,7,7q22.2-7q22.3,105808455,105902862,94407,-,-
BAC101_B12,7,7q22.2-7q22.3,105814700,105921366,106666,-,-
BAC115_D15,7,7q22.2-7q22.3,105868432,105946803,78371,-,-
BAC141_I22,7,7q22.3,106140883,106215866,74983,-,-
BAC53_E21,7,7q22.3,106172119,106278906,106787,-,-
BAC230_J21,7,7q22.3,106184981,106276134,91153,-,-
BAC39_F06,7,7q22.3,106194260,106280165,85905,-,-
BAC120_L15,7,7q22.3,106197034,106278909,81875,-,-
BAC88_A06,7,7q22.3,106224880,106356008,131128,-,-
BAC252_N22,7,7q22.3,106278926,106378196,99270,-,-
BAC144_C20,7,7q22.3,106281723,106391510,109787,-,-
BAC210_N08,7,7q22.3,106321221,106429097,107876,-,-
BAC39_K01,7,7q22.3,106356436,106502478,146042,-,-
BAC83_D16,7,7q22.3,106363109,106473597,110488,-,-
BAC150_F21,7,7q22.3,106374346,106452919,78573,-,-
BAC61_F17,7,7q22.3,106502803,106618883,116080,-,-
BAC28_J15,7,7q22.3,106503099,106596682,93583,-,-
BAC165_D22,7,7q22.3,106540842,106636487,95645,-,-
BAC59_N24,7,7q22.3,106596211,106713240,117029,-,-
BAC2_K14,7,7q22.3,106617872,106713260,95388,-,-
BAC119_O19,7,7q22.3,106618950,106713546,94596,-,-
BAC10_I03,7,7q22.3,106658974,106771791,112817,-,-
BAC70_L13,7,7q22.3,106675742,106765940,90198,-,-
BAC217_C06,7,7q22.3,106675903,106794561,118658,-,-
BAC41_M05,7,7q22.3,106686234,106808630,122396,-,-
BAC12_L09,7,7q22.3,106788453,106900784,112331,-,-
BAC41_K24,7,7q22.3,106901858,107011848,109990,-,-
BAC243_O01,7,7q22.3,106994710,107083393,88683,-,-
BAC230_O03,7,7q22.3,107069998,107158762,88764,-,-
BAC46_D11,7,7q22.3-7q31.1,107195600,107296685,101085,-,-
BAC226_I18,7,7q31.1,107227743,107316781,89038,-,-
BAC76_J15,7,7q31.1,107284335,107429307,144972,-,-
BAC187_G24,7,7q31.1,107296680,107427309,130629,-,-
BAC134_H21,7,7q31.1,107321959,107410948,88989,-,-
BAC100_N11,7,7q31.1,107346885,107497569,150684,-,-
BAC73_H18,7,7q31.1,107460563,107559464,98901,-,-
BAC56_P10,7,7q31.1,107469479,107559464,89985,-,-
BAC109_P11,7,7q31.1,107481539,107602617,121078,-,-
BAC32_K21,7,7q31.1,107481721,107578188,96467,-,-
BAC21_A06,7,7q31.1,107489108,107633185,144077,-,-
BAC39_O13,7,7q31.1,107490440,107582768,92328,-,-
BAC83_A18,7,7q31.1,107553523,107641650,88127,-,-
BAC179_P20,7,7q31.1,107610779,107710846,100067,-,-
BAC182_N17,7,7q31.1,107632225,107710846,78621,-,-
BAC49_I23,7,7q31.1,107633208,107709410,76202,-,-
BAC227_J22,7,7q31.1,107640193,107763901,123708,-,-
BAC249_H03,7,7q31.1,107697604,107785920,88316,-,-
BAC180_N11,7,7q31.1,107770271,107859877,89606,-,-
BAC66_L16,7,7q31.1,107770271,107859892,89621,-,-
BAC52_H09,7,7q31.1,107810834,107942261,131427,-,-
BAC139_J04,7,7q31.1,107817605,107913546,95941,-,-
BAC218_B20,7,7q31.1,107828130,107906922,78792,-,-
BAC171_O07,7,7q31.1,107902649,108002654,100005,-,-
BAC236_K08,7,7q31.1,107929794,108027879,98085,-,-
BAC27_J12,7,7q31.1,108008068,108154571,146503,-,-
BAC232_P13,7,7q31.1,108059262,108151204,91942,-,-
BAC23_L15,7,7q31.1,108257046,108396318,139272,-,-
BAC57_J16,7,7q31.1,108307696,108452618,144922,-,-
BAC65_C15,7,7q31.1,108326119,108484346,158227,-,-
BAC147_E10,7,7q31.1,108467640,108543865,76225,-,-
BAC110_P05,7,7q31.1,108543855,108646338,102483,-,-
BAC168_G21,7,7q31.1,108611645,108661360,49715,-,-
BAC149_N07,7,7q31.1,108728510,108823294,94784,-,-
BAC36_L17,7,7q31.1,108978508,109064738,86230,-,-
BAC20_H06,7,7q31.1,109023821,109156571,132750,-,-
BAC45_I10,7,7q31.1,109051572,109223452,171880,-,-
BAC95_P18,7,7q31.1,109268405,109357705,89300,-,-
BAC103_C24,7,7q31.1,109354551,109448865,94314,-,-
BAC135_I21,7,7q31.1,109561544,109653471,91927,-,-
BAC63_L15,7,7q31.1,109848075,109977135,129060,-,-
BAC162_P01,7,7q31.1,109880624,109959407,78783,-,-
BAC35_D05,7,7q31.1,109908267,110023936,115669,-,-
BAC40_M24,7,7q31.1,110037493,110114565,77072,-,-
BAC188_I08,7,7q31.1,110238003,110354919,116916,-,-
BAC81_H17,7,7q31.1,110256365,110364478,108113,-,-
BAC58_B05,7,7q31.1,110270800,110362552,91752,-,-
BAC248_D15,7,7q31.1,110304284,110385708,81424,-,-
BAC91_K19,7,7q31.1,110517995,110610740,92745,-,-
BAC12_I15,7,7q31.1,110657324,110771120,113796,-,-
BAC141_N20,7,7q31.1,110816391,110951539,135148,-,-
BAC183_C05,7,7q31.1,110886614,110980668,94054,-,-
BAC127_D07,7,7q31.1,111045121,111190054,144933,-,-
BAC189_K13,7,7q31.1,111045904,111138221,92317,-,-
BAC14_E16,7,7q31.1,111067841,111161129,93288,-,-
BAC175_G20,7,7q31.1,111077295,111177741,100446,-,-
BAC221_C19,7,7q31.1,111168448,111248703,80255,-,-
BAC15_I09,7,7q31.1,111233267,111384365,151098,-,-
BAC27_H17,7,7q31.1,111292795,111492506,199711,-,-
BAC86_G02,7,7q31.1,111324894,111438647,113753,-,-
BAC108_F13,7,7q31.1,111384371,111473377,89006,-,-
BAC197_E05,7,7q31.1,111598420,111696290,97870,-,-
BAC43_K21,7,7q31.1,111642931,111738979,96048,-,-
BAC233_H15,7,7q31.1,111696521,111793383,96862,-,-
BAC125_M05,7,7q31.1,111740655,111888044,147389,-,-
BAC219_D12,7,7q31.1,111779757,111878604,98847,-,-
BAC222_F14,7,7q31.1,111788195,111871877,83682,-,-
BAC180_F22,7,7q31.1,111849080,111923244,74164,-,-
BAC130_N03,7,7q31.1,111888112,111971461,83349,-,-
BAC152_I06,7,7q31.1,111888113,112008882,120769,-,-
BAC189_I02,7,7q31.1,112026153,112121022,94869,-,-
BAC31_G05,7,7q31.1,112047628,112169362,121734,-,-
BAC155_A06,7,7q31.1,112132915,112210933,78018,-,-
BAC50_A21,7,7q31.1,112207646,112324362,116716,-,-
BAC139_L16,7,7q31.1,112265363,112368260,102897,-,-
BAC117_B18,7,7q31.1,112272551,112368289,95738,-,-
BAC76_H13,7,7q31.1,112324662,112440617,115955,-,-
BAC162_B17,7,7q31.1,112626902,112698260,71358,-,-
BAC118_J19,7,7q31.1,112771730,112876445,104715,-,-
BAC217_K03,7,7q31.1,112846184,112937548,91364,-,-
BAC43_D20,7,7q31.1,112937540,113078387,140847,-,-
BAC244_O22,7,7q31.1,112990515,113078385,87870,-,-
BAC12_P06,7,7q31.1,113027211,113138800,111589,-,-
BAC116_L07,7,7q31.1,113034285,113153569,119284,-,-
BAC20_K03,7,7q31.1,113048802,113124969,76167,-,-
BAC72_J03,7,7q31.1,113621899,113765655,143756,-,-
BAC41_I02,7,7q31.1,113681889,113808180,126291,-,-
BAC86_D19,7,7q31.1,113843137,113955709,112572,-,-
BAC55_G01,7,7q31.1,113866659,113983562,116903,-,-
BAC115_A23,7,7q31.1,113919072,114010666,91594,-,-
BAC1_B12,7,7q31.1,114031779,114196042,164263,-,-
BAC24_M04,7,7q31.1,114088921,114118000,29079,-,-
BAC40_F19,7,7q31.1-7q31.2,114291211,114428313,137102,-,-
BAC132_D11,7,7q31.2,114497754,114604324,106570,-,-
BAC61_B15,7,7q31.2,114572341,114664713,92372,-,-
BAC162_J01,7,7q31.2,114591689,114669668,77979,-,-
BAC71_P13,7,7q31.2,114664708,114744811,80103,-,-
BAC190_D11,7,7q31.2,114983494,115060760,77266,-,-
BAC66_I06,7,7q31.2,115329760,115417885,88125,-,-
BAC146_F19,7,7q31.2,115598281,115679505,81224,-,-
BAC235_F01,7,7q31.2,115606112,115692794,86682,-,-
BAC184_N17,7,7q31.2,115711050,115808567,97517,-,-
BAC102_K07,7,7q31.2,115718518,115851771,133253,-,-
BAC34_L21,7,7q31.2,115775603,115866341,90738,-,-
BAC137_A12,7,7q31.2,115839966,115922294,82328,-,-
BAC119_B12,7,7q31.2,115899377,115968839,69462,-,-
BAC246_P03,7,7q31.2,115969063,116055503,86440,-,-
BAC42_C20,7,7q31.2,115988759,116089957,101198,-,-
BAC127_K08,7,7q31.2,116091791,116187733,95942,-,-
BAC73_I23,7,7q31.2,116205641,116361548,155907,-,-
BAC69_H14,7,7q31.2,116206306,116301211,94905,-,-
BAC83_I05,7,7q31.2,116276836,116395302,118466,-,-
BAC233_C21,7,7q31.2,116290569,116395302,104733,-,-
BAC64_D02,7,7q31.2,116346733,116451975,105242,-,-
BAC120_H13,7,7q31.2,116386569,116483211,96642,-,-
BAC37_B24,7,7q31.2,116433812,116554116,120304,-,-
BAC68_P14,7,7q31.2,116470895,116566114,95219,-,-
BAC200_K22,7,7q31.2,116515429,116585611,70182,-,-
BAC83_N01,7,7q31.2,116566108,116678760,112652,-,-
BAC36_B03,7,7q31.2,116581149,116678794,97645,-,-
BAC183_O20,7,7q31.2,116719966,116830005,110039,-,-
BAC190_P04,7,7q31.2,116734832,116844407,109575,-,-
BAC45_J10,7,7q31.2,116912914,117000109,87195,-,-
BAC78_A03,7,7q31.2,116966782,117057675,90893,-,-
BAC20_I07,7,7q31.2,117033115,117190467,157352,-,-
BAC184_F19,7,7q31.2-7q31.31,117093848,117222055,128207,-,-
BAC250_I23,7,7q31.2-7q31.31,117196774,117293815,97041,-,-
BAC75_E12,7,7q31.2-7q31.31,117196834,117296000,99166,-,-
BAC160_H14,7,7q31.31,117302303,117396985,94682,-,-
BAC49_P22,7,7q31.31,117316257,117434715,118458,-,-
BAC147_C10,7,7q31.31,117532225,117623514,91289,-,-
BAC102_B12,7,7q31.31,117653049,117751267,98218,-,-
BAC180_C23,7,7q31.31,117787241,117866182,78941,-,-
BAC151_I01,7,7q31.31,118086693,118192928,106235,-,-
BAC86_H09,7,7q31.31,118485559,118594843,109284,-,-
BAC182_O22,7,7q31.31,118960567,119039319,78752,-,-
BAC222_F05,7,7q31.31,119103174,119224585,121411,-,-
BAC97_K04,7,7q31.31,119144354,119285874,141520,-,-
BAC97_B05,7,7q31.31,119272295,119361795,89500,-,-
BAC189_F02,7,7q31.31,119433332,119523476,90144,-,-
BAC38_I15,7,7q31.31,119542036,119653285,111249,-,-
BAC51_H08,7,7q31.31,119563855,119660829,96974,-,-
BAC53_E14,7,7q31.31,119724264,119828886,104622,-,-
BAC242_M05,7,7q31.31,119732301,119823953,91652,-,-
BAC186_K19,7,7q31.31,119742444,119823953,81509,-,-
BAC49_H17,7,7q31.31,120373381,120497240,123859,-,-
BAC122_G11,7,7q31.31,120401844,120526958,125114,-,-
BAC230_K03,7,7q31.31,120497891,120591750,93859,-,-
BAC52_C23,7,7q31.31,120498355,120591684,93329,-,-
BAC162_I04,7,7q31.31,120686511,120787789,101278,-,-
BAC113_F23,7,7q31.31,120686513,120781014,94501,-,-
BAC8_K14,7,7q31.31,120740854,120833467,92613,-,-
BAC76_K22,7,7q31.31,120746221,120850032,103811,-,-
BAC119_L05,7,7q31.31-7q31.32,120832350,120986068,153718,-,-
BAC179_G08,7,7q31.31-7q31.32,120892857,120974625,81768,-,-
BAC217_C03,7,7q31.32,120944172,121042663,98491,-,-
BAC194_J19,7,7q31.32,121183966,121282900,98934,-,-
BAC59_E19,7,7q31.32,121209165,121290108,80943,-,-
BAC217_G13,7,7q31.32,121214867,121302907,88040,-,-
BAC40_D02,7,7q31.32,121273128,121379874,106746,-,-
BAC250_E11,7,7q31.32,121292788,121379874,87086,-,-
BAC85_H06,7,7q31.32,121315334,121394927,79593,-,-
BAC11_P16,7,7q31.32,121394916,121487432,92516,-,-
BAC57_N02,7,7q31.32,121476473,121556784,80311,-,-
BAC166_C05,7,7q31.32,121593582,121672731,79149,-,-
BAC142_F09,7,7q31.32,121651578,121745803,94225,-,-
BAC169_N02,7,7q31.32,121651624,121748251,96627,-,-
BAC26_E13,7,7q31.32,121669476,121797415,127939,-,-
BAC67_I17,7,7q31.32,121743413,121885157,141744,-,-
BAC155_E16,7,7q31.32,121804268,121902319,98051,-,-
BAC168_H01,7,7q31.32,121821306,121902321,81015,-,-
BAC185_O14,7,7q31.32,121957777,122051390,93613,-,-
BAC199_E22,7,7q31.32,122166234,122246737,80503,-,-
BAC37_D13,7,7q31.32,122262941,122346536,83595,-,-
BAC171_E19,7,7q31.32,122272906,122360760,87854,-,-
BAC92_I23,7,7q31.32,122386632,122485082,98450,-,-
BAC217_F06,7,7q31.32,122420620,122511295,90675,-,-
BAC238_E04,7,7q31.32,122522627,122607958,85331,-,-
BAC41_G11,7,7q31.32,122841095,122961248,120153,-,-
BAC235_C16,7,7q31.32,123033720,123125244,91524,-,-
BAC200_E20,7,7q31.32,123039118,123131921,92803,-,-
BAC71_J09,7,7q31.32,123042773,123130766,87993,-,-
BAC43_P19,7,7q31.32,123139605,123223368,83763,-,-
BAC142_I16,7,7q31.32,123480027,123569791,89764,-,-
BAC133_E21,7,7q31.32,123492366,123581167,88801,-,-
BAC248_A18,7,7q31.32-7q31.33,123511673,123606196,94523,-,-
BAC165_A23,7,7q31.33,123775701,123857743,82042,-,-
BAC158_L22,7,7q31.33,124105382,124185371,79989,-,-
BAC181_F01,7,7q31.33,124629462,124697303,67841,-,-
BAC66_E20,7,7q31.33,124950129,125032919,82790,-,-
BAC114_M16,7,7q31.33,125169696,125253250,83554,-,-
BAC102_J18,7,7q31.33,125218873,125302738,83865,-,-
BAC210_H01,7,7q31.33,125274621,125351349,76728,-,-
BAC43_G12,7,7q31.33,125302758,125422171,119413,-,-
BAC89_O13,7,7q31.33,125333892,125468913,135021,-,-
BAC50_D12,7,7q31.33,125334657,125445401,110744,-,-
BAC248_N02,7,7q31.33,125650785,125730665,79880,-,-
BAC238_G04,7,7q31.33,125715173,125839821,124648,-,-
BAC51_J05,7,7q31.33,125900185,126026057,125872,-,-
BAC31_J23,7,7q31.33,125906085,125995486,89401,-,-
BAC252_B07,7,7q31.33,125917355,126030319,112964,-,-
BAC179_D16,7,7q31.33,126042094,126139038,96944,-,-
BAC127_C14,7,7q31.33,126106465,126228276,121811,-,-
BAC146_K20,7,7q31.33,126145592,126228273,82681,-,-
BAC75_E19,7,7q31.33,126200087,126277040,76953,-,-
BAC127_L07,7,7q31.33,126272858,126394841,121983,-,-
BAC179_E11,7,7q31.33,126290834,126374607,83773,-,-
BAC192_H24,7,7q31.33,126388750,126520531,131781,-,-
BAC81_K20,7,7q31.33,126395995,126492173,96178,-,-
BAC41_A10,7,7q31.33,126407829,126495616,87787,-,-
BAC150_A20,7,7q31.33,126492170,126599998,107828,-,-
BAC102_O02,7,7q31.33,126574726,126666797,92071,-,-
BAC156_O02,7,7q31.33,126777390,126879011,101621,-,-
BAC51_N16,7,7q31.33-7q32.1,126782541,126909314,126773,-,-
BAC168_I06,7,7q32.1,126926767,127013104,86337,-,-
BAC67_M10,7,7q32.1,126930440,127028742,98302,-,-
BAC205_O04,7,7q32.1,126930487,127020343,89856,-,-
BAC186_E22,7,7q32.1,126940979,127047944,106965,-,-
BAC236_M14,7,7q32.1,126963388,127047944,84556,-,-
BAC131_L18,7,7q32.1,127028737,127105846,77109,-,-
BAC42_J17,7,7q32.1,127043618,127190043,146425,-,-
BAC34_J15,7,7q32.1,127248230,127329912,81682,-,-
BAC106_C18,7,7q32.1,127283459,127421419,137960,-,-
BAC173_M04,7,7q32.1,127304007,127414248,110241,-,-
BAC34_I04,7,7q32.1,127311852,127421419,109567,-,-
BAC61_C06,7,7q32.1,127329710,127496809,167099,-,-
BAC237_O10,7,7q32.1,127334369,127421419,87050,-,-
BAC28_J12,7,7q32.1,127499872,127569778,69906,-,-
BAC122_C05,7,7q32.1,127499881,127586356,86475,-,-
BAC183_N22,7,7q32.1,127547904,127664247,116343,-,-
BAC198_C08,7,7q32.1,127547915,127664294,116379,-,-
BAC67_P13,7,7q32.1,127635750,127738688,102938,-,-
BAC155_D16,7,7q32.1,127635750,127738718,102968,-,-
BAC90_P16,7,7q32.1,127723072,127823100,100028,-,-
BAC158_F03,7,7q32.1,127738713,127821276,82563,-,-
BAC158_I03,7,7q32.1,127738734,127821276,82542,-,-
BAC95_O09,7,7q32.1,127774643,127880951,106308,-,-
BAC230_B21,7,7q32.1,127780345,127862831,82486,-,-
BAC224_L08,7,7q32.1,127880945,128014570,133625,-,-
BAC143_I02,7,7q32.1,127880945,128022973,142028,-,-
BAC193_A06,7,7q32.1,127887401,127973230,85829,-,-
BAC223_J19,7,7q32.1,128021788,128154629,132841,-,-
BAC152_G20,7,7q32.1,128034134,128150188,116054,-,-
BAC152_P13,7,7q32.1,128045738,128139330,93592,-,-
BAC126_A20,7,7q32.1,128045740,128196137,150397,-,-
BAC80_C09,7,7q32.1,128055035,128199946,144911,-,-
BAC188_F01,7,7q32.1,128073701,128288118,214417,-,-
BAC171_F13,7,7q32.1,128073701,128175431,101730,-,-
BAC152_J07,7,7q32.1,128139476,128286983,147507,-,-
BAC168_L22,7,7q32.1,128139477,128226842,87365,-,-
BAC90_O10,7,7q32.1,128154628,128262210,107582,-,-
BAC71_H06,7,7q32.1,128197064,128287041,89977,-,-
BAC195_F16,7,7q32.1,128287039,128381056,94017,-,-
BAC200_L11,7,7q32.1,128289581,128378764,89183,-,-
BAC222_G07,7,7q32.1,128327907,128459932,132025,-,-
BAC61_L13,7,7q32.1,128384799,128522786,137987,-,-
BAC103_C23,7,7q32.1,128384799,128471137,86338,-,-
BAC83_A21,7,7q32.1,128403349,128549855,146506,-,-
BAC71_F21,7,7q32.1,128410993,128522786,111793,-,-
BAC235_D11,7,7q32.1,128448063,128549855,101792,-,-
BAC101_A10,7,7q32.1,128539222,128638864,99642,-,-
BAC157_N07,7,7q32.1,128552972,128701033,148061,-,-
BAC56_A02,7,7q32.1,128653425,128744251,90826,-,-
BAC195_O03,7,7q32.1,128744289,128867878,123589,-,-
BAC244_I04,7,7q32.1,128850774,128990981,140207,-,-
BAC173_G13,7,7q32.1-7q32.2,128908288,129010761,102473,-,-
BAC65_O13,7,7q32.1-7q32.2,128908600,129002935,94335,-,-
BAC221_P05,7,7q32.1-7q32.2,128912550,129008760,96210,-,-
BAC25_F20,7,7q32.1-7q32.2,128912556,129009506,96950,-,-
BAC162_H17,7,7q32.1-7q32.2,128912642,129002927,90285,-,-
BAC198_B18,7,7q32.1-7q32.2,128912858,129010761,97903,-,-
BAC12_H08,7,7q32.1-7q32.2,128914962,129010761,95799,-,-
BAC240_I24,7,7q32.1-7q32.2,128914962,129010760,95798,-,-
BAC218_E13,7,7q32.1-7q32.2,128921950,129010761,88811,-,-
BAC172_O15,7,7q32.2,129000370,129102937,102567,-,-
BAC8_C11,7,7q32.2,129010771,129176508,165737,-,-
BAC56_P21,7,7q32.2,129064344,129156907,92563,-,-
BAC151_C18,7,7q32.2,129083207,129195395,112188,-,-
BAC43_J10,7,7q32.2,129177301,129292450,115149,-,-
BAC128_B05,7,7q32.2,129189015,129278512,89497,-,-
BAC4_C04,7,7q32.2,129219503,129314233,94730,-,-
BAC168_M16,7,7q32.2,129283007,129362490,79483,-,-
BAC140_C02,7,7q32.2,129289217,129366484,77267,-,-
BAC234_C03,7,7q32.2,129303038,129386988,83950,-,-
BAC30_F19,7,7q32.2,129350537,129418046,67509,-,-
BAC219_E21,7,7q32.2,129386004,129488020,102016,-,-
BAC233_A05,7,7q32.2,129409735,129506781,97046,-,-
BAC89_D13,7,7q32.2,129418065,129513360,95295,-,-
BAC39_H13,7,7q32.2,129567605,129689561,121956,-,-
BAC75_A14,7,7q32.2,129591724,129689561,97837,-,-
BAC132_K09,7,7q32.2,129615196,129700946,85750,-,-
BAC56_L03,7,7q32.2,129678467,129756993,78526,-,-
BAC80_A07,7,7q32.2,129720978,129843716,122738,-,-
BAC143_I20,7,7q32.2,129746782,129868644,121862,-,-
BAC161_F24,7,7q32.2,129780350,129857711,77361,-,-
BAC122_K02,7,7q32.2,129954499,130054083,99584,-,-
BAC119_N04,7,7q32.2-7q32.3,130051342,130192944,141602,-,-
BAC149_D22,7,7q32.2-7q32.3,130070559,130185814,115255,-,-
BAC189_D17,7,7q32.2-7q32.3,130087071,130221452,134381,-,-
BAC188_E02,7,7q32.3,130119122,130185827,66705,-,-
BAC218_C02,7,7q32.3,130119122,130221997,102875,-,-
BAC39_P03,7,7q32.3,130127024,130250078,123054,-,-
BAC170_H05,7,7q32.3,130141412,130250081,108669,-,-
BAC195_A15,7,7q32.3,130145246,130241952,96706,-,-
BAC63_G17,7,7q32.3,130166734,130331022,164288,-,-
BAC91_D13,7,7q32.3,130195821,130286009,90188,-,-
BAC20_P06,7,7q32.3,130250256,130336705,86449,-,-
BAC148_O14,7,7q32.3,130318100,130415524,97424,-,-
BAC43_I07,7,7q32.3,130331057,130418104,87047,-,-
BAC64_H08,7,7q32.3,130337867,130436696,98829,-,-
BAC120_E24,7,7q32.3,130338849,130432451,93602,-,-
BAC147_G04,7,7q32.3,130349121,130432451,83330,-,-
BAC101_E14,7,7q32.3,130362231,130461304,99073,-,-
BAC170_P14,7,7q32.3,130375948,130450237,74289,-,-
BAC96_N11,7,7q32.3,130410722,130498352,87630,-,-
BAC75_L15,7,7q32.3,130415712,130498352,82640,-,-
BAC108_N10,7,7q32.3,130416095,130602068,185973,-,-
BAC63_N05,7,7q32.3,130450483,130531637,81154,-,-
BAC179_H07,7,7q32.3,130531838,130623872,92034,-,-
BAC190_K20,7,7q32.3,130689338,130781968,92630,-,-
BAC68_M11,7,7q32.3,130789375,130873847,84472,-,-
BAC124_K23,7,7q32.3,130802226,130886805,84579,-,-
BAC184_J05,7,7q32.3,130836854,130959410,122556,-,-
BAC115_C14,7,7q32.3,130850620,130952947,102327,-,-
BAC141_D22,7,7q32.3,130862778,130942175,79397,-,-
BAC71_I12,7,7q32.3,130862797,130962693,99896,-,-
BAC60_F03,7,7q32.3,130997206,131101828,104622,-,-
BAC189_E07,7,7q32.3,130997697,131080557,82860,-,-
BAC71_N11,7,7q32.3,131003775,131093488,89713,-,-
BAC31_A05,7,7q32.3,131067641,131154551,86910,-,-
BAC190_B11,7,7q32.3,131081775,131154551,72776,-,-
BAC115_H11,7,7q32.3,131123646,131234878,111232,-,-
BAC244_L08,7,7q32.3,131195181,131283320,88139,-,-
BAC55_P02,7,7q32.3,131219952,131337198,117246,-,-
BAC178_F21,7,7q32.3,131294682,131379604,84922,-,-
BAC32_K17,7,7q32.3,131309285,131448620,139335,-,-
BAC151_K18,7,7q32.3,131448618,131537727,89109,-,-
BAC66_J15,7,7q32.3,131463309,131547017,83708,-,-
BAC199_L01,7,7q32.3,131468340,131556566,88226,-,-
BAC232_N13,7,7q32.3,131513424,131631158,117734,-,-
BAC230_L19,7,7q32.3,131573482,131660561,87079,-,-
BAC156_H06,7,7q32.3,131606747,131699702,92955,-,-
BAC34_F10,7,7q32.3,131634877,131834475,199598,-,-
BAC10_L06,7,7q32.3,131636019,131826126,190107,-,-
BAC57_H07,7,7q32.3,131636034,131748165,112131,-,-
BAC11_I09,7,7q32.3,131655968,131753856,97888,-,-
BAC113_G06,7,7q32.3,131708491,131806513,98022,-,-
BAC76_K13,7,7q32.3,131748178,131844288,96110,-,-
BAC118_M24,7,7q32.3,131748178,131844826,96648,-,-
BAC229_O16,7,7q32.3,131753850,131844826,90976,-,-
BAC36_C20,7,7q32.3,131964625,132134308,169683,-,-
BAC124_B07,7,7q32.3,131989677,132082341,92664,-,-
BAC231_E05,7,7q32.3,132001363,132134308,132945,-,-
BAC67_N20,7,7q32.3,132001784,132098558,96774,-,-
BAC53_K02,7,7q32.3,132001821,132114797,112976,-,-
BAC172_J05,7,7q32.3,132001822,132109304,107482,-,-
BAC142_H10,7,7q32.3,132017223,132141366,124143,-,-
BAC102_F14,7,7q32.3,132052347,132133241,80894,-,-
BAC75_L09,7,7q32.3,132077095,132176197,99102,-,-
BAC168_L16,7,7q32.3,132205092,132292783,87691,-,-
BAC89_O01,7,7q32.3-7q33,132287373,132404466,117093,-,-
BAC41_F21,7,7q32.3-7q33,132300825,132436215,135390,-,-
BAC241_L03,7,7q32.3,132317603,132393093,75490,-,-
BAC102_L14,7,7q33,132435254,132535119,99865,-,-
BAC120_P08,7,7q33,132436265,132543992,107727,-,-
BAC243_H15,7,7q33,132474428,132568042,93614,-,-
BAC184_O13,7,7q33,132596355,132716891,120536,-,-
BAC194_A13,7,7q33,132700165,132788970,88805,-,-
BAC194_L12,7,7q33,132716901,132797963,81062,-,-
BAC96_O11,7,7q33,132770114,132883975,113861,-,-
BAC218_I05,7,7q33,132926890,133012827,85937,-,-
BAC85_C16,7,7q33,132928358,133012827,84469,-,-
BAC155_K23,7,7q33,133012820,133105808,92988,-,-
BAC88_F10,7,7q33,133012820,133105808,92988,-,-
BAC107_A15,7,7q33,133079980,133168784,88804,-,-
BAC238_G23,7,7q33,133136230,133223626,87396,-,-
BAC25_O03,7,7q33,133182461,133271189,88728,-,-
BAC66_O20,7,7q33,133194572,133292443,97871,-,-
BAC149_B14,7,7q33,133201999,133282058,80059,-,-
BAC152_H21,7,7q33,133240491,133368219,127728,-,-
BAC117_H15,7,7q33,133384102,133476084,91982,-,-
BAC31_P06,7,7q33,133384102,133488448,104346,-,-
BAC41_H09,7,7q33,133384102,133564263,180161,-,-
BAC233_O13,7,7q33,133488685,133576250,87565,-,-
BAC91_E11,7,7q33,133490696,133584211,93515,-,-
BAC34_I15,7,7q33,133584442,133716366,131924,-,-
BAC72_K20,7,7q33,133584452,133700441,115989,-,-
BAC18_J18,7,7q33,133697546,133826201,128655,-,-
BAC236_K23,7,7q33,133700434,133790839,90405,-,-
BAC32_O17,7,7q33,133703127,133810726,107599,-,-
BAC169_N19,7,7q33,133790385,133877696,87311,-,-
BAC219_B13,7,7q33,133790388,133883516,93128,-,-
BAC82_P07,7,7q33,133843563,133967527,123964,-,-
BAC180_B10,7,7q33,133845146,133964696,119550,-,-
BAC90_G05,7,7q33,133876465,133981475,105010,-,-
BAC218_B23,7,7q33,133943695,134035130,91435,-,-
BAC229_K14,7,7q33,133967595,134060261,92666,-,-
BAC188_L21,7,7q33,133970423,134074766,104343,-,-
BAC101_O22,7,7q33,133970423,134066429,96006,-,-
BAC33_I24,7,7q33,133971498,134063081,91583,-,-
BAC194_N09,7,7q33,133980500,134074768,94268,-,-
BAC75_M23,7,7q33,133981472,134044390,62918,-,-
BAC22_B22,7,7q33,133981472,134086339,104867,-,-
BAC88_L20,7,7q33,133994262,134129164,134902,-,-
BAC243_J15,7,7q33,134053559,134154933,101374,-,-
BAC162_B07,7,7q33,134056200,134132306,76106,-,-
BAC45_L10,7,7q33,134056211,134132576,76365,-,-
BAC220_J05,7,7q33,134066454,134152362,85908,-,-
BAC181_A15,7,7q33,134075059,134181647,106588,-,-
BAC129_M08,7,7q33,134103309,134181647,78338,-,-
BAC247_H04,7,7q33,134152632,134319097,166465,-,-
BAC233_L23,7,7q33,134164975,134268174,103199,-,-
BAC158_B17,7,7q33,134254861,134318744,63883,-,-
BAC79_G08,7,7q33,134280583,134450475,169892,-,-
BAC18_L07,7,7q33,134370578,134450563,79985,-,-
BAC220_J07,7,7q33,134379200,134465291,86091,-,-
BAC190_B07,7,7q33,134397765,134497669,99904,-,-
BAC60_C06,7,7q33,134467687,134572185,104498,-,-
BAC31_J19,7,7q33,134491281,134587122,95841,-,-
BAC34_I03,7,7q33,134508749,134694325,185576,-,-
BAC178_F19,7,7q33,134511775,134652548,140773,-,-
BAC160_O10,7,7q33,134584060,134694325,110265,-,-
BAC29_C20,7,7q33,134782697,134926569,143872,-,-
BAC39_C11,7,7q33,134789298,134951374,162076,-,-
BAC33_B12,7,7q33,134840498,134951367,110869,-,-
BAC135_A09,7,7q33,134851720,134962081,110361,-,-
BAC26_O21,7,7q33,134851764,135007633,155869,-,-
BAC100_H03,7,7q33,134908865,135006565,97700,-,-
BAC186_O13,7,7q33,134922998,134992074,69076,-,-
BAC184_H20,7,7q33,134922998,135011934,88936,-,-
BAC111_J15,7,7q33,134924561,135009196,84635,-,-
BAC96_I10,7,7q33,134926572,134990749,64177,-,-
BAC95_D07,7,7q33,134951418,135060137,108719,-,-
BAC66_M13,7,7q33,134962046,135054808,92762,-,-
BAC51_N03,7,7q33,134972642,135057161,84519,-,-
BAC195_I03,7,7q33,135011930,135141812,129882,-,-
BAC95_O06,7,7q33,135029971,135109461,79490,-,-
BAC136_K07,7,7q33,135054801,135173596,118795,-,-
BAC80_H13,7,7q33,135063703,135170033,106330,-,-
BAC86_E22,7,7q33,135125294,135206565,81271,-,-
BAC148_K15,7,7q33,135173589,135257303,83714,-,-
BAC31_A20,7,7q33,135190011,135283528,93517,-,-
BAC55_A13,7,7q33,135206557,135359156,152599,-,-
BAC52_C11,7,7q33,135318702,135434494,115792,-,-
BAC9_P08,7,7q33,135369643,135464235,94592,-,-
BAC143_C07,7,7q33,135408975,135499231,90256,-,-
BAC199_C02,7,7q33,135473036,135572518,99482,-,-
BAC53_P01,7,7q33,135475209,135603149,127940,-,-
BAC166_L06,7,7q33,135486487,135572252,85765,-,-
BAC139_N10,7,7q33,135558569,135664497,105928,-,-
BAC136_G12,7,7q33,135669854,135745069,75215,-,-
BAC68_P12,7,7q33,135756353,135866823,110470,-,-
BAC64_I07,7,7q33,135822589,135913148,90559,-,-
BAC141_N04,7,7q33,136088286,136170137,81851,-,-
BAC65_J04,7,7q33,136331723,136472698,140975,-,-
BAC248_M13,7,7q33,136343443,136416617,73174,-,-
BAC1_G16,7,7q33,136398871,136500413,101542,-,-
BAC116_A08,7,7q33,136654665,136758862,104197,-,-
BAC118_G20,7,7q33,136759171,136854876,95705,-,-
BAC39_O06,7,7q33,136827435,136969334,141899,-,-
BAC69_G19,7,7q33,136855613,136958539,102926,-,-
BAC192_N04,7,7q33,136905463,137009239,103776,-,-
BAC150_G24,7,7q33,136982366,137084715,102349,-,-
BAC183_P15,7,7q33,137037474,137162213,124739,-,-
BAC127_I10,7,7q33,137144342,137267863,123521,-,-
BAC34_D02,7,7q33,137151098,137275718,124620,-,-
BAC102_L09,7,7q33-7q34,137173806,137310834,137028,-,-
BAC133_D24,7,7q33,137205044,137275727,70683,-,-
BAC74_F08,7,7q33-7q34,137220761,137320218,99457,-,-
BAC40_O23,7,7q33-7q34,137259866,137501522,241656,-,-
BAC132_I10,7,7q33-7q34,137275721,137352539,76818,-,-
BAC124_K06,7,7q33-7q34,137286597,137402082,115485,-,-
BAC45_D18,7,7q33-7q34,137298725,137393890,95165,-,-
BAC116_C02,7,7q34,137417976,137506074,88098,-,-
BAC89_M15,7,7q34,137421227,137555911,134684,-,-
BAC239_I04,7,7q34,137422946,137501587,78641,-,-
BAC60_M01,7,7q34,137440600,137545038,104438,-,-
BAC20_D07,7,7q34,137440600,137550243,109643,-,-
BAC60_A11,7,7q34,137464579,137597897,133318,-,-
BAC31_P05,7,7q34,137559917,137673595,113678,-,-
BAC92_G03,7,7q34,137797644,137871192,73548,-,-
BAC125_H09,7,7q34,137834738,137863264,28526,-,-
BAC242_H12,7,7q34,137916210,138040782,124572,-,-
BAC35_I13,7,7q34,137936230,138103746,167516,-,-
BAC125_H11,7,7q34,137948323,138068476,120153,-,-
BAC204_H20,7,7q34,137953361,138054523,101162,-,-
BAC154_C05,7,7q34,138151915,138242415,90500,-,-
BAC96_O14,7,7q34,138218992,138330860,111868,-,-
BAC97_H02,7,7q34,138226286,138305856,79570,-,-
BAC204_B11,7,7q34,138226307,138330570,104263,-,-
BAC72_B04,7,7q34,138227980,138330861,102881,-,-
BAC92_L24,7,7q34,138267346,138349224,81878,-,-
BAC198_M21,7,7q34,138281358,138356946,75588,-,-
BAC105_D05,7,7q34,138362301,138447941,85640,-,-
BAC168_I14,7,7q34,138373207,138495069,121862,-,-
BAC23_G11,7,7q34,138374252,138478484,104232,-,-
BAC117_O11,7,7q34,138400412,138498185,97773,-,-
BAC181_P13,7,7q34,138431318,138508068,76750,-,-
BAC178_H23,7,7q34,138431318,138498184,66866,-,-
BAC241_F20,7,7q34,138447932,138547331,99399,-,-
BAC219_E11,7,7q34,138498651,138554806,56155,-,-
BAC63_I13,7,7q34,138516253,138634322,118069,-,-
BAC147_K10,7,7q34,138547350,138631203,83853,-,-
BAC145_F06,7,7q34,138641923,138726293,84370,-,-
BAC84_L12,7,7q34,138641928,138726293,84365,-,-
BAC36_P23,7,7q34,138702283,138816802,114519,-,-
BAC82_A07,7,7q34,138707704,138816805,109101,-,-
BAC91_N23,7,7q34,138743037,138851098,108061,-,-
BAC145_A08,7,7q34,138776011,138903354,127343,-,-
BAC166_I05,7,7q34,138808046,138903345,95299,-,-
BAC222_H15,7,7q34,138828138,138932690,104552,-,-
BAC175_I19,7,7q34,138881942,138982848,100906,-,-
BAC11_G18,7,7q34,138924817,139014978,90161,-,-
BAC76_E23,7,7q34,139111711,139219832,108121,-,-
BAC102_K22,7,7q34,139150445,139286376,135931,-,-
BAC133_J06,7,7q34,139160712,139219834,59122,-,-
BAC153_O17,7,7q34,139174419,139305045,130626,-,-
BAC90_O09,7,7q34,139178303,139347516,169213,-,-
BAC44_P14,7,7q34,139178789,139263686,84897,-,-
BAC230_D24,7,7q34,139200743,139307000,106257,-,-
BAC176_O07,7,7q34,139209307,139305043,95736,-,-
BAC236_C11,7,7q34,139308063,139396607,88544,-,-
BAC142_N02,7,7q34,139318587,139347128,28541,-,-
BAC120_F02,7,7q34,139320282,139407198,86916,-,-
BAC147_C04,7,7q34,139486664,139573178,86514,-,-
BAC160_B24,7,7q34,139495505,139593789,98284,-,-
BAC46_P19,7,7q34,139495514,139586915,91401,-,-
BAC107_N12,7,7q34,139496747,139576512,79765,-,-
BAC144_I13,7,7q34,139550183,139642024,91841,-,-
BAC177_D09,7,7q34,139589893,139697547,107654,-,-
BAC76_B18,7,7q34,139593946,139729459,135513,-,-
BAC72_E11,7,7q34,139593965,139691910,97945,-,-
BAC66_L20,7,7q34,139628252,139729458,101206,-,-
BAC241_K07,7,7q34,139634311,139712047,77736,-,-
BAC214_L09,7,7q34,139676475,139757726,81251,-,-
BAC57_A11,7,7q34,139697807,139800052,102245,-,-
BAC238_M23,7,7q34,139698998,139810974,111976,-,-
BAC32_A10,7,7q34,139729489,139867456,137967,-,-
BAC127_C09,7,7q34,139729553,139826861,97308,-,-
BAC217_D06,7,7q34,139757925,139856188,98263,-,-
BAC120_P14,7,7q34,139800057,139972878,172821,-,-
BAC146_F12,7,7q34,139800076,139920063,119987,-,-
BAC65_I23,7,7q34,139811054,139920043,108989,-,-
BAC180_D02,7,7q34,139882764,139972872,90108,-,-
BAC221_J04,7,7q34,139882764,139981898,99134,-,-
BAC27_P12,7,7q34,139884442,140012980,128538,-,-
BAC64_P11,7,7q34,139927805,140048973,121168,-,-
BAC92_K14,7,7q34,139927805,140048973,121168,-,-
BAC132_F07,7,7q34,139927845,140038696,110851,-,-
BAC52_B09,7,7q34,139927847,140094014,166167,-,-
BAC92_F05,7,7q34,139942049,140012999,70950,-,-
BAC130_H17,7,7q34,139953933,140041246,87313,-,-
BAC117_M20,7,7q34,140087026,140223528,136502,-,-
BAC132_J16,7,7q34,140224060,140303997,79937,-,-
BAC123_O15,7,7q34,140275206,140359182,83976,-,-
BAC135_O18,7,7q34,140275206,140361276,86070,-,-
BAC192_E18,7,7q34,140298053,140425912,127859,-,-
BAC38_C11,7,7q34,140298053,140385469,87416,-,-
BAC73_J12,7,7q34,140298057,140313454,15397,-,-
BAC148_E14,7,7q34,140304004,140385490,81486,-,-
BAC166_E23,7,7q34,140367423,140490225,122802,-,-
BAC197_D03,7,7q34,140504576,140593473,88897,-,-
BAC145_L09,7,7q34,140711595,140836220,124625,-,-
BAC52_M16,7,7q34,140712438,140795462,83024,-,-
BAC152_H07,7,7q34,140712449,140797130,84681,-,-
BAC171_A03,7,7q34,140720664,140810800,90136,-,-
BAC53_H22,7,7q34,140720664,140856954,136290,-,-
BAC231_J03,7,7q34,140810922,140890757,79835,-,-
BAC115_P02,7,7q34,140815402,140881779,66377,-,-
BAC226_K16,7,7q34,140834514,140909045,74531,-,-
BAC247_K11,7,7q34,140834728,140923308,88580,-,-
BAC237_J11,7,7q34,140845418,140923308,77890,-,-
BAC146_L10,7,7q34,140887817,140995172,107355,-,-
BAC53_C04,7,7q34,140887817,140977373,89556,-,-
BAC27_F18,7,7q34,140951708,141028319,76611,-,-
BAC82_P17,7,7q34,140992842,141083991,91149,-,-
BAC37_F01,7,7q34,141148031,141274064,126033,-,-
BAC106_A12,7,7q34,141169612,141341514,171902,-,-
BAC84_O19,7,7q34,141269323,141359216,89893,-,-
BAC154_D08,7,7q34,141400338,141520970,120632,-,-
BAC163_D23,7,7q34,141441442,141520970,79528,-,-
BAC88_F19,7,7q34,141472329,141557211,84882,-,-
BAC38_H07,7,7q34,141481296,141584012,102716,-,-
BAC63_N07,7,7q34,141484107,141572639,88532,-,-
BAC22_J06,7,7q34,141484127,141572637,88510,-,-
BAC53_F22,7,7q34,141660131,141793566,133435,-,-
BAC106_L04,7,7q34,141793279,141908477,115198,-,-
BAC118_D11,7,7q34,141835865,141919687,83822,-,-
BAC221_K10,7,7q34,141835865,141962965,127100,-,-
BAC185_C07,7,7q34,141872964,141984212,111248,-,-
BAC179_F05,7,7q34,141908474,142001026,92552,-,-
BAC184_G01,7,7q34,141913149,141984554,71405,-,-
BAC96_C07,7,7q34,141919909,142001024,81115,-,-
BAC89_G14,7,7q34,141998991,142097706,98715,-,-
BAC214_J04,7,7q34,142020333,142112041,91708,-,-
BAC109_B21,7,7q34,142066421,142183363,116942,yes,-
BAC159_G09,7,7q34,142103982,142235499,131517,yes,-
BAC173_J15,7,7q34,142126095,142240021,113926,yes,-
BAC110_N06,7,7q34,142227207,142364576,137369,-,-
BAC120_F07,7,7q34,142229279,142377184,147905,-,-
BAC196_E05,7,7q34,142324408,142421252,96844,-,-
BAC118_A11,7,7q34,142340954,142429437,88483,-,-
BAC50_K21,7,7q34,142389808,142470098,80290,-,-
BAC31_O14,7,7q34,142429432,142536948,107516,-,-
BAC57_D16,7,7q34,142436138,142536948,100810,-,-
BAC218_H10,7,7q34,142436145,142511112,74967,-,-
BAC55_F03,7,7q34,142470098,142553934,83836,-,-
BAC117_G20,7,7q34,142496749,142582086,85337,-,-
BAC15_A21,7,7q34,142551836,142631483,79647,-,-
BAC46_L16,7,7q34,142581462,142762511,181049,-,-
BAC235_L02,7,7q34,142586889,142782375,195486,-,-
BAC190_H08,7,7q34,142598045,142687946,89901,-,-
BAC83_J07,7,7q34,142612024,142726456,114432,-,-
BAC130_D09,7,7q34,142625029,142720882,95853,-,-
BAC132_H21,7,7q34,142626170,142720880,94710,-,-
BAC48_M02,7,7q34,142626193,142713153,86960,-,-
BAC234_H07,7,7q34,142629755,142720534,90779,-,-
BAC170_H19,7,7q34,142640185,142720871,80686,-,-
BAC4_P22,7,7q34,142640185,142726442,86257,-,-
BAC154_A21,7,7q34,142687940,142795907,107967,-,-
BAC171_N15,7,7q34-7q35,142795321,142887330,92009,yes,-
BAC226_F10,7,7q34-7q35,142795352,142890592,95240,yes,-
BAC150_I23,7,7q34-7q35,142796449,142903862,107413,yes,-
BAC50_D19,7,7q35,142822269,142925025,102756,yes,-
BAC151_O05,7,7q35,142887321,142991709,104388,-,-
BAC123_J11,7,7q35,142992096,143240437,248341,-,-
BAC91_A24,7,7q35,143161198,143253357,92159,-,-
BAC33_O07,7,7q35,143206716,143313674,106958,yes,-
BAC132_F21,7,7q35,143363329,143388199,24870,yes,-
BAC120_E18,7,7q35,143557352,143585922,28570,yes,-
BAC148_K08,7,7q35,143784255,143875224,90969,-,-
BAC166_I20,7,7q35,143795717,143880763,85046,-,-
BAC69_P16,7,7q35,143795751,143888761,93010,-,-
BAC25_P01,7,7q35,143810058,143912204,102146,-,-
BAC135_B24,7,7q35,143998907,144077951,79044,-,-
BAC50_F15,7,7q35,144027333,144177821,150488,-,-
BAC149_J21,7,7q35,144051598,144128859,77261,-,-
BAC60_G12,7,7q35,144064792,144193433,128641,-,-
BAC72_N07,7,7q35,144091890,144183783,91893,-,-
BAC115_F09,7,7q35,144359640,144513867,154227,-,-
BAC168_J23,7,7q35,144429748,144513867,84119,-,-
BAC38_P19,7,7q35,144514225,144691548,177323,-,-
BAC33_I09,7,7q35,144514225,144641951,127726,-,-
BAC27_C06,7,7q35,144514225,144643583,129358,-,-
BAC1_I10,7,7q35,144531663,144643590,111927,-,-
BAC35_L15,7,7q35,144537483,144694161,156678,-,-
BAC120_N04,7,7q35,144540082,144643590,103508,-,-
BAC88_K23,7,7q35,144565947,144708617,142670,-,-
BAC161_G17,7,7q35,144732018,144817686,85668,-,-
BAC144_G02,7,7q35,144762427,144871918,109491,-,-
BAC167_H07,7,7q35,145013394,145105898,92504,-,-
BAC23_K09,7,7q35,145149643,145247902,98259,-,-
BAC102_B07,7,7q35,145308748,145438174,129426,-,-
BAC33_H20,7,7q35,145525573,145633092,107519,-,-
BAC109_E13,7,7q35,145551712,145675466,123754,-,-
BAC28_H09,7,7q35,145633663,145738212,104549,-,-
BAC71_E14,7,7q35,145645841,145781488,135647,-,-
BAC191_J21,7,7q35,145667774,145748215,80441,-,-
BAC113_H11,7,7q35,145688107,145769966,81859,-,-
BAC22_G12,7,7q35,145722202,145851747,129545,-,-
BAC199_I11,7,7q35,145722202,145812653,90451,-,-
BAC19_E03,7,7q35,145816672,145918570,101898,-,-
BAC197_C19,7,7q35,145840436,145921581,81145,-,-
BAC38_F17,7,7q35,145918840,146056358,137518,-,-
BAC169_K17,7,7q35,145923500,145962715,39215,-,-
BAC26_N07,7,7q35,145962725,146069545,106820,-,-
BAC59_K16,7,7q35,145967986,146004394,36408,-,-
BAC198_P08,7,7q35,145989785,146067936,78151,-,-
BAC199_K10,7,7q35,146046332,146144733,98401,-,-
BAC137_H20,7,7q35,146149448,146237129,87681,-,-
BAC243_N24,7,7q35,146168693,146277135,108442,-,-
BAC128_C05,7,7q35,146277298,146371033,93735,-,-
BAC193_P13,7,7q35,146373370,146470473,97103,-,-
BAC150_P13,7,7q35,146399536,146508827,109291,-,-
BAC146_B20,7,7q35,146399536,146511136,111600,-,-
BAC175_L18,7,7q35,146511695,146600689,88994,-,-
BAC25_D07,7,7q35,146596905,146734572,137667,-,-
BAC78_N02,7,7q35,146688176,146786033,97857,-,-
BAC114_K22,7,7q35,146688232,146825872,137640,-,-
BAC118_E22,7,7q35,146748024,146859820,111796,-,-
BAC133_B20,7,7q35,146783211,146870013,86802,-,-
BAC109_F20,7,7q35,146842665,146983709,141044,-,-
BAC137_N23,7,7q35,146861749,146948220,86471,-,-
BAC60_L10,7,7q35,146927992,147026003,98011,-,-
BAC148_K05,7,7q35,147015485,147109985,94500,-,-
BAC79_I19,7,7q35,147019453,147109985,90532,-,-
BAC141_H11,7,7q35,147034223,147109987,75764,-,-
BAC136_P17,7,7q35,147044683,147122728,78045,-,-
BAC186_L16,7,7q35,147152250,147246211,93961,-,-
BAC144_M05,7,7q35,147158983,147246211,87228,-,-
BAC227_P11,7,7q35,147238610,147320849,82239,-,-
BAC38_A13,7,7q35,147246344,147382472,136128,-,-
BAC233_N12,7,7q35,147280767,147372607,91840,-,-
BAC5_A05,7,7q35,147312822,147400330,87508,-,-
BAC184_A05,7,7q35,147372249,147464419,92170,-,-
BAC89_P16,7,7q35,147374999,147489924,114925,-,-
BAC44_C04,7,7q35,147444182,147467080,22898,-,-
BAC176_E15,7,7q35-7q36.1,147458673,147569547,110874,-,-
BAC192_G17,7,7q35-7q36.1,147460700,147570028,109328,-,-
BAC218_G24,7,7q35-7q36.1,147476788,147569547,92759,-,-
BAC187_C05,7,7q35-7q36.1,147489918,147569547,79629,-,-
BAC81_N05,7,7q36.1,147520019,147697958,177939,-,-
BAC48_J04,7,7q36.1,147520026,147610494,90468,-,-
BAC36_J15,7,7q36.1,147570039,147713194,143155,-,-
BAC195_M07,7,7q36.1,147570663,147698008,127345,-,-
BAC58_D22,7,7q36.1,147570663,147689228,118565,-,-
BAC237_P13,7,7q36.1,147581114,147677424,96310,-,-
BAC37_F10,7,7q36.1,147581114,147681474,100360,-,-
BAC81_G08,7,7q36.1,147587810,147718205,130395,-,-
BAC31_L20,7,7q36.1,147593559,147712388,118829,-,-
BAC76_L22,7,7q36.1,147678723,147774009,95286,-,-
BAC139_H18,7,7q36.1,147702557,147774009,71452,-,-
BAC22_H17,7,7q36.1,147730322,147808974,78652,-,-
BAC237_M13,7,7q36.1,147734646,147808974,74328,-,-
BAC186_C13,7,7q36.1,147734646,147815132,80486,-,-
BAC78_I02,7,7q36.1,147776266,147917543,141277,-,-
BAC218_B06,7,7q36.1,147808963,147900109,91146,-,-
BAC145_L18,7,7q36.1,147810435,147900109,89674,-,-
BAC178_K02,7,7q36.1,147815127,147894420,79293,-,-
BAC109_A22,7,7q36.1,147826836,148032181,205345,-,-
BAC230_I23,7,7q36.1,147880744,147966270,85526,-,-
BAC69_J19,7,7q36.1,147883991,147956368,72377,-,-
BAC171_A12,7,7q36.1,147919787,148012715,92928,-,-
BAC188_E14,7,7q36.1,148023963,148144259,120296,-,-
BAC229_G16,7,7q36.1,148066369,148159324,92955,-,-
BAC73_P10,7,7q36.1,148066791,148155960,89169,-,-
BAC186_A09,7,7q36.1,148159320,148250387,91067,-,-
BAC166_C20,7,7q36.1,148163752,148250589,86837,-,-
BAC119_M17,7,7q36.1,148250584,148339735,89151,-,-
BAC249_H01,7,7q36.1,148282356,148365088,82732,-,-
BAC132_C09,7,7q36.1,148282390,148357410,75020,-,-
BAC125_A02,7,7q36.1,148365088,148489833,124745,-,-
BAC113_P14,7,7q36.1,148386879,148494719,107840,-,-
BAC223_N08,7,7q36.1,148386972,148493586,106614,-,-
BAC17_J04,7,7q36.1,148398554,148518874,120320,-,-
BAC83_H17,7,7q36.1,148398554,148493586,95032,-,-
BAC208_D04,7,7q36.1,148453232,148532768,79536,-,-
BAC80_H22,7,7q36.1,148524549,148662488,137939,-,-
BAC118_N16,7,7q36.1,148532557,148612704,80147,-,-
BAC151_H18,7,7q36.1,148568070,148665870,97800,-,-
BAC163_P03,7,7q36.1,148581327,148673210,91883,-,-
BAC124_L15,7,7q36.1,148581327,148669910,88583,-,-
BAC149_C23,7,7q36.1,148581327,148669910,88583,-,-
BAC92_L02,7,7q36.1,148710700,148722829,12129,-,-
BAC169_E03,7,7q36.1,148750044,148824808,74764,-,-
BAC82_E14,7,7q36.1,148814457,148906503,92046,-,-
BAC223_O10,7,7q36.1,148851602,148951846,100244,-,-
BAC147_E17,7,7q36.1,148928428,149057645,129217,-,-
BAC43_J06,7,7q36.1,148951158,149073973,122815,-,-
BAC165_B08,7,7q36.1,148954432,149062350,107918,-,-
BAC119_M22,7,7q36.1,148961943,149073977,112034,-,-
BAC185_A17,7,7q36.1,148964511,149050903,86392,-,-
BAC125_K10,7,7q36.1,148971477,149073977,102500,-,-
BAC242_K18,7,7q36.1,149062347,149148281,85934,-,-
BAC142_B22,7,7q36.1,149136156,149221568,85412,yes,-
BAC135_P10,7,7q36.1,149136174,149221568,85394,yes,-
BAC193_P02,7,7q36.1,149231084,149321095,90011,-,-
BAC97_D20,7,7q36.1,149242093,149329539,87446,-,-
BAC133_A24,7,7q36.1,149425317,149520754,95437,-,-
BAC240_J18,7,7q36.1,149434032,149530796,96764,-,-
BAC179_A03,7,7q36.1,149460298,149521271,60973,-,-
BAC234_L23,7,7q36.1,149550751,149637254,86503,-,-
BAC159_I12,7,7q36.1,149666948,149737161,70213,-,-
BAC77_P04,7,7q36.1,149670930,149773056,102126,-,-
BAC66_F03,7,7q36.1,149671318,149811856,140538,-,-
BAC122_P01,7,7q36.1,149684617,149777584,92967,-,-
BAC126_C02,7,7q36.1,149689319,149828878,139559,-,-
BAC122_N12,7,7q36.1,149689319,149828876,139557,-,-
BAC176_F07,7,7q36.1,149737536,149831978,94442,-,-
BAC144_N13,7,7q36.1,149755263,149837129,81866,-,-
BAC59_G20,7,7q36.1,149798790,149904831,106041,-,-
BAC113_M06,7,7q36.1,149881566,150004631,123065,-,-
BAC172_F10,7,7q36.1,149942857,150030359,87502,-,-
BAC50_A05,7,7q36.1,149986047,150102384,116337,-,-
BAC120_C10,7,7q36.1,149995053,150139373,144320,-,-
BAC190_O11,7,7q36.1,149995071,150118286,123215,-,-
BAC24_D11,7,7q36.1,150028329,150175034,146705,-,-
BAC45_C06,7,7q36.1,150030384,150136045,105661,-,-
BAC96_E11,7,7q36.1,150045256,150136054,90798,-,-
BAC168_B01,7,7q36.1,150136047,150254405,118358,-,-
BAC167_L14,7,7q36.1,150139401,150226132,86731,-,-
BAC117_F19,7,7q36.1,150259327,150387482,128155,-,-
BAC244_F08,7,7q36.1,150283349,150375562,92213,-,-
BAC146_G24,7,7q36.1,150362831,150475864,113033,-,-
BAC197_F02,7,7q36.1,150396311,150494098,97787,-,-
BAC196_D01,7,7q36.1,150416604,150494098,77494,-,-
BAC88_E22,7,7q36.1,150535182,150658623,123441,yes,-
BAC34_P14,7,7q36.1,150553972,150639692,85720,-,-
BAC45_I17,7,7q36.1,150554142,150658626,104484,yes,-
BAC238_A15,7,7q36.1,150588225,150705411,117186,-,-
BAC218_M13,7,7q36.1,150629231,150722954,93723,-,-
BAC237_N12,7,7q36.1,150683741,150777129,93388,-,-
BAC97_B03,7,7q36.1,150693965,150777129,83164,-,-
BAC218_I04,7,7q36.1,150694724,150805584,110860,-,-
BAC83_K18,7,7q36.1,150722996,150846375,123379,-,-
BAC226_N23,7,7q36.1,150809164,150912916,103752,-,-
BAC227_L08,7,7q36.1,150929185,151024246,95061,-,-
BAC243_O22,7,7q36.1,150937078,151008944,71866,-,-
BAC231_K05,7,7q36.1,150951847,151017122,65275,-,-
BAC132_D15,7,7q36.1,150980558,151100024,119466,-,-
BAC38_K05,7,7q36.1,150989850,151070644,80794,-,-
BAC192_O14,7,7q36.1,150992513,151077243,84730,-,-
BAC82_H23,7,7q36.1,150992513,151096322,103809,-,-
BAC242_I16,7,7q36.1,151017117,151122904,105787,-,-
BAC27_H19,7,7q36.1,151039420,151267674,228254,-,-
BAC39_F15,7,7q36.1,151108814,151210120,101306,-,-
BAC176_G22,7,7q36.1,151108814,151221166,112352,-,-
BAC151_K16,7,7q36.1,151126696,151210121,83425,-,-
BAC234_O03,7,7q36.1,151198216,151298668,100452,-,-
BAC30_H03,7,7q36.1,151291016,151396731,105715,-,-
BAC40_P05,7,7q36.1,151397056,151487310,90254,-,-
BAC115_F07,7,7q36.1,151423749,151538453,114704,-,-
BAC169_I07,7,7q36.1,151598349,151709799,111450,-,-
BAC152_O14,7,7q36.1,151619485,151709784,90299,-,-
BAC123_C04,7,7q36.1,151619485,151709799,90314,-,-
BAC23_L10,7,7q36.1,151709794,151811198,101404,-,-
BAC187_M10,7,7q36.1,151709794,151840058,130264,-,-
BAC83_G01,7,7q36.1,151710076,151811196,101120,-,-
BAC59_I01,7,7q36.1,151710076,151813411,103335,-,-
BAC108_L15,7,7q36.1,151743507,151840058,96551,-,-
BAC106_I12,7,7q36.1,151748016,151843241,95225,-,-
BAC78_I07,7,7q36.1,151813435,151922184,108749,-,-
BAC188_I18,7,7q36.1,151843239,151936633,93394,-,-
BAC43_E15,7,7q36.1,151859672,152019353,159681,-,-
BAC234_E02,7,7q36.1,151879586,151998944,119358,-,-
BAC176_F10,7,7q36.1,151909210,152037950,128740,-,-
BAC237_N04,7,7q36.1,151922175,152049268,127093,-,-
BAC124_O22,7,7q36.1,151936671,152089122,152451,-,-
BAC67_C13,7,7q36.1,151973308,152077720,104412,-,-
BAC39_A19,7,7q36.1,151976975,152081826,104851,-,-
BAC123_G05,7,7q36.1-7q36.2,152088848,152226526,137678,-,-
BAC18_I07,7,7q36.1,152098079,152188681,90602,-,-
BAC187_B21,7,7q36.1,152107119,152188411,81292,-,-
BAC52_N20,7,7q36.1,152107123,152188255,81132,-,-
BAC22_C05,7,7q36.2,152323887,152447409,123522,-,-
BAC165_J14,7,7q36.2,152353386,152449841,96455,-,-
BAC39_C16,7,7q36.2,152549324,152640737,91413,-,-
BAC239_B11,7,7q36.2,152566016,152673878,107862,-,-
BAC126_B18,7,7q36.2,152566040,152662670,96630,-,-
BAC82_I11,7,7q36.2,152581753,152694752,112999,-,-
BAC67_C10,7,7q36.2,152634000,152735656,101656,-,-
BAC84_F12,7,7q36.2,152651527,152773638,122111,-,-
BAC31_L13,7,7q36.2,152658090,152833450,175360,-,-
BAC185_L06,7,7q36.2,152729320,152817164,87844,-,-
BAC133_M24,7,7q36.2,152833442,152915286,81844,-,-
BAC72_D15,7,7q36.2,152872008,152959195,87187,-,-
BAC168_A17,7,7q36.2,152892727,152973333,80606,-,-
BAC202_O15,7,7q36.2,152908046,152987493,79447,-,-
BAC66_F16,7,7q36.2,152915279,153031458,116179,-,-
BAC204_I19,7,7q36.2,152915281,153005665,90384,-,-
BAC51_I12,7,7q36.2,152987491,153101799,114308,-,-
BAC10_E05,7,7q36.2,153118605,153214035,95430,-,-
BAC83_H10,7,7q36.2,153127671,153231663,103992,-,-
BAC92_O10,7,7q36.2,153231692,153333711,102019,-,-
BAC204_B16,7,7q36.2,153231779,153333711,101932,-,-
BAC38_F14,7,7q36.2,153259567,153355113,95546,-,-
BAC45_F06,7,7q36.2,153263833,153330435,66602,-,-
BAC114_G10,7,7q36.2,153447477,153556103,108626,-,-
BAC8_J10,7,7q36.2,153509279,153650330,141051,-,-
BAC246_M09,7,7q36.2,153721590,153829877,108287,-,-
BAC90_C23,7,7q36.2,154013669,154152043,138374,-,-
BAC227_C23,7,7q36.2,154048736,154157404,108668,-,-
BAC63_L09,7,7q36.2,154057721,154152043,94322,-,-
BAC102_I13,7,7q36.2,154098459,154187417,88958,-,-
BAC222_M10,7,7q36.2,154152034,154267686,115652,-,-
BAC140_I02,7,7q36.2,154206828,154280506,73678,-,-
BAC106_M17,7,7q36.2,154255735,154376115,120380,-,-
BAC186_C21,7,7q36.2,154267756,154375154,107398,-,-
BAC218_H08,7,7q36.2,154280498,154376115,95617,-,-
BAC116_M19,7,7q36.2,154295068,154447518,152450,-,-
BAC168_D05,7,7q36.2,154318224,154437896,119672,-,-
BAC239_K11,7,7q36.2,154334369,154435980,101611,-,-
BAC19_G23,7,7q36.2,154344646,154491665,147019,-,-
BAC96_K21,7,7q36.2,154348498,154435994,87496,-,-
BAC153_C09,7,7q36.2,154361210,154445818,84608,-,-
BAC149_C02,7,7q36.2,154363927,154441246,77319,-,-
BAC76_L08,7,7q36.2,154531582,154659285,127703,-,-
BAC36_P17,7,7q36.2,154531582,154616101,84519,-,-
BAC129_F09,7,7q36.2,154617603,154697612,80009,-,-
BAC108_C06,7,7q36.2-7q36.3,154617603,154710160,92557,-,-
BAC160_D07,7,7q36.3,154866604,154966957,100353,-,-
BAC120_I09,7,7q36.3,154894609,154994317,99708,-,-
BAC33_E05,7,7q36.3,154896210,155032615,136405,-,-
BAC128_H22,7,7q36.3,154905674,155040493,134819,-,-
BAC125_G03,7,7q36.3,154929205,155037299,108094,-,-
BAC33_F15,7,7q36.3,154940451,155027636,87185,-,-
BAC156_E15,7,7q36.3,154982905,155061555,78650,-,-
BAC226_L06,7,7q36.3,154988580,155079761,91181,-,-
BAC147_N21,7,7q36.3,154994475,155062730,68255,-,-
BAC15_O23,7,7q36.3,154994475,155079757,85282,-,-
BAC27_K12,7,7q36.3,154994475,155093393,98918,-,-
BAC166_E24,7,7q36.3,155061892,155147551,85659,-,-
BAC184_N14,7,7q36.3,155072894,155162507,89613,-,-
BAC73_P08,7,7q36.3,155081213,155179872,98659,-,-
BAC171_D10,7,7q36.3,155234385,155324293,89908,-,-
BAC180_C07,7,7q36.3,155305319,155380509,75190,-,-
BAC147_I08,7,7q36.3,155313380,155390059,76679,-,-
BAC63_M12,7,7q36.3,155370645,155458529,87884,-,-
BAC104_A23,7,7q36.3,155371684,155509981,138297,-,-
BAC21_P01,7,7q36.3,155383058,155528839,145781,-,-
BAC53_I04,7,7q36.3,155433983,155524659,90676,-,-
BAC162_F15,7,7q36.3,155436145,155519827,83682,-,-
BAC171_O16,7,7q36.3,155597876,155718626,120750,-,-
BAC218_E10,7,7q36.3,155707993,155803762,95769,-,-
BAC81_J17,7,7q36.3,155709370,155868641,159271,-,-
BAC179_N17,7,7q36.3,155813793,155900425,86632,-,-
BAC161_I06,7,7q36.3,155815686,155911172,95486,-,-
BAC60_F16,7,7q36.3,155836101,156023200,187099,-,-
BAC31_N04,7,7q36.3,155836104,155985739,149635,-,-
BAC226_J06,7,7q36.3,155837535,155994169,156634,-,-
BAC129_H09,7,7q36.3,155868635,155981727,113092,-,-
BAC148_L11,7,7q36.3,155900420,155981755,81335,-,-
BAC25_K11,7,7q36.3,156001019,156160483,159464,-,-
BAC8_P05,7,7q36.3,156023233,156167966,144733,-,-
BAC96_C15,7,7q36.3,156075218,156167979,92761,-,-
BAC41_G15,7,7q36.3,156095097,156194640,99543,-,-
BAC218_E16,7,7q36.3,156113467,156184038,70571,-,-
BAC96_L05,7,7q36.3,156271792,156443680,171888,-,-
BAC192_O02,7,7q36.3,156305595,156418891,113296,-,-
BAC148_K04,7,7q36.3,156315130,156411474,96344,-,-
BAC219_M04,7,7q36.3,156339924,156416982,77058,-,-
BAC51_E01,7,7q36.3,156412840,156549168,136328,-,-
BAC107_C05,7,7q36.3,156418006,156550806,132800,-,-
BAC92_D20,7,7q36.3,156450494,156657482,206988,-,-
BAC221_M02,7,7q36.3,156484548,156563695,79147,-,-
BAC73_A17,7,7q36.3,156530304,156694513,164209,-,-
BAC25_A09,7,7q36.3,156545758,156657482,111724,-,-
BAC206_N22,7,7q36.3,156549170,156689540,140370,-,-
BAC71_J13,7,7q36.3,156549170,156677755,128585,-,-
BAC185_H18,7,7q36.3,156563774,156665857,102083,-,-
BAC249_J03,7,7q36.3,156565131,156694511,129380,-,-
BAC81_L07,7,7q36.3,156570626,156731812,161186,-,-
BAC141_E11,7,7q36.3,156587675,156697054,109379,-,-
BAC193_K22,7,7q36.3,156716261,156820535,104274,-,-
BAC144_C21,7,7q36.3,156716261,156803841,87580,-,-
BAC82_K18,7,7q36.3,156716261,156803841,87580,-,-
BAC63_B04,7,7q36.3,156731824,156813343,81519,-,-
BAC248_C09,7,7q36.3,156731824,156813339,81515,-,-
BAC250_H07,7,7q36.3,156761575,156864201,102626,-,-
BAC218_L14,7,7q36.3,156803833,156931346,127513,-,-
BAC107_P17,7,7q36.3,156817824,156936240,118416,-,-
BAC182_A08,7,7q36.3,156849702,156928208,78506,-,-
BAC132_P02,7,7q36.3,156849702,156936240,86538,-,-
BAC199_L19,7,7q36.3,156864221,156931346,67125,-,-
BAC233_P17,7,7q36.3,156931413,157000715,69302,-,-
BAC200_D24,7,7q36.3,156949924,157036486,86562,-,-
BAC241_N06,7,7q36.3,156980977,157061046,80069,-,-
BAC82_J06,7,7q36.3,157041256,157148131,106875,-,-
BAC67_N03,7,7q36.3,157060280,157148131,87851,-,-
BAC122_N11,7,7q36.3,157079349,157165610,86261,-,-
BAC126_E07,7,7q36.3,157079349,157165610,86261,-,-
BAC62_D09,7,7q36.3,157159439,157265714,106275,-,-
BAC186_E06,7,7q36.3,157209718,157301827,92109,-,-
BAC82_L19,7,7q36.3,157267443,157392088,124645,-,-
BAC158_B21,7,7q36.3,157301862,157392088,90226,-,-
BAC33_G11,7,7q36.3,157301889,157463931,162042,-,-
BAC158_J08,7,7q36.3,157327449,157484979,157530,-,-
BAC170_P19,7,7q36.3,157360532,157449889,89357,-,-
BAC75_M11,7,7q36.3,157385442,157498606,113164,-,-
BAC193_G05,7,7q36.3,157392125,157497806,105681,-,-
BAC48_L05,7,7q36.3,157400933,157491902,90969,-,-
BAC182_P07,7,7q36.3,157519058,157595694,76636,-,-
BAC237_E15,7,7q36.3,157557955,157640701,82746,-,-
BAC137_O12,7,7q36.3,157774792,157880163,105371,-,-
BAC157_F19,7,7q36.3,157777618,157880163,102545,-,-
BAC157_E19,7,7q36.3,157777618,157880163,102545,-,-
BAC66_N15,7,7q36.3,157777906,157880163,102257,-,-
BAC152_M20,7,7q36.3,157779223,157880160,100937,-,-
BAC231_M21,7,7q36.3,157787019,157890993,103974,-,-
BAC182_E17,7,7q36.3,157788998,157890900,101902,-,-
BAC92_G22,7,7q36.3,157803062,157924900,121838,-,-
BAC192_N19,7,7q36.3,157842327,157940592,98265,-,-
BAC68_E09,7,7q36.3,157948594,158051524,102930,-,-
BAC116_L09,7,7q36.3,157967860,158051524,83664,-,-
BAC107_O14,7,7q36.3,157969033,158051524,82491,-,-
BAC223_B24,7,7q36.3,157969200,158051856,82656,-,-
BAC127_A17,7,7q36.3,157984640,158056186,71546,-,-
BAC36_D23,7,7q36.3,157984640,158066466,81826,-,-
BAC179_A08,7,7q36.3,158135083,158209160,74077,-,-
BAC101_G15,7,7q36.3,158135083,158233809,98726,-,-
BAC230_H02,7,7q36.3,158138576,158224504,85928,-,-
BAC250_F10,7,7q36.3,158140601,158249233,108632,-,-
BAC144_F05,7,7q36.3,158141643,158247161,105518,-,-
BAC155_D11,7,7q36.3,158149886,158226423,76537,-,-
BAC232_M07,7,7q36.3,158176271,158266074,89803,-,-
BAC1_L12,7,7q36.3,158247297,158389215,141918,-,-
BAC168_D19,7,7q36.3,158252910,158368670,115760,-,-
BAC70_B02,7,7q36.3,158252978,158390324,137346,-,-
BAC248_B19,7,7q36.3,158266072,158369094,103022,-,-
BAC74_C07,7,7q36.3,158266091,158356324,90233,-,-
BAC64_J12,7,7q36.3,158279798,158397257,117459,-,-
BAC112_J05,7,7q36.3,158305217,158397173,91956,-,-
BAC229_G05,7,7q36.3,158306935,158396977,90042,-,-
BAC53_G09,7,7q36.3,158306935,158446120,139185,-,-
BAC181_F05,7,7q36.3,158306935,158390324,83389,-,-
BAC135_L01,7,7q36.3,158390340,158457544,67204,-,-
BAC69_F14,7,7q36.3,158446115,158536082,89967,-,-
BAC41_I14,7,7q36.3,158483691,158606464,122773,-,-
BAC68_F18,7,7q36.3,158494380,158644029,149649,-,-
BAC143_C24,7,7q36.3,158496617,158603430,106813,-,-
BAC71_C11,7,7q36.3,158535411,158621447,86036,-,-
BAC86_E16,7,7q36.3,158565708,158666435,100727,-,-
BAC35_H05,7,7q36.3,158569322,158654670,85348,-,-
BAC69_E04,7,7q36.3,158616812,158732999,116187,-,-
BAC73_L24,7,7q36.3,158697581,158804856,107275,-,-
BAC90_P05,8,8p23.3,98493,179859,81366,-,-
BAC199_F12,8,8p23.3,156875,228846,71971,-,-
BAC171_E05,8,8p23.3,158688,252925,94237,-,-
BAC115_C21,8,8p23.3,158879,303702,144823,-,-
BAC189_F11,8,8p23.3,184704,270317,85613,-,-
BAC78_E03,8,8p23.3,227105,370216,143111,-,-
BAC38_L02,8,8p23.3,227105,313441,86336,-,-
BAC30_P21,8,8p23.3,228840,337611,108771,-,-
BAC218_F21,8,8p23.3,250654,352664,102010,-,-
BAC122_D17,8,8p23.3,284455,392858,108403,-,-
BAC78_A19,8,8p23.3,318131,432800,114669,-,-
BAC50_B19,8,8p23.3,529723,681857,152134,-,-
BAC221_F22,8,8p23.3,529752,664035,134283,-,-
BAC52_I19,8,8p23.3,540758,627435,86677,-,-
BAC41_P07,8,8p23.3,540766,637485,96719,-,-
BAC63_J13,8,8p23.3,564491,649613,85122,-,-
BAC133_M07,8,8p23.3,564747,668117,103370,-,-
BAC176_L01,8,8p23.3,571176,675688,104512,-,-
BAC235_M14,8,8p23.3,627434,752711,125277,-,-
BAC59_I19,8,8p23.3,649704,867252,217548,-,-
BAC123_O08,8,8p23.3,680216,752711,72495,-,-
BAC46_C03,8,8p23.3,690992,795709,104717,-,-
BAC237_F13,8,8p23.3,708442,795719,87277,-,-
BAC2_M12,8,8p23.3,715719,808976,93257,-,-
BAC122_N17,8,8p23.3,731165,822988,91823,-,-
BAC126_E06,8,8p23.3,731165,822988,91823,-,-
BAC132_F11,8,8p23.3,752706,823384,70678,-,-
BAC157_L22,8,8p23.3,764685,862620,97935,-,-
BAC101_K10,8,8p23.3,764687,849187,84500,-,-
BAC29_C18,8,8p23.3,766850,860173,93323,-,-
BAC17_H23,8,8p23.3,766850,860156,93306,-,-
BAC65_M24,8,8p23.3,822982,906289,83307,-,-
BAC53_M20,8,8p23.3,822986,914410,91424,-,-
BAC181_E17,8,8p23.3,823389,910782,87393,-,-
BAC53_J06,8,8p23.3,873149,968003,94854,-,-
BAC90_E06,8,8p23.3,906556,996341,89785,-,-
BAC71_N03,8,8p23.3,914506,996327,81821,-,-
BAC97_H08,8,8p23.3,918818,1013307,94489,-,-
BAC88_B07,8,8p23.3,1013571,1109554,95983,-,-
BAC83_E02,8,8p23.3,1039791,1138196,98405,-,-
BAC234_L10,8,8p23.3,1132430,1211445,79015,-,-
BAC77_H16,8,8p23.3,1132459,1241918,109459,-,-
BAC17_H10,8,8p23.3,1138191,1222369,84178,-,-
BAC46_E24,8,8p23.3,1289262,1436201,146939,-,-
BAC210_J24,8,8p23.3,1352488,1463440,110952,-,-
BAC105_P18,8,8p23.3,1374577,1479472,104895,-,-
BAC11_E06,8,8p23.3,1383093,1478412,95319,-,-
BAC187_O01,8,8p23.3,1386989,1478334,91345,-,-
BAC113_N08,8,8p23.3,1585995,1713052,127057,-,-
BAC142_C07,8,8p23.3,1586484,1686237,99753,-,-
BAC96_O13,8,8p23.3,1586484,1711111,124627,-,-
BAC243_B07,8,8p23.3,1589923,1681011,91088,-,-
BAC217_A18,8,8p23.3,1600133,1761891,161758,-,-
BAC50_B11,8,8p23.3,1637558,1752317,114759,-,-
BAC106_F20,8,8p23.3,1644873,1752330,107457,-,-
BAC31_A03,8,8p23.3,1703163,1830915,127752,-,-
BAC73_J21,8,8p23.3,1709805,1812771,102966,-,-
BAC83_F16,8,8p23.3,1709839,1829450,119611,-,-
BAC8_M05,8,8p23.3,1711114,1830930,119816,-,-
BAC160_N01,8,8p23.3,1758799,1849464,90665,-,-
BAC94_M12,8,8p23.3,1758799,1879158,120359,-,-
BAC67_P11,8,8p23.3,1790760,1886086,95326,-,-
BAC116_B03,8,8p23.3,1805957,1923166,117209,-,-
BAC125_E14,8,8p23.3,1812819,1907745,94926,-,-
BAC58_L16,8,8p23.3,1830923,2012138,181215,-,-
BAC68_L08,8,8p23.3,1849729,1934033,84304,-,-
BAC125_M23,8,8p23.3,1907738,1994939,87201,-,-
BAC244_A23,8,8p23.3,1918335,1994877,76542,-,-
BAC57_P09,8,8p23.3,1956069,2092507,136438,yes,-
BAC248_L20,8,8p23.3,2022813,2141640,118827,-,-
BAC31_D09,8,8p23.3,2080794,2162595,81801,-,-
BAC235_I09,8,8p23.2,2326541,2414316,87775,-,-
BAC228_O19,8,8p23.2,2348489,2435151,86662,-,-
BAC64_F16,8,8p23.2,2358173,2438609,80436,-,-
BAC171_I06,8,8p23.2,2383900,2484431,100531,-,-
BAC95_H08,8,8p23.2,2443036,2541295,98259,-,-
BAC75_A04,8,8p23.2,2463499,2570090,106591,-,-
BAC238_G22,8,8p23.2,2484440,2581524,97084,-,-
BAC175_D07,8,8p23.2,2484440,2573196,88756,-,-
BAC26_A09,8,8p23.2,2489040,2581467,92427,-,-
BAC186_F16,8,8p23.2,2513499,2581509,68010,-,-
BAC119_N14,8,8p23.2,2525863,2619094,93231,-,-
BAC24_P13,8,8p23.2,2647274,2771057,123783,-,-
BAC231_J05,8,8p23.2,2675456,2764586,89130,-,-
BAC130_F18,8,8p23.2,2766502,2843826,77324,-,-
BAC108_I12,8,8p23.2,2967090,3099067,131977,-,-
BAC121_M13,8,8p23.2,2987296,3085511,98215,-,-
BAC149_I02,8,8p23.2,3040771,3133106,92335,-,-
BAC53_O01,8,8p23.2,3073252,3192783,119531,-,-
BAC114_D14,8,8p23.2,3097369,3191568,94199,-,-
BAC78_I06,8,8p23.2,3129613,3213938,84325,-,-
BAC165_F06,8,8p23.2,3156500,3266011,109511,-,-
BAC67_N08,8,8p23.2,3213936,3313781,99845,-,-
BAC236_M20,8,8p23.2,3251240,3329538,78298,-,-
BAC56_M13,8,8p23.2,3255462,3397193,141731,-,-
BAC42_P13,8,8p23.2,3323004,3454380,131376,-,-
BAC33_O22,8,8p23.2,3323021,3422317,99296,-,-
BAC186_I19,8,8p23.2,3346962,3419568,72606,-,-
BAC96_I06,8,8p23.2,3401668,3492073,90405,-,-
BAC233_G18,8,8p23.2,3415819,3492073,76254,-,-
BAC157_D15,8,8p23.2,3454376,3576813,122437,-,-
BAC30_O19,8,8p23.2,3501241,3587642,86401,-,-
BAC66_A02,8,8p23.2,3531900,3626325,94425,-,-
BAC222_O08,8,8p23.2,3531900,3626322,94422,-,-
BAC91_L15,8,8p23.2,3743121,3816372,73251,-,-
BAC229_J04,8,8p23.2,3768085,3847587,79502,-,-
BAC20_L09,8,8p23.2,3816497,3989467,172970,-,-
BAC166_M24,8,8p23.2,3846135,3930737,84602,-,-
BAC100_E15,8,8p23.2,3891561,3973416,81855,-,-
BAC65_C06,8,8p23.2,3893739,4018168,124429,-,-
BAC50_O22,8,8p23.2,3916513,4027630,111117,-,-
BAC66_O19,8,8p23.2,3937006,4018168,81162,-,-
BAC124_O20,8,8p23.2,3995218,4075012,79794,-,-
BAC79_I11,8,8p23.2,4037335,4132491,95156,-,-
BAC107_L08,8,8p23.2,4112418,4211969,99551,-,-
BAC237_I17,8,8p23.2,4127440,4222614,95174,-,-
BAC43_K22,8,8p23.2,4203965,4284840,80875,-,-
BAC232_K08,8,8p23.2,4245138,4331496,86358,-,-
BAC51_F23,8,8p23.2,4251637,4433709,182072,-,-
BAC29_K12,8,8p23.2,4323428,4415405,91977,-,-
BAC178_B22,8,8p23.2,4505873,4605525,99652,-,-
BAC116_N16,8,8p23.2,4545303,4653388,108085,-,-
BAC115_J20,8,8p23.2,4553961,4664343,110382,-,-
BAC159_D12,8,8p23.2,4558700,4644525,85825,-,-
BAC127_O03,8,8p23.2,4739260,4834898,95638,-,-
BAC31_H01,8,8p23.2,4869236,4960256,91020,-,-
BAC113_G09,8,8p23.2,4884151,4980315,96164,-,-
BAC136_I04,8,8p23.2,4901223,4982815,81592,-,-
BAC233_B04,8,8p23.2,5030802,5129880,99078,-,-
BAC142_M19,8,8p23.2,5045957,5145000,99043,-,-
BAC29_G07,8,8p23.2,5057522,5247041,189519,-,-
BAC70_I07,8,8p23.2,5083903,5176587,92684,-,-
BAC59_O03,8,8p23.2,5096833,5187894,91061,-,-
BAC61_J18,8,8p23.2,5104773,5186433,81660,-,-
BAC239_M13,8,8p23.2,5185958,5283904,97946,-,-
BAC1_J24,8,8p23.2,5245380,5385292,139912,-,-
BAC104_K24,8,8p23.2,5263469,5385224,121755,-,-
BAC104_J06,8,8p23.2,5283932,5370469,86537,-,-
BAC243_P11,8,8p23.2,5289656,5376682,87026,-,-
BAC166_E08,8,8p23.2,5338979,5422503,83524,-,-
BAC38_D22,8,8p23.2,5371253,5498954,127701,-,-
BAC217_D18,8,8p23.2,5371254,5464050,92796,-,-
BAC95_L21,8,8p23.2,5377812,5478124,100312,-,-
BAC150_F13,8,8p23.2,5385219,5486978,101759,-,-
BAC53_C24,8,8p23.2,5385298,5509292,123994,-,-
BAC33_C17,8,8p23.2,5393874,5492735,98861,-,-
BAC235_N06,8,8p23.2,5505423,5619421,113998,-,-
BAC63_D19,8,8p23.2,5505426,5619421,113995,-,-
BAC176_N11,8,8p23.2,5575867,5653128,77261,-,-
BAC74_K15,8,8p23.2,5593562,5688575,95013,-,-
BAC21_M15,8,8p23.2,5598834,5682439,83605,-,-
BAC15_C21,8,8p23.2,5619547,5694321,74774,-,-
BAC114_J09,8,8p23.2,5682691,5805811,123120,-,-
BAC120_C14,8,8p23.2,5742927,5893848,150921,-,-
BAC12_C11,8,8p23.2,5852677,5954205,101528,-,-
BAC100_J21,8,8p23.2,5948381,6054196,105815,-,-
BAC145_L23,8,8p23.2,5954229,6067578,113349,-,-
BAC83_L21,8,8p23.2,5954229,6054173,99944,-,-
BAC29_N03,8,8p23.2,5996501,6086113,89612,-,-
BAC175_I03,8,8p23.2,6010796,6105987,95191,-,-
BAC240_N05,8,8p23.2,6037903,6119625,81722,-,-
BAC48_H09,8,8p23.1,6529987,6680008,150021,-,-
BAC167_L15,8,8p23.1,6562772,6645782,83010,-,-
BAC33_M01,8,8p23.1,6604701,6741629,136928,yes,-
BAC27_G19,8,8p23.1,6645775,6741630,95855,yes,-
BAC29_J14,8,8p23.1,6648166,6741627,93461,yes,-
BAC231_N03,8,8p23.1,6648194,6784079,135885,yes,-
BAC175_C06,8,8p23.1,6680002,6784079,104077,yes,-
BAC1_I21,8,8p23.1,6698092,6803822,105730,yes,-
BAC141_D01,8,8p23.1,6718760,6821039,102279,yes,-
BAC101_N07,8,8p23.1,6798044,6869916,71872,yes,-
BAC168_A06,8,8p23.1,6803816,6869916,66100,yes,-
BAC181_B08,8,8p23.1,6816821,6949478,132657,yes,-
BAC54_M03,8,8p23.1,6825827,6940911,115084,yes,-
BAC117_D03,8,8p23.1,6828464,6949593,121129,-,-
BAC110_D04,8,8p23.1,6840229,6928020,87791,yes,-
BAC69_J10,8,8p23.1,6843501,6946577,103076,yes,-
BAC118_B10,8,8p23.1,6862600,7007710,145110,yes,-
BAC54_L14,8,8p23.1,6869911,6989187,119276,yes,-
BAC124_F24,8,8p23.1,6875243,6991662,116419,yes,-
BAC113_C07,8,8p23.1,6895271,7010113,114842,yes,-
BAC101_P06,8,8p23.1,6928015,7035082,107067,-,-
BAC165_K23,8,8p23.1,6982813,7077579,94766,-,-
BAC20_O21,8,8p23.1,6991721,7100489,108768,-,-
BAC153_F18,8,8p23.1,7007704,7130894,123190,-,-
BAC126_B05,8,8p23.1,7007704,7177966,170262,yes,-
BAC78_M05,8,8p23.1,7026514,7100405,73891,-,-
BAC153_B20,8,8p23.1,7033098,7105091,71993,-,-
BAC149_A08,8,8p23.1,7115746,7182755,67009,yes,-
BAC57_F02,8,8p23.1,7123368,7203607,80239,yes,-
BAC11_A16,8,8p23.1,7247189,7390681,143492,yes,-
BAC224_G19,8,8p23.1,7301737,7428916,127179,yes,-
BAC89_H15,8,8p23.1,7323700,8026409,702709,-,-
BAC234_K05,8,8p23.1,7323757,7428915,105158,yes,-
BAC135_H20,8,8p23.1,7334671,7428919,94248,yes,-
BAC37_B11,8,8p23.1,7451365,8026409,575044,-,-
BAC144_D23,8,8p23.1,7451369,8055750,604381,-,-
BAC198_M14,8,8p23.1,7973341,8072164,98823,-,-
BAC151_B19,8,8p23.1,8066938,8167937,100999,-,-
BAC8_E01,8,8p23.1,8085813,8306756,220943,-,-
BAC30_M19,8,8p23.1,8141264,8264624,123360,-,-
BAC97_K02,8,8p23.1,8148182,8271097,122915,-,-
BAC105_P02,8,8p23.1,8164668,8264624,99956,-,-
BAC80_M24,8,8p23.1,8263864,8359063,95199,-,-
BAC242_L12,8,8p23.1,8286037,8419726,133689,-,-
BAC172_H22,8,8p23.1,8338486,8409613,71127,-,-
BAC25_H24,8,8p23.1,8413733,8526555,112822,-,-
BAC62_E17,8,8p23.1,8415854,8515341,99487,-,-
BAC176_H09,8,8p23.1,8463546,8555168,91622,-,-
BAC148_A23,8,8p23.1,8469023,8570834,101811,-,-
BAC191_J10,8,8p23.1,8526974,8607430,80456,-,-
BAC224_P02,8,8p23.1,8555957,8654774,98817,-,-
BAC34_H05,8,8p23.1,8555957,8646707,90750,-,-
BAC137_C03,8,8p23.1,8555957,8638190,82233,-,-
BAC90_M06,8,8p23.1,8587163,8699865,112702,-,-
BAC194_P23,8,8p23.1,8600029,8704587,104558,-,-
BAC204_D22,8,8p23.1,8668053,8782410,114357,-,-
BAC61_G20,8,8p23.1,8704655,8803275,98620,-,-
BAC34_E08,8,8p23.1,8767033,8871913,104880,-,-
BAC84_F02,8,8p23.1,8768767,8865810,97043,-,-
BAC171_B13,8,8p23.1,8801151,8868736,67585,-,-
BAC40_O22,8,8p23.1,8972106,9110631,138525,-,-
BAC161_C01,8,8p23.1,8972641,9066699,94058,yes,-
BAC187_N09,8,8p23.1,9003650,9118545,114895,yes,-
BAC238_B07,8,8p23.1,9004669,9089464,84795,yes,-
BAC189_C02,8,8p23.1,9004669,9118545,113876,yes,-
BAC31_K09,8,8p23.1,9110626,9199837,89211,-,-
BAC188_N19,8,8p23.1,9118539,9249506,130967,-,-
BAC44_J16,8,8p23.1,9142485,9287926,145441,-,-
BAC176_L13,8,8p23.1,9254073,9343314,89241,-,-
BAC60_I11,8,8p23.1,9341054,9468861,127807,-,-
BAC159_E06,8,8p23.1,9412434,9505588,93154,-,-
BAC240_L09,8,8p23.1,9412465,9493957,81492,-,-
BAC62_P02,8,8p23.1,9597257,9685682,88425,-,-
BAC45_E06,8,8p23.1,9627526,9795567,168041,-,-
BAC227_C22,8,8p23.1,9631037,9700385,69348,-,-
BAC70_D16,8,8p23.1,9640043,9770507,130464,-,-
BAC143_O21,8,8p23.1,9673565,9761188,87623,-,-
BAC92_J17,8,8p23.1,9673777,9761188,87411,-,-
BAC149_O23,8,8p23.1,9673777,9771816,98039,-,-
BAC154_P24,8,8p23.1,9797728,9886142,88414,-,-
BAC27_J04,8,8p23.1,9805627,9894679,89052,-,-
BAC158_N14,8,8p23.1,9818608,9896432,77824,-,-
BAC229_O09,8,8p23.1,9860254,9945293,85039,-,-
BAC82_K19,8,8p23.1,9907087,10011094,104007,-,-
BAC175_K12,8,8p23.1,9921578,10011094,89516,-,-
BAC165_I07,8,8p23.1,9921578,10011094,89516,-,-
BAC52_B19,8,8p23.1,9928970,10046181,117211,-,-
BAC82_O18,8,8p23.1,9942423,10092648,150225,-,-
BAC38_B09,8,8p23.1,9945298,10049838,104540,-,-
BAC157_E02,8,8p23.1,9957063,10032497,75434,-,-
BAC40_I12,8,8p23.1,10011092,10106074,94982,-,-
BAC150_D09,8,8p23.1,10011099,10129840,118741,-,-
BAC80_N15,8,8p23.1,10040788,10167032,126244,-,-
BAC37_B06,8,8p23.1,10051747,10146735,94988,-,-
BAC10_K01,8,8p23.1,10056025,10147546,91521,-,-
BAC170_G21,8,8p23.1,10176760,10302910,126150,-,-
BAC88_J19,8,8p23.1,10220935,10302372,81437,-,-
BAC131_C13,8,8p23.1,10225629,10315071,89442,-,-
BAC116_N20,8,8p23.1,10302944,10421857,118913,-,-
BAC237_B24,8,8p23.1,10309567,10421857,112290,-,-
BAC158_N12,8,8p23.1,10353924,10438087,84163,-,-
BAC106_L15,8,8p23.1,10441256,10592562,151306,-,-
BAC191_A19,8,8p23.1,10480339,10576102,95763,-,-
BAC53_H21,8,8p23.1,10483676,10595247,111571,-,-
BAC87_B23,8,8p23.1,10483694,10583645,99951,-,-
BAC68_F12,8,8p23.1,10494909,10584583,89674,-,-
BAC106_K15,8,8p23.1,10494909,10592552,97643,-,-
BAC183_B04,8,8p23.1,10494923,10592562,97639,-,-
BAC130_B06,8,8p23.1,10495070,10576119,81049,-,-
BAC113_A04,8,8p23.1,10603904,10689839,85935,-,-
BAC81_G06,8,8p23.1,10650975,10763350,112375,-,-
BAC221_E10,8,8p23.1,10651255,10740516,89261,-,-
BAC150_M15,8,8p23.1,10706703,10809056,102353,-,-
BAC196_D13,8,8p23.1,10745863,10902312,156449,-,-
BAC235_O21,8,8p23.1,10760014,10930859,170845,-,-
BAC194_B14,8,8p23.1,10765071,10861822,96751,-,-
BAC128_D06,8,8p23.1,10779951,10904429,124478,-,-
BAC233_C11,8,8p23.1,10788805,10904429,115624,-,-
BAC34_O04,8,8p23.1,10798793,10904429,105636,-,-
BAC36_N20,8,8p23.1,10833914,10959203,125289,-,-
BAC240_B05,8,8p23.1,10854499,10960878,106379,-,-
BAC148_K23,8,8p23.1,10952249,11062593,110344,-,-
BAC218_A19,8,8p23.1,10961916,11046615,84699,-,-
BAC78_L19,8,8p23.1,11018701,11108041,89340,-,-
BAC234_I04,8,8p23.1,11029065,11123964,94899,-,-
BAC230_M14,8,8p23.1,11109158,11215318,106160,-,-
BAC106_D04,8,8p23.1,11131767,11222894,91127,-,-
BAC84_G23,8,8p23.1,11137651,11257074,119423,-,-
BAC192_C17,8,8p23.1,11141559,11222896,81337,-,-
BAC68_A09,8,8p23.1,11199192,11315309,116117,-,-
BAC247_L13,8,8p23.1,11240891,11325654,84763,-,-
BAC235_E05,8,8p23.1,11331588,11433539,101951,-,-
BAC167_E06,8,8p23.1,11368215,11449582,81367,-,-
BAC30_E21,8,8p23.1,11405903,11511519,105616,-,-
BAC208_D16,8,8p23.1,11422068,11507290,85222,-,-
BAC199_E16,8,8p23.1,11435400,11536830,101430,-,-
BAC41_J01,8,8p23.1,11445790,11536815,91025,-,-
BAC8_C08,8,8p23.1,11507344,11601413,94069,-,-
BAC195_I18,8,8p23.1,11560581,11652726,92145,-,-
BAC102_L16,8,8p23.1,11588151,11745868,157717,-,-
BAC244_K13,8,8p23.1,11601408,11677484,76076,-,-
BAC239_E18,8,8p23.1,11611398,11729331,117933,-,-
BAC175_K15,8,8p23.1,11626702,11721975,95273,-,-
BAC40_H19,8,8p23.1,11626702,11715402,88700,-,-
BAC162_B06,8,8p23.1,11626702,11715136,88434,-,-
BAC117_I23,8,8p23.1,11628039,11715435,87396,-,-
BAC64_D05,8,8p23.1,11645419,11765598,120179,-,-
BAC217_J18,8,8p23.1,11652875,11732671,79796,-,-
BAC217_B02,8,8p23.1,11729349,11829102,99753,-,-
BAC84_F09,8,8p23.1,11750671,11855784,105113,-,-
BAC206_A10,8,8p23.1,11821409,11918158,96749,yes,-
BAC72_D18,8,8p23.1,11883073,12224717,341644,-,-
BAC70_H09,8,8p23.1,11920398,12270939,350541,-,-
BAC217_O05,8,8p23.1,12089536,12442853,353317,-,-
BAC244_B16,8,8p23.1,12424888,12529719,104831,-,-
BAC170_I16,8,8p23.1,12478239,12590522,112283,-,-
BAC127_D04,8,8p23.1,12518254,12612761,94507,-,-
BAC165_E15,8,8p23.1,12528053,12622961,94908,-,-
BAC155_B02,8,8p23.1,12529713,12610280,80567,-,-
BAC227_P17,8,8p23.1,12551641,12666790,115149,-,-
BAC248_O02,8,8p23.1,12622955,12687352,64397,-,-
BAC100_F01,8,8p23.1-8p22,12698967,12827644,128677,-,-
BAC10_H15,8,8p22,12767696,12869666,101970,-,-
BAC147_M06,8,8p22,12789497,12869666,80169,-,-
BAC88_I13,8,8p22,12839159,12929275,90116,-,-
BAC25_M24,8,8p22,12851817,12993206,141389,-,-
BAC223_H17,8,8p22,12896242,13030714,134472,-,-
BAC124_I09,8,8p22,12943690,13027588,83898,-,-
BAC121_B13,8,8p22,12970380,13088327,117947,-,-
BAC53_F19,8,8p22,13024385,13137293,112908,-,-
BAC86_I12,8,8p22,13165967,13277599,111632,-,-
BAC243_D16,8,8p22,13173047,13263655,90608,-,-
BAC14_F13,8,8p22,13201683,13321467,119784,-,-
BAC140_B10,8,8p22,13301383,13395066,93683,-,-
BAC83_C03,8,8p22,13416244,13518065,101821,-,-
BAC218_M22,8,8p22,13438354,13532001,93647,-,-
BAC68_B04,8,8p22,13438354,13508296,69942,-,-
BAC14_G12,8,8p22,13476090,13574171,98081,-,-
BAC224_K04,8,8p22,13482369,13569245,86876,-,-
BAC155_A12,8,8p22,13518062,13601450,83388,-,-
BAC80_D18,8,8p22,13537309,13636532,99223,-,-
BAC50_K05,8,8p22,13706156,13791889,85733,-,-
BAC179_K09,8,8p22,13716794,13791886,75092,-,-
BAC86_I17,8,8p22,13739561,13842221,102660,-,-
BAC200_I07,8,8p22,13940269,14017420,77151,-,-
BAC118_D22,8,8p22,13970834,14057931,87097,-,-
BAC115_F06,8,8p22,13989962,14088599,98637,-,-
BAC127_A22,8,8p22,13989970,14085555,95585,-,-
BAC189_D09,8,8p22,14017608,14085558,67950,-,-
BAC71_E07,8,8p22,14068119,14188007,119888,-,-
BAC155_M18,8,8p22,14085550,14179771,94221,-,-
BAC153_O08,8,8p22,14091911,14172386,80475,-,-
BAC150_C10,8,8p22,14241363,14316575,75212,-,-
BAC29_G16,8,8p22,14326654,14489669,163015,-,-
BAC229_E06,8,8p22,14341487,14426705,85218,-,-
BAC39_J04,8,8p22,14429198,14517607,88409,-,-
BAC97_C06,8,8p22,14429437,14517607,88170,-,-
BAC97_N13,8,8p22,14472684,14562451,89767,-,-
BAC95_E20,8,8p22,14572889,14704776,131887,-,-
BAC40_P10,8,8p22,14657464,14791122,133658,yes,-
BAC91_G16,8,8p22,14872041,14949633,77592,-,-
BAC228_H03,8,8p22,14988969,15073134,84165,-,-
BAC194_E21,8,8p22,15027713,15133050,105337,-,-
BAC73_A05,8,8p22,15027715,15133050,105335,-,-
BAC30_N20,8,8p22,15028057,15125726,97669,-,-
BAC139_O08,8,8p22,15066591,15163230,96639,-,-
BAC137_J06,8,8p22,15070086,15169296,99210,-,-
BAC196_B23,8,8p22,15190889,15299356,108467,-,-
BAC243_N16,8,8p22,15194714,15294451,99737,-,-
BAC118_D05,8,8p22,15198424,15295819,97395,-,-
BAC65_O08,8,8p22,15198426,15295780,97354,-,-
BAC114_B09,8,8p22,15204823,15339845,135022,-,-
BAC248_P19,8,8p22,15524221,15595318,71097,-,-
BAC186_G17,8,8p22,15533590,15611208,77618,-,-
BAC63_I24,8,8p22,15622206,15718524,96318,-,-
BAC44_I04,8,8p22,15715324,15782568,67244,-,-
BAC236_F10,8,8p22,15766039,15904460,138421,-,-
BAC105_I07,8,8p22,16043089,16161860,118771,-,-
BAC118_D12,8,8p22,16046664,16129465,82801,-,-
BAC30_N02,8,8p22,16158941,16279616,120675,-,-
BAC116_F01,8,8p22,16170712,16275854,105142,-,-
BAC29_N17,8,8p22,16234567,16320429,85862,-,-
BAC194_N13,8,8p22,16243204,16329292,86088,-,-
BAC70_F11,8,8p22,16290511,16359286,68775,-,-
BAC150_N20,8,8p22,16522730,16611529,88799,-,-
BAC168_F21,8,8p22,16610677,16684816,74139,-,-
BAC144_F08,8,8p22,16684810,16799319,114509,-,-
BAC69_L11,8,8p22,16799317,16879982,80665,-,-
BAC67_F16,8,8p22,16890882,16990115,99233,-,-
BAC151_N08,8,8p22,17047925,17122759,74834,-,-
BAC177_F13,8,8p22,17086630,17177457,90827,-,-
BAC32_A09,8,8p22,17192427,17285111,92684,-,-
BAC84_K02,8,8p22,17257708,17371522,113814,-,-
BAC41_L06,8,8p22,17319262,17420540,101278,-,-
BAC219_E24,8,8p22,17374292,17457700,83408,-,-
BAC22_E14,8,8p22,17424615,17520602,95987,-,-
BAC82_P02,8,8p22,17425684,17544252,118568,-,-
BAC175_M24,8,8p22,17428263,17520602,92339,-,-
BAC27_O21,8,8p22,17503360,17586287,82927,-,-
BAC61_B17,8,8p22,17520633,17617876,97243,-,-
BAC91_B08,8,8p22,17544247,17628401,84154,-,-
BAC55_P14,8,8p22,17549324,17662251,112927,-,-
BAC221_L04,8,8p22,17587280,17662992,75712,-,-
BAC116_J08,8,8p22,17617955,17775323,157368,-,-
BAC90_I05,8,8p22,17662986,17733185,70199,-,-
BAC239_L17,8,8p22,17687155,17786565,99410,-,-
BAC61_G15,8,8p22,17687185,17799578,112393,-,-
BAC181_P17,8,8p22,17688836,17796009,107173,-,-
BAC90_B06,8,8p22,17699728,17799216,99488,-,-
BAC166_D02,8,8p22,17704073,17799216,95143,-,-
BAC91_J10,8,8p22,17705776,17806566,100790,-,-
BAC27_P14,8,8p22,17763700,17885889,122189,-,-
BAC82_F18,8,8p22,17817510,17935270,117760,-,-
BAC82_L18,8,8p22,17820727,17899221,78494,-,-
BAC250_C09,8,8p22,17978244,18062239,83995,-,-
BAC147_K06,8,8p22,17999109,18124674,125565,-,-
BAC30_O17,8,8p22,18005841,18091524,85683,-,-
BAC11_E14,8,8p22,18030846,18150064,119218,-,-
BAC106_D05,8,8p22,18080688,18183188,102500,-,-
BAC68_A11,8,8p22,18268767,18357083,88316,-,-
BAC21_K20,8,8p22,18304907,18429959,125052,-,-
BAC85_C23,8,8p22,18577973,18648864,70891,-,-
BAC240_B17,8,8p22,18690154,18787977,97823,-,-
BAC32_I15,8,8p22,18692645,18787153,94508,-,-
BAC187_D21,8,8p22,18770500,18867487,96987,-,-
BAC106_A22,8,8p22,18786716,18916479,129763,-,-
BAC21_M09,8,8p22,18787170,18888737,101567,-,-
BAC97_E07,8,8p22,18877999,18977602,99603,-,-
BAC86_L12,8,8p22,18998700,19086807,88107,-,-
BAC102_A16,8,8p22-8p21.3,19061587,19157262,95675,-,-
BAC231_A01,8,8p22,19081880,19095842,13962,-,-
BAC171_F10,8,8p22-8p21.3,19086801,19176923,90122,-,-
BAC35_G09,8,8p21.3,19119117,19195053,75936,-,-
BAC122_O13,8,8p21.3,19187401,19298026,110625,-,-
BAC104_H02,8,8p21.3,19201846,19302839,100993,-,-
BAC117_L16,8,8p21.3,19226564,19372028,145464,-,-
BAC170_F23,8,8p21.3,19226857,19303418,76561,-,-
BAC131_P19,8,8p21.3,19235328,19328150,92822,-,-
BAC15_K10,8,8p21.3,19256196,19352708,96512,-,-
BAC134_D05,8,8p21.3,19288331,19373525,85194,-,-
BAC92_J23,8,8p21.3,19300268,19379804,79536,-,-
BAC197_P15,8,8p21.3,19306091,19404050,97959,-,-
BAC163_K13,8,8p21.3,19342169,19423337,81168,-,-
BAC6_B24,8,8p21.3,19397035,19560616,163581,-,-
BAC161_F14,8,8p21.3,19423464,19502461,78997,-,-
BAC193_D06,8,8p21.3,19462074,19556086,94012,-,-
BAC63_N06,8,8p21.3,19538834,19628844,90010,-,-
BAC31_D08,8,8p21.3,19642497,19742818,100321,-,-
BAC185_M06,8,8p21.3,19672261,19762456,90195,-,-
BAC148_O22,8,8p21.3,19672261,19685833,13572,-,-
BAC180_D23,8,8p21.3,19683319,19759863,76544,-,-
BAC152_H22,8,8p21.3,19779071,19876057,96986,-,-
BAC91_F07,8,8p21.3,19835726,19930350,94624,-,-
BAC193_L13,8,8p21.3,19920623,20009035,88412,-,-
BAC223_C08,8,8p21.3,19941891,20056737,114846,-,-
BAC79_O20,8,8p21.3,20125617,20344480,218863,-,-
BAC72_E14,8,8p21.3,20143032,20264529,121497,-,-
BAC48_O10,8,8p21.3,20173773,20272088,98315,-,-
BAC136_C08,8,8p21.3,20174789,20297029,122240,-,-
BAC64_H17,8,8p21.3,20218772,20307949,89177,-,-
BAC83_I18,8,8p21.3,20235842,20344489,108647,-,-
BAC44_M16,8,8p21.3,20262722,20419736,157014,-,-
BAC200_N12,8,8p21.3,20276868,20377241,100373,-,-
BAC218_A04,8,8p21.3,20297023,20378439,81416,-,-
BAC101_I03,8,8p21.3,20397823,20482064,84241,-,-
BAC117_D17,8,8p21.3,20580025,20684008,103983,-,-
BAC1_A04,8,8p21.3,20661233,20747020,85787,-,-
BAC70_O07,8,8p21.3,20663757,20752520,88763,-,-
BAC106_A15,8,8p21.3,20684315,20776722,92407,-,-
BAC49_N11,8,8p21.3,20704055,20811718,107663,-,-
BAC232_I04,8,8p21.3,20781640,20880501,98861,-,-
BAC59_G24,8,8p21.3,20880587,20982972,102385,-,-
BAC6_P12,8,8p21.3,20952216,21058182,105966,-,-
BAC137_I09,8,8p21.3,20973189,21110623,137434,-,-
BAC32_O15,8,8p21.3,20988484,21078553,90069,-,-
BAC117_P13,8,8p21.3,21003230,21134415,131185,-,-
BAC252_G12,8,8p21.3,21031940,21133236,101296,-,-
BAC234_I01,8,8p21.3,21031943,21133237,101294,-,-
BAC118_D23,8,8p21.3,21044788,21141410,96622,-,-
BAC54_G07,8,8p21.3,21233427,21352377,118950,-,-
BAC142_F21,8,8p21.3,21257806,21341387,83581,-,-
BAC180_N08,8,8p21.3,21335038,21435772,100734,-,-
BAC234_L09,8,8p21.3,21341706,21434389,92683,-,-
BAC96_O15,8,8p21.3,21341706,21451546,109840,-,-
BAC27_N21,8,8p21.3,21345437,21426943,81506,-,-
BAC240_P20,8,8p21.3,21345458,21426943,81485,-,-
BAC149_M19,8,8p21.3,21402259,21521805,119546,-,-
BAC165_H15,8,8p21.3,21451541,21549586,98045,-,-
BAC136_G19,8,8p21.3,21474525,21563876,89351,-,-
BAC74_G17,8,8p21.3,21481161,21577925,96764,-,-
BAC243_C01,8,8p21.3,21497649,21593645,95996,-,-
BAC240_E02,8,8p21.3,21772051,21851396,79345,-,-
BAC56_M07,8,8p21.3,21772051,21855668,83617,-,-
BAC176_L07,8,8p21.3,21778074,21871138,93064,-,-
BAC181_J02,8,8p21.3,21916535,22031631,115096,-,-
BAC217_D04,8,8p21.3,22055840,22138598,82758,-,-
BAC157_L06,8,8p21.3,22055840,22160885,105045,-,-
BAC40_D06,8,8p21.3,22075826,22203101,127275,-,-
BAC242_I19,8,8p21.3,22079846,22165725,85879,-,-
BAC131_J10,8,8p21.3,22087568,22168874,81306,-,-
BAC5_G01,8,8p21.3,22130159,22254145,123986,-,-
BAC110_M02,8,8p21.3,22223188,22314952,91764,-,-
BAC76_J21,8,8p21.3,22223273,22329874,106601,-,-
BAC137_O14,8,8p21.3,22278544,22375968,97424,-,-
BAC135_C13,8,8p21.3,22292894,22381895,89001,-,-
BAC55_D14,8,8p21.3,22292894,22389655,96761,-,-
BAC108_O12,8,8p21.3,22356687,22463981,107294,-,-
BAC242_G13,8,8p21.3,22359499,22519831,160332,-,-
BAC228_D12,8,8p21.3,22378452,22463319,84867,-,-
BAC108_N05,8,8p21.3,22435621,22522931,87310,-,-
BAC46_C22,8,8p21.3,22549732,22668634,118902,-,-
BAC38_N04,8,8p21.3,22567303,22673576,106273,-,-
BAC15_M07,8,8p21.3,22579131,22713810,134679,-,-
BAC222_F15,8,8p21.3,22668812,22768384,99572,-,-
BAC76_A05,8,8p21.3,22716112,22844762,128650,-,-
BAC239_B02,8,8p21.3,22727605,22809260,81655,-,-
BAC223_D15,8,8p21.3,22843905,23015869,171964,-,-
BAC8_B11,8,8p21.3,22845063,22951831,106768,-,-
BAC83_D09,8,8p21.3,22879300,22996814,117514,-,-
BAC53_A18,8,8p21.3,22879303,22986775,107472,-,-
BAC88_O10,8,8p21.3,22919735,23015876,96141,-,-
BAC242_C08,8,8p21.3,22951945,23045680,93735,-,-
BAC147_F07,8,8p21.3,23074448,23166181,91733,-,-
BAC36_I21,8,8p21.3,23086788,23224353,137565,-,-
BAC114_E11,8,8p21.3,23134876,23240351,105475,-,-
BAC230_G05,8,8p21.3,23143705,23240330,96625,-,-
BAC203_B20,8,8p21.3,23166368,23243619,77251,-,-
BAC182_G22,8,8p21.3,23305140,23393912,88772,-,-
BAC186_H11,8,8p21.3-8p21.2,23320872,23453162,132290,-,-
BAC94_C05,8,8p21.3-8p21.2,23321132,23477662,156530,-,-
BAC118_F05,8,8p21.3-8p21.2,23359203,23492628,133425,-,-
BAC90_H20,8,8p21.2,23570582,23659071,88489,-,-
BAC173_M12,8,8p21.2,23582247,23671388,89141,-,-
BAC153_I10,8,8p21.2,23589792,23674814,85022,-,-
BAC36_O21,8,8p21.2,23614445,23697118,82673,-,-
BAC86_D15,8,8p21.2,23741144,23884924,143780,-,-
BAC42_A10,8,8p21.2,23759685,23835944,76259,-,-
BAC76_I12,8,8p21.2,23789213,23873625,84412,-,-
BAC191_I17,8,8p21.2,23798823,23884944,86121,-,-
BAC172_B12,8,8p21.2,23818235,23948230,129995,-,-
BAC150_L11,8,8p21.2,24163116,24309111,145995,-,-
BAC55_G16,8,8p21.2,24242953,24339240,96287,-,-
BAC211_E18,8,8p21.2,24325728,24412783,87055,-,-
BAC222_F13,8,8p21.2,24379468,24481431,101963,-,-
BAC168_A03,8,8p21.2,24431824,24535987,104163,-,-
BAC122_P13,8,8p21.2,24431824,24535895,104071,-,-
BAC231_B05,8,8p21.2,24595663,24713338,117675,-,-
BAC219_C03,8,8p21.2,24680701,24766174,85473,-,-
BAC54_E08,8,8p21.2,24681438,24784184,102746,-,-
BAC131_K21,8,8p21.2,24754862,24832540,77678,-,-
BAC123_A18,8,8p21.2,24766185,24898587,132402,-,-
BAC115_N17,8,8p21.2,24766496,24859490,92994,-,-
BAC114_P18,8,8p21.2,24786522,24885535,99013,-,-
BAC126_J04,8,8p21.2,24885529,24963539,78010,-,-
BAC122_K22,8,8p21.2,24885529,24963545,78016,-,-
BAC79_N24,8,8p21.2,24885571,24986810,101239,-,-
BAC57_I12,8,8p21.2,25033437,25116107,82670,-,-
BAC120_H06,8,8p21.2,25091773,25277738,185965,-,-
BAC246_J07,8,8p21.2,25146286,25230879,84593,-,-
BAC149_F08,8,8p21.2,25146500,25265998,119498,-,-
BAC43_F24,8,8p21.2,25165787,25288012,122225,-,-
BAC144_G18,8,8p21.2,25203845,25278127,74282,-,-
BAC51_G11,8,8p21.2,25280118,25379805,99687,-,-
BAC31_I19,8,8p21.2,25288010,25375681,87671,-,-
BAC16_K16,8,8p21.2,25308734,25397650,88916,-,-
BAC247_N17,8,8p21.2,25355922,25434155,78233,-,-
BAC180_F20,8,8p21.2,25405247,25481965,76718,-,-
BAC180_H11,8,8p21.2,25515051,25597723,82672,-,-
BAC106_A20,8,8p21.2,25566675,25714653,147978,-,-
BAC83_M03,8,8p21.2,25658386,25775846,117460,-,-
BAC110_L01,8,8p21.2,25664960,25759332,94372,-,-
BAC118_B08,8,8p21.2,25766078,25852524,86446,-,-
BAC179_A14,8,8p21.2,25794641,25890451,95810,-,-
BAC140_C15,8,8p21.2,25824781,25907086,82305,-,-
BAC149_J08,8,8p21.2,25832727,25937836,105109,-,-
BAC35_N09,8,8p21.2,25842238,25936234,93996,-,-
BAC182_N08,8,8p21.2,25981964,26126579,144615,-,-
BAC177_O09,8,8p21.2,26066860,26149181,82321,-,-
BAC238_L05,8,8p21.2,26168856,26240877,72021,-,-
BAC61_O16,8,8p21.2,26206510,26280124,73614,-,-
BAC23_A09,8,8p21.2,26351681,26489763,138082,-,-
BAC126_I03,8,8p21.2,26365604,26538317,172713,-,-
BAC181_H24,8,8p21.2,26505377,26593693,88316,-,-
BAC103_K20,8,8p21.2,26611823,26713016,101193,-,-
BAC88_B13,8,8p21.2,26612749,26728757,116008,-,-
BAC45_H11,8,8p21.2,26621454,26728757,107303,-,-
BAC41_B09,8,8p21.2,26633666,26718356,84690,-,-
BAC180_D01,8,8p21.2,26649763,26739042,89279,-,-
BAC13_N23,8,8p21.2,26665946,26763158,97212,-,-
BAC37_K17,8,8p21.2,26799863,26917838,117975,-,-
BAC107_A04,8,8p21.2,26843241,26935744,92503,-,-
BAC79_L10,8,8p21.2,26881908,26994326,112418,-,-
BAC33_E15,8,8p21.2,26924741,27026020,101279,-,-
BAC151_M10,8,8p21.2,26940651,27050617,109966,-,-
BAC175_M16,8,8p21.2,26986978,27073940,86962,-,-
BAC161_I10,8,8p21.2,26992217,27062738,70521,-,-
BAC80_K01,8,8p21.2,27054296,27207675,153379,-,-
BAC41_F07,8,8p21.2,27073938,27180891,106953,-,-
BAC179_A23,8,8p21.2,27094714,27207699,112985,-,-
BAC148_I22,8,8p21.2,27095054,27183257,88203,-,-
BAC223_K12,8,8p21.2,27180912,27324004,143092,-,-
BAC136_G03,8,8p21.2,27207694,27295885,88191,-,-
BAC37_K16,8,8p21.2,27207694,27325595,117901,-,-
BAC237_O20,8,8p21.2,27215255,27324004,108749,-,-
BAC144_J18,8,8p21.2,27238150,27324004,85854,-,-
BAC43_K08,8,8p21.2-8p21.1,27296002,27428370,132368,-,-
BAC226_P02,8,8p21.2,27314097,27334305,20208,-,-
BAC49_I07,8,8p21.2-8p21.1,27319921,27431171,111250,-,-
BAC41_E21,8,8p21.2-8p21.1,27384210,27473651,89441,-,-
BAC155_C24,8,8p21.2-8p21.1,27388074,27491360,103286,-,-
BAC242_L15,8,8p21.1,27404189,27520113,115924,-,-
BAC187_C09,8,8p21.1,27406040,27521984,115944,-,-
BAC224_A01,8,8p21.1,27438045,27521619,83574,-,-
BAC175_J19,8,8p21.1,27471313,27587674,116361,-,-
BAC155_C13,8,8p21.1,27480137,27562039,81902,-,-
BAC127_P21,8,8p21.1,27491547,27587674,96127,-,-
BAC248_N15,8,8p21.1,27514435,27623665,109230,-,-
BAC237_K17,8,8p21.1,27749005,27859269,110264,-,-
BAC73_J18,8,8p21.1,27775445,27874831,99386,-,-
BAC233_H21,8,8p21.1,27790812,27940198,149386,-,-
BAC75_L21,8,8p21.1,27790821,27918527,127706,-,-
BAC132_I09,8,8p21.1,27795145,27877929,82784,-,-
BAC143_I23,8,8p21.1,27795145,27900223,105078,-,-
BAC175_E06,8,8p21.1,27802564,27894470,91906,-,-
BAC184_C17,8,8p21.1,27848689,27954716,106027,-,-
BAC31_C19,8,8p21.1,27848692,27960898,112206,-,-
BAC72_C18,8,8p21.1,27912181,28003674,91493,-,-
BAC55_O13,8,8p21.1,27918848,27995779,76931,-,-
BAC43_C10,8,8p21.1,27958503,28059825,101322,-,-
BAC87_A01,8,8p21.1,28005688,28092904,87216,-,-
BAC120_H18,8,8p21.1,28066581,28233017,166436,-,-
BAC90_G09,8,8p21.1,28093062,28207258,114196,-,-
BAC65_E11,8,8p21.1,28100407,28213628,113221,-,-
BAC37_N01,8,8p21.1,28129194,28280250,151056,-,-
BAC102_H24,8,8p21.1,28233173,28329836,96663,-,-
BAC73_O16,8,8p21.1,28238493,28329820,91327,-,-
BAC169_D02,8,8p21.1,28283655,28329638,45983,-,-
BAC83_M20,8,8p21.1,28303570,28414748,111178,-,-
BAC142_A12,8,8p21.1,28442232,28528061,85829,-,-
BAC224_F13,8,8p21.1,28485998,28581002,95004,-,-
BAC96_J15,8,8p21.1,28503140,28574779,71639,-,-
BAC97_F20,8,8p21.1,28537312,28651605,114293,-,-
BAC111_B22,8,8p21.1,28571529,28767705,196176,-,-
BAC92_G08,8,8p21.1,28606604,28691591,84987,-,-
BAC117_I18,8,8p21.1,28628184,28710082,81898,-,-
BAC56_F10,8,8p21.1,28632058,28767697,135639,-,-
BAC12_F03,8,8p21.1,28632058,28718728,86670,-,-
BAC8_C10,8,8p21.1,28696629,28787112,90483,-,-
BAC24_C14,8,8p21.1,28835177,28942238,107061,-,-
BAC59_M07,8,8p21.1,28958057,29070552,112495,-,-
BAC25_M05,8,8p21.1,28959236,29070554,111318,-,-
BAC79_J21,8,8p21.1,28998677,29220341,221664,-,-
BAC109_N17,8,8p21.1,29033044,29116555,83511,-,-
BAC34_F24,8,8p21.1,29119370,29232070,112700,-,-
BAC25_I08,8,8p21.1,29129263,29253906,124643,-,-
BAC184_K16,8,8p21.1,29249328,29339967,90639,-,-
BAC125_B07,8,8p21.1,29282235,29362808,80573,-,-
BAC30_M23,8,8p21.1,29282921,29379190,96269,-,-
BAC232_G14,8,8p21.1,29398471,29508808,110337,-,-
BAC234_C10,8,8p21.1,29433230,29527034,93804,-,-
BAC46_N18,8,8p21.1,29434516,29521003,86487,-,-
BAC22_L21,8,8p21.1-8p12,29532584,29710316,177732,-,-
BAC39_M14,8,8p21.1,29565119,29626479,61360,-,-
BAC51_P18,8,8p21.1-8p12,29574517,29703774,129257,-,-
BAC129_K14,8,8p21.1,29579227,29654836,75609,-,-
BAC197_D11,8,8p21.1,29591785,29672436,80651,-,-
BAC170_I03,8,8p12,29858743,29961453,102710,-,-
BAC134_F14,8,8p12,29884031,29941059,57028,-,-
BAC103_H20,8,8p12,29932666,30086474,153808,-,-
BAC233_B03,8,8p12,29949320,30027702,78382,-,-
BAC243_K12,8,8p12,29958727,30049423,90696,-,-
BAC26_F09,8,8p12,29988496,30087289,98793,-,-
BAC116_D14,8,8p12,30040484,30115225,74741,-,-
BAC56_F12,8,8p12,30049425,30152585,103160,-,-
BAC1_D08,8,8p12,30076221,30159224,83003,-,-
BAC182_H02,8,8p12,30115345,30214780,99435,-,-
BAC83_G13,8,8p12,30138614,30247860,109246,-,-
BAC83_L16,8,8p12,30186963,30298722,111759,-,-
BAC111_J17,8,8p12,30188496,30289983,101487,-,-
BAC154_M23,8,8p12,30214775,30308876,94101,-,-
BAC223_H10,8,8p12,30308870,30392299,83429,-,-
BAC219_P12,8,8p12,30336094,30455370,119276,-,-
BAC85_A17,8,8p12,30369295,30455370,86075,-,-
BAC96_N23,8,8p12,30493673,30614466,120793,-,-
BAC73_H17,8,8p12,30512905,30589264,76359,-,-
BAC175_O05,8,8p12,30517691,30632688,114997,-,-
BAC161_J06,8,8p12,30577760,30688299,110539,-,-
BAC228_L13,8,8p12,30585312,30662472,77160,-,-
BAC76_P04,8,8p12,30589259,30696837,107578,-,-
BAC160_L16,8,8p12,30624761,30717941,93180,-,-
BAC62_D02,8,8p12,30624811,30729800,104989,-,-
BAC197_J23,8,8p12,30632562,30717979,85417,-,-
BAC81_I12,8,8p12,30688305,30798694,110389,-,-
BAC57_F01,8,8p12,30697742,30820925,123183,-,-
BAC178_B10,8,8p12,30846538,30967687,121149,-,-
BAC226_P20,8,8p12,30888584,30992091,103507,-,-
BAC12_P04,8,8p12,31055518,31145425,89907,-,-
BAC232_C23,8,8p12,31055521,31145612,90091,-,-
BAC125_C17,8,8p12,31075505,31258081,182576,-,-
BAC102_B21,8,8p12,31085539,31190867,105328,-,-
BAC148_B18,8,8p12,31124075,31231221,107146,-,-
BAC185_H10,8,8p12,31142274,31231196,88922,-,-
BAC53_E06,8,8p12,31145609,31226728,81119,-,-
BAC224_E04,8,8p12,31190463,31273198,82735,-,-
BAC32_A05,8,8p12,31216267,31318671,102404,-,-
BAC182_K16,8,8p12,31229657,31326643,96986,-,-
BAC8_M12,8,8p12,31259561,31361159,101598,-,-
BAC152_K01,8,8p12,31425446,31507200,81754,-,-
BAC241_P01,8,8p12,31437286,31519893,82607,-,-
BAC144_K08,8,8p12,31445228,31519893,74665,-,-
BAC198_E04,8,8p12,31495991,31594699,98708,-,-
BAC55_J14,8,8p12,31523761,31615300,91539,-,-
BAC123_L07,8,8p12,31692392,31799183,106791,-,-
BAC11_C18,8,8p12,31733634,31846224,112590,-,-
BAC40_H21,8,8p12,31765265,31876517,111252,-,-
BAC124_F07,8,8p12,32008393,32139849,131456,-,-
BAC102_B13,8,8p12,32078558,32223535,144977,-,-
BAC194_J03,8,8p12,32163698,32262113,98415,-,-
BAC60_E17,8,8p12,32225361,32327221,101860,-,-
BAC179_E16,8,8p12,32232508,32327221,94713,-,-
BAC26_M16,8,8p12,32255629,32362421,106792,-,-
BAC110_D16,8,8p12,32303087,32401271,98184,-,-
BAC249_A14,8,8p12,32327214,32429650,102436,-,-
BAC189_K04,8,8p12,32349067,32438993,89926,-,-
BAC180_P16,8,8p12,32519899,32613631,93732,-,-
BAC63_M21,8,8p12,32590447,32691100,100653,-,-
BAC89_I14,8,8p12,32604921,32697862,92941,-,-
BAC172_L02,8,8p12,32659251,32733674,74423,-,-
BAC238_K01,8,8p12,32745494,32855462,109968,-,-
BAC161_C06,8,8p12,32754203,32850666,96463,-,-
BAC45_G17,8,8p12,32816897,32942085,125188,-,-
BAC57_O03,8,8p12,32930099,33030472,100373,-,-
BAC225_O12,8,8p12,33077293,33156778,79485,-,-
BAC188_P06,8,8p12,33081133,33181156,100023,-,-
BAC220_H18,8,8p12,33184889,33281776,96887,-,-
BAC130_M07,8,8p12,33300099,33381397,81298,-,-
BAC54_I15,8,8p12,33321671,33413587,91916,-,-
BAC50_A14,8,8p12,33382523,33502734,120211,-,-
BAC165_F16,8,8p12,33413581,33502478,88897,-,-
BAC107_E06,8,8p12,33447503,33545143,97640,-,-
BAC102_N06,8,8p12,33560021,33661481,101460,-,-
BAC235_M08,8,8p12,33568585,33667370,98785,-,-
BAC247_F01,8,8p12,33568597,33661479,92882,-,-
BAC45_N05,8,8p12,33568623,33661427,92804,-,-
BAC235_O13,8,8p12,33634090,33711372,77282,-,-
BAC179_N15,8,8p12,33698470,33789733,91263,-,-
BAC194_B10,8,8p12,33750826,33832624,81798,-,-
BAC102_D08,8,8p12,33841490,33927054,85564,-,-
BAC86_K01,8,8p12,33869492,33961389,91897,-,-
BAC115_B07,8,8p12,33967858,34056467,88609,-,-
BAC185_G09,8,8p12,33967858,34094766,126908,-,-
BAC233_F04,8,8p12,34013453,34099472,86019,-,-
BAC71_I09,8,8p12,34018448,34143770,125322,-,-
BAC84_N22,8,8p12,34044919,34143771,98852,-,-
BAC241_C11,8,8p12,34086931,34204374,117443,-,-
BAC178_D15,8,8p12,34182524,34266247,83723,-,-
BAC33_H17,8,8p12,34293258,34386103,92845,-,-
BAC132_B09,8,8p12,34343570,34456140,112570,-,-
BAC42_D11,8,8p12,34361930,34456261,94331,-,-
BAC74_A15,8,8p12,34389558,34498392,108834,-,-
BAC221_D13,8,8p12,34456256,34516243,59987,-,-
BAC181_B16,8,8p12,34498525,34591535,93010,-,-
BAC44_O16,8,8p12,34560938,34718885,157947,-,-
BAC176_E10,8,8p12,34631602,34718891,87289,-,-
BAC39_N09,8,8p12,34631602,34711063,79461,-,-
BAC49_J05,8,8p12,34708329,34830020,121691,-,-
BAC71_F10,8,8p12,34740307,34833183,92876,-,-
BAC157_D14,8,8p12,34740919,34831215,90296,-,-
BAC162_O08,8,8p12,34751465,34839225,87760,-,-
BAC29_I17,8,8p12,34839411,34927429,88018,-,-
BAC48_E04,8,8p12,34839427,34927561,88134,-,-
BAC63_L02,8,8p12,34887019,34957418,70399,-,-
BAC116_C23,8,8p12,34957437,35105185,147748,-,-
BAC172_D16,8,8p12,34977514,35068054,90540,-,-
BAC17_F05,8,8p12,35074684,35173646,98962,-,-
BAC252_H20,8,8p12,35103925,35241789,137864,-,-
BAC219_P05,8,8p12,35310410,35413220,102810,-,-
BAC230_C19,8,8p12,35334944,35413220,78276,-,-
BAC148_C02,8,8p12,35391707,35487773,96066,-,-
BAC186_N09,8,8p12,35437304,35514056,76752,-,-
BAC176_B23,8,8p12,35478600,35571846,93246,-,-
BAC123_N07,8,8p12,35502568,35589700,87132,-,-
BAC221_N16,8,8p12,35502582,35589700,87118,-,-
BAC239_K05,8,8p12,35515860,35614262,98402,-,-
BAC106_I21,8,8p12,35588395,35695240,106845,-,-
BAC84_M14,8,8p12,35684070,35770782,86712,-,-
BAC96_H05,8,8p12,35759258,35850953,91695,-,-
BAC249_M23,8,8p12,35879168,35960874,81706,-,-
BAC177_N12,8,8p12,35909423,36018379,108956,-,-
BAC155_C02,8,8p12,36098359,36185638,87279,-,-
BAC182_A10,8,8p12,36199143,36288144,89001,-,-
BAC217_N12,8,8p12,36252178,36334994,82816,-,-
BAC162_G21,8,8p12,36349854,36453673,103819,-,-
BAC118_J17,8,8p12,36361718,36453674,91956,-,-
BAC32_D11,8,8p12,36475217,36556720,81503,-,-
BAC91_M06,8,8p12,36541739,36632719,90980,-,-
BAC228_H12,8,8p12,36556765,36632702,75937,-,-
BAC43_M11,8,8p12,36583179,36687850,104671,-,-
BAC237_A05,8,8p12,36614053,36702156,88103,-,-
BAC203_F11,8,8p12,36771823,36859607,87784,-,-
BAC196_K06,8,8p12,36894044,37001949,107905,-,-
BAC200_A19,8,8p12,36988538,37078169,89631,-,-
BAC137_P14,8,8p12,37119445,37217133,97688,-,-
BAC162_E21,8,8p12,37212751,37298006,85255,-,-
BAC45_P06,8,8p12,37243408,37324622,81214,-,-
BAC150_M19,8,8p12,37249353,37335793,86440,-,-
BAC71_G11,8,8p12,37291160,37399402,108242,-,-
BAC60_F02,8,8p12,37311841,37412194,100353,-,-
BAC183_P16,8,8p12,37345663,37491278,145615,-,-
BAC148_L15,8,8p12,37431653,37518146,86493,-,-
BAC14_D15,8,8p12,37449414,37557019,107605,-,-
BAC1_I16,8,8p12,37467697,37685898,218201,-,-
BAC242_K08,8,8p12,37470595,37549976,79381,-,-
BAC238_E16,8,8p12,37474794,37557020,82226,-,-
BAC144_B24,8,8p12,37492610,37587589,94979,-,-
BAC176_J16,8,8p12,37549974,37692862,142888,-,-
BAC18_M06,8,8p12,37550015,37646947,96932,-,-
BAC39_K17,8,8p12,37640888,37730572,89684,-,-
BAC110_H13,8,8p12,37730740,37856756,126016,-,-
BAC224_E23,8,8p12,37883156,37970435,87279,-,-
BAC13_A19,8,8p12,37896345,38006380,110035,-,-
BAC176_G11,8,8p12,37899983,38000637,100654,-,-
BAC101_H14,8,8p12,37923703,38015490,91787,-,-
BAC222_P11,8,8p12,37923770,38015490,91720,-,-
BAC220_H08,8,8p12,38039163,38127524,88361,-,-
BAC78_A13,8,8p12,38056064,38147796,91732,-,-
BAC181_M17,8,8p12,38056064,38152877,96813,-,-
BAC198_D20,8,8p12,38102986,38174706,71720,-,-
BAC243_I18,8,8p12,38127597,38249280,121683,-,-
BAC152_N18,8,8p12,38131682,38229745,98063,-,-
BAC168_P23,8,8p12,38148462,38222346,73884,-,-
BAC127_F14,8,8p12,38154849,38242791,87942,-,-
BAC57_C24,8,8p12,38154849,38266887,112038,-,-
BAC59_B07,8,8p12,38242785,38345977,103192,-,-
BAC231_G07,8,8p12,38299748,38467093,167345,-,-
BAC172_J20,8,8p12,38385475,38472323,86848,-,-
BAC158_N09,8,8p12,38400956,38497281,96325,-,-
BAC37_C09,8,8p12-8p11.23,38437145,38529202,92057,-,-
BAC240_P19,8,8p11.23,38549335,38640391,91056,-,-
BAC141_L23,8,8p11.23,38681175,38761522,80347,-,-
BAC236_L24,8,8p11.23,38776969,38871226,94257,-,-
BAC27_K09,8,8p11.23,38794927,38913669,118742,-,-
BAC104_G01,8,8p11.23,38794927,38924125,129198,-,-
BAC58_D21,8,8p11.23,38801385,38913692,112307,-,-
BAC200_C12,8,8p11.23,38822572,38913692,91120,-,-
BAC129_G16,8,8p11.23,38858335,38970623,112288,-,-
BAC221_G14,8,8p11.23,38931141,39059543,128402,-,-
BAC217_P03,8,8p11.23,38931141,39041634,110493,-,-
BAC188_D08,8,8p11.23,38939225,39020619,81394,-,-
BAC128_N03,8,8p11.23,38939226,39037695,98469,-,-
BAC10_E01,8,8p11.23,38939231,39020619,81388,-,-
BAC21_F20,8,8p11.23,38940849,39029313,88464,-,-
BAC50_B12,8,8p11.23,39020855,39109907,89052,-,-
BAC169_B17,8,8p11.23,39094972,39178677,83705,-,-
BAC214_F22,8,8p11.23,39095134,39183144,88010,-,-
BAC153_P07,8,8p11.23,39095373,39186718,91345,-,-
BAC27_A02,8,8p11.23,39186734,39295904,109170,-,-
BAC105_B10,8,8p11.23,39194281,39295904,101623,-,-
BAC81_F08,8,8p11.23,39205416,39307157,101741,-,-
BAC95_D21,8,8p11.23,39212201,39307960,95759,-,-
BAC124_M18,8,8p11.23,39235325,39321819,86494,-,-
BAC166_H22,8,8p11.22,39542616,39625113,82497,-,-
BAC12_J01,8,8p11.22,39702972,39811923,108951,-,-
BAC75_D11,8,8p11.22,39734271,39801799,67528,-,-
BAC39_K19,8,8p11.22-8p11.21,39753413,39966790,213377,-,-
BAC199_D11,8,8p11.22-8p11.21,39823646,39932300,108654,-,-
BAC41_C22,8,8p11.22-8p11.21,39899695,40039470,139775,-,-
BAC58_O10,8,8p11.21,39937166,40027051,89885,-,-
BAC21_N14,8,8p11.21,39976496,40148580,172084,-,-
BAC81_M16,8,8p11.21,39983354,40081040,97686,-,-
BAC244_A18,8,8p11.21,40007428,40081790,74362,-,-
BAC43_K18,8,8p11.21,40121614,40218036,96422,-,-
BAC76_E16,8,8p11.21,40184831,40316269,131438,-,-
BAC130_F02,8,8p11.21,40268885,40351254,82369,-,-
BAC141_I05,8,8p11.21,40288584,40375311,86727,-,-
BAC160_E24,8,8p11.21,40288584,40378323,89739,-,-
BAC186_G10,8,8p11.21,40341184,40425719,84535,-,-
BAC27_I12,8,8p11.21,40453818,40591053,137235,-,-
BAC250_O04,8,8p11.21,40474604,40561809,87205,-,-
BAC217_J09,8,8p11.21,40506194,40591057,84863,-,-
BAC24_O09,8,8p11.21,40663075,40766748,103673,-,-
BAC230_J14,8,8p11.21,40666807,40748849,82042,-,-
BAC232_M09,8,8p11.21,40848631,40941471,92840,-,-
BAC217_I23,8,8p11.21,40942125,41056586,114461,-,-
BAC10_K15,8,8p11.21,41009033,41122237,113204,-,-
BAC125_J03,8,8p11.21,41056579,41128733,72154,-,-
BAC6_F13,8,8p11.21,41082714,41176883,94169,-,-
BAC196_F08,8,8p11.21,41101623,41216444,114821,-,-
BAC242_G19,8,8p11.21,41122232,41198173,75941,-,-
BAC69_G03,8,8p11.21,41122263,41292858,170595,-,-
BAC185_A07,8,8p11.21,41128834,41251004,122170,-,-
BAC232_F05,8,8p11.21,41167086,41239319,72233,-,-
BAC197_E16,8,8p11.21,41239314,41325014,85700,-,-
BAC55_B07,8,8p11.21,41246861,41374788,127927,-,-
BAC167_N01,8,8p11.21,41325560,41425297,99737,-,-
BAC206_C24,8,8p11.21,41335061,41425133,90072,-,-
BAC191_H15,8,8p11.21,41374782,41445104,70322,-,-
BAC189_H01,8,8p11.21,41389289,41493540,104251,-,-
BAC30_I07,8,8p11.21,41394277,41486567,92290,-,-
BAC237_L19,8,8p11.21,41485694,41586950,101256,-,-
BAC226_O01,8,8p11.21,41499921,41612094,112173,-,-
BAC135_I07,8,8p11.21,41522276,41669166,146890,-,-
BAC135_N02,8,8p11.21,41562218,41666796,104578,-,-
BAC52_N19,8,8p11.21,41562218,41652408,90190,-,-
BAC144_O04,8,8p11.21,41568256,41682504,114248,-,-
BAC27_J09,8,8p11.21,41616835,41713972,97137,-,-
BAC147_O15,8,8p11.21,41666791,41781564,114773,-,-
BAC247_P01,8,8p11.21,41688299,41778020,89721,-,-
BAC224_A18,8,8p11.21,41697288,41807721,110433,-,-
BAC182_G03,8,8p11.21,41711694,41827501,115807,-,-
BAC234_K20,8,8p11.21,41719700,41807120,87420,-,-
BAC159_I08,8,8p11.21,42027454,42091938,64484,-,-
BAC109_F15,8,8p11.21,42040269,42126389,86120,-,-
BAC27_J23,8,8p11.21,42092051,42205664,113613,-,-
BAC25_L14,8,8p11.21,42095601,42145985,50384,-,-
BAC68_G20,8,8p11.21,42108986,42218528,109542,-,-
BAC131_B21,8,8p11.21,42122110,42209660,87550,-,-
BAC56_L19,8,8p11.21,42126508,42233581,107073,-,-
BAC29_L17,8,8p11.21,42126508,42271678,145170,-,-
BAC247_J02,8,8p11.21,42142011,42228503,86492,-,-
BAC198_J24,8,8p11.21,42146154,42267051,120897,-,-
BAC123_G23,8,8p11.21,42146853,42306503,159650,-,-
BAC179_P11,8,8p11.21,42218519,42329029,110510,-,-
BAC213_M10,8,8p11.21,42228689,42328001,99312,-,-
BAC128_I12,8,8p11.21,42263184,42347589,84405,-,-
BAC155_D08,8,8p11.21,42349308,42434978,85670,-,-
BAC190_N16,8,8p11.21,42383492,42483250,99758,-,-
BAC65_G16,8,8p11.21,42394767,42498222,103455,-,-
BAC143_E22,8,8p11.21,42403927,42483250,79323,-,-
BAC51_F08,8,8p11.21,42418162,42540455,122293,-,-
BAC83_L09,8,8p11.21,42418164,42532761,114597,-,-
BAC223_D22,8,8p11.21,42458609,42546543,87934,-,-
BAC91_N11,8,8p11.21,42546537,42661857,115320,-,-
BAC217_N10,8,8p11.21,42569942,42662421,92479,-,-
BAC73_D12,8,8p11.21,42624697,42715186,90489,-,-
BAC56_C22,8,8p11.21,42665731,42764846,99115,-,-
BAC179_I23,8,8p11.21,42732678,42816796,84118,-,-
BAC109_H17,8,8p11.21,42767699,42862689,94990,-,-
BAC65_F15,8,8p11.21,42777792,42923251,145459,-,-
BAC2_F07,8,8p11.21,42840366,42932610,92244,-,-
BAC158_C22,8,8p11.21,42852575,42935249,82674,-,-
BAC176_D09,8,8p11.21,42911059,43012855,101796,-,-
BAC129_N13,8,8p11.21,42932924,43028496,95572,-,-
BAC243_M10,8,8p11.21,42960995,43053071,92076,-,-
BAC247_E16,8,8p11.21,42961006,43100243,139237,-,-
BAC117_G23,8,8p11.21,43052061,43146892,94831,-,-
BAC127_B18,8,8p11.21,43060751,43146905,86154,-,-
BAC79_N11,8,8p11.21,43066070,43174144,108074,-,-
BAC199_D07,8,8p11.21,43098979,43183043,84064,-,-
BAC83_L07,8,8p11.21-8p11.1,43119033,43206585,87552,-,-
BAC86_O07,8,8p11.21-8p11.1,43163341,43253493,90152,-,-
BAC199_D10,8,8p11.1,43228153,43281370,53217,-,-
BAC191_M17,8,8p11.1,43297127,43367696,70569,-,-
BAC7_K18,8,8p11.1,43327327,43478575,151248,-,-
BAC104_L13,8,8p11.1,43443745,43538003,94258,-,-
BAC160_K10,8,8p11.1,43461041,43538818,77777,-,-
BAC192_L13,8,8p11.1,43538811,43603251,64440,-,-
BAC229_K15,8,8q11.1,46965866,47035049,69183,-,-
BAC134_A23,8,8q11.1,47026751,47149637,122886,-,-
BAC108_B21,8,8q11.1,47130888,47221352,90464,-,-
BAC250_E22,8,8q11.1,47142799,47228797,85998,-,-
BAC135_L22,8,8q11.1,47147471,47218462,70991,-,-
BAC63_C13,8,8q11.1,47168203,47260042,91839,-,-
BAC20_A04,8,8q11.1,47252603,47381757,129154,-,-
BAC72_E06,8,8q11.1,47269364,47356438,87074,-,-
BAC220_D05,8,8q11.1,47287362,47372963,85601,-,-
BAC199_I24,8,8q11.1,47372956,47454318,81362,-,-
BAC222_B23,8,8q11.1,47541902,47640002,98100,-,-
BAC66_C22,8,8q11.1,47700273,47785271,84998,-,-
BAC199_A12,8,8q11.1,47903982,48034608,130626,-,-
BAC149_F07,8,8q11.1,47939753,48047163,107410,-,-
BAC66_H09,8,8q11.1,47941508,47953779,12271,-,-
BAC194_N17,8,8q11.1,47972840,48063569,90729,-,-
BAC28_B06,8,8q11.1,47979731,48080711,100980,-,-
BAC37_L15,8,8q11.1-8q11.21,48003479,48115496,112017,-,-
BAC247_J23,8,8q11.1-8q11.21,48082307,48192687,110380,-,-
BAC250_F08,8,8q11.21,48100371,48184817,84446,-,-
BAC75_O11,8,8q11.21,48344731,48438301,93570,-,-
BAC143_J09,8,8q11.21,48521278,48628140,106862,-,-
BAC88_F13,8,8q11.21,48527616,48672830,145214,-,-
BAC103_N22,8,8q11.21,48561436,48672821,111385,-,-
BAC231_E03,8,8q11.21,48583721,48680538,96817,-,-
BAC188_J17,8,8q11.21,48672827,48753986,81159,-,-
BAC27_A16,8,8q11.21,48716801,48866065,149264,-,-
BAC116_B04,8,8q11.21,48721579,48833939,112360,-,-
BAC15_G09,8,8q11.21,48721583,48817199,95616,-,-
BAC38_E10,8,8q11.21,48726271,48828438,102167,-,-
BAC152_E14,8,8q11.21,48773878,48860499,86621,-,-
BAC208_M02,8,8q11.21,48794314,48877517,83203,-,-
BAC46_O06,8,8q11.21,48833973,48933508,99535,-,-
BAC121_I13,8,8q11.21,48903911,48931055,27144,-,-
BAC242_C15,8,8q11.21,48954452,49060810,106358,-,-
BAC77_E20,8,8q11.21,48955403,49053083,97680,-,-
BAC41_G04,8,8q11.21,48955403,49060810,105407,-,-
BAC142_E22,8,8q11.21,49011506,49089699,78193,-,-
BAC218_F20,8,8q11.21,49017859,49084326,66467,-,-
BAC21_M04,8,8q11.21,49120326,49242734,122408,-,-
BAC66_K02,8,8q11.21,49127536,49249966,122430,-,-
BAC44_I10,8,8q11.21,49137832,49272573,134741,-,-
BAC46_I02,8,8q11.21,49143337,49243456,100119,-,-
BAC171_A17,8,8q11.21,49167303,49254278,86975,-,-
BAC53_M12,8,8q11.21,49200679,49297283,96604,-,-
BAC226_N24,8,8q11.21,49219308,49324365,105057,-,-
BAC36_N17,8,8q11.21,49222573,49308237,85664,-,-
BAC79_G20,8,8q11.21,49222573,49328874,106301,-,-
BAC182_E15,8,8q11.21,49248807,49344789,95982,-,-
BAC197_P20,8,8q11.21,49248869,49345032,96163,-,-
BAC12_I20,8,8q11.21,49254272,49345032,90760,-,-
BAC88_P02,8,8q11.21,49428291,49541675,113384,-,-
BAC119_J08,8,8q11.21,49447623,49541674,94051,-,-
BAC145_H17,8,8q11.21,49483226,49569046,85820,-,-
BAC244_K16,8,8q11.21,49483327,49560247,76920,-,-
BAC175_B01,8,8q11.21,49509025,49587002,77977,-,-
BAC67_N11,8,8q11.21,49513703,49609175,95472,-,-
BAC234_J17,8,8q11.21,49540959,49628554,87595,-,-
BAC155_O22,8,8q11.21,49541666,49619986,78320,-,-
BAC83_L04,8,8q11.21,49541666,49634675,93009,-,-
BAC131_F16,8,8q11.21,49541667,49622480,80813,-,-
BAC151_I16,8,8q11.21,49569039,49648488,79449,-,-
BAC61_B12,8,8q11.21,49634669,49724785,90116,-,-
BAC71_J18,8,8q11.21,49640920,49730458,89538,-,-
BAC68_C06,8,8q11.21,49667874,49771792,103918,-,-
BAC115_G16,8,8q11.21,49724776,49822444,97668,-,-
BAC14_O09,8,8q11.21,49729867,49868176,138309,-,-
BAC97_L21,8,8q11.21,49758778,49868903,110125,-,-
BAC82_M09,8,8q11.21,49803506,49900978,97472,-,-
BAC166_F23,8,8q11.21,49810843,49898394,87551,-,-
BAC42_B11,8,8q11.21,49823784,49861867,38083,-,-
BAC176_O19,8,8q11.21,49868435,49957196,88761,-,-
BAC193_D15,8,8q11.21,49880280,49959442,79162,-,-
BAC182_F09,8,8q11.21,49880280,49981278,100998,-,-
BAC44_I16,8,8q11.21,49897613,49995230,97617,-,-
BAC173_M15,8,8q11.21,49912737,50005987,93250,-,-
BAC44_E13,8,8q11.21,49951500,50020402,68902,-,-
BAC171_O23,8,8q11.21,49982495,50095276,112781,-,-
BAC25_L04,8,8q11.21,50047666,50138982,91316,-,-
BAC131_E09,8,8q11.21,50050694,50127942,77248,-,-
BAC20_N03,8,8q11.21,50071369,50187424,116055,-,-
BAC121_D19,8,8q11.21,50088433,50224184,135751,-,-
BAC249_F20,8,8q11.21,50099937,50187424,87487,-,-
BAC151_B18,8,8q11.21,50138979,50237505,98526,-,-
BAC168_G08,8,8q11.22,50407732,50499602,91870,-,-
BAC163_I17,8,8q11.22,50513662,50622458,108796,-,-
BAC68_I15,8,8q11.22,50643172,50752794,109622,-,-
BAC241_M18,8,8q11.22,50876438,50962192,85754,-,-
BAC85_C09,8,8q11.22,50964310,51046276,81966,-,-
BAC239_E09,8,8q11.22,51111551,51199917,88366,-,-
BAC167_M19,8,8q11.22,51132546,51230771,98225,-,-
BAC21_P11,8,8q11.22,51208774,51305953,97179,-,-
BAC37_A03,8,8q11.22,51251517,51384253,132736,-,-
BAC217_F21,8,8q11.22,51317917,51400763,82846,-,-
BAC148_M12,8,8q11.22,51321787,51400690,78903,-,-
BAC249_L19,8,8q11.22,51333239,51438600,105361,-,-
BAC84_H11,8,8q11.22,51422512,51539311,116799,-,-
BAC225_D14,8,8q11.22,51484679,51577398,92719,-,-
BAC169_C07,8,8q11.22,51607768,51690708,82940,-,-
BAC161_F04,8,8q11.22,51607769,51692333,84564,-,-
BAC179_F08,8,8q11.22,51722863,51812817,89954,-,-
BAC158_H06,8,8q11.22,51879346,51982534,103188,-,-
BAC75_E08,8,8q11.22,51959611,52047987,88376,-,-
BAC123_M22,8,8q11.22,51997881,52087738,89857,-,-
BAC136_G23,8,8q11.22,51997881,52092814,94933,-,-
BAC242_K06,8,8q11.22,52017152,52092801,75649,-,-
BAC123_M07,8,8q11.22,52072989,52184138,111149,-,-
BAC247_M24,8,8q11.22,52087735,52166799,79064,-,-
BAC198_E24,8,8q11.22,52238545,52314991,76446,-,-
BAC32_C11,8,8q11.22,52252916,52349977,97061,-,-
BAC153_K12,8,8q11.22,52252916,52350000,97084,-,-
BAC88_C03,8,8q11.22,52299966,52402644,102678,-,-
BAC249_E02,8,8q11.22,52402906,52479329,76423,-,-
BAC155_J11,8,8q11.22,52490500,52548858,58358,-,-
BAC113_A02,8,8q11.22,52505445,52621855,116410,-,-
BAC65_A22,8,8q11.22,52712782,52798013,85231,-,-
BAC116_M04,8,8q11.22-8q11.23,52726021,52831502,105481,-,-
BAC46_H13,8,8q11.22-8q11.23,52773890,52895107,121217,-,-
BAC158_C09,8,8q11.22-8q11.23,52780608,52886972,106364,-,-
BAC158_D09,8,8q11.22-8q11.23,52780624,52886972,106348,-,-
BAC20_N22,8,8q11.23,52876536,53017635,141099,-,-
BAC133_P02,8,8q11.23,52899175,53019422,120247,-,-
BAC217_N02,8,8q11.23,52934532,53023146,88614,-,-
BAC42_B14,8,8q11.23,52964566,53092516,127950,-,-
BAC125_I06,8,8q11.23,53003357,53092420,89063,-,-
BAC100_O13,8,8q11.23,53076826,53160519,83693,-,-
BAC169_H04,8,8q11.23,53193247,53288094,94847,-,-
BAC34_K10,8,8q11.23,53218187,53300500,82313,-,-
BAC168_M14,8,8q11.23,53240516,53323810,83294,-,-
BAC15_K17,8,8q11.23,53289806,53454215,164409,-,-
BAC178_A08,8,8q11.23,53324802,53454545,129743,-,-
BAC52_D09,8,8q11.23,53340098,53429904,89806,-,-
BAC161_K03,8,8q11.23,53443055,53521510,78455,-,-
BAC148_G11,8,8q11.23,53523292,53610495,87203,-,-
BAC222_G08,8,8q11.23,53583478,53662763,79285,-,-
BAC90_P11,8,8q11.23,53662895,53762365,99470,-,-
BAC89_G05,8,8q11.23,53736401,53817190,80789,-,-
BAC60_E11,8,8q11.23,53755497,53865696,110199,-,-
BAC37_P11,8,8q11.23,53759266,53861692,102426,-,-
BAC210_C16,8,8q11.23,53784180,53878348,94168,-,-
BAC209_A03,8,8q11.23,53817370,53896841,79471,-,-
BAC46_P20,8,8q11.23,53817428,53913086,95658,-,-
BAC67_P12,8,8q11.23,53832003,53918845,86842,-,-
BAC65_F05,8,8q11.23,53865696,53953530,87834,-,-
BAC234_H12,8,8q11.23,53896914,53972727,75813,-,-
BAC157_E18,8,8q11.23,53896914,53999710,102796,-,-
BAC242_G07,8,8q11.23,53990721,54086876,96155,-,-
BAC169_F08,8,8q11.23,54014542,54088594,74052,-,-
BAC240_N11,8,8q11.23,54123632,54207704,84072,-,-
BAC60_J17,8,8q11.23,54173637,54301947,128310,-,-
BAC248_G05,8,8q11.23,54204090,54293271,89181,-,-
BAC189_E20,8,8q11.23,54227845,54313330,85485,-,-
BAC145_E12,8,8q11.23,54316333,54394880,78547,-,-
BAC108_K10,8,8q11.23,54405771,54490031,84260,-,-
BAC139_C16,8,8q11.23,54503850,54581273,77423,-,-
BAC200_E22,8,8q11.23,54557711,54655929,98218,-,-
BAC237_G07,8,8q11.23,54676275,54781999,105724,-,-
BAC78_H10,8,8q11.23,54680285,54782982,102697,-,-
BAC96_L07,8,8q11.23,54736700,54827563,90863,-,-
BAC161_C22,8,8q11.23,54845488,54929168,83680,-,-
BAC31_O08,8,8q11.23,54845490,54936080,90590,-,-
BAC139_N13,8,8q11.23,54906027,54991721,85694,-,-
BAC232_C10,8,8q11.23,54909356,55001322,91966,-,-
BAC145_J03,8,8q11.23,54937088,55055734,118646,-,-
BAC150_B10,8,8q11.23,54990673,55076722,86049,-,-
BAC231_B03,8,8q11.23,55055727,55139953,84226,-,-
BAC243_N17,8,8q11.23,55069835,55178265,108430,-,-
BAC97_A14,8,8q11.23,55082475,55213032,130557,-,-
BAC88_A11,8,8q11.23,55082475,55172024,89549,-,-
BAC26_N13,8,8q11.23,55125801,55212315,86514,-,-
BAC237_K04,8,8q11.23,55130238,55241083,110845,-,-
BAC65_N06,8,8q11.23,55140066,55228117,88051,-,-
BAC142_G10,8,8q11.23,55217709,55297322,79613,-,-
BAC197_K19,8,8q11.23,55228111,55320443,92332,-,-
BAC187_N19,8,8q11.23,55306356,55396553,90197,-,-
BAC115_K09,8,8q11.23,55328502,55453719,125217,-,-
BAC66_A01,8,8q11.23,55328502,55402896,74394,-,-
BAC30_P24,8,8q11.23,55328550,55424470,95920,-,-
BAC168_A16,8,8q11.23,55364599,55457695,93096,-,-
BAC132_M14,8,8q11.23,55382616,55466012,83396,-,-
BAC219_F06,8,8q11.23,55457691,55564517,106826,-,-
BAC182_O14,8,8q11.23,55466007,55556768,90761,-,-
BAC230_B17,8,8q11.23,55469631,55563647,94016,-,-
BAC176_G16,8,8q11.23,55477335,55561062,83727,-,-
BAC82_H15,8,8q11.23-8q12.1,55497918,55603417,105499,-,-
BAC242_F10,8,8q11.23-8q12.1,55563847,55642526,78679,-,-
BAC224_F06,8,8q11.23-8q12.1,55581796,55665091,83295,-,-
BAC247_J14,8,8q12.1,55778758,55873976,95218,-,-
BAC186_I10,8,8q12.1,55815868,55905127,89259,-,-
BAC146_C04,8,8q12.1,55838435,55903640,65205,-,-
BAC119_M21,8,8q12.1,55878093,55966945,88852,-,-
BAC122_C10,8,8q12.1,55919732,56018742,99010,-,-
BAC66_H13,8,8q12.1,55945969,56046454,100485,-,-
BAC106_M11,8,8q12.1,55971025,56115094,144069,-,-
BAC188_C10,8,8q12.1,56007415,56096810,89395,-,-
BAC125_H08,8,8q12.1,56023776,56157936,134160,-,-
BAC18_H14,8,8q12.1,56028419,56128748,100329,-,-
BAC67_G05,8,8q12.1,56033056,56136606,103550,-,-
BAC41_M14,8,8q12.1,56137713,56327174,189461,-,-
BAC120_J15,8,8q12.1,56137859,56251147,113288,-,-
BAC17_H19,8,8q12.1,56183588,56310965,127377,-,-
BAC52_F07,8,8q12.1,56187018,56336035,149017,-,-
BAC224_I14,8,8q12.1,56278664,56363085,84421,-,-
BAC183_B23,8,8q12.1,56380032,56457819,77787,-,-
BAC78_O16,8,8q12.1,56422309,56523209,100900,-,-
BAC147_G13,8,8q12.1,56435050,56523213,88163,-,-
BAC120_G19,8,8q12.1,56506395,56606318,99923,-,-
BAC28_P17,8,8q12.1,56578916,56655032,76116,-,-
BAC20_L03,8,8q12.1,56580698,56600675,19977,-,-
BAC221_H04,8,8q12.1,56604395,56712968,108573,-,-
BAC117_K15,8,8q12.1,56606370,56713328,106958,-,-
BAC35_C01,8,8q12.1,56608628,56692141,83513,-,-
BAC160_M20,8,8q12.1,56619056,56741270,122214,-,-
BAC218_P05,8,8q12.1,56641009,56706212,65203,-,-
BAC73_A01,8,8q12.1,56691617,56815441,123824,-,-
BAC83_P19,8,8q12.1,56692219,56787878,95659,-,-
BAC120_C05,8,8q12.1,56697738,56815441,117703,-,-
BAC60_K05,8,8q12.1,56741284,56840185,98901,-,-
BAC38_L18,8,8q12.1,56762266,56871255,108989,-,-
BAC56_H22,8,8q12.1,56815314,56901331,86017,-,-
BAC41_E13,8,8q12.1,56858218,56942267,84049,-,-
BAC177_N07,8,8q12.1,56899365,56999941,100576,-,-
BAC41_J14,8,8q12.1,56899365,56999923,100558,-,-
BAC252_N17,8,8q12.1,56943526,57043362,99836,-,-
BAC197_B12,8,8q12.1,56956573,57046849,90276,-,-
BAC106_L05,8,8q12.1,56956577,57051041,94464,-,-
BAC109_F06,8,8q12.1,56963868,57061689,97821,-,-
BAC203_J03,8,8q12.1,57104693,57204089,99396,-,-
BAC218_H13,8,8q12.1,57110701,57218233,107532,-,-
BAC156_I24,8,8q12.1,57135688,57218235,82547,-,-
BAC204_E16,8,8q12.1,57139779,57236794,97015,-,-
BAC230_H22,8,8q12.1,57141230,57223610,82380,-,-
BAC139_N24,8,8q12.1,57165087,57236987,71900,-,-
BAC86_K11,8,8q12.1,57187083,57270272,83189,-,-
BAC162_M12,8,8q12.1,57242456,57317810,75354,-,-
BAC158_I22,8,8q12.1,57348987,57456381,107394,-,-
BAC168_I24,8,8q12.1,57362841,57489871,127030,-,-
BAC248_M10,8,8q12.1,57388926,57490820,101894,-,-
BAC22_C03,8,8q12.1,57489869,57630906,141037,-,-
BAC78_O02,8,8q12.1,57505673,57651505,145832,-,-
BAC32_G06,8,8q12.1,57518384,57650338,131954,-,-
BAC232_A04,8,8q12.1,57529732,57623567,93835,-,-
BAC141_B04,8,8q12.1,57552085,57667805,115720,-,-
BAC144_P11,8,8q12.1,57558039,57650334,92295,-,-
BAC36_B12,8,8q12.1,57667800,57786322,118522,-,-
BAC97_M21,8,8q12.1,57689321,57761845,72524,-,-
BAC185_M09,8,8q12.1,57699967,57786328,86361,-,-
BAC176_I04,8,8q12.1,57786323,57871219,84896,-,-
BAC120_K03,8,8q12.1,57824960,57856397,31437,-,-
BAC56_G19,8,8q12.1,57843831,57949902,106071,-,-
BAC252_C11,8,8q12.1,57856392,57949902,93510,-,-
BAC17_N22,8,8q12.1,57873435,57969905,96470,-,-
BAC84_H03,8,8q12.1,57903467,58020606,117139,-,-
BAC147_B05,8,8q12.1,57950167,58032190,82023,-,-
BAC184_F06,8,8q12.1,58041501,58144694,103193,-,-
BAC181_F17,8,8q12.1,58046401,58123447,77046,-,-
BAC249_G02,8,8q12.1,58182642,58264951,82309,-,-
BAC90_P12,8,8q12.1,58209198,58290686,81488,-,-
BAC59_I07,8,8q12.1,58276279,58331232,54953,-,-
BAC150_O06,8,8q12.1,58280927,58376567,95640,-,-
BAC178_K07,8,8q12.1,58382185,58463382,81197,-,-
BAC91_A14,8,8q12.1,58492221,58572053,79832,-,-
BAC152_G16,8,8q12.1,58530544,58626304,95760,-,-
BAC148_O16,8,8q12.1,58721491,58827914,106423,-,-
BAC30_P15,8,8q12.1,58765226,58881512,116286,-,-
BAC59_J08,8,8q12.1,58829801,58956979,127178,-,-
BAC76_E18,8,8q12.1,58879181,58970047,90866,-,-
BAC115_A10,8,8q12.1,58941575,59030739,89164,-,-
BAC169_O12,8,8q12.1,58990388,59112411,122023,-,-
BAC36_D24,8,8q12.1,59034684,59146813,112129,-,-
BAC86_L16,8,8q12.1,59146844,59242864,96020,-,-
BAC179_B06,8,8q12.1,59148898,59248058,99160,-,-
BAC103_C01,8,8q12.1,59344569,59436290,91721,-,-
BAC179_I19,8,8q12.1,59397396,59496798,99402,-,-
BAC183_F18,8,8q12.1,59478323,59552872,74549,-,-
BAC184_B15,8,8q12.1,59495274,59575647,80373,-,-
BAC104_P03,8,8q12.1,59497216,59615414,118198,-,-
BAC44_N14,8,8q12.1,59497995,59619882,121887,-,-
BAC105_J04,8,8q12.1,59504514,59590023,85509,-,-
BAC197_E21,8,8q12.1,59516531,59594065,77534,-,-
BAC34_P13,8,8q12.1,59546512,59643333,96821,-,-
BAC58_M04,8,8q12.1,59575641,59693928,118287,-,-
BAC121_O23,8,8q12.1,59575682,59674563,98881,-,-
BAC223_N17,8,8q12.1,59615476,59694492,79016,-,-
BAC121_H08,8,8q12.1,59615606,59703934,88328,-,-
BAC227_H07,8,8q12.1,59646049,59703934,57885,-,-
BAC101_L20,8,8q12.1,59820115,59928580,108465,-,-
BAC135_A02,8,8q12.1,59979846,60099183,119337,-,-
BAC249_F14,8,8q12.1,59979876,60137896,158020,-,-
BAC30_N24,8,8q12.1,60026605,60149114,122509,-,-
BAC70_H15,8,8q12.1,60116233,60231183,114950,-,-
BAC115_A08,8,8q12.1,60141945,60268572,126627,-,-
BAC91_I11,8,8q12.1,60162110,60261227,99117,-,-
BAC37_K22,8,8q12.1,60185320,60306508,121188,-,-
BAC157_P07,8,8q12.1,60449904,60552523,102619,-,-
BAC154_B08,8,8q12.1,60476014,60581494,105480,-,-
BAC80_C06,8,8q12.1,60484122,60587597,103475,-,-
BAC92_F03,8,8q12.1,60597856,60712660,114804,-,-
BAC238_L17,8,8q12.1,60634897,60709539,74642,-,-
BAC128_O10,8,8q12.1,60639798,60731900,92102,-,-
BAC31_P11,8,8q12.1,60802772,60887252,84480,-,-
BAC163_E22,8,8q12.1,60854541,60943071,88530,-,-
BAC55_B05,8,8q12.1,60923187,61080840,157653,-,-
BAC119_L18,8,8q12.1,61117079,61218462,101383,-,-
BAC244_I06,8,8q12.1,61204755,61301780,97025,-,-
BAC44_C15,8,8q12.1,61218607,61301624,83017,-,-
BAC250_I03,8,8q12.1,61227417,61310654,83237,-,-
BAC129_M06,8,8q12.1,61309915,61412804,102889,-,-
BAC75_P02,8,8q12.1,61378611,61472002,93391,-,-
BAC78_D13,8,8q12.1,61430446,61548534,118088,-,-
BAC32_L07,8,8q12.1,61445615,61549580,103965,-,-
BAC166_F02,8,8q12.1,61503562,61616014,112452,-,-
BAC32_N10,8,8q12.1,61537519,61652735,115216,-,-
BAC144_C03,8,8q12.1,61559057,61652738,93681,-,-
BAC91_C16,8,8q12.1,61560124,61652739,92615,-,-
BAC231_H21,8,8q12.1,61569290,61652739,83449,-,-
BAC161_J03,8,8q12.1,61594070,61694348,100278,-,-
BAC25_J11,8,8q12.1,61616098,61694251,78153,-,-
BAC237_M22,8,8q12.2,61781312,61859789,78477,-,-
BAC8_O11,8,8q12.2,61864496,61956957,92461,-,-
BAC237_K10,8,8q12.2,61972339,62094940,122601,-,-
BAC160_C07,8,8q12.2,62000088,62078577,78489,-,-
BAC198_L08,8,8q12.2,62094934,62255746,160812,-,-
BAC129_P05,8,8q12.2,62179043,62277916,98873,-,-
BAC185_N16,8,8q12.2,62229648,62310658,81010,-,-
BAC186_F24,8,8q12.3,62453188,62552284,99096,-,-
BAC222_A19,8,8q12.3,62495097,62590617,95520,-,-
BAC197_C08,8,8q12.3,62499607,62583073,83466,-,-
BAC76_A02,8,8q12.3,62557788,62653892,96104,-,-
BAC180_N14,8,8q12.3,62569620,62668581,98961,-,-
BAC159_M12,8,8q12.3,62578497,62672594,94097,-,-
BAC22_O12,8,8q12.3,62590644,62704666,114022,-,-
BAC96_H02,8,8q12.3,62598637,62714023,115386,-,-
BAC233_J23,8,8q12.3,62731494,62825403,93909,-,-
BAC53_K17,8,8q12.3,62824501,62908590,84089,-,-
BAC196_N13,8,8q12.3,62851461,62957966,106505,-,-
BAC124_J12,8,8q12.3,62974787,63078976,104189,-,-
BAC235_A18,8,8q12.3,63024371,63114711,90340,-,-
BAC67_G14,8,8q12.3,63145790,63259493,113703,-,-
BAC22_I10,8,8q12.3,63205287,63325171,119884,-,-
BAC95_L04,8,8q12.3,63344704,63475007,130303,-,-
BAC250_L15,8,8q12.3,63371664,63449749,78085,-,-
BAC89_C14,8,8q12.3,63488788,63603913,115125,-,-
BAC76_D10,8,8q12.3,63488788,63603917,115129,-,-
BAC240_K03,8,8q12.3,63529542,63618166,88624,-,-
BAC173_A04,8,8q12.3,63618204,63730590,112386,-,-
BAC1_A14,8,8q12.3,63703358,63854377,151019,-,-
BAC192_I19,8,8q12.3,63763414,63843787,80373,-,-
BAC84_G06,8,8q12.3,63831858,63934533,102675,-,-
BAC86_A24,8,8q12.3,63899875,64010969,111094,-,-
BAC176_L22,8,8q12.3,63904425,63972459,68034,-,-
BAC73_E19,8,8q12.3,63904441,64009296,104855,-,-
BAC176_H11,8,8q12.3,63941052,64031062,90010,-,-
BAC169_N22,8,8q12.3,64004878,64079226,74348,-,-
BAC109_B16,8,8q12.3,64009505,64091571,82066,-,-
BAC208_F14,8,8q12.3,64009505,64093994,84489,-,-
BAC110_N09,8,8q12.3,64010208,64124177,113969,-,-
BAC27_I10,8,8q12.3,64050143,64148599,98456,-,-
BAC120_A05,8,8q12.3,64079536,64164592,85056,-,-
BAC104_O21,8,8q12.3,64153680,64237770,84090,-,-
BAC105_D06,8,8q12.3,64202025,64357738,155713,-,-
BAC62_J04,8,8q12.3,64237762,64354668,116906,-,-
BAC217_K07,8,8q12.3,64238044,64332288,94244,-,-
BAC40_P17,8,8q12.3,64319494,64410710,91216,-,-
BAC91_G06,8,8q12.3,64351435,64447434,95999,-,-
BAC217_K05,8,8q12.3,64357985,64454116,96131,-,-
BAC25_N10,8,8q12.3,64506976,64594509,87533,-,-
BAC91_E08,8,8q12.3,64602551,64725484,122933,-,-
BAC13_N06,8,8q12.3,64606925,64733496,126571,-,-
BAC243_J17,8,8q12.3,64621007,64723331,102324,-,-
BAC97_A01,8,8q12.3,64631467,64723321,91854,-,-
BAC58_B18,8,8q12.3,64674502,64787840,113338,-,-
BAC43_N01,8,8q12.3,64697851,64838733,140882,-,-
BAC199_N08,8,8q12.3,64780530,64851668,71138,-,-
BAC149_P16,8,8q12.3,64820781,64903170,82389,-,-
BAC22_C04,8,8q12.3,65039478,65159887,120409,-,-
BAC200_K06,8,8q12.3,65087480,65170063,82583,-,-
BAC152_D06,8,8q12.3,65152785,65251076,98291,-,-
BAC194_O11,8,8q12.3,65223074,65314658,91584,-,-
BAC157_N02,8,8q12.3,65573303,65617065,43762,-,-
BAC73_J02,8,8q12.3,65612962,65703632,90670,-,-
BAC170_C16,8,8q12.3,65715279,65788350,73071,-,-
BAC25_M08,8,8q12.3,65725309,65870716,145407,-,-
BAC75_O07,8,8q12.3,65928640,66051095,122455,-,-
BAC117_G08,8,8q13.1,66163615,66233263,69648,-,-
BAC146_M14,8,8q13.1,66164773,66272918,108145,-,-
BAC181_D22,8,8q13.1,66165891,66247350,81459,-,-
BAC55_H05,8,8q13.1,66240931,66366692,125761,-,-
BAC219_G13,8,8q13.1,66247345,66326127,78782,-,-
BAC10_E16,8,8q13.1,66381652,66495765,114113,-,-
BAC200_C24,8,8q13.1,66383961,66526781,142820,-,-
BAC2_I19,8,8q13.1,66410901,66495770,84869,-,-
BAC218_J19,8,8q13.1,66410901,66536462,125561,-,-
BAC101_E05,8,8q13.1,66410903,66495770,84867,-,-
BAC149_G16,8,8q13.1,66414434,66495770,81336,-,-
BAC195_P08,8,8q13.1,66420725,66526781,106056,-,-
BAC64_N08,8,8q13.1,66451555,66580808,129253,-,-
BAC96_E01,8,8q13.1,66580920,66688748,107828,-,-
BAC175_P22,8,8q13.1,66658813,66743894,85081,-,-
BAC139_E08,8,8q13.1,66666653,66749402,82749,-,-
BAC40_K03,8,8q13.1,66671530,66842398,170868,-,-
BAC84_K20,8,8q13.1,66686583,66775512,88929,-,-
BAC80_P18,8,8q13.1,66708003,66867630,159627,-,-
BAC198_K19,8,8q13.1,66742630,66866555,123925,-,-
BAC133_K08,8,8q13.1,66747885,66866555,118670,-,-
BAC63_H21,8,8q13.1,66754663,66855809,101146,-,-
BAC49_L11,8,8q13.1,66974284,67079001,104717,-,-
BAC85_J13,8,8q13.1,67042063,67140723,98660,-,-
BAC122_M22,8,8q13.1,67238186,67345680,107494,-,-
BAC219_P06,8,8q13.1,67339048,67454060,115012,-,-
BAC235_L24,8,8q13.1,67339090,67417108,78018,-,-
BAC126_O13,8,8q13.1,67345326,67456601,111275,-,-
BAC63_D23,8,8q13.1,67362092,67444654,82562,-,-
BAC84_F13,8,8q13.1,67383122,67543076,159954,-,-
BAC125_C01,8,8q13.1,67426809,67541342,114533,-,-
BAC92_F07,8,8q13.1,67456593,67542303,85710,-,-
BAC166_E11,8,8q13.1,67516818,67603840,87022,-,-
BAC126_O03,8,8q13.1,67538513,67667053,128540,-,-
BAC237_J01,8,8q13.1,67541418,67625848,84430,-,-
BAC246_L07,8,8q13.1,67542315,67625846,83531,-,-
BAC222_D24,8,8q13.1,67641600,67745731,104131,-,-
BAC10_N09,8,8q13.1,67651384,67746611,95227,-,-
BAC220_N13,8,8q13.1,67651769,67738325,86556,-,-
BAC180_B11,8,8q13.1,67730142,67810267,80125,-,-
BAC43_C13,8,8q13.1,67745764,67851645,105881,-,-
BAC35_A10,8,8q13.1,67745972,67871385,125413,-,-
BAC60_M18,8,8q13.1,67746608,67851648,105040,-,-
BAC1_D11,8,8q13.1,67746611,67828183,81572,-,-
BAC237_P22,8,8q13.1,67764598,67855739,91141,-,-
BAC184_B14,8,8q13.1,67928327,68012510,84183,-,-
BAC152_C22,8,8q13.1,67942534,68034052,91518,-,-
BAC83_G10,8,8q13.1,67945601,68039080,93479,-,-
BAC238_D21,8,8q13.1,67961922,68059949,98027,-,-
BAC192_E05,8,8q13.1-8q13.2,67978676,68102448,123772,-,-
BAC91_G03,8,8q13.1,67992873,68091957,99084,-,-
BAC139_I13,8,8q13.1-8q13.2,68026250,68135239,108989,-,-
BAC21_A15,8,8q13.1,68042194,68076910,34716,-,-
BAC23_B03,8,8q13.1-8q13.2,68059974,68200401,140427,-,-
BAC128_L06,8,8q13.2,68102783,68175850,73067,-,-
BAC210_A09,8,8q13.2,68125571,68223480,97909,-,-
BAC33_B05,8,8q13.2,68150970,68238467,87497,-,-
BAC34_I23,8,8q13.2,68238464,68332274,93810,-,-
BAC29_E16,8,8q13.2,68249158,68343080,93922,-,-
BAC180_M09,8,8q13.2,68343074,68444177,101103,-,-
BAC110_F01,8,8q13.2,68367755,68485482,117727,-,-
BAC247_D12,8,8q13.2,68380894,68463555,82661,-,-
BAC161_P05,8,8q13.2,68449109,68547765,98656,-,-
BAC55_M23,8,8q13.2,68449822,68553808,103986,-,-
BAC217_M06,8,8q13.2,68485475,68570897,85422,-,-
BAC102_D11,8,8q13.2,68485478,68621041,135563,-,-
BAC244_M23,8,8q13.2,68489484,68620968,131484,-,-
BAC226_D20,8,8q13.2,68608873,68691290,82417,-,-
BAC189_I18,8,8q13.2,68608873,68703001,94128,-,-
BAC193_G06,8,8q13.2,68628148,68739702,111554,-,-
BAC86_B23,8,8q13.2,68652222,68756715,104493,-,-
BAC151_D10,8,8q13.2,68742327,68839842,97515,-,-
BAC120_M17,8,8q13.2,68811117,68923291,112174,-,-
BAC123_I16,8,8q13.2,68909726,69006364,96638,-,-
BAC1_G20,8,8q13.2,69132765,69214905,82140,-,-
BAC157_C10,8,8q13.2,69170440,69244927,74487,-,-
BAC188_L19,8,8q13.2,69330752,69417746,86994,-,-
BAC160_N05,8,8q13.2,69368163,69438438,70275,-,-
BAC39_E22,8,8q13.2,69369291,69516747,147456,-,-
BAC50_F01,8,8q13.2,69455939,69566273,110334,-,-
BAC163_I06,8,8q13.2,69506408,69584921,78513,-,-
BAC200_F07,8,8q13.2,69646422,69732181,85759,-,-
BAC65_H05,8,8q13.2,69656473,69781823,125350,-,-
BAC183_A14,8,8q13.2,69679044,69786880,107836,-,-
BAC199_K04,8,8q13.2,69714439,69825148,110709,-,-
BAC128_A06,8,8q13.2,69860502,69942834,82332,-,-
BAC24_B20,8,8q13.2,70027729,70142534,114805,-,-
BAC92_O08,8,8q13.2,70127472,70223121,95649,-,-
BAC101_O23,8,8q13.2,70148513,70241854,93341,-,-
BAC39_B04,8,8q13.2,70261816,70366786,104970,-,-
BAC107_B17,8,8q13.2,70332662,70409833,77171,-,-
BAC224_P18,8,8q13.2,70353284,70452572,99288,-,-
BAC113_F02,8,8q13.2,70430439,70510303,79864,-,-
BAC133_K03,8,8q13.2-8q13.3,70510616,70609534,98918,-,-
BAC36_H08,8,8q13.2-8q13.3,70526988,70601255,74267,-,-
BAC224_A17,8,8q13.2-8q13.3,70529427,70621261,91834,-,-
BAC32_H08,8,8q13.2-8q13.3,70556361,70684654,128293,-,-
BAC88_L06,8,8q13.2-8q13.3,70569691,70665569,95878,-,-
BAC43_J01,8,8q13.2-8q13.3,70570126,70680171,110045,-,-
BAC8_B03,8,8q13.3,70665915,70784317,118402,-,-
BAC42_M11,8,8q13.3,70684752,70849436,164684,-,-
BAC82_D16,8,8q13.3,70802063,70928441,126378,-,-
BAC241_D01,8,8q13.3,70821643,70921857,100214,-,-
BAC149_O14,8,8q13.3,70849430,70939405,89975,-,-
BAC8_C02,8,8q13.3,70862551,70994632,132081,-,-
BAC186_C22,8,8q13.3,70874007,70962452,88445,-,-
BAC73_H10,8,8q13.3,70919492,71033575,114083,-,-
BAC31_O13,8,8q13.3,70943722,71027759,84037,-,-
BAC86_K21,8,8q13.3,70943724,71115913,172189,-,-
BAC131_K13,8,8q13.3,71043688,71146563,102875,-,-
BAC117_L22,8,8q13.3,71078708,71199149,120441,-,-
BAC223_M15,8,8q13.3,71113329,71218790,105461,-,-
BAC198_N09,8,8q13.3,71116202,71240451,124249,-,-
BAC153_D13,8,8q13.3,71134453,71231621,97168,-,-
BAC17_D07,8,8q13.3,71146564,71244544,97980,-,-
BAC176_O08,8,8q13.3,71270295,71356566,86271,-,-
BAC173_K11,8,8q13.3,71295568,71395844,100276,-,-
BAC226_C16,8,8q13.3,71314966,71400652,85686,-,-
BAC59_B02,8,8q13.3,71395900,71496885,100985,-,-
BAC74_D06,8,8q13.3,71430384,71528257,97873,-,-
BAC106_J14,8,8q13.3,71475919,71541793,65874,-,-
BAC31_N10,8,8q13.3,71569691,71672062,102371,-,-
BAC202_E18,8,8q13.3,71569692,71677547,107855,-,-
BAC55_K22,8,8q13.3,71569694,71673177,103483,-,-
BAC72_E13,8,8q13.3,71708213,71780952,72739,-,-
BAC165_C14,8,8q13.3,71740486,71828348,87862,-,-
BAC156_F14,8,8q13.3,71886870,71972795,85925,-,-
BAC146_D10,8,8q13.3,71986302,72066864,80562,-,-
BAC139_G03,8,8q13.3,71986316,72077447,91131,-,-
BAC92_M16,8,8q13.3,72061687,72167754,106067,-,-
BAC247_P04,8,8q13.3,72081013,72167754,86741,-,-
BAC165_I19,8,8q13.3,72142919,72236326,93407,-,-
BAC65_A08,8,8q13.3,72165098,72289673,124575,-,-
BAC1_D18,8,8q13.3,72277885,72376349,98464,-,-
BAC80_K15,8,8q13.3,72410978,72524506,113528,-,-
BAC120_P11,8,8q13.3,72528031,72638797,110766,-,-
BAC129_H03,8,8q13.3,72535244,72658298,123054,-,-
BAC96_J20,8,8q13.3,72618227,72715396,97169,-,-
BAC241_O05,8,8q13.3,72914447,72992201,77754,-,-
BAC240_H01,8,8q13.3,72915156,73003659,88503,-,-
BAC133_E17,8,8q13.3,73013994,73097993,83999,-,-
BAC180_K07,8,8q13.3,73039612,73125291,85679,-,-
BAC70_B04,8,8q13.3,73040736,73177430,136694,-,-
BAC18_E22,8,8q13.3,73170268,73255247,84979,-,-
BAC21_P22,8,8q13.3,73186689,73281674,94985,-,-
BAC250_P15,8,8q13.3,73199907,73215660,15753,-,-
BAC197_M08,8,8q13.3,73200404,73326130,125726,-,-
BAC66_C07,8,8q13.3,73214101,73335160,121059,-,-
BAC26_J12,8,8q13.3,73391993,73503418,111425,-,-
BAC134_D12,8,8q13.3,73427316,73548660,121344,-,-
BAC117_L06,8,8q13.3,73459572,73565051,105479,-,-
BAC105_G02,8,8q13.3,73503605,73607159,103554,-,-
BAC35_F18,8,8q13.3,73503605,73606895,103290,-,-
BAC224_M19,8,8q13.3,73679717,73756950,77233,-,-
BAC48_K10,8,8q13.3,73686211,73823138,136927,-,-
BAC25_F12,8,8q13.3,73696344,73779729,83385,-,-
BAC63_D09,8,8q13.3,73710014,73831837,121823,-,-
BAC160_K01,8,8q13.3,73840901,73930293,89392,-,-
BAC146_J20,8,8q13.3,73859102,73947328,88226,-,-
BAC36_O14,8,8q13.3,73876646,73980943,104297,-,-
BAC2_G14,8,8q21.11,74042137,74131341,89204,-,-
BAC115_I05,8,8q21.11,74077128,74166484,89356,-,-
BAC39_M03,8,8q21.11,74140159,74240456,100297,-,-
BAC89_A08,8,8q21.11,74149953,74257268,107315,-,-
BAC175_G12,8,8q21.11,74166509,74249809,83300,-,-
BAC142_D10,8,8q21.11,74170153,74257971,87818,-,-
BAC200_D10,8,8q21.11,74186002,74263550,77548,-,-
BAC33_P22,8,8q21.11,74255863,74350928,95065,-,-
BAC78_K09,8,8q21.11,74259102,74373276,114174,-,-
BAC50_A06,8,8q21.11,74259119,74360854,101735,-,-
BAC89_M11,8,8q21.11,74373335,74461360,88025,-,-
BAC155_N02,8,8q21.11,74384883,74507236,122353,-,-
BAC130_N05,8,8q21.11,74422247,74548920,126673,-,-
BAC191_I02,8,8q21.11,74422528,74507237,84709,-,-
BAC71_B06,8,8q21.11,74440019,74545423,105404,-,-
BAC81_M22,8,8q21.11,74470214,74583912,113698,-,-
BAC177_N09,8,8q21.11,74497767,74580475,82708,-,-
BAC60_L14,8,8q21.11,74629801,74748377,118576,-,-
BAC189_I19,8,8q21.11,74666944,74748371,81427,-,-
BAC73_N02,8,8q21.11,74676671,74724199,47528,-,-
BAC66_N02,8,8q21.11,74680214,74766889,86675,-,-
BAC195_E18,8,8q21.11,74767001,74845227,78226,-,-
BAC76_A10,8,8q21.11,74767001,74861444,94443,-,-
BAC162_A07,8,8q21.11,74793060,74892294,99234,-,-
BAC101_D09,8,8q21.11,74793060,74891351,98291,-,-
BAC41_N06,8,8q21.11,74793064,74908994,115930,-,-
BAC153_C02,8,8q21.11,74985337,75092054,106717,-,-
BAC67_M09,8,8q21.11,75037504,75205736,168232,-,-
BAC10_C21,8,8q21.11,75072852,75217499,144647,-,-
BAC250_A05,8,8q21.11,75090640,75170999,80359,-,-
BAC249_I08,8,8q21.11,75205753,75292201,86448,-,-
BAC62_B14,8,8q21.11,75207852,75292096,84244,-,-
BAC203_O14,8,8q21.11,75372863,75492975,120112,-,-
BAC2_I12,8,8q21.11,75534304,75623647,89343,-,-
BAC88_F03,8,8q21.11,75623641,75712204,88563,-,-
BAC1_E22,8,8q21.11,75791141,75943081,151940,-,-
BAC53_N15,8,8q21.11,75824861,75920588,95727,-,-
BAC144_K09,8,8q21.11,75992131,76087301,95170,-,-
BAC154_N10,8,8q21.11,76087291,76159875,72584,-,-
BAC19_C10,8,8q21.11,76121953,76251859,129906,-,-
BAC36_H12,8,8q21.11,76159889,76245837,85948,-,-
BAC118_E04,8,8q21.11,76176271,76255087,78816,-,-
BAC179_D14,8,8q21.11,76316344,76427913,111569,-,-
BAC96_E02,8,8q21.11,76398444,76509236,110792,-,-
BAC123_L13,8,8q21.11,76402652,76520864,118212,-,-
BAC53_K08,8,8q21.11,76418032,76571259,153227,-,-
BAC219_D22,8,8q21.11,76447794,76558439,110645,-,-
BAC26_J15,8,8q21.11,76500930,76582415,81485,-,-
BAC226_I06,8,8q21.11,76533253,76621132,87879,-,-
BAC102_H15,8,8q21.11,76558479,76644687,86208,-,-
BAC56_D11,8,8q21.11,76582746,76679146,96400,-,-
BAC19_L08,8,8q21.11,76734683,76827160,92477,-,-
BAC192_B08,8,8q21.11,76752408,76827160,74752,-,-
BAC63_J09,8,8q21.11,76757473,76851233,93760,-,-
BAC43_M23,8,8q21.11,76799405,76884295,84890,-,-
BAC91_E05,8,8q21.11,76885149,76991481,106332,-,-
BAC108_P05,8,8q21.11,77337120,77445545,108425,-,-
BAC234_C20,8,8q21.11,77768560,77851278,82718,-,-
BAC234_M17,8,8q21.11,77830466,77927688,97222,-,-
BAC134_D21,8,8q21.11,78026871,78137696,110825,-,-
BAC146_P17,8,8q21.11,78176987,78246713,69726,-,-
BAC22_B08,8,8q21.11-8q21.12,78429069,78539009,109940,-,-
BAC181_M11,8,8q21.12,78612024,78633495,21471,-,-
BAC237_I05,8,8q21.12,78714511,78815055,100544,-,-
BAC184_I21,8,8q21.12,78736241,78821656,85415,-,-
BAC238_F06,8,8q21.12,78748254,78838253,89999,-,-
BAC17_N13,8,8q21.12,78822723,78945333,122610,-,-
BAC132_I18,8,8q21.12,78857740,78978832,121092,-,-
BAC162_E05,8,8q21.12,78871924,78978832,106908,-,-
BAC150_P10,8,8q21.12,78958990,79028867,69877,-,-
BAC252_I04,8,8q21.12,79053326,79181244,127918,-,-
BAC234_D23,8,8q21.12,79330810,79465264,134454,-,-
BAC12_P19,8,8q21.12,79446363,79520430,74067,-,-
BAC42_G05,8,8q21.12,79475971,79564821,88850,-,-
BAC230_H05,8,8q21.12,79540875,79637367,96492,-,-
BAC249_M03,8,8q21.12,79637361,79722131,84770,-,-
BAC59_E20,8,8q21.12,79676263,79776178,99915,-,-
BAC13_B08,8,8q21.12,79679823,79776178,96355,-,-
BAC217_O23,8,8q21.12,79843613,79919381,75768,-,-
BAC84_A13,8,8q21.12,79983548,80061465,77917,-,-
BAC83_D06,8,8q21.13,80376786,80472118,95332,-,-
BAC82_O07,8,8q21.13,80498317,80581473,83156,-,-
BAC20_D16,8,8q21.13,80510236,80625158,114922,-,-
BAC166_P10,8,8q21.13,80531817,80655406,123589,-,-
BAC170_N23,8,8q21.13,80562327,80644049,81722,-,-
BAC1_P15,8,8q21.13,80626308,80691752,65444,-,-
BAC82_B18,8,8q21.13,80650117,80769888,119771,-,-
BAC39_O20,8,8q21.13,80722489,80827702,105213,-,-
BAC200_E06,8,8q21.13,80796181,80871779,75598,-,-
BAC144_D19,8,8q21.13,81037091,81121332,84241,-,-
BAC10_J14,8,8q21.13,81076464,81184228,107764,-,-
BAC76_C15,8,8q21.13,81076851,81194474,117623,-,-
BAC226_J07,8,8q21.13,81091216,81184231,93015,-,-
BAC166_P22,8,8q21.13,81092147,81184948,92801,-,-
BAC247_D21,8,8q21.13,81142375,81221860,79485,-,-
BAC152_I16,8,8q21.13,81176420,81283771,107351,-,-
BAC43_M21,8,8q21.13,81184226,81309908,125682,-,-
BAC223_G07,8,8q21.13,81221873,81302998,81125,-,-
BAC97_G02,8,8q21.13,81232427,81357876,125449,-,-
BAC154_K03,8,8q21.13,81290383,81387020,96637,-,-
BAC105_E18,8,8q21.13,81295886,81400025,104139,-,-
BAC86_O18,8,8q21.13,81303074,81440469,137395,-,-
BAC61_C14,8,8q21.13,81303075,81407864,104789,-,-
BAC107_D17,8,8q21.13,81303087,81408969,105882,-,-
BAC148_N22,8,8q21.13,81309984,81400027,90043,-,-
BAC22_O22,8,8q21.13,81325596,81441453,115857,-,-
BAC145_P10,8,8q21.13,81336546,81440469,103923,-,-
BAC90_A18,8,8q21.13,81336746,81451533,114787,-,-
BAC150_N14,8,8q21.13,81409583,81493743,84160,-,-
BAC178_P02,8,8q21.13,81450902,81559482,108580,-,-
BAC43_J17,8,8q21.13,81458847,81567619,108772,-,-
BAC235_O03,8,8q21.13,81464182,81558337,94155,-,-
BAC140_K14,8,8q21.13,81467488,81559533,92045,-,-
BAC156_I04,8,8q21.13,81489203,81567619,78416,-,-
BAC73_H11,8,8q21.13,81567633,81650260,82627,-,-
BAC20_E22,8,8q21.13,81601165,81708643,107478,-,-
BAC182_O11,8,8q21.13,81735775,81842870,107095,-,-
BAC42_P24,8,8q21.13,81795591,81914629,119038,-,-
BAC62_K13,8,8q21.13,81834118,81955578,121460,-,-
BAC115_H16,8,8q21.13,81842892,81942740,99848,-,-
BAC42_C16,8,8q21.13,81891880,82006480,114600,-,-
BAC100_P21,8,8q21.13,81955728,82098291,142563,-,-
BAC141_G14,8,8q21.13,82086635,82175200,88565,-,-
BAC119_B19,8,8q21.13,82184056,82282803,98747,-,-
BAC234_G16,8,8q21.13,82279868,82390895,111027,-,-
BAC84_J15,8,8q21.13,82311313,82422123,110810,-,-
BAC162_B02,8,8q21.13,82352876,82431896,79020,-,-
BAC21_I14,8,8q21.13,82360018,82472196,112178,-,-
BAC200_M16,8,8q21.13,82429570,82512632,83062,-,-
BAC57_O15,8,8q21.13,82472200,82576368,104168,-,-
BAC163_I14,8,8q21.13,82484224,82569851,85627,-,-
BAC27_C16,8,8q21.13,82552220,82636090,83870,-,-
BAC182_E07,8,8q21.13,82709834,82793263,83429,-,-
BAC40_C01,8,8q21.13,82735784,82816685,80901,-,-
BAC109_P16,8,8q21.13,82764058,82846661,82603,-,-
BAC110_K11,8,8q21.13,82859217,82958125,98908,-,-
BAC74_E10,8,8q21.13,83142363,83245720,103357,-,-
BAC14_I17,8,8q21.13,83266499,83374801,108302,-,-
BAC29_I12,8,8q21.13,83393530,83492039,98509,-,-
BAC39_P18,8,8q21.13,83415538,83530419,114881,-,-
BAC169_E06,8,8q21.13,83511393,83596502,85109,-,-
BAC228_N03,8,8q21.13,83515811,83584784,68973,-,-
BAC42_E14,8,8q21.13,83578926,83692633,113707,-,-
BAC122_L06,8,8q21.13,83633716,83786938,153222,-,-
BAC126_A02,8,8q21.13,83634053,83786938,152885,-,-
BAC110_O04,8,8q21.13,83898159,84000755,102596,-,-
BAC160_N17,8,8q21.13,84083204,84185558,102354,-,-
BAC43_G18,8,8q21.13,84084255,84173182,88927,-,-
BAC68_B15,8,8q21.13,84139244,84236715,97471,-,-
BAC5_P08,8,8q21.13,84211060,84342173,131113,-,-
BAC44_O09,8,8q21.13,84220081,84295941,75860,-,-
BAC26_H04,8,8q21.13,84319857,84418147,98290,-,-
BAC189_N10,8,8q21.13,84545303,84650192,104889,-,-
BAC71_I03,8,8q21.13,84685285,84773992,88707,-,-
BAC43_J15,8,8q21.13,84767578,84884078,116500,-,-
BAC203_J12,8,8q21.13,84767687,84850216,82529,-,-
BAC63_J01,8,8q21.13-8q21.2,84842763,84942894,100131,-,-
BAC153_E03,8,8q21.2,84970025,85064808,94783,-,-
BAC146_K13,8,8q21.2,84981636,85067154,85518,-,-
BAC84_K01,8,8q21.2,85047774,85141851,94077,-,-
BAC102_I01,8,8q21.2,85111990,85195834,83844,-,-
BAC133_A06,8,8q21.2,85117260,85197088,79828,-,-
BAC224_K05,8,8q21.2,85517484,85585598,68114,-,-
BAC155_E06,8,8q21.2,85751174,85847166,95992,-,-
BAC237_E01,8,8q21.2,85847160,85939403,92243,-,-
BAC76_I01,8,8q21.2,86309634,86408157,98523,-,-
BAC147_G11,8,8q21.2,86438615,86513806,75191,-,-
BAC53_P21,8,8q21.2,86484887,86598375,113488,yes,-
BAC96_N22,8,8q21.2,86522586,86615498,92912,yes,-
BAC227_B03,8,8q21.2,86553663,86655664,102001,yes,-
BAC115_H18,8,8q21.2,86615492,86744701,129209,-,-
BAC151_H03,8,8q21.2,86628143,86757376,129233,-,-
BAC149_L19,8,8q21.2,86690671,86756913,66242,-,-
BAC107_H14,8,8q21.2,86691606,86863166,171560,-,-
BAC107_N05,8,8q21.2,86756907,86875390,118483,-,-
BAC161_H08,8,8q21.2,86756950,86862736,105786,-,-
BAC154_I06,8,8q21.2,86971478,87057473,85995,-,-
BAC52_C18,8,8q21.2,87055819,87149482,93663,-,-
BAC96_P19,8,8q21.2,87078835,87190386,111551,-,-
BAC185_E01,8,8q21.2-8q21.3,87130610,87216915,86305,-,-
BAC63_A15,8,8q21.3,87302683,87386854,84171,-,-
BAC224_A06,8,8q21.3,87306794,87402829,96035,-,-
BAC29_E21,8,8q21.3,87323005,87429127,106122,-,-
BAC149_G18,8,8q21.3,87351626,87451533,99907,-,-
BAC165_I09,8,8q21.3,87402821,87484112,81291,-,-
BAC11_A08,8,8q21.3,87441914,87541160,99246,-,-
BAC33_K14,8,8q21.3,87499274,87616498,117224,-,-
BAC65_E15,8,8q21.3,87525359,87616372,91013,-,-
BAC181_A05,8,8q21.3,87532608,87622263,89655,-,-
BAC70_O02,8,8q21.3,87541169,87667139,125970,-,-
BAC81_C13,8,8q21.3,87569035,87666570,97535,-,-
BAC43_L20,8,8q21.3,87575946,87692360,116414,-,-
BAC110_J10,8,8q21.3,87616679,87717916,101237,-,-
BAC225_C01,8,8q21.3,87784951,87883446,98495,-,-
BAC219_O16,8,8q21.3,88007293,88136431,129138,-,-
BAC33_M18,8,8q21.3,88023944,88159474,135530,-,-
BAC120_D07,8,8q21.3,88062522,88170368,107846,-,-
BAC38_F22,8,8q21.3,88071532,88189810,118278,-,-
BAC237_J22,8,8q21.3,88327082,88405521,78439,-,-
BAC125_I11,8,8q21.3,88695494,88788145,92651,-,-
BAC159_K06,8,8q21.3,88725676,88821455,95779,-,-
BAC147_L01,8,8q21.3,88903230,88999475,96245,-,-
BAC160_D15,8,8q21.3,88946267,89072496,126229,-,-
BAC12_J10,8,8q21.3,88977282,89090811,113529,-,-
BAC37_H09,8,8q21.3,88977282,89114021,136739,-,-
BAC89_P02,8,8q21.3,89032573,89152788,120215,-,-
BAC36_B02,8,8q21.3,89054271,89140062,85791,-,-
BAC214_A13,8,8q21.3,89056800,89135889,79089,-,-
BAC105_N03,8,8q21.3,89190202,89286032,95830,-,-
BAC228_A02,8,8q21.3,89256118,89349687,93569,-,-
BAC172_P17,8,8q21.3,89268235,89355310,87075,-,-
BAC68_K11,8,8q21.3,89314328,89429821,115493,-,-
BAC70_E15,8,8q21.3,89361196,89473504,112308,-,-
BAC76_J19,8,8q21.3,89451358,89551330,99972,-,-
BAC32_G21,8,8q21.3,89458136,89562356,104220,-,-
BAC75_O09,8,8q21.3,89473776,89599546,125770,-,-
BAC66_J18,8,8q21.3,89539577,89629916,90339,-,-
BAC191_M15,8,8q21.3,89598415,89669383,70968,-,-
BAC162_N07,8,8q21.3,89691647,89770710,79063,-,-
BAC44_A18,8,8q21.3,89785623,89918296,132673,-,-
BAC246_N06,8,8q21.3,89828015,89913618,85603,-,-
BAC146_P19,8,8q21.3,90082972,90156846,73874,-,-
BAC194_K04,8,8q21.3,90303357,90377561,74204,-,-
BAC199_H06,8,8q21.3,90323882,90436899,113017,-,-
BAC114_L15,8,8q21.3,90493091,90573471,80380,-,-
BAC113_A08,8,8q21.3,90616233,90748570,132337,-,-
BAC12_B03,8,8q21.3,90713824,90839741,125917,-,-
BAC22_J16,8,8q21.3,90905560,91025106,119546,-,-
BAC167_O08,8,8q21.3,90966659,91056123,89464,-,-
BAC166_O09,8,8q21.3,91017512,91127240,109728,-,-
BAC90_P15,8,8q21.3,91034606,91125957,91351,-,-
BAC56_J05,8,8q21.3,91056117,91136638,80521,-,-
BAC171_M15,8,8q21.3,91185397,91279846,94449,-,-
BAC230_B16,8,8q21.3,91232981,91304138,71157,-,-
BAC101_N23,8,8q21.3,91280123,91383566,103443,-,-
BAC237_F06,8,8q21.3,91304321,91410515,106194,-,-
BAC92_K10,8,8q21.3,91413451,91539983,126532,-,-
BAC252_F08,8,8q21.3,91511899,91631094,119195,-,-
BAC60_O13,8,8q21.3,91665520,91787843,122323,-,-
BAC83_J09,8,8q21.3,92087412,92190031,102619,-,-
BAC78_I14,8,8q21.3,92203727,92296195,92468,-,-
BAC240_G05,8,8q21.3,92322991,92483487,160496,-,-
BAC33_K08,8,8q21.3,92372723,92475840,103117,-,-
BAC28_F22,8,8q21.3,92381126,92425095,43969,-,-
BAC37_B09,8,8q21.3,92398897,92513474,114577,-,-
BAC69_H13,8,8q21.3,92649838,92739576,89738,-,-
BAC242_K12,8,8q21.3,92652472,92739576,87104,-,-
BAC21_H10,8,8q21.3,92760577,92854095,93518,-,-
BAC58_L22,8,8q21.3,92809680,92958451,148771,-,-
BAC167_D04,8,8q21.3,92856055,92957922,101867,-,-
BAC177_G21,8,8q21.3,92856101,92980153,124052,-,-
BAC86_F11,8,8q21.3,92926360,93030676,104316,-,-
BAC88_L18,8,8q21.3,92958443,92971280,12837,-,-
BAC66_K17,8,8q21.3,93082383,93173805,91422,-,-
BAC226_E02,8,8q21.3,93164487,93248826,84339,-,-
BAC60_O04,8,8q21.3,93332489,93413297,80808,-,-
BAC224_O22,8,8q21.3,93350956,93429555,78599,-,-
BAC109_N06,8,8q21.3,93383773,93497110,113337,-,-
BAC37_H05,8,8q21.3-8q22.1,93474869,93591130,116261,-,-
BAC31_F04,8,8q22.1,93622101,93748893,126792,-,-
BAC146_I13,8,8q22.1,93652183,93729783,77600,-,-
BAC53_N14,8,8q22.1,93775675,93867003,91328,-,-
BAC221_K04,8,8q22.1,93813934,93883323,69389,-,-
BAC102_J17,8,8q22.1,94083917,94187944,104027,-,-
BAC91_H08,8,8q22.1,94193001,94327861,134860,-,-
BAC144_C01,8,8q22.1,94198179,94280492,82313,-,-
BAC29_H04,8,8q22.1,94202731,94347059,144328,-,-
BAC1_N24,8,8q22.1,94276663,94377292,100629,-,-
BAC8_D03,8,8q22.1,94298836,94408604,109768,-,-
BAC126_C10,8,8q22.1,94300021,94408604,108583,-,-
BAC122_J19,8,8q22.1,94300021,94408604,108583,-,-
BAC109_F18,8,8q22.1,94401350,94546579,145229,-,-
BAC91_K11,8,8q22.1,94401350,94497507,96157,-,-
BAC149_I07,8,8q22.1,94408598,94490870,82272,-,-
BAC66_C12,8,8q22.1,94546617,94636003,89386,-,-
BAC140_H14,8,8q22.1,94620177,94712494,92317,-,-
BAC131_J09,8,8q22.1,94676451,94761233,84782,-,-
BAC220_P21,8,8q22.1,94712488,94788446,75958,-,-
BAC115_M21,8,8q22.1,94712488,94735700,23212,-,-
BAC132_J24,8,8q22.1,94854382,94947669,93287,-,-
BAC119_G12,8,8q22.1,95069167,95175613,106446,-,-
BAC109_B07,8,8q22.1,95294940,95382473,87533,-,-
BAC45_D13,8,8q22.1,95308809,95414513,105704,-,-
BAC86_B07,8,8q22.1,95408310,95524509,116199,-,-
BAC191_N11,8,8q22.1,95435571,95517240,81669,-,-
BAC103_C17,8,8q22.1,95460872,95603613,142741,-,-
BAC131_M13,8,8q22.1,95502405,95582059,79654,-,-
BAC218_K14,8,8q22.1,95648868,95732643,83775,-,-
BAC66_I04,8,8q22.1,95649176,95749826,100650,-,-
BAC90_D24,8,8q22.1,95682564,95823190,140626,-,-
BAC242_D18,8,8q22.1,95707760,95800666,92906,-,-
BAC157_F10,8,8q22.1,95733818,95841833,108015,-,-
BAC96_L04,8,8q22.1,95817112,95896019,78907,-,-
BAC252_L15,8,8q22.1,95896013,96012440,116427,-,-
BAC95_B21,8,8q22.1,95992787,96076227,83440,-,-
BAC184_M01,8,8q22.1,96059625,96172330,112705,-,-
BAC200_I06,8,8q22.1,96079485,96184530,105045,-,-
BAC178_L23,8,8q22.1,96099918,96190574,90656,-,-
BAC165_B13,8,8q22.1,96111820,96203942,92122,-,-
BAC137_D11,8,8q22.1,96172479,96254727,82248,-,-
BAC137_I08,8,8q22.1,96184559,96303258,118699,-,-
BAC146_F20,8,8q22.1,96203944,96300840,96896,-,-
BAC191_G06,8,8q22.1,96300992,96401241,100249,-,-
BAC78_D02,8,8q22.1,96305284,96433828,128544,-,-
BAC27_F04,8,8q22.1,96305292,96389893,84601,-,-
BAC235_G06,8,8q22.1,96309094,96397459,88365,-,-
BAC55_M03,8,8q22.1,96370652,96509413,138761,-,-
BAC21_C20,8,8q22.1,96411081,96509437,98356,-,-
BAC233_J18,8,8q22.1,96413994,96494576,80582,-,-
BAC149_M05,8,8q22.1,96413994,96511250,97256,-,-
BAC132_E15,8,8q22.1,96463592,96572258,108666,-,-
BAC76_K05,8,8q22.1,96818544,96906145,87601,-,-
BAC134_P12,8,8q22.1,96822217,96917613,95396,-,-
BAC182_P09,8,8q22.1,96830338,96939470,109132,-,-
BAC103_A18,8,8q22.1,97047755,97162915,115160,-,-
BAC197_B11,8,8q22.1,97114549,97196159,81610,-,-
BAC79_K20,8,8q22.1,97119311,97206033,86722,-,-
BAC1_M08,8,8q22.1,97313804,97413697,99893,-,-
BAC181_I05,8,8q22.1,97350545,97449664,99119,-,-
BAC214_B12,8,8q22.1,97411596,97511898,100302,-,-
BAC181_L12,8,8q22.1,97442564,97525523,82959,-,-
BAC148_H14,8,8q22.1,97501213,97586004,84791,-,-
BAC91_F17,8,8q22.1,97512099,97606090,93991,-,-
BAC122_C04,8,8q22.1,97689955,97788800,98845,-,-
BAC143_H11,8,8q22.1,97695022,97788800,93778,-,-
BAC90_H11,8,8q22.1,97695271,97796441,101170,-,-
BAC110_F16,8,8q22.1,97743972,97889710,145738,-,-
BAC1_G19,8,8q22.1,97974526,98074773,100247,-,-
BAC135_J03,8,8q22.1,97977037,98074773,97736,-,-
BAC20_L20,8,8q22.1,97993052,98111362,118310,-,-
BAC248_D20,8,8q22.1,98123262,98205629,82367,-,-
BAC46_H04,8,8q22.1,98156455,98251997,95542,-,-
BAC64_A06,8,8q22.1,98190238,98310363,120125,-,-
BAC194_G03,8,8q22.1,98237602,98337242,99640,-,-
BAC170_H07,8,8q22.1,98240366,98365346,124980,-,-
BAC165_K06,8,8q22.1,98247909,98334864,86955,-,-
BAC165_J15,8,8q22.1,98389943,98457297,67354,-,-
BAC81_O24,8,8q22.1,98446957,98558742,111785,-,-
BAC127_K09,8,8q22.1,98558844,98690744,131900,-,-
BAC205_G23,8,8q22.1,98609232,98688729,79497,-,-
BAC137_G15,8,8q22.1,98609820,98728230,118410,-,-
BAC2_M04,8,8q22.1,98657363,98809784,152421,-,-
BAC59_O09,8,8q22.1,98679299,98816604,137305,-,-
BAC68_M05,8,8q22.1,98699324,98811475,112151,-,-
BAC201_A07,8,8q22.1,98785721,98896972,111251,-,-
BAC206_I03,8,8q22.1,98816879,98925884,109005,-,-
BAC97_A04,8,8q22.1,98831573,98984523,152950,-,-
BAC228_N17,8,8q22.1,98853066,98969737,116671,-,-
BAC82_M05,8,8q22.1,98923570,99033516,109946,-,-
BAC57_F14,8,8q22.1,98923570,99022000,98430,-,-
BAC18_P03,8,8q22.1,98952452,99038771,86319,-,-
BAC197_H11,8,8q22.1,98952484,99023589,71105,-,-
BAC68_D07,8,8q22.1,99001158,99097193,96035,-,-
BAC39_H17,8,8q22.1-8q22.2,99004112,99109324,105212,-,-
BAC58_K24,8,8q22.1-8q22.2,99023617,99130350,106733,-,-
BAC19_A24,8,8q22.1-8q22.2,99061113,99174765,113652,-,-
BAC183_A18,8,8q22.1-8q22.2,99073726,99157794,84068,-,-
BAC45_I06,8,8q22.2,99115568,99312134,196566,-,-
BAC25_E23,8,8q22.2,99148281,99256246,107965,-,-
BAC236_J11,8,8q22.2,99161530,99256246,94716,-,-
BAC101_C18,8,8q22.2,99172043,99314744,142701,-,-
BAC152_D02,8,8q22.2,99205388,99321924,116536,-,-
BAC152_G24,8,8q22.2,99237485,99314744,77259,-,-
BAC117_I11,8,8q22.2,99314098,99356957,42859,-,-
BAC131_M03,8,8q22.2,99321918,99416746,94828,-,-
BAC125_B04,8,8q22.2,99394566,99512173,117607,-,-
BAC109_B03,8,8q22.2,99509691,99629754,120063,-,-
BAC179_H14,8,8q22.2,99513016,99602872,89856,-,-
BAC110_L05,8,8q22.2,99594125,99697620,103495,-,-
BAC247_J18,8,8q22.2,99648531,99733638,85107,-,-
BAC167_L18,8,8q22.2,99655943,99749465,93522,-,-
BAC173_P09,8,8q22.2,99802943,99929029,126086,-,-
BAC240_L06,8,8q22.2,99823785,99930227,106442,-,-
BAC185_O19,8,8q22.2,100001478,100081132,79654,-,-
BAC167_J22,8,8q22.2,100012406,100095396,82990,-,-
BAC8_L12,8,8q22.2,100016354,100153865,137511,-,-
BAC152_H12,8,8q22.2,100076328,100204159,127831,-,-
BAC218_D15,8,8q22.2,100156473,100237639,81166,-,-
BAC69_E02,8,8q22.2,100158849,100307729,148880,-,-
BAC40_C21,8,8q22.2,100196081,100292631,96550,-,-
BAC122_M04,8,8q22.2,100274997,100353585,78588,-,-
BAC225_O14,8,8q22.2,100284555,100423751,139196,-,-
BAC110_F04,8,8q22.2,100292665,100415677,123012,-,-
BAC70_O08,8,8q22.2,100295240,100457325,162085,-,-
BAC52_J02,8,8q22.2,100300509,100415659,115150,-,-
BAC65_P10,8,8q22.2,100319675,100415672,95997,-,-
BAC189_D13,8,8q22.2,100373509,100462048,88539,-,-
BAC252_D09,8,8q22.2,100373509,100469875,96366,-,-
BAC188_F13,8,8q22.2,100403177,100479071,75894,-,-
BAC102_C16,8,8q22.2,100423766,100542896,119130,-,-
BAC97_O21,8,8q22.2,100476976,100665698,188722,-,-
BAC41_H08,8,8q22.2,100486599,100571514,84915,-,-
BAC24_I16,8,8q22.2,100506758,100605511,98753,-,-
BAC249_D08,8,8q22.2,100713781,100811168,97387,-,-
BAC149_G03,8,8q22.2,100742645,100824023,81378,-,-
BAC38_K04,8,8q22.2,100834017,100945338,111321,-,-
BAC57_D18,8,8q22.2,100835540,100922190,86650,-,-
BAC228_B19,8,8q22.2,100885594,100972878,87284,-,-
BAC151_H07,8,8q22.2,100985863,101075313,89450,-,-
BAC34_N03,8,8q22.2,101006898,101105700,98802,-,-
BAC248_P02,8,8q22.2,101017964,101109830,91866,-,-
BAC27_G05,8,8q22.2,101049474,101131454,81980,-,-
BAC199_C14,8,8q22.2,101124329,101193789,69460,-,-
BAC57_B03,8,8q22.2,101131731,101244351,112620,-,-
BAC43_J21,8,8q22.2,101269083,101349754,80671,-,-
BAC194_D18,8,8q22.2,101388545,101500781,112236,-,-
BAC56_F21,8,8q22.2-8q22.3,101526204,101614178,87974,-,-
BAC38_I06,8,8q22.2-8q22.3,101583171,101686834,103663,-,-
BAC186_B11,8,8q22.3,101617945,101711726,93781,-,-
BAC176_O05,8,8q22.3,101635698,101737200,101502,-,-
BAC60_K15,8,8q22.3,101659516,101748849,89333,-,-
BAC115_C04,8,8q22.3,101686937,101792681,105744,-,-
BAC38_J12,8,8q22.3,101695749,101793110,97361,-,-
BAC166_G03,8,8q22.3,101737194,101843688,106494,-,-
BAC122_F03,8,8q22.3,101765993,101871815,105822,-,-
BAC162_H15,8,8q22.3,101781500,101872022,90522,-,-
BAC21_E10,8,8q22.3,101903167,101988997,85830,-,-
BAC208_F08,8,8q22.3,101930588,102023687,93099,-,-
BAC81_M08,8,8q22.3,101930588,102086350,155762,-,-
BAC200_E08,8,8q22.3,101960453,102068504,108051,-,-
BAC167_J19,8,8q22.3,101965460,102091376,125916,-,-
BAC156_C11,8,8q22.3,101971097,102075746,104649,-,-
BAC103_F14,8,8q22.3,101989023,102086354,97331,-,-
BAC135_F23,8,8q22.3,102038149,102140324,102175,-,-
BAC52_D19,8,8q22.3,102070276,102186372,116096,-,-
BAC131_L10,8,8q22.3,102078720,102157429,78709,-,-
BAC10_F07,8,8q22.3,102078720,102189974,111254,-,-
BAC244_M02,8,8q22.3,102079901,102189970,110069,-,-
BAC230_A10,8,8q22.3,102091548,102236300,144752,-,-
BAC141_G19,8,8q22.3,102092335,102173349,81014,-,-
BAC237_D14,8,8q22.3,102098525,102186374,87849,-,-
BAC10_H24,8,8q22.3,102158966,102255026,96060,-,-
BAC204_B01,8,8q22.3,102236308,102320384,84076,-,-
BAC133_F02,8,8q22.3,102290613,102374453,83840,-,-
BAC67_L04,8,8q22.3,102315202,102462274,147072,-,-
BAC153_A12,8,8q22.3,102340030,102419773,79743,-,-
BAC242_A20,8,8q22.3,102357971,102442469,84498,-,-
BAC108_B09,8,8q22.3,102409019,102567114,158095,-,-
BAC151_O04,8,8q22.3,102431192,102539167,107975,-,-
BAC209_L11,8,8q22.3,102442463,102539076,96613,-,-
BAC214_N11,8,8q22.3,102506025,102595423,89398,-,-
BAC157_F12,8,8q22.3,102513408,102619613,106205,-,-
BAC109_H19,8,8q22.3,102534508,102619613,85105,-,-
BAC249_E15,8,8q22.3,102563394,102643934,80540,-,-
BAC40_H09,8,8q22.3,102608433,102756252,147819,-,-
BAC71_L02,8,8q22.3,102654747,102763125,108378,-,-
BAC103_A01,8,8q22.3,102669990,102756256,86266,-,-
BAC79_P23,8,8q22.3,102680451,102770350,89899,-,-
BAC131_K08,8,8q22.3,102708298,102799483,91185,-,-
BAC117_I14,8,8q22.3,102735254,102812866,77612,-,-
BAC226_M17,8,8q22.3,102774808,102858594,83786,-,-
BAC142_L21,8,8q22.3,102774808,102854491,79683,-,-
BAC225_D04,8,8q22.3,102826038,102905152,79114,-,-
BAC61_B18,8,8q22.3,102854526,102976558,122032,-,-
BAC123_A05,8,8q22.3,103085074,103193867,108793,-,-
BAC118_I18,8,8q22.3,103193897,103269501,75604,-,-
BAC222_H11,8,8q22.3,103251678,103346873,95195,-,-
BAC106_H06,8,8q22.3,103270828,103393592,122764,-,-
BAC200_C08,8,8q22.3,103287335,103402138,114803,-,-
BAC180_J02,8,8q22.3,103291587,103366727,75140,-,-
BAC96_J01,8,8q22.3,103298397,103387644,89247,-,-
BAC25_D11,8,8q22.3,103314332,103391577,77245,-,-
BAC129_O03,8,8q22.3,103336935,103431507,94572,-,-
BAC224_C10,8,8q22.3,103391769,103469884,78115,-,-
BAC106_C10,8,8q22.3,103508358,103591719,83361,-,-
BAC82_D22,8,8q22.3,103591747,103708018,116271,-,-
BAC153_C04,8,8q22.3,103651676,103756753,105077,-,-
BAC157_N15,8,8q22.3,103654721,103766448,111727,-,-
BAC134_H03,8,8q22.3,103740091,103891379,151288,-,-
BAC154_E20,8,8q22.3,103756746,103837469,80723,-,-
BAC97_E18,8,8q22.3,103757620,103834072,76452,-,-
BAC83_B10,8,8q22.3,103961862,104080803,118941,-,-
BAC218_D21,8,8q22.3,103969903,104074387,104484,-,-
BAC185_E06,8,8q22.3,103984633,104074920,90287,-,-
BAC185_N03,8,8q22.3,103984652,104074694,90042,-,-
BAC181_O16,8,8q22.3,103984675,104074920,90245,-,-
BAC135_C18,8,8q22.3,103985235,104074694,89459,-,-
BAC160_L20,8,8q22.3,103986701,104080747,94046,-,-
BAC96_K08,8,8q22.3,103989580,104091367,101787,-,-
BAC15_H18,8,8q22.3,103998432,104144732,146300,-,-
BAC77_B02,8,8q22.3,104082468,104175398,92930,-,-
BAC48_E01,8,8q22.3,104332024,104441699,109675,-,-
BAC127_K16,8,8q22.3,104335732,104457284,121552,-,-
BAC128_K05,8,8q22.3,104374841,104454776,79935,-,-
BAC211_N02,8,8q22.3,104441749,104538385,96636,-,-
BAC175_C18,8,8q22.3,104441775,104520787,79012,-,-
BAC35_F15,8,8q22.3,104442952,104538390,95438,-,-
BAC227_L20,8,8q22.3,104454561,104541642,87081,-,-
BAC162_N05,8,8q22.3,104480034,104564597,84563,-,-
BAC70_G11,8,8q22.3,104688664,104748079,59415,-,-
BAC70_A17,8,8q22.3,104701877,104829207,127330,-,-
BAC161_I05,8,8q22.3,104770179,104861718,91539,-,-
BAC195_J01,8,8q22.3,104773989,104791593,17604,-,-
BAC129_M07,8,8q22.3,104850393,104929731,79338,-,-
BAC115_I07,8,8q22.3,104929751,105033805,104054,-,-
BAC62_M05,8,8q22.3,105090338,105223173,132835,-,-
BAC229_L15,8,8q22.3,105180680,105272994,92314,-,-
BAC214_O01,8,8q22.3,105223168,105296399,73231,-,-
BAC37_O04,8,8q22.3,105253465,105345013,91548,-,-
BAC192_D21,8,8q22.3,105276343,105366603,90260,-,-
BAC11_H02,8,8q22.3,105294925,105390430,95505,-,-
BAC167_L10,8,8q22.3,105308697,105394313,85616,-,-
BAC141_H20,8,8q22.3,105337728,105449312,111584,-,-
BAC78_M04,8,8q22.3,105368619,105507465,138846,-,-
BAC167_O12,8,8q22.3,105390464,105485536,95072,-,-
BAC154_D20,8,8q22.3,105403372,105441085,37713,-,-
BAC123_F06,8,8q22.3,105428851,105527448,98597,-,-
BAC193_H04,8,8q22.3,105827641,105907431,79790,-,-
BAC106_A07,8,8q22.3,105842814,105938389,95575,-,-
BAC97_C03,8,8q22.3,105919154,106010056,90902,-,-
BAC110_O18,8,8q22.3,105950765,106050673,99908,-,-
BAC108_A06,8,8q22.3-8q23.1,106066147,106145790,79643,-,-
BAC65_O17,8,8q23.1,106100521,106197245,96724,-,-
BAC137_J15,8,8q23.1,106161512,106256357,94845,-,-
BAC11_N03,8,8q23.1,106183015,106286496,103481,-,-
BAC187_D22,8,8q23.1,106216715,106294380,77665,-,-
BAC27_I17,8,8q23.1,106331594,106473344,141750,-,-
BAC150_I08,8,8q23.1,106477412,106565584,88172,-,-
BAC237_M08,8,8q23.1,106578808,106677714,98906,-,-
BAC168_E12,8,8q23.1,106927765,107024815,97050,-,-
BAC16_G23,8,8q23.1,107048536,107150244,101708,-,-
BAC64_F02,8,8q23.1,107173255,107320229,146974,-,-
BAC83_P12,8,8q23.1,107224772,107318194,93422,-,-
BAC42_J10,8,8q23.1,107388317,107492243,103926,-,-
BAC38_K03,8,8q23.1,107426789,107534445,107656,-,-
BAC223_H20,8,8q23.1,107481245,107563821,82576,-,-
BAC75_C08,8,8q23.1,107528429,107615456,87027,-,-
BAC130_J04,8,8q23.1,107574083,107667378,93295,-,-
BAC150_B20,8,8q23.1,107781339,107888137,106798,-,-
BAC148_N24,8,8q23.1,107781340,107871957,90617,-,-
BAC195_C09,8,8q23.1,107825941,107928562,102621,-,-
BAC66_C08,8,8q23.1,107870375,107984087,113712,-,-
BAC124_N19,8,8q23.1,107871978,107964924,92946,-,-
BAC65_D18,8,8q23.1,107899625,108002800,103175,-,-
BAC179_B02,8,8q23.1,107984082,108084930,100848,-,-
BAC169_B05,8,8q23.1,108066232,108155716,89484,-,-
BAC146_P08,8,8q23.1,108166170,108291950,125780,-,-
BAC43_C17,8,8q23.1,108257767,108376361,118594,-,-
BAC173_O17,8,8q23.1,108321060,108404194,83134,-,-
BAC100_C14,8,8q23.1,108642707,108737942,95235,-,-
BAC20_K18,8,8q23.1,108926848,109035197,108349,-,-
BAC122_P24,8,8q23.1,109051959,109141800,89841,-,-
BAC193_J19,8,8q23.1,109157355,109244969,87614,-,-
BAC167_G23,8,8q23.1,109234741,109327234,92493,-,-
BAC233_I09,8,8q23.1,109298255,109383523,85268,-,-
BAC69_G09,8,8q23.1,109325880,109444712,118832,-,-
BAC235_I14,8,8q23.1,109411098,109507311,96213,-,-
BAC178_E06,8,8q23.1,109444706,109566381,121675,-,-
BAC102_L24,8,8q23.1,109473327,109580164,106837,-,-
BAC75_C23,8,8q23.1,109580387,109705740,125353,-,-
BAC92_H04,8,8q23.1,109597506,109678160,80654,-,-
BAC60_D15,8,8q23.1,109887583,109972503,84920,-,-
BAC242_O14,8,8q23.1,109972500,110057124,84624,-,-
BAC178_C01,8,8q23.1,110073265,110183579,110314,-,-
BAC156_D04,8,8q23.1,110151006,110243248,92242,-,-
BAC197_L07,8,8q23.1,110289027,110369741,80714,-,-
BAC37_M23,8,8q23.1,110369821,110506619,136798,-,-
BAC1_H03,8,8q23.1,110442885,110569842,126957,-,-
BAC29_J09,8,8q23.1,110465023,110547581,82558,-,-
BAC45_A10,8,8q23.2,110668858,110781317,112459,-,-
BAC76_A16,8,8q23.2,110739989,110854679,114690,-,-
BAC117_M05,8,8q23.2,110781340,110875855,94515,-,-
BAC119_P12,8,8q23.2,110893816,110983552,89736,-,-
BAC27_J02,8,8q23.2,111205357,111340573,135216,-,-
BAC168_O08,8,8q23.2,111587926,111683696,95770,-,-
BAC140_A19,8,8q23.2,111610406,111689793,79387,-,-
BAC195_P22,8,8q23.2,111689788,111751025,61237,-,-
BAC126_O04,8,8q23.2,112052197,112147129,94932,-,-
BAC43_P07,8,8q23.3,112307207,112407015,99808,-,-
BAC19_K20,8,8q23.3,112477099,112571039,93940,-,-
BAC62_N20,8,8q23.3,112645494,112772137,126643,-,-
BAC238_G08,8,8q23.3,112785534,112864018,78484,-,-
BAC60_A03,8,8q23.3,112864275,112989928,125653,-,-
BAC158_L03,8,8q23.3,112910561,113029073,118512,-,-
BAC103_J19,8,8q23.3,112936290,113029098,92808,-,-
BAC252_D03,8,8q23.3,112962822,113043470,80648,-,-
BAC100_M06,8,8q23.3,113014438,113157008,142570,-,-
BAC21_J24,8,8q23.3,113068899,113175441,106542,-,-
BAC236_A06,8,8q23.3,113070752,113140812,70060,-,-
BAC37_F12,8,8q23.3,113086149,113179944,93795,-,-
BAC124_L02,8,8q23.3,113102365,113160464,58099,-,-
BAC246_D07,8,8q23.3,113147367,113279004,131637,-,-
BAC56_J24,8,8q23.3,113160811,113292431,131620,-,-
BAC96_A21,8,8q23.3,113192147,113287736,95589,-,-
BAC169_H19,8,8q23.3,113192462,113299835,107373,-,-
BAC77_E12,8,8q23.3,113280594,113409666,129072,-,-
BAC71_E09,8,8q23.3,113311498,113405658,94160,-,-
BAC86_B06,8,8q23.3,113398403,113503939,105536,-,-
BAC186_C10,8,8q23.3,113466773,113537894,71121,-,-
BAC241_J01,8,8q23.3,113613091,113711419,98328,-,-
BAC237_B05,8,8q23.3,113638615,113769103,130488,-,-
BAC240_B09,8,8q23.3,113677177,113791023,113846,-,-
BAC114_M18,8,8q23.3,113677179,113790727,113548,-,-
BAC59_A08,8,8q23.3,113710082,113820205,110123,-,-
BAC26_L18,8,8q23.3,113805072,113888893,83821,-,-
BAC41_N11,8,8q23.3,114015568,114138521,122953,-,-
BAC43_E14,8,8q23.3,114022517,114131612,109095,-,-
BAC36_D02,8,8q23.3,114409222,114545608,136386,-,-
BAC219_P09,8,8q23.3,114592458,114725844,133386,-,-
BAC194_F18,8,8q23.3,114695216,114780356,85140,-,-
BAC23_B24,8,8q23.3,114730522,114848542,118020,-,-
BAC26_C15,8,8q23.3,114760700,114860336,99636,-,-
BAC223_L15,8,8q23.3,114893472,114981702,88230,-,-
BAC169_M20,8,8q23.3,114916998,115003152,86154,-,-
BAC65_L05,8,8q23.3,114969341,115055578,86237,-,-
BAC185_G19,8,8q23.3,115233531,115328437,94906,-,-
BAC204_H21,8,8q23.3,115339515,115424319,84804,-,-
BAC40_P09,8,8q23.3,115360111,115472564,112453,-,-
BAC194_P08,8,8q23.3,115424459,115523916,99457,-,-
BAC65_M05,8,8q23.3,115601551,115733086,131535,-,-
BAC33_M22,8,8q23.3,115699195,115789383,90188,-,-
BAC61_N10,8,8q23.3,115840828,115937681,96853,-,-
BAC160_D22,8,8q23.3,115937673,116089784,152111,-,-
BAC102_M21,8,8q23.3,115986351,116073797,87446,-,-
BAC80_J01,8,8q23.3,115986352,116085093,98741,-,-
BAC68_K03,8,8q23.3,116090990,116189684,98694,-,-
BAC169_I16,8,8q23.3,116112901,116189684,76783,-,-
BAC167_L02,8,8q23.3,116114092,116181008,66916,-,-
BAC132_F16,8,8q23.3,116346089,116453095,107006,-,-
BAC145_O23,8,8q23.3,116366850,116463028,96178,-,-
BAC69_B07,8,8q23.3,116516548,116600025,83477,-,-
BAC229_C20,8,8q23.3,116742028,116832505,90477,-,-
BAC176_H16,8,8q23.3,116937688,117027644,89956,-,-
BAC103_P03,8,8q23.3,116941013,117034402,93389,-,-
BAC181_O06,8,8q23.3,117077332,117145501,68169,-,-
BAC116_F17,8,8q23.3,117098783,117198857,100074,-,-
BAC197_N02,8,8q23.3,117099135,117208617,109482,-,-
BAC96_B03,8,8q23.3,117150688,117267336,116648,-,-
BAC180_G16,8,8q23.3,117183297,117276667,93370,-,-
BAC170_B21,8,8q23.3,117211191,117311036,99845,-,-
BAC165_N06,8,8q23.3,117220931,117311036,90105,-,-
BAC11_A11,8,8q23.3,117430846,117527336,96490,-,-
BAC231_F23,8,8q23.3,117463445,117524893,61448,-,-
BAC186_D21,8,8q23.3,117553416,117654879,101463,-,-
BAC14_A14,8,8q24.11,117767650,117864766,97116,-,-
BAC60_F13,8,8q24.11,117779151,117942850,163699,-,-
BAC250_N14,8,8q24.11,117839160,117911231,72071,-,-
BAC39_P14,8,8q24.11,117898636,117995587,96951,-,-
BAC68_M16,8,8q24.11,118310322,118397964,87642,-,-
BAC85_E22,8,8q24.11,118331745,118414447,82702,-,-
BAC41_C05,8,8q24.11,118543672,118664118,120446,-,-
BAC222_M15,8,8q24.11,118543695,118628366,84671,-,-
BAC26_H17,8,8q24.11,118577372,118661340,83968,-,-
BAC71_K17,8,8q24.11,118766406,118865922,99516,-,-
BAC240_N02,8,8q24.11,118892792,118976442,83650,-,-
BAC52_P19,8,8q24.11,118900724,118976442,75718,-,-
BAC110_O15,8,8q24.11,118934049,119045610,111561,-,-
BAC227_O14,8,8q24.11,118934049,119041283,107234,-,-
BAC210_C23,8,8q24.11,118946769,119045610,98841,-,-
BAC139_B17,8,8q24.11,119062516,119138102,75586,-,-
BAC80_L10,8,8q24.11,119109018,119198400,89382,-,-
BAC199_P22,8,8q24.11-8q24.12,119131146,119219298,88152,-,-
BAC71_L12,8,8q24.12,119222960,119343053,120093,-,-
BAC252_O19,8,8q24.12,119358452,119475582,117130,-,-
BAC125_D05,8,8q24.12,119377088,119483422,106334,-,-
BAC96_B17,8,8q24.12,119388333,119479818,91485,-,-
BAC200_E17,8,8q24.12,119396534,119465172,68638,-,-
BAC151_I03,8,8q24.12,119401330,119501392,100062,-,-
BAC109_G09,8,8q24.12,119442311,119582610,140299,-,-
BAC27_A17,8,8q24.12,119650113,119778488,128375,-,-
BAC159_I03,8,8q24.12,119927963,119996228,68265,-,-
BAC67_K14,8,8q24.12,119949597,120041254,91657,-,-
BAC246_A07,8,8q24.12,120036199,120116621,80422,-,-
BAC125_F07,8,8q24.12,120042782,120153115,110333,-,-
BAC167_L23,8,8q24.12,120097465,120204775,107310,-,-
BAC137_B24,8,8q24.12,120106954,120185757,78803,-,-
BAC198_O03,8,8q24.12,120113403,120204775,91372,-,-
BAC232_G19,8,8q24.12,120182277,120266624,84347,-,-
BAC95_P17,8,8q24.12,120188556,120292218,103662,-,-
BAC215_N01,8,8q24.12,120318998,120419787,100789,-,-
BAC192_F01,8,8q24.12,120392005,120490182,98177,-,-
BAC135_F20,8,8q24.12,120394390,120539993,145603,-,-
BAC248_F14,8,8q24.12,120490322,120603789,113467,-,-
BAC37_G07,8,8q24.12,120494123,120595606,101483,-,-
BAC22_N04,8,8q24.12,120624821,120749221,124400,-,-
BAC95_P02,8,8q24.12,120696801,120784129,87328,-,-
BAC103_A04,8,8q24.12,120698133,120820423,122290,-,-
BAC105_M01,8,8q24.12,120714744,120854359,139615,-,-
BAC78_N19,8,8q24.12,120717877,120813292,95415,-,-
BAC117_M15,8,8q24.12,120741999,120817297,75298,-,-
BAC23_K06,8,8q24.12,120759258,120927067,167809,-,-
BAC35_K07,8,8q24.12,120791310,120855591,64281,-,-
BAC229_P19,8,8q24.12,120810736,120899293,88557,-,-
BAC90_N19,8,8q24.12,120864684,120956660,91976,-,-
BAC168_L01,8,8q24.12,120937824,121020702,82878,-,-
BAC199_P02,8,8q24.12,120971405,121082167,110762,-,-
BAC118_J23,8,8q24.12,121057915,121140821,82906,-,-
BAC36_G11,8,8q24.12,121156473,121270237,113764,-,-
BAC213_N08,8,8q24.12,121169388,121269032,99644,-,-
BAC40_L13,8,8q24.12,121209683,121400310,190627,-,-
BAC189_K03,8,8q24.12,121240214,121325441,85227,-,-
BAC167_L04,8,8q24.12,121284783,121365793,81010,-,-
BAC199_I23,8,8q24.12,121322070,121403329,81259,-,-
BAC12_L19,8,8q24.12,121322092,121431561,109469,-,-
BAC182_D20,8,8q24.12,121358831,121441810,82979,-,-
BAC57_P14,8,8q24.12,121433447,121520721,87274,-,-
BAC45_L02,8,8q24.12,121441814,121546312,104498,-,-
BAC211_B14,8,8q24.12,121482711,121577924,95213,-,-
BAC157_I23,8,8q24.12,121514568,121619590,105022,-,-
BAC150_P04,8,8q24.12,121530080,121627014,96934,-,-
BAC51_E15,8,8q24.12,121545423,121673328,127905,-,-
BAC121_N19,8,8q24.12,121600618,121677575,76957,-,-
BAC25_K03,8,8q24.12,121653285,121791109,137824,-,-
BAC149_A11,8,8q24.12,121654942,121779042,124100,-,-
BAC127_E06,8,8q24.12,121669965,121787527,117562,-,-
BAC167_K02,8,8q24.12,121673786,121779042,105256,-,-
BAC141_I06,8,8q24.12,121700342,121795092,94750,-,-
BAC88_I02,8,8q24.12,121790866,121897299,106433,-,-
BAC246_L15,8,8q24.12,121808649,121897286,88637,-,-
BAC148_H04,8,8q24.12,121817951,121897299,79348,-,-
BAC43_G11,8,8q24.12,122201754,122326357,124603,-,-
BAC46_M18,8,8q24.12,122376447,122461937,85490,-,-
BAC172_N22,8,8q24.12-8q24.13,122477351,122542653,65302,-,-
BAC65_K02,8,8q24.13,122529313,122680821,151508,-,-
BAC122_M12,8,8q24.13,122542646,122633085,90439,-,-
BAC224_J10,8,8q24.13,122601867,122680841,78974,-,-
BAC194_K07,8,8q24.13,122623630,122703843,80213,-,-
BAC125_D14,8,8q24.13,122737945,122846223,108278,-,-
BAC235_P11,8,8q24.13,122793202,122884667,91465,-,-
BAC172_B19,8,8q24.13,122793202,122877170,83968,-,-
BAC169_O20,8,8q24.13,122854516,122964252,109736,-,-
BAC226_N04,8,8q24.13,122884672,122979503,94831,-,-
BAC40_P13,8,8q24.13,122894269,122977557,83288,-,-
BAC106_E16,8,8q24.13,123079685,123196851,117166,-,-
BAC146_G02,8,8q24.13,123265666,123345050,79384,-,-
BAC179_P09,8,8q24.13,123345286,123410466,65180,-,-
BAC50_P19,8,8q24.13,123499474,123599164,99690,-,-
BAC154_C06,8,8q24.13,123515964,123590296,74332,-,-
BAC223_P01,8,8q24.13,123557853,123643412,85559,-,-
BAC75_A18,8,8q24.13,123594596,123677715,83119,-,-
BAC107_E07,8,8q24.13,123677709,123820804,143095,-,-
BAC230_O16,8,8q24.13,123700559,123796462,95903,-,-
BAC132_J08,8,8q24.13,123716672,123808798,92126,-,-
BAC144_M02,8,8q24.13,123737152,123829069,91917,-,-
BAC148_N23,8,8q24.13,123741314,123820805,79491,-,-
BAC198_M07,8,8q24.13,123797427,123910807,113380,-,-
BAC244_N12,8,8q24.13,123797985,123887554,89569,-,-
BAC11_M02,8,8q24.13,123844569,123963644,119075,-,-
BAC218_C22,8,8q24.13,123911208,124009049,97841,-,-
BAC240_K17,8,8q24.13,123977452,124063025,85573,-,-
BAC154_P11,8,8q24.13,124009310,124154186,144876,-,-
BAC99_K23,8,8q24.13,124009648,124093850,84202,-,-
BAC173_K09,8,8q24.13,124010782,124099954,89172,-,-
BAC145_P15,8,8q24.13,124061149,124154186,93037,-,-
BAC108_G06,8,8q24.13,124063018,124164157,101139,-,-
BAC237_J13,8,8q24.13,124063018,124147864,84846,-,-
BAC42_O06,8,8q24.13,124070295,124214210,143915,-,-
BAC52_E15,8,8q24.13,124083427,124214185,130758,-,-
BAC175_E07,8,8q24.13,124164148,124260627,96479,-,-
BAC129_A20,8,8q24.13,124188534,124297573,109039,-,-
BAC34_K08,8,8q24.13,124195176,124291337,96161,-,-
BAC161_E13,8,8q24.13,124211692,124294585,82893,-,-
BAC252_G06,8,8q24.13,124249732,124374729,124997,-,-
BAC49_G22,8,8q24.13,124249809,124371785,121976,-,-
BAC236_B02,8,8q24.13,124337807,124432308,94501,-,-
BAC48_J10,8,8q24.13,124343472,124437134,93662,-,-
BAC19_E22,8,8q24.13,124353291,124468937,115646,-,-
BAC84_C04,8,8q24.13,124371830,124490897,119067,-,-
BAC177_N08,8,8q24.13,124407203,124490897,83694,-,-
BAC92_K22,8,8q24.13,124420372,124518088,97716,-,-
BAC168_I12,8,8q24.13,124456058,124549595,93537,-,-
BAC190_K02,8,8q24.13,124469256,124540850,71594,-,-
BAC40_J20,8,8q24.13,124515361,124606738,91377,-,-
BAC181_M06,8,8q24.13,124602348,124677183,74835,-,-
BAC86_J10,8,8q24.13,124677176,124773303,96127,-,-
BAC219_A18,8,8q24.13,124784062,124867989,83927,-,-
BAC114_E01,8,8q24.13,124801906,124894574,92668,-,-
BAC199_A10,8,8q24.13,124805504,124899796,94292,-,-
BAC28_F08,8,8q24.13,124805532,124894772,89240,-,-
BAC100_O19,8,8q24.13,124872765,124966785,94020,-,-
BAC86_B17,8,8q24.13,124894767,124996144,101377,-,-
BAC42_M13,8,8q24.13,124922131,125022190,100059,-,-
BAC97_I19,8,8q24.13,124943769,125042687,98918,-,-
BAC150_N03,8,8q24.13,125019695,125111611,91916,-,-
BAC52_I15,8,8q24.13,125023152,125151069,127917,-,-
BAC193_B20,8,8q24.13,125040769,125140852,100083,-,-
BAC155_E19,8,8q24.13,125097350,125177576,80226,-,-
BAC191_N09,8,8q24.13,125128068,125214450,86382,-,-
BAC197_L08,8,8q24.13,125151063,125272375,121312,-,-
BAC11_K10,8,8q24.13,125172096,125287117,115021,-,-
BAC247_L22,8,8q24.13,125191741,125275863,84122,-,-
BAC45_L17,8,8q24.13,125219785,125327878,108093,-,-
BAC102_M16,8,8q24.13,125257404,125347678,90274,-,-
BAC248_K16,8,8q24.13,125257670,125349275,91605,-,-
BAC242_M11,8,8q24.13,125287111,125370045,82934,-,-
BAC53_D11,8,8q24.13,125287115,125370042,82927,-,-
BAC91_N01,8,8q24.13,125399510,125500016,100506,-,-
BAC110_I10,8,8q24.13,125440516,125534552,94036,-,-
BAC231_I03,8,8q24.13,125440519,125534552,94033,-,-
BAC148_P24,8,8q24.13,125448245,125538656,90411,-,-
BAC154_H09,8,8q24.13,125448313,125611086,162773,-,-
BAC137_J16,8,8q24.13,125475693,125559317,83624,-,-
BAC233_N17,8,8q24.13,125534812,125617253,82441,-,-
BAC61_B21,8,8q24.13,125590833,125693808,102975,-,-
BAC141_O14,8,8q24.13,125597743,125672786,75043,-,-
BAC80_H19,8,8q24.13,125618138,125727013,108875,-,-
BAC233_N14,8,8q24.13,125647241,125750246,103005,-,-
BAC48_K12,8,8q24.13,125670046,125813938,143892,-,-
BAC234_N16,8,8q24.13,125685760,125831368,145608,-,-
BAC124_M21,8,8q24.13,125750240,125842833,92593,-,-
BAC213_E06,8,8q24.13,125754464,125915019,160555,-,-
BAC244_C21,8,8q24.13,125771549,125886952,115403,-,-
BAC61_K13,8,8q24.13,125771572,125912923,141351,-,-
BAC58_J24,8,8q24.13,125774768,125886952,112184,-,-
BAC182_H06,8,8q24.13,125814492,125912942,98450,-,-
BAC22_B12,8,8q24.13,125835006,126039162,204156,-,-
BAC56_G08,8,8q24.13,125842827,125930680,87853,-,-
BAC81_O23,8,8q24.13,125886945,125981279,94334,-,-
BAC123_G10,8,8q24.13,125886945,125970207,83262,-,-
BAC135_C12,8,8q24.13,125901052,125983170,82118,-,-
BAC68_J12,8,8q24.13,125905920,125996569,90649,-,-
BAC179_G12,8,8q24.13,125978844,126059018,80174,-,-
BAC134_F03,8,8q24.13,126026081,126154646,128565,-,-
BAC58_O23,8,8q24.13,126149925,126314514,164589,-,-
BAC88_J13,8,8q24.13,126254709,126374103,119394,-,-
BAC29_D23,8,8q24.13,126311298,126414114,102816,-,-
BAC80_E22,8,8q24.13,126317019,126414121,97102,-,-
BAC235_K20,8,8q24.13,126367287,126465876,98589,-,-
BAC105_E03,8,8q24.13,126414127,126515004,100877,-,-
BAC107_F08,8,8q24.13,126438136,126571394,133258,-,-
BAC5_O05,8,8q24.13,126442534,126553553,111019,-,-
BAC26_J17,8,8q24.13,126442534,126585150,142616,-,-
BAC42_J16,8,8q24.13,126472380,126585150,112770,-,-
BAC92_J18,8,8q24.13,126472606,126606835,134229,-,-
BAC218_P10,8,8q24.13,126563100,126681048,117948,-,-
BAC134_L01,8,8q24.13,126590364,126687218,96854,-,-
BAC189_A20,8,8q24.13,126613475,126713398,99923,-,-
BAC28_C09,8,8q24.13,126701637,126798540,96903,-,-
BAC32_C13,8,8q24.13,126807444,126917623,110179,-,-
BAC22_A21,8,8q24.13,126835201,126917623,82422,-,-
BAC125_E21,8,8q24.13,126919217,127003736,84519,-,-
BAC184_P22,8,8q24.13,126947484,127030285,82801,-,-
BAC142_J11,8,8q24.13,126966506,127060812,94306,-,-
BAC26_N03,8,8q24.13,126998312,127100648,102336,-,-
BAC155_L01,8,8q24.13,127049973,127152335,102362,-,-
BAC2_O13,8,8q24.13,127086008,127169366,83358,-,-
BAC106_F12,8,8q24.13,127169199,127267684,98485,-,-
BAC124_O24,8,8q24.13-8q24.21,127252027,127329765,77738,-,-
BAC147_I16,8,8q24.13-8q24.21,127267676,127353432,85756,-,-
BAC102_J06,8,8q24.21,127418080,127511813,93733,-,-
BAC186_I22,8,8q24.21,127636283,127760865,124582,-,-
BAC186_D16,8,8q24.21,127646133,127771951,125818,-,-
BAC154_G08,8,8q24.21,127691469,127771680,80211,-,-
BAC35_G06,8,8q24.21,127855439,127964112,108673,-,-
BAC196_O04,8,8q24.21,127871907,127960883,88976,-,-
BAC191_N13,8,8q24.21,127966843,128064300,97457,-,-
BAC31_G20,8,8q24.21,127970019,128046091,76072,-,-
BAC75_P21,8,8q24.21,127970019,128064272,94253,-,-
BAC160_E13,8,8q24.21,127970031,128045056,75025,-,-
BAC198_K07,8,8q24.21,128047876,128148974,101098,-,-
BAC53_L17,8,8q24.21,128110225,128193827,83602,-,-
BAC136_I10,8,8q24.21,128371183,128472054,100871,-,-
BAC71_J05,8,8q24.21,128537601,128639510,101909,-,-
BAC88_M01,8,8q24.21,128537606,128657319,119713,-,-
BAC110_E05,8,8q24.21,128577341,128689429,112088,-,-
BAC83_L15,8,8q24.21,128577341,128676090,98749,-,-
BAC151_G24,8,8q24.21,128615156,128706715,91559,-,-
BAC195_E13,8,8q24.21,128676159,128794598,118439,-,-
BAC68_I02,8,8q24.21,128791040,128885559,94519,-,-
BAC229_D13,8,8q24.21,128800101,128881786,81685,-,-
BAC192_N08,8,8q24.21,128800101,128877448,77347,-,-
BAC39_M05,8,8q24.21,128801165,128906038,104873,-,-
BAC186_H16,8,8q24.21,128852937,128957175,104238,-,-
BAC180_J01,8,8q24.21,128866501,128951097,84596,-,-
BAC146_J17,8,8q24.21,128881994,128980537,98543,-,-
BAC44_O14,8,8q24.21,128891825,129012613,120788,-,-
BAC90_K23,8,8q24.21,128957169,129038307,81138,-,-
BAC72_M18,8,8q24.21,129029906,129135849,105943,-,-
BAC220_B07,8,8q24.21,129151084,129242366,91282,-,-
BAC157_M08,8,8q24.21,129234422,129316111,81689,-,-
BAC231_H11,8,8q24.21,129234422,129332353,97931,-,-
BAC237_D16,8,8q24.21,129594434,129694886,100452,-,-
BAC158_H13,8,8q24.21,129594434,129674196,79762,-,-
BAC92_C08,8,8q24.21,129688753,129786656,97903,-,-
BAC53_I06,8,8q24.21,129859305,129938473,79168,-,-
BAC90_O04,8,8q24.21,129975289,130150036,174747,-,-
BAC82_D04,8,8q24.21,129989174,130075991,86817,-,-
BAC193_O03,8,8q24.21,130114660,130200985,86325,-,-
BAC91_O14,8,8q24.21,130294103,130413921,119818,-,-
BAC107_H12,8,8q24.21,130359067,130461876,102809,-,-
BAC36_L02,8,8q24.21,130481520,130613408,131888,-,-
BAC221_K12,8,8q24.21,130574775,130679875,105100,-,-
BAC158_G18,8,8q24.21,130747847,130816007,68160,-,-
BAC51_I20,8,8q24.21,130786062,130916424,130362,yes,-
BAC8_D07,8,8q24.21,130786147,130916969,130822,yes,-
BAC80_L16,8,8q24.21,130805637,130916107,110470,yes,-
BAC128_O06,8,8q24.21,130865689,131008179,142490,-,-
BAC106_N19,8,8q24.21,130917178,131072962,155784,-,-
BAC209_N02,8,8q24.21,130937995,131076917,138922,-,-
BAC206_P08,8,8q24.21,131034706,131120640,85934,-,-
BAC105_E02,8,8q24.21,131072955,131147465,74510,-,-
BAC58_N22,8,8q24.21,131093782,131208103,114321,-,-
BAC65_H12,8,8q24.21,131120649,131232495,111846,-,-
BAC75_M15,8,8q24.21,131235577,131340490,104913,-,-
BAC195_N23,8,8q24.21,131335153,131416010,80857,-,-
BAC76_O07,8,8q24.21,131383424,131455975,72551,-,-
BAC233_I11,8,8q24.21,131392381,131485737,93356,-,-
BAC57_O23,8,8q24.22,131520568,131629489,108921,-,-
BAC38_L01,8,8q24.22,131549304,131672199,122895,-,-
BAC239_D12,8,8q24.22,131568599,131676943,108344,-,-
BAC80_I05,8,8q24.22,131640840,131730353,89513,-,-
BAC51_H10,8,8q24.22,131658241,131796959,138718,-,-
BAC196_M09,8,8q24.22,131724215,131825814,101599,-,-
BAC151_J23,8,8q24.22,131770343,131872573,102230,-,-
BAC116_D17,8,8q24.22,131771476,131858284,86808,-,-
BAC120_P05,8,8q24.22,131797290,131921578,124288,-,-
BAC218_O11,8,8q24.22,131832808,131915749,82941,-,-
BAC159_O03,8,8q24.22,132049152,132139125,89973,-,-
BAC59_A23,8,8q24.22,132060108,132141326,81218,-,-
BAC158_I08,8,8q24.22,132098141,132181019,82878,-,-
BAC217_C15,8,8q24.22,132166873,132273397,106524,-,-
BAC243_N05,8,8q24.22,132402876,132503917,101041,-,-
BAC180_O17,8,8q24.22,132413200,132501857,88657,-,-
BAC56_I19,8,8q24.22,132485629,132572991,87362,-,-
BAC36_N18,8,8q24.22,132487234,132663973,176739,-,-
BAC179_J18,8,8q24.22,132524910,132599031,74121,-,-
BAC132_H23,8,8q24.22,132597769,132690934,93165,-,-
BAC90_P04,8,8q24.22,132611904,132704000,92096,-,-
BAC200_G22,8,8q24.22,132748754,132831975,83221,-,-
BAC186_F09,8,8q24.22,132784899,132881821,96922,-,-
BAC2_D13,8,8q24.22,132930125,133042852,112727,-,-
BAC192_O03,8,8q24.22,132955803,133029966,74163,-,-
BAC224_K13,8,8q24.22,133050214,133128135,77921,-,-
BAC219_K15,8,8q24.22,133128129,133234908,106779,-,-
BAC181_P03,8,8q24.22,133131575,133215585,84010,-,-
BAC162_C06,8,8q24.22,133155820,133234908,79088,-,-
BAC71_N12,8,8q24.22,133183799,133301251,117452,-,-
BAC125_I08,8,8q24.22,133245001,133348221,103220,-,-
BAC192_J09,8,8q24.22,133279639,133361071,81432,-,-
BAC64_I19,8,8q24.22,133281830,133383441,101611,-,-
BAC171_E01,8,8q24.22,133286453,133361071,74618,-,-
BAC108_L03,8,8q24.22,133319100,133408484,89384,-,-
BAC24_B01,8,8q24.22,133319108,133387743,68635,-,-
BAC153_M15,8,8q24.22,133361354,133453819,92465,-,-
BAC131_F08,8,8q24.22,133361354,133453818,92464,-,-
BAC117_K03,8,8q24.22,133426309,133520534,94225,-,-
BAC68_I23,8,8q24.22,133489852,133608098,118246,-,-
BAC106_E23,8,8q24.22,133514235,133653380,139145,-,-
BAC183_H02,8,8q24.22,133582387,133710243,127856,-,-
BAC29_H19,8,8q24.22,133596920,133732372,135452,-,-
BAC141_H08,8,8q24.22,133608093,133695395,87302,-,-
BAC167_B09,8,8q24.22,133608094,133727132,119038,-,-
BAC106_I15,8,8q24.22,133761189,133883571,122382,-,-
BAC233_L07,8,8q24.22,133789910,133865691,75781,-,-
BAC248_K02,8,8q24.22,133992255,134105265,113010,-,-
BAC242_G02,8,8q24.22,133994927,134092332,97405,-,-
BAC30_D12,8,8q24.22,133994973,134138294,143321,-,-
BAC101_I04,8,8q24.22,134003774,134092331,88557,-,-
BAC117_K09,8,8q24.22,134003774,134148333,144559,-,-
BAC141_O01,8,8q24.22,134004476,134121049,116573,-,-
BAC100_A11,8,8q24.22,134015852,134111824,95972,-,-
BAC241_E20,8,8q24.22,134022344,134111824,89480,-,-
BAC10_L07,8,8q24.22,134034955,134130949,95994,-,-
BAC81_L24,8,8q24.22,134042751,134195629,152878,-,-
BAC163_A18,8,8q24.22,134042758,134148333,105575,-,-
BAC97_K13,8,8q24.22,134124702,134332771,208069,-,-
BAC119_L08,8,8q24.22,134130948,134244532,113584,-,-
BAC125_P02,8,8q24.22,134130948,134248354,117406,-,-
BAC173_C23,8,8q24.22,134138286,134223481,85195,-,-
BAC32_C21,8,8q24.22,134148342,134344696,196354,-,-
BAC92_E14,8,8q24.22,134156537,134297153,140616,-,-
BAC126_M05,8,8q24.22,134176362,134304921,128559,-,-
BAC221_I04,8,8q24.22,134236844,134342339,105495,-,-
BAC113_P08,8,8q24.22,134244526,134344801,100275,-,-
BAC125_F15,8,8q24.22,134248349,134332771,84422,-,-
BAC42_K12,8,8q24.22,134248349,134422587,174238,-,-
BAC107_K07,8,8q24.22,134280502,134366178,85676,-,-
BAC84_M21,8,8q24.22,134342548,134422602,80054,-,-
BAC146_I16,8,8q24.22,134344794,134440638,95844,-,-
BAC18_O14,8,8q24.22,134344836,134441165,96329,-,-
BAC56_C14,8,8q24.22,134437460,134515003,77543,-,-
BAC51_F18,8,8q24.22,134440654,134533800,93146,-,-
BAC158_E23,8,8q24.22,134448308,134528974,80666,-,-
BAC169_H02,8,8q24.22,134483196,134618746,135550,-,-
BAC248_I07,8,8q24.22,134528982,134623159,94177,-,-
BAC139_M03,8,8q24.22,134545999,134638654,92655,-,-
BAC73_M09,8,8q24.22,134563705,134674642,110937,-,-
BAC126_K09,8,8q24.22,134598793,134694480,95687,-,-
BAC193_C13,8,8q24.22,134638647,134693759,55112,-,-
BAC219_O07,8,8q24.22,134871530,134990219,118689,-,-
BAC189_D16,8,8q24.22,134871530,134956314,84784,-,-
BAC106_C15,8,8q24.22,134880823,134990219,109396,-,-
BAC176_B17,8,8q24.22,134932570,135027766,95196,-,-
BAC220_I24,8,8q24.22,135017931,135106265,88334,-,-
BAC64_D17,8,8q24.22,135027761,135115943,88182,-,-
BAC218_M03,8,8q24.22,135040467,135127283,86816,-,-
BAC149_F03,8,8q24.22,135051576,135172889,121313,-,-
BAC146_G13,8,8q24.22,135139721,135228362,88641,-,-
BAC194_C15,8,8q24.22,135181375,135296053,114678,-,-
BAC192_C11,8,8q24.22,135203479,135287603,84124,-,-
BAC231_P01,8,8q24.22,135228356,135314743,86387,-,-
BAC100_M09,8,8q24.22,135332332,135491092,158760,-,-
BAC158_G16,8,8q24.22,135332338,135437068,104730,-,-
BAC232_C01,8,8q24.22,135338200,135431905,93705,-,-
BAC6_N22,8,8q24.22,135364885,135461292,96407,-,-
BAC58_N21,8,8q24.22,135364904,135455217,90313,-,-
BAC149_L07,8,8q24.22,135551488,135636882,85394,-,-
BAC134_N07,8,8q24.22,135551488,135634646,83158,-,-
BAC230_B13,8,8q24.22,135557411,135660414,103003,-,-
BAC150_P12,8,8q24.22,135673467,135809603,136136,-,-
BAC69_M23,8,8q24.22,135697222,135829020,131798,-,-
BAC178_P11,8,8q24.22,135721790,135815288,93498,-,-
BAC2_B11,8,8q24.22,135724825,135809580,84755,-,-
BAC246_L17,8,8q24.22,135752817,135839925,87108,-,-
BAC181_I14,8,8q24.22,135752817,135829047,76230,-,-
BAC57_F03,8,8q24.22,135782261,135896127,113866,-,-
BAC21_J08,8,8q24.22,135809785,135898817,89032,-,-
BAC69_N05,8,8q24.22,135864429,135976462,112033,-,-
BAC56_F18,8,8q24.22,135902434,135998625,96191,-,-
BAC83_B20,8,8q24.22,135941793,136018352,76559,-,-
BAC83_J04,8,8q24.22,135949243,136071001,121758,-,-
BAC238_J08,8,8q24.22,135967713,136058973,91260,-,-
BAC44_O04,8,8q24.22,135994487,136119754,125267,-,-
BAC156_H20,8,8q24.22,136084870,136195285,110415,-,-
BAC101_L02,8,8q24.22,136107793,136226171,118378,-,-
BAC109_H03,8,8q24.22,136143367,136227488,84121,-,-
BAC218_A13,8,8q24.22,136173900,136252183,78283,-,-
BAC198_C10,8,8q24.22,136178205,136263802,85597,-,-
BAC90_C04,8,8q24.22,136259162,136378604,119442,-,-
BAC246_M13,8,8q24.22,136322136,136486560,164424,-,-
BAC123_O14,8,8q24.22,136322136,136399452,77316,-,-
BAC145_F11,8,8q24.22,136351399,136459593,108194,-,-
BAC40_I02,8,8q24.22,136351437,136485187,133750,-,-
BAC233_M05,8,8q24.22,136364114,136493433,129319,-,-
BAC218_O23,8,8q24.22,136378639,136486574,107935,-,-
BAC144_N01,8,8q24.22,136406569,136486575,80006,-,-
BAC90_P21,8,8q24.22-8q24.23,136450991,136533701,82710,-,-
BAC21_B16,8,8q24.23,136533481,136544191,10710,-,-
BAC240_E12,8,8q24.23,136592231,136673221,80990,-,-
BAC91_E15,8,8q24.23,136600537,136708823,108286,-,-
BAC198_P20,8,8q24.23,136633566,136704749,71183,-,-
BAC176_K01,8,8q24.23,136733026,136833795,100769,-,-
BAC39_L16,8,8q24.23,136739080,136865879,126799,-,-
BAC64_E13,8,8q24.23,136739080,136949955,210875,-,-
BAC223_O01,8,8q24.23,136766682,136895973,129291,-,-
BAC46_N09,8,8q24.23,136790766,136906754,115988,-,-
BAC184_N23,8,8q24.23,136790814,136883611,92797,-,-
BAC43_A23,8,8q24.23,136791365,136947179,155814,-,-
BAC62_F14,8,8q24.23,136900426,137027995,127569,-,-
BAC38_K08,8,8q24.23,136947192,137068482,121290,-,-
BAC162_M14,8,8q24.23,136963484,137060399,96915,-,-
BAC199_G14,8,8q24.23,137056277,137148652,92375,-,-
BAC140_F18,8,8q24.23,137084195,137169208,85013,-,-
BAC163_C11,8,8q24.23,137085121,137181900,96779,-,-
BAC10_E09,8,8q24.23,137098438,137169522,71084,-,-
BAC193_N16,8,8q24.23,137120227,137200466,80239,-,-
BAC229_C01,8,8q24.23,137148647,137244400,95753,-,-
BAC193_D10,8,8q24.23,137240006,137335632,95626,-,-
BAC167_C10,8,8q24.23,137388368,137472160,83792,-,-
BAC80_B05,8,8q24.23,137448498,137603285,154787,-,-
BAC221_L17,8,8q24.23,137489956,137574926,84970,-,-
BAC157_J15,8,8q24.23,137590631,137675122,84491,-,-
BAC85_F03,8,8q24.23,137759202,137842523,83321,-,-
BAC120_E16,8,8q24.23,137759205,137855975,96770,-,-
BAC182_G17,8,8q24.23,137956416,138040039,83623,-,-
BAC195_D21,8,8q24.23,138256251,138341192,84941,-,-
BAC165_C15,8,8q24.23,138325747,138401874,76127,-,-
BAC244_M15,8,8q24.23,138357097,138463021,105924,-,-
BAC159_L10,8,8q24.23,138386544,138450772,64228,-,-
BAC161_G16,8,8q24.23,138438735,138532994,94259,-,-
BAC217_B17,8,8q24.23,138583661,138693096,109435,-,-
BAC229_L18,8,8q24.23,138648140,138738926,90786,-,-
BAC244_L21,8,8q24.23,138783139,138918735,135596,-,-
BAC224_A23,8,8q24.23,138801732,138881657,79925,-,-
BAC156_L04,8,8q24.23,138848507,138961021,112514,-,-
BAC151_B14,8,8q24.23,138848507,138926551,78044,-,-
BAC199_G10,8,8q24.23,138924627,139039819,115192,-,-
BAC30_G23,8,8q24.23,138954711,139046953,92242,-,-
BAC238_D01,8,8q24.23,139072834,139159626,86792,-,-
BAC197_E14,8,8q24.23,139114635,139196428,81793,-,-
BAC177_B10,8,8q24.23,139114635,139199357,84722,-,-
BAC133_A02,8,8q24.23,139114807,139236086,121279,-,-
BAC161_B18,8,8q24.23,139143776,139221190,77414,-,-
BAC151_A24,8,8q24.23,139151824,139234007,82183,-,-
BAC91_G23,8,8q24.23,139201264,139288976,87712,-,-
BAC145_E04,8,8q24.23,139319717,139473054,153337,-,-
BAC183_D23,8,8q24.23,139403764,139516718,112954,-,-
BAC169_K14,8,8q24.23,139428918,139511044,82126,-,-
BAC33_J05,8,8q24.23,139481209,139569853,88644,-,-
BAC76_J24,8,8q24.23,139516822,139532992,16170,-,-
BAC224_E06,8,8q24.23,139516868,139614924,98056,-,-
BAC58_P10,8,8q24.23,139520900,139609190,88290,-,-
BAC27_F01,8,8q24.23,139570111,139673477,103366,-,-
BAC132_L16,8,8q24.23,139571507,139665743,94236,-,-
BAC148_N06,8,8q24.23,139616256,139703828,87572,-,-
BAC222_G11,8,8q24.23,139640237,139722408,82171,-,-
BAC15_E10,8,8q24.23,139640237,139783521,143284,-,-
BAC188_M24,8,8q24.23,139693465,139759268,65803,-,-
BAC171_E22,8,8q24.23,139842249,139929030,86781,-,-
BAC91_B09,8,8q24.23-8q24.3,139855295,140000224,144929,-,-
BAC76_N02,8,8q24.23-8q24.3,139943494,140065119,121625,-,-
BAC43_H09,8,8q24.3,140127141,140212535,85394,-,-
BAC37_C13,8,8q24.3,140145305,140251051,105746,-,-
BAC177_D19,8,8q24.3,140157765,140234371,76606,-,-
BAC139_G07,8,8q24.3,140203857,140302351,98494,-,-
BAC77_M23,8,8q24.3,140228481,140341484,113003,-,-
BAC165_C10,8,8q24.3,140271585,140364176,92591,-,-
BAC18_P15,8,8q24.3,140272046,140380520,108474,-,-
BAC178_A06,8,8q24.3,140281870,140417548,135678,-,-
BAC21_K04,8,8q24.3,140342828,140477868,135040,-,-
BAC73_I03,8,8q24.3,140352895,140436120,83225,-,-
BAC127_M04,8,8q24.3,140436115,140523856,87741,-,-
BAC76_M02,8,8q24.3,140445302,140528861,83559,-,-
BAC44_I12,8,8q24.3,140446433,140529119,82686,-,-
BAC160_I21,8,8q24.3,140491124,140581238,90114,-,-
BAC97_N11,8,8q24.3,140525613,140616249,90636,-,-
BAC49_F01,8,8q24.3,140531925,140659403,127478,-,-
BAC39_G20,8,8q24.3,140536780,140694960,158180,-,-
BAC167_F18,8,8q24.3,140548120,140695650,147530,-,-
BAC250_H18,8,8q24.3,140624394,140694953,70559,-,-
BAC23_B10,8,8q24.3,140629041,140737964,108923,-,-
BAC130_L14,8,8q24.3,140666021,140791303,125282,-,-
BAC219_B11,8,8q24.3,140769463,140914588,145125,-,-
BAC158_J19,8,8q24.3,140772152,140909528,137376,-,-
BAC32_P22,8,8q24.3,140772153,140913507,141354,-,-
BAC88_N12,8,8q24.3,140801554,140888305,86751,-,-
BAC132_O02,8,8q24.3,140818011,140910505,92494,-,-
BAC223_I05,8,8q24.3,140818011,140910471,92460,-,-
BAC180_H08,8,8q24.3,140831134,140926137,95003,-,-
BAC252_O10,8,8q24.3,140909555,141039104,129549,-,-
BAC196_E13,8,8q24.3,140909556,141039104,129548,-,-
BAC73_M18,8,8q24.3,140913573,141010590,97017,-,-
BAC100_B23,8,8q24.3,140914584,141012994,98410,-,-
BAC66_I02,8,8q24.3,140926132,141036056,109924,-,-
BAC85_I18,8,8q24.3,140965114,141064549,99435,-,-
BAC180_F13,8,8q24.3,140978606,141063188,84582,-,-
BAC63_G24,8,8q24.3,140979941,141093999,114058,-,-
BAC49_C04,8,8q24.3,140982553,141093999,111446,-,-
BAC156_F02,8,8q24.3,141049121,141164064,114943,-,-
BAC10_J02,8,8q24.3,141062517,141191395,128878,-,-
BAC133_G03,8,8q24.3,141085495,141222853,137358,-,-
BAC15_K15,8,8q24.3,141098850,141191387,92537,-,-
BAC238_D02,8,8q24.3,141108954,141201836,92882,-,-
BAC116_F06,8,8q24.3,141108954,141222876,113922,-,-
BAC36_G01,8,8q24.3,141110515,141239924,129409,-,-
BAC102_N17,8,8q24.3,141272928,141460461,187533,-,-
BAC115_M17,8,8q24.3,141273994,141375089,101095,-,-
BAC107_C03,8,8q24.3,141303043,141401301,98258,-,-
BAC162_B11,8,8q24.3,141357405,141474162,116757,-,-
BAC161_O23,8,8q24.3,141367772,141460461,92689,-,-
BAC2_E15,8,8q24.3,141370143,141459140,88997,-,-
BAC217_B13,8,8q24.3,141394734,141524577,129843,-,-
BAC160_A06,8,8q24.3,141410429,141518944,108515,-,-
BAC189_J16,8,8q24.3,141416745,141515624,98879,-,-
BAC37_H03,8,8q24.3,141476681,141566331,89650,-,-
BAC157_P09,8,8q24.3,141532799,141662238,129439,-,-
BAC114_G22,8,8q24.3,141545982,141704928,158946,-,-
BAC190_N07,8,8q24.3,141559272,141660120,100848,-,-
BAC63_P09,8,8q24.3,141579121,141674329,95208,-,-
BAC158_N19,8,8q24.3,141579123,141662225,83102,-,-
BAC149_G13,8,8q24.3,141579125,141738478,159353,-,-
BAC145_P06,8,8q24.3,141586760,141675893,89133,-,-
BAC100_M07,8,8q24.3,141596184,141745626,149442,-,-
BAC39_J13,8,8q24.3,141604552,141691138,86586,-,-
BAC139_E17,8,8q24.3,141704937,141777133,72196,-,-
BAC75_E02,8,8q24.3,141739047,141813708,74661,-,-
BAC249_K21,8,8q24.3,141761228,141862215,100987,-,-
BAC181_O22,8,8q24.3,141775708,141871280,95572,-,-
BAC204_C15,8,8q24.3,141775712,141864297,88585,-,-
BAC228_J03,8,8q24.3,141832681,141916645,83964,-,-
BAC133_M06,8,8q24.3,141914527,142035515,120988,-,-
BAC180_O14,8,8q24.3,141916642,142023689,107047,-,-
BAC49_F02,8,8q24.3,141916653,142023639,106986,-,-
BAC100_P19,8,8q24.3,141920419,142023714,103295,-,-
BAC230_M15,8,8q24.3,141949312,142035515,86203,-,-
BAC139_E16,8,8q24.3,141969563,142055891,86328,-,-
BAC226_K05,8,8q24.3,141989299,142075796,86497,-,-
BAC9_H14,8,8q24.3,141989299,142075796,86497,-,-
BAC60_G06,8,8q24.3,142050212,142163657,113445,-,-
BAC16_C11,8,8q24.3,142062400,142172095,109695,-,-
BAC19_E21,8,8q24.3,142075798,142198930,123132,-,-
BAC116_B06,8,8q24.3,142115621,142214833,99212,-,-
BAC75_O22,8,8q24.3,142115642,142202444,86802,-,-
BAC31_M03,8,8q24.3,142132383,142205098,72715,-,-
BAC97_F09,8,8q24.3,142134528,142265703,131175,-,-
BAC161_J11,8,8q24.3,142163652,142265701,102049,-,-
BAC146_G08,8,8q24.3,142227408,142353206,125798,-,-
BAC188_E24,8,8q24.3,142227440,142345107,117667,-,-
BAC180_P04,8,8q24.3,142244199,142356775,112576,-,-
BAC247_F02,8,8q24.3,142308821,142396464,87643,-,-
BAC142_J16,8,8q24.3,142314794,142466278,151484,-,-
BAC223_P13,8,8q24.3,142353200,142484996,131796,-,-
BAC105_L02,8,8q24.3,142353404,142484996,131592,-,-
BAC15_A20,8,8q24.3,142359712,142370760,11048,-,-
BAC209_B19,8,8q24.3,142396397,142484996,88599,-,-
BAC165_L04,8,8q24.3,142396461,142484996,88535,-,-
BAC248_O12,8,8q24.3,142396509,142486786,90277,-,-
BAC152_I03,8,8q24.3,142404423,142486786,82363,-,-
BAC227_K05,8,8q24.3,142668455,142754914,86459,-,-
BAC56_L01,8,8q24.3,142903110,143031272,128162,-,-
BAC136_I03,8,8q24.3,142906592,142990979,84387,-,-
BAC155_J21,8,8q24.3,143028634,143110246,81612,-,-
BAC119_L17,8,8q24.3,143040812,143247205,206393,-,-
BAC126_B14,8,8q24.3,143110238,143209483,99245,-,-
BAC48_O11,8,8q24.3,143131353,143259707,128354,-,-
BAC67_G12,8,8q24.3,143160163,143280871,120708,-,-
BAC115_N18,8,8q24.3,143165360,143271175,105815,-,-
BAC237_E07,8,8q24.3,143224451,143303962,79511,-,-
BAC229_N13,8,8q24.3,143499025,143601588,102563,-,-
BAC66_N14,8,8q24.3,143501971,143611021,109050,-,-
BAC78_P17,8,8q24.3,143720193,143816162,95969,-,-
BAC127_O19,8,8q24.3,143745327,143874425,129098,-,-
BAC51_K19,8,8q24.3,143751505,143920371,168866,-,-
BAC248_H12,8,8q24.3,143816477,143915074,98597,-,-
BAC185_E03,8,8q24.3,143824287,143942418,118131,-,-
BAC80_H03,8,8q24.3,144118164,144215600,97436,-,-
BAC170_E14,8,8q24.3,144140066,144229826,89760,-,-
BAC36_O22,8,8q24.3,144140066,144229820,89754,-,-
BAC148_O04,8,8q24.3,144144791,144278547,133756,-,-
BAC68_F11,8,8q24.3,144157638,144244441,86803,-,-
BAC142_A07,8,8q24.3,144178365,144291895,113530,-,-
BAC130_D14,8,8q24.3,144184252,144282053,97801,-,-
BAC24_M19,8,8q24.3,144268856,144291899,23043,-,-
BAC179_F03,8,8q24.3,144280131,144417787,137656,-,-
BAC208_O07,8,8q24.3,144417818,144540074,122256,-,-
BAC248_J09,8,8q24.3,144548965,144636414,87449,-,-
BAC244_O01,8,8q24.3,144549367,144638906,89539,-,-
BAC37_J12,8,8q24.3,144571199,144743456,172257,-,-
BAC145_J12,8,8q24.3,144657717,144743771,86054,-,-
BAC59_C09,8,8q24.3,144807440,144930485,123045,-,-
BAC140_B14,8,8q24.3,144830774,144930485,99711,-,-
BAC136_C07,8,8q24.3,144830774,144930485,99711,-,-
BAC240_I05,8,8q24.3,144911233,144996533,85300,-,-
BAC114_M10,8,8q24.3,144978120,144996428,18308,-,-
BAC230_E06,8,8q24.3,144978122,145054265,76143,-,-
BAC60_N04,8,8q24.3,144996527,145120272,123745,-,-
BAC57_F07,8,8q24.3,144996527,145114293,117766,-,-
BAC150_O18,8,8q24.3,145054260,145152416,98156,-,-
BAC191_B20,8,8q24.3,145054267,145160385,106118,-,-
BAC119_A10,8,8q24.3,145191095,145375173,184078,yes,-
BAC37_G16,8,8q24.3,145204818,145288055,83237,-,-
BAC109_K03,8,8q24.3,145298613,145384455,85842,-,-
BAC27_O09,8,8q24.3,145358564,145597650,239086,yes,-
BAC59_D14,8,8q24.3,145384461,145580407,195946,-,-
BAC33_L01,8,8q24.3,145394386,145580407,186021,-,-
BAC195_D02,8,8q24.3,145475011,145580407,105396,-,-
BAC239_L13,8,8q24.3,145486882,145628846,141964,yes,-
BAC241_B10,8,8q24.3,145498834,145580407,81573,-,-
BAC193_J11,8,8q24.3,145648970,145759358,110388,yes,-
BAC243_O12,8,8q24.3,145648982,145762120,113138,yes,-
BAC231_O03,8,8q24.3,145689700,145806412,116712,yes,-
BAC135_C02,8,8q24.3,145709491,145806412,96921,-,-
BAC123_P17,8,8q24.3,145752069,145842340,90271,-,-
BAC39_A09,8,8q24.3,145759353,145851538,92185,-,-
BAC220_N02,8,8q24.3,145762155,145831712,69557,-,-
BAC82_E07,8,8q24.3,145864984,146015743,150759,-,-
BAC123_L12,8,8q24.3,145882696,145985429,102733,-,-
BAC218_F22,8,8q24.3,145894810,145976576,81766,-,-
BAC162_G05,8,8q24.3,145898406,145998873,100467,-,-
BAC201_K02,8,8q24.3,145904174,145987862,83688,-,-
BAC66_I24,8,8q24.3,145923845,145998901,75056,-,-
BAC231_N23,8,8q24.3,145945693,146036579,90886,-,-
BAC90_J13,8,8q24.3,145949091,146036481,87390,-,-
BAC90_P13,8,8q24.3,145949490,146036565,87075,-,-
BAC37_L02,8,8q24.3,145969856,146072401,102545,-,-
BAC15_K02,8,8q24.3,146015801,146139237,123436,-,-
BAC240_A24,8,8q24.3,146042442,146145262,102820,-,-
BAC25_O16,8,8q24.3,146043780,146171876,128096,-,-
BAC48_M07,8,8q24.3,146075563,146170939,95376,-,-
BAC172_F08,8,8q24.3,146119042,146201248,82206,-,-
BAC40_B18,9,9p24.3,50221,147286,97065,yes,-
BAC53_K10,9,9p24.3,67460,170902,103442,yes,-
BAC24_O07,9,9p24.3,147880,288425,140545,-,-
BAC131_A19,9,9p24.3,224812,317135,92323,-,-
BAC57_F05,9,9p24.3,241509,336205,94696,-,-
BAC37_B08,9,9p24.3,252749,354301,101552,-,-
BAC176_J18,9,9p24.3,288913,373700,84787,-,-
BAC30_I17,9,9p24.3,304921,465421,160500,-,-
BAC160_K09,9,9p24.3,318513,417968,99455,-,-
BAC103_I12,9,9p24.3,327205,431985,104780,-,-
BAC189_I01,9,9p24.3,384449,491072,106623,-,-
BAC222_I23,9,9p24.3,391413,488204,96791,-,-
BAC53_N08,9,9p24.3,414748,566802,152054,-,-
BAC71_F15,9,9p24.3,488330,573525,85195,-,-
BAC57_C01,9,9p24.3,502603,638601,135998,-,-
BAC11_I05,9,9p24.3,573730,784117,210387,-,-
BAC60_D06,9,9p24.3,617482,740717,123235,-,-
BAC24_N07,9,9p24.3,646889,743327,96438,-,-
BAC22_E06,9,9p24.3,650343,795535,145192,-,-
BAC28_K22,9,9p24.3,650561,743327,92766,-,-
BAC144_K24,9,9p24.3,655155,757531,102376,-,-
BAC101_J20,9,9p24.3,655155,777993,122838,-,-
BAC51_P01,9,9p24.3,672460,801876,129416,-,-
BAC101_F15,9,9p24.3,705950,795548,89598,-,-
BAC219_C02,9,9p24.3,732590,840369,107779,-,-
BAC189_N02,9,9p24.3,733486,813734,80248,-,-
BAC186_L14,9,9p24.3,801926,919185,117259,-,-
BAC217_I01,9,9p24.3,813808,908707,94899,-,-
BAC250_B08,9,9p24.3,919315,1032114,112799,-,-
BAC195_M05,9,9p24.3,1029200,1112741,83541,-,-
BAC70_M16,9,9p24.3,1047945,1147221,99276,-,-
BAC33_P03,9,9p24.3,1058533,1145269,86736,-,-
BAC226_L11,9,9p24.3,1112734,1217526,104792,-,-
BAC57_K07,9,9p24.3,1112734,1228186,115452,-,-
BAC76_B15,9,9p24.3,1112734,1176590,63856,-,-
BAC217_G11,9,9p24.3,1137986,1221117,83131,-,-
BAC239_M18,9,9p24.3,1245463,1302965,57502,-,-
BAC125_O18,9,9p24.3,1292054,1387152,95098,-,-
BAC180_K21,9,9p24.3,1313047,1400018,86971,-,-
BAC109_K14,9,9p24.3,1379632,1471130,91498,-,-
BAC57_D12,9,9p24.3,1590437,1734271,143834,-,-
BAC226_F04,9,9p24.3,1826909,1913684,86775,-,-
BAC181_M08,9,9p24.3,1834719,1916717,81998,-,-
BAC60_C12,9,9p24.3,1834719,1918037,83318,-,-
BAC146_E11,9,9p24.3,1845050,1927979,82929,-,-
BAC116_F04,9,9p24.3,1950896,2048076,97180,-,-
BAC76_D11,9,9p24.3,1950957,2046556,95599,-,-
BAC27_K05,9,9p24.3,2087249,2173099,85850,-,-
BAC73_G21,9,9p24.3-9p24.2,2196916,2285783,88867,-,-
BAC31_G08,9,9p24.2,2211092,2328813,117721,-,-
BAC55_I14,9,9p24.2,2286626,2397487,110861,-,-
BAC176_D02,9,9p24.2,2291512,2384419,92907,-,-
BAC155_P05,9,9p24.2,2291512,2375585,84073,-,-
BAC86_O15,9,9p24.2,2333147,2344787,11640,-,-
BAC117_J15,9,9p24.2,2452000,2580195,128195,-,-
BAC149_M22,9,9p24.2,2476860,2557064,80204,-,-
BAC75_D17,9,9p24.2,2524819,2622873,98054,-,-
BAC65_D05,9,9p24.2,2580189,2689192,109003,-,-
BAC24_N21,9,9p24.2,2589424,2721400,131976,-,-
BAC148_H21,9,9p24.2,2777576,2861634,84058,-,-
BAC92_E12,9,9p24.2,2806948,2925454,118506,-,-
BAC170_P23,9,9p24.2,2815278,2925885,110607,-,-
BAC59_A10,9,9p24.2,2958303,3078169,119866,-,-
BAC66_E09,9,9p24.2,2979745,3091806,112061,-,-
BAC123_H03,9,9p24.2,3005550,3138385,132835,-,-
BAC168_N16,9,9p24.2,3094902,3197288,102386,-,-
BAC51_P19,9,9p24.2,3233343,3353198,119855,-,-
BAC71_P14,9,9p24.2,3275999,3390661,114662,-,-
BAC57_K23,9,9p24.2,3326069,3470610,144541,-,-
BAC153_D18,9,9p24.2,3363085,3456874,93789,-,-
BAC153_C18,9,9p24.2,3363085,3456911,93826,-,-
BAC141_F20,9,9p24.2,3470756,3568648,97892,-,-
BAC58_P24,9,9p24.2,3535068,3675760,140692,-,-
BAC223_M13,9,9p24.2,3544855,3627895,83040,-,-
BAC39_L14,9,9p24.2,3549234,3643050,93816,-,-
BAC249_O10,9,9p24.2,3687361,3764803,77442,-,-
BAC223_J10,9,9p24.2,3740036,3813214,73178,-,-
BAC193_J05,9,9p24.2,3764798,3844276,79478,-,-
BAC168_B06,9,9p24.2,3764907,3890915,126008,-,-
BAC41_N07,9,9p24.2,3824241,3921852,97611,-,-
BAC86_B21,9,9p24.2,3847397,3946028,98631,-,-
BAC100_G15,9,9p24.2,3857791,3955976,98185,-,-
BAC106_K21,9,9p24.2,3921867,4011781,89914,-,-
BAC81_E24,9,9p24.2,3922291,4004124,81833,-,-
BAC221_P14,9,9p24.2,3930339,4025665,95326,-,-
BAC187_P05,9,9p24.2,3993763,4083664,89901,-,-
BAC95_N18,9,9p24.2,4009171,4096491,87320,-,-
BAC165_M03,9,9p24.2,4011775,4096491,84716,-,-
BAC199_A14,9,9p24.2,4051781,4140047,88266,-,-
BAC36_L21,9,9p24.2,4172957,4303233,130276,-,-
BAC81_H23,9,9p24.2,4175259,4256275,81016,-,-
BAC171_K08,9,9p24.2,4315759,4384080,68321,-,-
BAC130_L08,9,9p24.2,4375102,4457433,82331,-,-
BAC26_G14,9,9p24.2,4377055,4484973,107918,-,-
BAC179_K06,9,9p24.2-9p24.1,4522970,4609735,86765,-,-
BAC227_D09,9,9p24.2-9p24.1,4524846,4605824,80978,-,-
BAC208_H11,9,9p24.2-9p24.1,4525157,4610285,85128,-,-
BAC111_F06,9,9p24.1,4610552,4704543,93991,-,-
BAC171_F23,9,9p24.1,4628225,4736473,108248,-,-
BAC62_M04,9,9p24.1,4707443,4736453,29010,-,-
BAC123_J13,9,9p24.1,4769794,4855240,85446,-,-
BAC149_E12,9,9p24.1,4842336,4926458,84122,-,-
BAC228_B18,9,9p24.1,4847084,4976377,129293,-,-
BAC149_F04,9,9p24.1,4888445,4979215,90770,-,-
BAC136_A20,9,9p24.1,4891068,4989399,98331,-,-
BAC44_C08,9,9p24.1,4891939,4976423,84484,-,-
BAC42_N03,9,9p24.1,4943923,5073382,129459,-,-
BAC241_G09,9,9p24.1,5051821,5136777,84956,-,-
BAC114_C14,9,9p24.1,5120235,5235610,115375,-,-
BAC125_C16,9,9p24.1,5248691,5345851,97160,-,-
BAC108_H06,9,9p24.1,5278774,5391543,112769,-,-
BAC51_N23,9,9p24.1,5278778,5362672,83894,-,-
BAC183_G08,9,9p24.1,5312762,5391168,78406,-,-
BAC23_K04,9,9p24.1,5368867,5453009,84142,-,-
BAC96_L13,9,9p24.1,5434454,5553718,119264,-,-
BAC220_H20,9,9p24.1,5436654,5508806,72152,-,-
BAC186_P23,9,9p24.1,5623230,5704364,81134,-,-
BAC65_O01,9,9p24.1,5694393,5791689,97296,-,-
BAC224_H21,9,9p24.1,5775870,5860185,84315,-,-
BAC84_N16,9,9p24.1,5778423,5868932,90509,-,-
BAC59_H14,9,9p24.1,5819347,5901032,81685,-,-
BAC181_P22,9,9p24.1,5938473,6033829,95356,-,-
BAC92_J12,9,9p24.1,5938728,6019215,80487,-,-
BAC236_J08,9,9p24.1,5946376,6057978,111602,-,-
BAC160_D23,9,9p24.1,6028929,6107430,78501,-,-
BAC60_D03,9,9p24.1,6107603,6194432,86829,-,-
BAC82_H04,9,9p24.1,6169579,6278549,108970,-,-
BAC222_K17,9,9p24.1,6229315,6319537,90222,-,-
BAC21_K24,9,9p24.1,6294670,6315216,20546,-,-
BAC143_E17,9,9p24.1,6352072,6444464,92392,-,-
BAC243_E17,9,9p24.1,6365733,6462864,97131,-,-
BAC65_G17,9,9p24.1,6454526,6475223,20697,-,-
BAC145_A23,9,9p24.1,6516895,6629356,112461,-,-
BAC4_C22,9,9p24.1,6589981,6676608,86627,-,-
BAC149_B11,9,9p24.1,6642960,6739015,96055,-,-
BAC130_F09,9,9p24.1,6661600,6739015,77415,-,-
BAC52_A24,9,9p24.1,6693897,6775852,81955,-,-
BAC148_L21,9,9p24.1,6860648,6950282,89634,-,-
BAC218_N10,9,9p24.1,6860656,6949925,89269,-,-
BAC175_F07,9,9p24.1,6906631,6986205,79574,-,-
BAC218_A20,9,9p24.1,7040456,7131346,90890,-,-
BAC129_J07,9,9p24.1,7150992,7254748,103756,-,-
BAC73_G14,9,9p24.1,7324109,7435719,111610,-,-
BAC139_J01,9,9p24.1,7334856,7427501,92645,-,-
BAC56_F09,9,9p24.1,7459690,7570330,110640,-,-
BAC71_D01,9,9p24.1,7577607,7697533,119926,-,-
BAC191_L04,9,9p24.1,7620281,7732925,112644,-,-
BAC44_B03,9,9p24.1,7668141,7704773,36632,-,-
BAC49_F05,9,9p24.1,7678528,7766484,87956,-,-
BAC239_C11,9,9p24.1,7681665,7766542,84877,-,-
BAC116_K02,9,9p24.1,7681665,7780800,99135,-,-
BAC85_O11,9,9p24.1,7714707,7919078,204371,-,-
BAC166_I03,9,9p24.1,7812111,7903359,91248,-,-
BAC160_A23,9,9p24.1,7824643,7907323,82680,-,-
BAC143_C21,9,9p24.1,8129493,8219295,89802,-,-
BAC131_J15,9,9p24.1,8156874,8248668,91794,-,-
BAC136_L03,9,9p24.1,8219384,8318472,99088,-,-
BAC152_L16,9,9p24.1,8219384,8302438,83054,-,-
BAC109_K08,9,9p24.1,8222488,8289792,67304,-,-
BAC218_E23,9,9p24.1,8248757,8352108,103351,-,-
BAC65_P20,9,9p24.1,8308610,8450089,141479,-,-
BAC80_F23,9,9p24.1,8308622,8413950,105328,-,-
BAC182_N05,9,9p24.1,8486276,8571688,85412,-,-
BAC196_I04,9,9p24.1,8517439,8613743,96304,-,-
BAC100_L05,9,9p24.1,8710328,8865766,155438,-,-
BAC114_O03,9,9p24.1,8722487,8829748,107261,-,-
BAC135_L18,9,9p24.1,8723184,8806578,83394,-,-
BAC116_P02,9,9p24.1,8732147,8865765,133618,-,-
BAC249_N09,9,9p24.1,8752846,8843405,90559,-,-
BAC33_B13,9,9p23,9165670,9222467,56797,-,-
BAC32_M06,9,9p23,9541417,9693475,152058,-,-
BAC118_J08,9,9p23,9954663,10065457,110794,-,-
BAC32_C04,9,9p23,10029959,10116656,86697,-,-
BAC114_D11,9,9p23,10116964,10237376,120412,-,-
BAC78_B09,9,9p23,10219936,10314775,94839,-,-
BAC252_G14,9,9p23,10290569,10389271,98702,-,-
BAC179_P04,9,9p23,10309253,10389271,80018,-,-
BAC242_B10,9,9p23,10725937,10759480,33543,-,-
BAC30_D02,9,9p23,10754117,10858470,104353,-,-
BAC156_A23,9,9p23,10769623,10840788,71165,-,-
BAC76_M08,9,9p23,10997470,11081822,84352,-,-
BAC26_M14,9,9p23,11079355,11090219,10864,-,-
BAC43_P12,9,9p23,11296771,11410840,114069,-,-
BAC153_D03,9,9p23,11395005,11477198,82193,-,-
BAC81_G13,9,9p23,11395005,11489929,94924,-,-
BAC173_J01,9,9p23,11437893,11524224,86331,-,-
BAC24_P23,9,9p23,11522869,11629045,106176,-,-
BAC189_O19,9,9p23,11988179,12073999,85820,-,-
BAC109_O17,9,9p23,12003523,12094428,90905,-,-
BAC152_B10,9,9p23,12117571,12201622,84051,-,-
BAC18_D12,9,9p23,12262863,12345788,82925,-,-
BAC137_A08,9,9p23,12292598,12385035,92437,-,-
BAC71_J11,9,9p23,12416166,12531508,115342,-,-
BAC63_I06,9,9p23,12600952,12709523,108571,-,-
BAC120_N17,9,9p23,12619507,12756169,136662,-,-
BAC70_N18,9,9p23,12726149,12830453,104304,-,-
BAC49_F14,9,9p23,12765187,12849994,84807,-,-
BAC37_M02,9,9p23,12912286,13003931,91645,-,-
BAC133_J22,9,9p23,12972173,13076627,104454,-,-
BAC241_G01,9,9p23,12972210,13057637,85427,-,-
BAC232_M14,9,9p23,13056900,13140419,83519,-,-
BAC232_F21,9,9p23,13355183,13435316,80133,-,-
BAC75_A02,9,9p23,13405352,13512912,107560,-,-
BAC78_B03,9,9p23,13413050,13501683,88633,-,-
BAC210_J18,9,9p23,13435508,13519306,83798,-,-
BAC234_B17,9,9p23,13570843,13669726,98883,-,-
BAC192_L17,9,9p23,13601771,13706901,105130,-,-
BAC141_I17,9,9p23,13706013,13821971,115958,-,-
BAC14_D17,9,9p23,13796625,13949409,152784,-,-
BAC19_P12,9,9p23,13857283,13942196,84913,-,-
BAC28_L14,9,9p22.3,14200117,14314787,114670,-,-
BAC102_K09,9,9p22.3,14211850,14338876,127026,-,-
BAC108_N17,9,9p22.3,14282816,14379026,96210,-,-
BAC82_D14,9,9p22.3,14314789,14424653,109864,-,-
BAC108_F06,9,9p22.3,14329939,14433503,103564,-,-
BAC193_J13,9,9p22.3,14332067,14428654,96587,-,-
BAC172_M08,9,9p22.3,14342686,14424038,81352,-,-
BAC118_A16,9,9p22.3,14380631,14463235,82604,-,-
BAC139_H09,9,9p22.3,14420154,14498634,78480,-,-
BAC44_A06,9,9p22.3,14463435,14575808,112373,-,-
BAC179_A21,9,9p22.3,14470625,14551041,80416,-,-
BAC58_A22,9,9p22.3,14485230,14575822,90592,-,-
BAC213_O18,9,9p22.3,14743793,14841255,97462,-,-
BAC61_C17,9,9p22.3,14756060,14845833,89773,-,-
BAC227_L16,9,9p22.3,14763619,14845833,82214,-,-
BAC213_E09,9,9p22.3,14769456,14883589,114133,-,-
BAC143_N03,9,9p22.3,14790130,14940521,150391,-,-
BAC143_C10,9,9p22.3,14841260,14921360,80100,-,-
BAC154_F24,9,9p22.3,14943501,15043127,99626,-,-
BAC40_I09,9,9p22.3,15164518,15281845,117327,-,-
BAC198_H04,9,9p22.3,15248334,15360899,112565,-,-
BAC133_O13,9,9p22.3,15248334,15325872,77538,-,-
BAC23_A04,9,9p22.3,15302446,15421009,118563,-,-
BAC160_P23,9,9p22.3,15323278,15410019,86741,-,-
BAC50_B06,9,9p22.3,15337144,15533810,196666,-,-
BAC182_E02,9,9p22.3,15372729,15486314,113585,-,-
BAC200_K09,9,9p22.3,15384472,15485821,101349,-,-
BAC190_D21,9,9p22.3,15410128,15486331,76203,-,-
BAC75_F04,9,9p22.3,15471237,15582852,111615,-,-
BAC232_E10,9,9p22.3,15486325,15587485,101160,-,-
BAC189_A12,9,9p22.3,15529209,15618530,89321,-,-
BAC161_G09,9,9p22.3,15560820,15663699,102879,-,-
BAC147_M01,9,9p22.3,15666172,15758164,91992,-,-
BAC130_B13,9,9p22.3,16017371,16113244,95873,-,-
BAC109_O05,9,9p22.3,16022357,16118329,95972,-,-
BAC236_N20,9,9p22.3,16070430,16159025,88595,-,-
BAC115_G13,9,9p22.3,16082312,16179262,96950,-,-
BAC146_L17,9,9p22.3,16082312,16195478,113166,-,-
BAC167_P11,9,9p22.3,16087511,16199827,112316,-,-
BAC115_G11,9,9p22.3,16093090,16213712,120622,-,-
BAC48_L10,9,9p22.3,16141067,16248297,107230,-,-
BAC200_F12,9,9p22.3,16154979,16213723,58744,-,-
BAC249_F02,9,9p22.3,16218846,16309283,90437,-,-
BAC209_G18,9,9p22.3,16224195,16330690,106495,-,-
BAC89_K05,9,9p22.3,16240166,16331669,91503,-,-
BAC130_F07,9,9p22.3,16244697,16352112,107415,-,-
BAC149_M04,9,9p22.3,16320902,16419769,98867,-,-
BAC176_P16,9,9p22.3,16380616,16474406,93790,-,-
BAC17_O15,9,9p22.3,16380805,16473697,92892,-,-
BAC171_K16,9,9p22.3,16416340,16517190,100850,-,-
BAC29_F18,9,9p22.3-9p22.2,16540154,16618610,78456,-,-
BAC59_L06,9,9p22.2,16618715,16733243,114528,-,-
BAC120_L04,9,9p22.2,16643272,16734824,91552,-,-
BAC107_B03,9,9p22.2,16720058,16871020,150962,-,-
BAC146_C02,9,9p22.2,16725853,16810610,84757,-,-
BAC147_O17,9,9p22.2,16743718,16909064,165346,-,-
BAC69_O22,9,9p22.2,16810604,16958053,147449,-,-
BAC234_J09,9,9p22.2,16812587,16909064,96477,-,-
BAC220_N22,9,9p22.2,16820112,16887677,67565,-,-
BAC168_A13,9,9p22.2,16838347,16958859,120512,-,-
BAC80_O22,9,9p22.2,16838347,17009227,170880,-,-
BAC160_H09,9,9p22.2,16838347,16925425,87078,-,-
BAC25_P07,9,9p22.2,16840913,16957082,116169,-,-
BAC252_K01,9,9p22.2,17071700,17174993,103293,-,-
BAC12_J23,9,9p22.2,17083368,17162953,79585,-,-
BAC236_O16,9,9p22.2,17563063,17671172,108109,-,-
BAC59_H01,9,9p22.2,17575411,17683547,108136,-,-
BAC56_K22,9,9p22.2,17662780,17812245,149465,-,-
BAC167_I23,9,9p22.2,17776393,17879937,103544,-,-
BAC160_C08,9,9p22.2,17853709,17942897,89188,-,-
BAC27_J11,9,9p22.2,18104016,18221987,117971,-,-
BAC132_A10,9,9p22.2,18126193,18145460,19267,-,-
BAC200_P13,9,9p22.2,18133116,18221987,88871,-,-
BAC141_F06,9,9p22.2,18182554,18264937,82383,-,-
BAC89_D18,9,9p22.2,18289164,18401995,112831,-,-
BAC144_D11,9,9p22.2-9p22.1,18417702,18505903,88201,-,-
BAC73_O14,9,9p22.2-9p22.1,18455213,18550380,95167,-,-
BAC227_H16,9,9p22.2-9p22.1,18455242,18533344,78102,-,-
BAC129_L15,9,9p22.1,18560615,18656627,96012,-,-
BAC236_L09,9,9p22.1,18662544,18768282,105738,-,-
BAC76_L21,9,9p22.1,18702997,18804388,101391,-,-
BAC163_F09,9,9p22.1,18716524,18808862,92338,-,-
BAC26_N20,9,9p22.1,18741167,18897532,156365,-,-
BAC131_J14,9,9p22.1,18742201,18821282,79081,-,-
BAC239_H09,9,9p22.1,18743459,18867773,124314,-,-
BAC128_E07,9,9p22.1,18821013,18908176,87163,-,-
BAC141_C06,9,9p22.1,18875210,18953676,78466,-,-
BAC144_G16,9,9p22.1,18938731,19027948,89217,-,-
BAC171_B18,9,9p22.1,18960075,19062089,102014,-,-
BAC165_E12,9,9p22.1,18973096,19062089,88993,-,-
BAC71_C13,9,9p22.1,19062522,19172641,110119,-,-
BAC218_I19,9,9p22.1,19102725,19179071,76346,-,-
BAC89_H13,9,9p22.1,19114200,19206379,92179,-,-
BAC19_H17,9,9p22.1,19151606,19243716,92110,-,-
BAC163_K14,9,9p22.1,19179069,19361076,182007,-,-
BAC236_C09,9,9p22.1,19216316,19300400,84084,-,-
BAC96_G03,9,9p22.1,19216329,19301642,85313,-,-
BAC190_J17,9,9p22.1,19338825,19448715,109890,-,-
BAC211_D11,9,9p22.1,19625450,19723864,98414,-,-
BAC189_M09,9,9p22.1,19625510,19699753,74243,-,-
BAC42_L20,9,9p22.1,19716386,19826870,110484,-,-
BAC83_B13,9,9p22.1-9p21.3,19882760,19962615,79855,-,-
BAC74_A05,9,9p21.3,19931357,20014354,82997,-,-
BAC49_B18,9,9p21.3,19971224,20106279,135055,-,-
BAC217_A24,9,9p21.3,19973073,20067759,94686,-,-
BAC239_N11,9,9p21.3,19973100,20067759,94659,-,-
BAC42_G17,9,9p21.3,20084508,20226816,142308,-,-
BAC219_C04,9,9p21.3,20104860,20219453,114593,-,-
BAC23_N15,9,9p21.3,20213216,20298775,85559,-,-
BAC65_B15,9,9p21.3,20355356,20441517,86161,-,-
BAC160_C10,9,9p21.3,20495254,20587845,92591,-,-
BAC145_L02,9,9p21.3,20555265,20666106,110841,-,-
BAC127_H04,9,9p21.3,20561324,20685590,124266,-,-
BAC92_E02,9,9p21.3,20654830,20758679,103849,-,-
BAC221_P20,9,9p21.3,20679644,20758679,79035,-,-
BAC79_D09,9,9p21.3,20801312,20852078,50766,-,-
BAC115_C03,9,9p21.3,20829276,20921107,91831,-,-
BAC238_K08,9,9p21.3,21213846,21310124,96278,-,-
BAC243_O15,9,9p21.3,21213998,21338579,124581,-,-
BAC20_A07,9,9p21.3,21247598,21331161,83563,-,-
BAC91_A16,9,9p21.3,21272829,21344102,71273,-,-
BAC18_F19,9,9p21.3,21594199,21684904,90705,-,-
BAC55_F13,9,9p21.3,21726114,21856741,130627,-,-
BAC189_H19,9,9p21.3,21794494,21879943,85449,-,-
BAC34_F13,9,9p21.3,21891756,21981163,89407,-,-
BAC97_B16,9,9p21.3,21914241,21952126,37885,-,-
BAC37_H18,9,9p21.3,22185655,22317114,131459,-,-
BAC148_B23,9,9p21.3,22280458,22379852,99394,-,-
BAC187_H07,9,9p21.3,22348397,22416444,68047,-,-
BAC165_B20,9,9p21.3,22736265,22832064,95799,-,-
BAC12_B17,9,9p21.3,22981458,23084926,103468,-,-
BAC203_M08,9,9p21.3,23115110,23192252,77142,-,-
BAC55_M01,9,9p21.3,23198564,23304544,105980,-,-
BAC1_P24,9,9p21.3,23211181,23308856,97675,-,-
BAC105_A06,9,9p21.3,23387982,23483370,95388,-,-
BAC120_C04,9,9p21.3,23520916,23608997,88081,-,-
BAC223_L05,9,9p21.3,23627428,23704991,77563,-,-
BAC20_O11,9,9p21.3,23639563,23737481,97918,-,-
BAC137_L16,9,9p21.3,23665603,23759045,93442,-,-
BAC29_N23,9,9p21.3,23701587,23786271,84684,-,-
BAC88_P21,9,9p21.3,23737930,23838640,100710,-,-
BAC76_C17,9,9p21.3,23828318,23913697,85379,-,-
BAC16_I23,9,9p21.3,23874088,23975582,101494,-,-
BAC50_N04,9,9p21.3,23913691,24042091,128400,-,-
BAC54_K03,9,9p21.3,24119134,24231773,112639,-,-
BAC186_J22,9,9p21.3,24246431,24377847,131416,-,-
BAC92_O21,9,9p21.3,24589557,24702136,112579,-,-
BAC96_F20,9,9p21.3,24650094,24744309,94215,-,-
BAC163_D24,9,9p21.3,24769593,24849689,80096,-,-
BAC162_F20,9,9p21.3,24989118,25131378,142260,-,-
BAC151_J10,9,9p21.3,25243712,25355866,112154,-,-
BAC123_I21,9,9p21.3,25248840,25377970,129130,-,-
BAC31_C09,9,9p21.3,25355864,25458374,102510,-,-
BAC57_L19,9,9p21.2,25548208,25653639,105431,-,-
BAC145_J16,9,9p21.2,25553808,25653639,99831,-,-
BAC222_O01,9,9p21.2,25835351,25901821,66470,-,-
BAC53_H04,9,9p21.2,25944937,26033625,88688,-,-
BAC27_C20,9,9p21.2,26225535,26314680,89145,-,-
BAC141_K09,9,9p21.2,26385749,26465921,80172,-,-
BAC58_M20,9,9p21.2,26435356,26584817,149461,-,-
BAC61_L01,9,9p21.2,26641080,26737832,96752,-,-
BAC59_G03,9,9p21.2,26641129,26776419,135290,-,-
BAC59_E02,9,9p21.2,26725423,26844456,119033,-,-
BAC127_D14,9,9p21.2,26795134,26914845,119711,-,-
BAC150_I16,9,9p21.2,26912683,27020092,107409,-,-
BAC39_O15,9,9p21.2,26942293,27088314,146021,-,-
BAC81_P02,9,9p21.2,27015735,27158677,142942,-,-
BAC140_M03,9,9p21.2,27027255,27125752,98497,-,-
BAC146_J05,9,9p21.2,27077305,27180642,103337,-,-
BAC23_G05,9,9p21.2,27116285,27218099,101814,-,-
BAC134_J22,9,9p21.2,27163217,27239167,75950,-,-
BAC86_G04,9,9p21.2,27191325,27277229,85904,-,-
BAC46_F22,9,9p21.2,27241795,27344424,102629,-,-
BAC69_J11,9,9p21.2,27263121,27377054,113933,-,-
BAC42_P06,9,9p21.2,27277223,27416451,139228,-,-
BAC114_A16,9,9p21.2,27348290,27435321,87031,-,-
BAC50_A22,9,9p21.2,27359509,27489235,129726,-,-
BAC162_C08,9,9p21.2,27650487,27751086,100599,-,-
BAC185_B24,9,9p21.2,27663674,27748350,84676,-,-
BAC192_G09,9,9p21.2,27673112,27748350,75238,-,-
BAC244_O09,9,9p21.2,27751443,27835073,83630,-,-
BAC171_E07,9,9p21.1,28168315,28303699,135384,-,-
BAC66_N04,9,9p21.1,28280820,28378837,98017,-,-
BAC115_L10,9,9p21.1,28323124,28435345,112221,-,-
BAC49_J13,9,9p21.1,28463445,28552446,89001,-,-
BAC116_D23,9,9p21.1,28468614,28556463,87849,-,-
BAC192_F24,9,9p21.1,28483874,28575953,92079,-,-
BAC228_L20,9,9p21.1,28522636,28618222,95586,-,-
BAC223_G06,9,9p21.1,28765201,28852825,87624,-,-
BAC145_L10,9,9p21.1,28768734,28851823,83089,-,-
BAC95_F11,9,9p21.1,28815579,28923662,108083,-,-
BAC32_G17,9,9p21.1,28827758,28940107,112349,-,-
BAC242_A16,9,9p21.1,28841281,28931959,90678,-,-
BAC211_K01,9,9p21.1,28974035,29051714,77679,-,-
BAC205_E19,9,9p21.1,29099358,29181613,82255,-,-
BAC159_A02,9,9p21.1,29108515,29188415,79900,-,-
BAC20_M12,9,9p21.1,29181904,29310116,128212,-,-
BAC65_K17,9,9p21.1,29258834,29357896,99062,-,-
BAC68_A21,9,9p21.1,29263975,29357857,93882,-,-
BAC43_H01,9,9p21.1,29297821,29382029,84208,-,-
BAC128_H24,9,9p21.1,29408781,29501451,92670,-,-
BAC180_J24,9,9p21.1,29463574,29530617,67043,-,-
BAC152_E12,9,9p21.1,29748081,29843565,95484,-,-
BAC69_D23,9,9p21.1,29748089,29834519,86430,-,-
BAC178_D16,9,9p21.1,29869337,29976489,107152,-,-
BAC193_O18,9,9p21.1,29898661,29983551,84890,-,-
BAC57_P03,9,9p21.1,29976493,30137414,160921,-,-
BAC123_K07,9,9p21.1,30038329,30123570,85241,-,-
BAC67_F11,9,9p21.1,30186273,30327336,141063,-,-
BAC108_F05,9,9p21.1,30291465,30337413,45948,-,-
BAC217_D01,9,9p21.1,30311574,30401679,90105,-,-
BAC179_P10,9,9p21.1,30365814,30456440,90626,-,-
BAC83_C14,9,9p21.1,30420364,30557493,137129,-,-
BAC33_H23,9,9p21.1,30665422,30743932,78510,-,-
BAC90_F13,9,9p21.1,30734356,30830444,96088,-,-
BAC236_K21,9,9p21.1,30805192,30911762,106570,-,-
BAC197_F16,9,9p21.1,30822905,30909290,86385,-,-
BAC76_J02,9,9p21.1,31031198,31117930,86732,-,-
BAC223_L04,9,9p21.1,31142700,31223068,80368,-,-
BAC110_D09,9,9p21.1,31231015,31376974,145959,-,-
BAC50_C17,9,9p21.1,31233597,31333589,99992,-,-
BAC109_E21,9,9p21.1,31349532,31436099,86567,-,-
BAC102_G22,9,9p21.1,31350366,31437408,87042,-,-
BAC153_C15,9,9p21.1,31410956,31504833,93877,-,-
BAC122_C22,9,9p21.1,31806975,31887807,80832,-,-
BAC196_K08,9,9p21.1,31926937,32012463,85526,-,-
BAC22_C02,9,9p21.1,31936092,32087547,151455,-,-
BAC25_E09,9,9p21.1,31997946,32087531,89585,-,-
BAC29_C10,9,9p21.1,32012382,32117953,105571,-,-
BAC246_J24,9,9p21.1,32035846,32135379,99533,-,-
BAC170_C08,9,9p21.1,32342915,32437941,95026,-,-
BAC8_N07,9,9p21.1,32365060,32500066,135006,-,-
BAC156_J07,9,9p21.1,32394904,32505989,111085,-,-
BAC247_B05,9,9p21.1,32414769,32496905,82136,-,-
BAC129_N23,9,9p21.1,32506264,32619980,113716,-,-
BAC72_O02,9,9p21.1-9p13.3,32797104,32888543,91439,-,-
BAC100_P01,9,9p13.3,32828648,32921742,93094,-,-
BAC63_C19,9,9p13.3,32864465,32988394,123929,-,-
BAC167_L08,9,9p13.3,32921736,33016832,95096,-,-
BAC217_I20,9,9p13.3,32921736,33029044,107308,-,-
BAC156_G13,9,9p13.3,33069404,33167987,98583,-,-
BAC155_M12,9,9p13.3,33141825,33270655,128830,-,-
BAC165_C13,9,9p13.3,33180164,33263882,83718,-,-
BAC160_F02,9,9p13.3,33180190,33274050,93860,-,-
BAC148_J23,9,9p13.3,33200442,33276564,76122,-,-
BAC181_P23,9,9p13.3,33200550,33345639,145089,-,-
BAC108_L08,9,9p13.3,33264107,33345639,81532,-,-
BAC33_C07,9,9p13.3,33274053,33364156,90103,-,-
BAC226_O19,9,9p13.3,33301327,33449146,147819,-,-
BAC177_N11,9,9p13.3,33310473,33400887,90414,-,-
BAC63_M22,9,9p13.3,33341472,33486014,144542,-,-
BAC103_I10,9,9p13.3,33350871,33462502,111631,-,-
BAC178_P17,9,9p13.3,33364148,33484680,120532,-,-
BAC90_L07,9,9p13.3,33457321,33586384,129063,-,-
BAC97_O12,9,9p13.3,33486032,33586368,100336,-,-
BAC61_D24,9,9p13.3,33531282,33613162,81880,-,-
BAC166_G07,9,9p13.3,33682535,33790218,107683,-,-
BAC75_G03,9,9p13.3,33781131,33887689,106558,-,-
BAC131_N18,9,9p13.3,33790215,33879017,88802,-,-
BAC45_H06,9,9p13.3,33790252,33887685,97433,-,-
BAC52_D04,9,9p13.3,33852465,33928293,75828,-,-
BAC35_O16,9,9p13.3,33852579,33972053,119474,-,-
BAC46_I07,9,9p13.3,33942537,34065665,123128,-,-
BAC179_I10,9,9p13.3,33949914,34054801,104887,-,-
BAC158_L12,9,9p13.3,33960281,34065667,105386,-,-
BAC90_I07,9,9p13.3,33991984,34088639,96655,-,-
BAC167_M12,9,9p13.3,33994223,34085933,91710,-,-
BAC84_M11,9,9p13.3,34016949,34137500,120551,-,-
BAC127_I18,9,9p13.3,34089891,34181513,91622,-,-
BAC123_O09,9,9p13.3,34181508,34258961,77453,-,-
BAC101_O08,9,9p13.3,34236802,34349706,112904,-,-
BAC18_F24,9,9p13.3,34250450,34356896,106446,-,-
BAC180_C08,9,9p13.3,34412605,34497672,85067,-,-
BAC189_D05,9,9p13.3,34467032,34619489,152457,-,-
BAC78_P08,9,9p13.3,34512138,34612692,100554,-,-
BAC236_O21,9,9p13.3,34522215,34699779,177564,-,-
BAC186_K07,9,9p13.3,34522229,34605214,82985,-,-
BAC72_A13,9,9p13.3,34736878,34813657,76779,-,-
BAC116_P09,9,9p13.3,34914899,35091840,176941,-,-
BAC219_L10,9,9p13.3,34923003,35033326,110323,-,-
BAC177_H17,9,9p13.3,34940796,35033327,92531,-,-
BAC166_P06,9,9p13.3,34940947,35038725,97778,-,-
BAC225_M08,9,9p13.3,34940957,35023551,82594,-,-
BAC9_B18,9,9p13.3,35035658,35130665,95007,-,-
BAC236_G18,9,9p13.3,35068657,35156880,88223,-,-
BAC125_M17,9,9p13.3,35102304,35198724,96420,-,-
BAC75_L02,9,9p13.3,35120305,35253339,133034,-,-
BAC28_B03,9,9p13.3,35142962,35282465,139503,-,-
BAC65_K05,9,9p13.3,35193412,35336549,143137,-,-
BAC81_E01,9,9p13.3,35252030,35362268,110238,-,-
BAC187_B19,9,9p13.3,35282537,35387099,104562,-,-
BAC187_P16,9,9p13.3,35442580,35528092,85512,-,-
BAC59_O22,9,9p13.3,35509832,35670838,161006,-,-
BAC224_M06,9,9p13.3,35529613,35682020,152407,-,-
BAC236_N22,9,9p13.3,35530910,35623103,92193,-,-
BAC132_N05,9,9p13.3,35533933,35621888,87955,-,-
BAC57_F22,9,9p13.3,35543278,35667497,124219,-,-
BAC118_P09,9,9p13.3,35545598,35665509,119911,-,-
BAC60_C22,9,9p13.3,35561282,35660777,99495,-,-
BAC131_A17,9,9p13.3,35568605,35665496,96891,-,-
BAC249_K02,9,9p13.3,35608039,35721772,113733,-,-
BAC92_M13,9,9p13.3,35613497,35749201,135704,-,-
BAC54_N10,9,9p13.3,35664718,35801244,136526,-,-
BAC48_N04,9,9p13.3,35737965,35848774,110809,-,-
BAC191_G04,9,9p13.3,35914520,35997704,83184,-,-
BAC177_A09,9,9p13.3,35920611,36008851,88240,-,-
BAC118_P13,9,9p13.3,36065132,36155131,89999,-,-
BAC36_P19,9,9p13.3,36105520,36201949,96429,-,-
BAC135_G04,9,9p13.3,36105521,36181631,76110,-,-
BAC173_C01,9,9p13.3,36155125,36251549,96424,-,-
BAC119_F24,9,9p13.3,36179858,36271187,91329,-,-
BAC36_H10,9,9p13.3-9p13.2,36251936,36352967,101031,-,-
BAC168_H02,9,9p13.2,36333149,36482420,149271,-,-
BAC18_K22,9,9p13.2,36338103,36428405,90302,-,-
BAC59_K19,9,9p13.2,36353086,36426063,72977,-,-
BAC115_C16,9,9p13.2,36392864,36491385,98521,-,-
BAC74_M06,9,9p13.2,36469271,36566449,97178,-,-
BAC201_J08,9,9p13.2,36475497,36600364,124867,-,-
BAC24_J10,9,9p13.2,36558927,36658786,99859,-,-
BAC59_D19,9,9p13.2,36566546,36654122,87576,-,-
BAC117_P02,9,9p13.2,36599063,36710630,111567,-,-
BAC204_J24,9,9p13.2,36620465,36710632,90167,-,-
BAC95_I01,9,9p13.2,36674130,36809310,135180,-,-
BAC117_J01,9,9p13.2,36730430,36847280,116850,-,-
BAC57_C03,9,9p13.2,36752063,36904321,152258,-,-
BAC34_I21,9,9p13.2,36781974,36903967,121993,-,-
BAC234_A12,9,9p13.2,36847275,36939586,92311,-,-
BAC184_C09,9,9p13.2,36859454,36957979,98525,-,-
BAC131_L20,9,9p13.2,36973989,37098075,124086,-,-
BAC36_F20,9,9p13.2,37000770,37134440,133670,-,-
BAC37_B01,9,9p13.2,37069440,37186555,117115,-,-
BAC83_C20,9,9p13.2,37128297,37223237,94940,-,-
BAC63_A09,9,9p13.2,37134481,37247196,112715,-,-
BAC80_I02,9,9p13.2,37330419,37441552,111133,-,-
BAC154_D24,9,9p13.2,37364219,37477037,112818,-,-
BAC226_N11,9,9p13.2,37432645,37555788,123143,-,-
BAC96_H19,9,9p13.2,37432645,37522680,90035,-,-
BAC186_C07,9,9p13.2,37477029,37622593,145564,-,-
BAC233_B01,9,9p13.2,37502464,37615920,113456,-,-
BAC235_L08,9,9p13.2,37550104,37643605,93501,-,-
BAC146_E04,9,9p13.2,37569432,37651365,81933,-,-
BAC227_P10,9,9p13.2,37633870,37692840,58970,-,-
BAC202_L24,9,9p13.2,37647371,37745207,97836,-,-
BAC185_C04,9,9p13.2,37655365,37723093,67728,-,-
BAC46_B06,9,9p13.2,37655513,37716698,61185,-,-
BAC236_E14,9,9p13.2,37819505,37917884,98379,-,-
BAC191_M23,9,9p13.2,37827517,37911334,83817,-,-
BAC175_G21,9,9p13.2,37834088,37917887,83799,-,-
BAC144_E05,9,9p13.2-9p13.1,37917960,38056404,138444,-,-
BAC135_P11,9,9p13.2-9p13.1,37917960,38001823,83863,-,-
BAC91_P06,9,9p13.2,37923378,37960733,37355,-,-
BAC32_E03,9,9p13.2-9p13.1,37949168,38079400,130232,-,-
BAC102_G15,9,9p13.2-9p13.1,37949171,38096835,147664,-,-
BAC60_K02,9,9p13.2-9p13.1,37978589,38079580,100991,-,-
BAC191_F06,9,9p13.1,38002943,38096835,93892,-,-
BAC178_H07,9,9p13.1,38136894,38226553,89659,-,-
BAC91_K17,9,9p13.1,38136894,38284432,147538,-,-
BAC189_L11,9,9p13.1,38140311,38222160,81849,-,-
BAC5_M09,9,9p13.1,38154983,38269886,114903,-,-
BAC96_N21,9,9p13.1,38165915,38272273,106358,-,-
BAC237_K19,9,9p13.1,38190150,38272277,82127,-,-
BAC213_K08,9,9p13.1,38239274,38335336,96062,-,-
BAC194_F08,9,9p13.1,38447334,38543567,96233,-,-
BAC168_L17,9,9p13.1,38448486,38540463,91977,-,-
BAC117_C18,9,9p13.1,38448486,38534982,86496,-,-
BAC244_N02,9,9p13.1,38450474,38544550,94076,-,-
BAC32_E14,9,9p13.1,38594931,38690090,95159,-,-
BAC143_C13,9,9p13.1,38607676,38693937,86261,-,-
BAC97_K14,9,9p13.1,38616994,38715953,98959,-,-
BAC121_H19,9,9p13.1,38689527,38777144,87617,-,-
BAC227_F06,9,9p13.1,38715948,38739405,23457,-,-
BAC122_M20,9,9p13.1,38770542,38866356,95814,-,-
BAC126_C01,9,9p13.1,38770813,38866356,95543,-,-
BAC126_F08,9,9p13.1,38788722,38915577,126855,-,-
BAC29_M02,9,9p13.1,38901531,39024926,123395,-,-
BAC55_C12,9,9p13.1,38903690,39085719,182029,-,-
BAC148_L12,9,9p13.1,38967041,39052535,85494,-,-
BAC39_G16,9,9p13.1,38972986,38998060,25074,-,-
BAC80_E13,9,9p13.1-9p12,39052658,40520095,1467437,-,-
BAC61_K16,9,9p13.1,39107581,39221745,114164,-,-
BAC176_I14,9,9p13.1,39109783,39198685,88902,-,-
BAC54_O21,9,9p13.1,39127245,39775464,648219,-,-
BAC220_P23,9,9p13.1,39154799,39794377,639578,-,-
BAC248_M09,9,9p13.1,39224653,39353069,128416,-,-
BAC143_B23,9,9p13.1,39246501,39348521,102020,-,-
BAC63_J10,9,9p13.1,39271417,39382492,111075,-,-
BAC235_G12,9,9p13.1-9p12,39367461,40794046,1426585,-,-
BAC6_L17,9,9p13.1,39382487,39497414,114927,-,-
BAC8_M18,9,9p13.1,39389703,39503470,113767,-,-
BAC105_M05,9,9p13.1-9p12,39417200,41683304,2266104,-,-
BAC63_D11,9,9p13.1,39419103,39508353,89250,-,-
BAC119_C07,9,9p13.1,39457394,39538286,80892,-,-
BAC109_L10,9,9p13.1-9p12,39508344,41756802,2248458,-,-
BAC39_B06,9,9p13.1-9p12,39525688,40856619,1330931,-,-
BAC183_H08,9,9p13.1,39538409,39623598,85189,-,-
BAC33_H09,9,9p13.1-9p12,39623903,41861164,2237261,-,-
BAC149_D16,9,9p13.1,40092596,40181335,88739,-,-
BAC100_F20,9,9p12,40295423,40401108,105685,-,-
BAC183_A13,9,9p12,40527682,40606776,79094,-,-
BAC51_K14,9,9p12,40549548,40663808,114260,-,-
BAC120_D12,9,9p12,40574478,40673899,99421,-,-
BAC197_L09,9,9p12,40583449,40697655,114206,-,-
BAC78_C19,9,9p12,40673890,40755729,81839,-,-
BAC117_M07,9,9p12,40784983,40911818,126835,-,-
BAC108_D22,9,9p12,42022242,42139803,117561,-,-
BAC52_A06,9,9p12,42023170,42156500,133330,-,-
BAC106_M04,9,9p12,42055123,42138358,83235,-,-
BAC146_M08,9,9p12,42130018,42216418,86400,-,-
BAC58_M02,9,9p12,42268744,42391617,122873,-,-
BAC119_H02,9,9p11.2,42469342,42589978,120636,-,-
BAC183_F05,9,9p11.2,42716319,42802932,86613,-,-
BAC240_F06,9,9p11.2,42720198,42827547,107349,-,-
BAC78_M03,9,9p11.2,42721226,42809444,88218,-,-
BAC190_H10,9,9p11.2,42750565,42836914,86349,-,-
BAC222_M08,9,9p11.2,42750565,42827524,76959,-,-
BAC161_C07,9,9p11.2,42766527,42844337,77810,-,-
BAC179_K15,9,9p11.2,42809438,42891830,82392,-,-
BAC88_M22,9,9p11.2,43012554,43141302,128748,-,-
BAC67_F23,9,9p11.2,43153121,44183641,1030520,-,-
BAC173_K22,9,9p11.2,43254876,43350120,95244,-,-
BAC113_J07,9,9p11.2,43392218,43480687,88469,-,-
BAC161_L01,9,9p11.2,43408742,43480685,71943,-,-
BAC8_N08,9,9p11.2,43508761,43631934,123173,-,-
BAC1_C15,9,9p11.2,43575387,43729528,154141,-,-
BAC156_J08,9,9p11.2,43575437,43660305,84868,-,-
BAC24_K19,9,9p11.2,44666789,44770991,104202,-,-
BAC56_I10,9,9p11.2,44669255,44756985,87730,-,-
BAC194_F09,9,9p11.2,44911532,45002063,90531,-,-
BAC224_D15,9,9p11.2,44915830,45000929,85099,-,-
BAC96_O18,9,9p11.2-9p11.1,44926745,46974976,2048231,-,-
BAC236_B06,9,9p11.2,44929015,45618387,689372,-,-
BAC62_J18,9,9p11.2-9p11.1,44968512,46982473,2013961,-,-
BAC193_J03,9,9p11.2,45034473,45132121,97648,-,-
BAC124_N12,9,9p11.2,45087283,45176937,89654,-,-
BAC56_J14,9,9p11.2,45322994,45800550,477556,-,-
BAC2_J21,9,9p11.2,45412928,45551903,138975,-,-
BAC234_F15,9,9p11.2,45575079,46050892,475813,-,-
BAC181_K22,9,9p11.2,45961260,46050905,89645,-,-
BAC163_P07,9,9p11.2-9p11.1,46064106,46982473,918367,-,-
BAC173_C16,9,9q12,66581156,68346821,1765665,-,-
BAC172_I09,9,9q12,67015500,69094573,2079073,-,-
BAC102_P19,9,9q12,67420234,68705142,1284908,-,-
BAC131_B19,9,9q12,67648136,67740544,92408,-,-
BAC51_I05,9,9q12,67685991,67844658,158667,-,-
BAC100_C16,9,9q12,67707737,67802737,95000,-,-
BAC234_D21,9,9q12,67774015,67831423,57408,-,-
BAC144_N14,9,9q12,67911190,67981947,70757,-,-
BAC238_P10,9,9q12,67911190,67981947,70757,-,-
BAC187_F14,9,9q12,67914079,67981947,67868,-,-
BAC197_L17,9,9q12,68062395,68179759,117364,-,-
BAC233_A15,9,9q12,68063785,68165012,101227,-,-
BAC178_C06,9,9q12,68072661,68165012,92351,-,-
BAC178_D06,9,9q12,68072667,68165012,92345,-,-
BAC142_L05,9,9q12,68188581,68531232,342651,-,-
BAC197_D07,9,9q12,68410176,68495165,84989,yes,-
BAC109_L09,9,9q13,70061549,70157770,96221,-,-
BAC145_C11,9,9q13,70224724,70339285,114561,-,-
BAC202_B20,9,9q13,70241820,70338308,96488,-,-
BAC104_L23,9,9q13,70404237,70496298,92061,-,-
BAC51_I23,9,9q13-9q21.11,70410741,70522078,111337,-,-
BAC219_M02,9,9q13,70457592,70470956,13364,-,-
BAC161_C10,9,9q21.11,70573449,70692423,118974,-,-
BAC166_F12,9,9q21.11,70578822,70661737,82915,-,-
BAC127_F05,9,9q21.11,70626407,70795037,168630,-,-
BAC52_L17,9,9q21.11,70630346,70734854,104508,-,-
BAC42_J19,9,9q21.11,70676181,70779114,102933,-,-
BAC48_J06,9,9q21.11,70692447,70772421,79974,-,-
BAC85_J18,9,9q21.11,70775123,70860573,85450,-,-
BAC239_C01,9,9q21.11,70779109,70869088,89979,-,-
BAC160_O08,9,9q21.11,70784734,70901406,116672,-,-
BAC115_O24,9,9q21.11,70825350,70950338,124988,-,-
BAC58_J10,9,9q21.11,70847027,70960464,113437,-,-
BAC184_D16,9,9q21.11,70850848,70956967,106119,-,-
BAC198_A08,9,9q21.11,70921967,71003352,81385,-,-
BAC83_B15,9,9q21.11,70983729,71076057,92328,-,-
BAC67_J20,9,9q21.11,71005519,71135958,130439,-,-
BAC144_P15,9,9q21.11,71050359,71175396,125037,-,-
BAC109_O22,9,9q21.11,71059603,71157364,97761,-,-
BAC70_O18,9,9q21.11,71081487,71160097,78610,-,-
BAC10_I24,9,9q21.11,71128189,71283603,155414,-,-
BAC31_D21,9,9q21.11,71133940,71229326,95386,-,-
BAC173_D12,9,9q21.11,71231348,71342385,111037,-,-
BAC125_H15,9,9q21.11,71268339,71398395,130056,-,-
BAC73_O02,9,9q21.11,71318827,71398407,79580,-,-
BAC172_L07,9,9q21.11,71342469,71430166,87697,-,-
BAC103_O03,9,9q21.11,71431097,71539941,108844,-,-
BAC83_A20,9,9q21.11,71573611,71603051,29440,-,-
BAC247_N05,9,9q21.11,71603046,71704156,101110,-,-
BAC81_L19,9,9q21.11,71648598,71761848,113250,-,-
BAC76_L01,9,9q21.11,71671481,71757477,85996,-,-
BAC126_E13,9,9q21.11,71696257,71786772,90515,-,-
BAC24_L13,9,9q21.11,71712269,71837183,124914,-,-
BAC33_O04,9,9q21.11,71731498,71814254,82756,-,-
BAC172_A20,9,9q21.11,71814334,71885021,70687,-,-
BAC168_P05,9,9q21.11,71862172,71928106,65934,-,-
BAC230_H10,9,9q21.11,71864885,71945817,80932,-,-
BAC38_H09,9,9q21.11,71918615,72061954,143339,-,-
BAC45_A18,9,9q21.11,72048722,72143334,94612,-,-
BAC83_H12,9,9q21.11,72071001,72151643,80642,-,-
BAC231_E09,9,9q21.11,72188908,72273368,84460,-,-
BAC143_K03,9,9q21.11,72281183,72361897,80714,-,-
BAC230_N04,9,9q21.11,72284096,72358918,74822,-,-
BAC55_J06,9,9q21.11,72310044,72436546,126502,-,-
BAC235_L15,9,9q21.11,72324904,72452210,127306,-,-
BAC75_L03,9,9q21.11,72326143,72417113,90970,-,-
BAC182_C06,9,9q21.11,72361892,72469162,107270,-,-
BAC150_K13,9,9q21.11,72366608,72456491,89883,-,-
BAC44_K10,9,9q21.11,72493658,72666915,173257,-,-
BAC25_J21,9,9q21.11,72562362,72643683,81321,-,-
BAC71_F01,9,9q21.11,72571697,72666669,94972,-,-
BAC51_M22,9,9q21.11-9q21.12,72613523,72751169,137646,-,-
BAC168_C06,9,9q21.11-9q21.12,72694867,72797252,102385,-,-
BAC84_K23,9,9q21.12,72795608,72882642,87034,-,-
BAC89_H14,9,9q21.12-9q21.13,72985456,73108398,122942,-,-
BAC153_I12,9,9q21.12-9q21.13,73089936,73163119,73183,-,-
BAC103_G15,9,9q21.13,73189844,73285430,95586,-,-
BAC100_N05,9,9q21.13,73189844,73279292,89448,-,-
BAC141_J20,9,9q21.13,73202848,73289825,86977,-,-
BAC44_M18,9,9q21.13,73202856,73285119,82263,-,-
BAC29_L16,9,9q21.13,73213312,73308069,94757,-,-
BAC146_H22,9,9q21.13,73228496,73327875,99379,-,-
BAC54_K05,9,9q21.13,73295952,73416689,120737,-,-
BAC220_F17,9,9q21.13,73351664,73452913,101249,-,-
BAC41_J02,9,9q21.13,73443894,73548160,104266,-,-
BAC195_B21,9,9q21.13,73515265,73600059,84794,-,-
BAC13_J21,9,9q21.13,73519814,73600059,80245,-,-
BAC88_H10,9,9q21.13,73600053,73718975,118922,-,-
BAC150_E15,9,9q21.13,73604737,73756146,151409,-,-
BAC64_K15,9,9q21.13,73664772,73779631,114859,-,-
BAC28_D04,9,9q21.13,73698335,73784406,86071,-,-
BAC125_H16,9,9q21.13,73719078,73840208,121130,-,-
BAC228_I21,9,9q21.13,73835587,73926484,90897,-,-
BAC65_J03,9,9q21.13,73839841,73969171,129330,-,-
BAC156_G05,9,9q21.13,73925118,74013388,88270,-,-
BAC58_D16,9,9q21.13,73949652,74068219,118567,-,-
BAC27_D23,9,9q21.13,73961793,74067107,105314,-,-
BAC81_B19,9,9q21.13,73973751,74067124,93373,-,-
BAC141_B01,9,9q21.13,73980861,74068248,87387,-,-
BAC64_L20,9,9q21.13,74106185,74223915,117730,-,-
BAC106_C09,9,9q21.13,74127422,74233452,106030,-,-
BAC126_K20,9,9q21.13,74298294,74436868,138574,-,-
BAC68_O10,9,9q21.13,74372993,74433953,60960,-,-
BAC97_G20,9,9q21.13,74385433,74529835,144402,-,-
BAC88_E14,9,9q21.13,74412063,74524955,112892,-,-
BAC230_F18,9,9q21.13,74519759,74622619,102860,-,-
BAC60_A01,9,9q21.13,74603874,74694075,90201,-,-
BAC167_D19,9,9q21.13,74760325,74843837,83512,-,-
BAC196_M07,9,9q21.13,74761177,74843868,82691,-,-
BAC142_C14,9,9q21.13,75189994,75268257,78263,-,-
BAC200_M03,9,9q21.13,75197547,75274396,76849,-,-
BAC185_D16,9,9q21.13,75242339,75338906,96567,-,-
BAC177_H18,9,9q21.13,75290643,75385087,94444,-,-
BAC197_G06,9,9q21.13,75545592,75625240,79648,-,-
BAC2_E02,9,9q21.13,75582266,75700888,118622,-,-
BAC184_P18,9,9q21.13,75743242,75797764,54522,-,-
BAC96_C11,9,9q21.13,75941949,76066621,124672,-,-
BAC34_N15,9,9q21.13,75943071,76038913,95842,-,-
BAC97_M12,9,9q21.13,76038907,76167159,128252,-,-
BAC41_B05,9,9q21.13,76312748,76405935,93187,-,-
BAC96_F13,9,9q21.13,76379680,76476865,97185,-,-
BAC40_J09,9,9q21.13,76476868,76579906,103038,-,-
BAC23_O10,9,9q21.13,76549006,76661181,112175,-,-
BAC73_I06,9,9q21.13,76559636,76649573,89937,-,-
BAC113_L07,9,9q21.13,76626788,76748893,122105,-,-
BAC116_N02,9,9q21.13,76752216,76874267,122051,-,-
BAC104_B06,9,9q21.13,76809743,76942559,132816,-,-
BAC84_F11,9,9q21.13,76831495,76939920,108425,-,-
BAC52_D07,9,9q21.13,76922492,77012932,90440,-,-
BAC157_C14,9,9q21.13,76973540,77057641,84101,-,-
BAC222_E13,9,9q21.13,76977014,77041190,64176,-,-
BAC152_E07,9,9q21.13,77009736,77122709,112973,-,-
BAC167_I07,9,9q21.13,77060902,77197226,136324,-,-
BAC60_E04,9,9q21.13,77120583,77267695,147112,-,-
BAC73_L11,9,9q21.13,77122889,77230586,107697,-,-
BAC150_K02,9,9q21.13,77197022,77267706,70684,-,-
BAC71_J06,9,9q21.13,77201479,77294910,93431,-,-
BAC180_F21,9,9q21.13,77202158,77294935,92777,-,-
BAC224_G14,9,9q21.13,77207313,77294920,87607,-,-
BAC81_F07,9,9q21.13,77310623,77413866,103243,-,-
BAC21_M06,9,9q21.13,77314177,77405361,91184,-,-
BAC180_B18,9,9q21.13,77326569,77406261,79692,-,-
BAC110_G17,9,9q21.13,77385635,77490302,104667,-,-
BAC228_C02,9,9q21.13,77385640,77490302,104662,-,-
BAC145_G16,9,9q21.13,77431547,77540137,108590,-,-
BAC162_L12,9,9q21.13,77451114,77530974,79860,-,-
BAC237_B18,9,9q21.13,77490295,77573056,82761,-,-
BAC91_G10,9,9q21.13,77526416,77621900,95484,-,-
BAC120_G07,9,9q21.13,77533645,77625847,92202,-,-
BAC103_C21,9,9q21.13,77636604,77736508,99904,-,-
BAC244_K23,9,9q21.13,77677573,77774223,96650,-,-
BAC194_P12,9,9q21.13,77683143,77761004,77861,-,-
BAC39_P13,9,9q21.13,77692139,77782629,90490,-,-
BAC78_B18,9,9q21.13,77764164,77859575,95411,-,-
BAC184_M12,9,9q21.13,77774626,77848342,73716,-,-
BAC57_K11,9,9q21.13,77795076,77880584,85508,-,-
BAC186_I07,9,9q21.13,77843942,77932984,89042,-,-
BAC180_H04,9,9q21.13,77844488,77939479,94991,-,-
BAC92_D01,9,9q21.13,77918661,78033112,114451,-,-
BAC183_O21,9,9q21.13,77983945,78081305,97360,-,-
BAC53_K03,9,9q21.13,78038509,78187572,149063,-,-
BAC115_M22,9,9q21.13,78081136,78174722,93586,-,-
BAC27_K16,9,9q21.13,78144818,78271676,126858,-,-
BAC76_N04,9,9q21.13,78188343,78307345,119002,-,-
BAC162_P05,9,9q21.13,78188343,78286067,97724,-,-
BAC128_J21,9,9q21.13,78203603,78294183,90580,-,-
BAC45_J18,9,9q21.13,78206757,78286062,79305,-,-
BAC12_K07,9,9q21.13,78214578,78308384,93806,-,-
BAC95_P13,9,9q21.13,78226844,78326153,99309,-,-
BAC209_H11,9,9q21.13,78227322,78346811,119489,-,-
BAC97_P19,9,9q21.13,78298481,78391680,93199,-,-
BAC189_P12,9,9q21.13,78308379,78406327,97948,-,-
BAC33_H18,9,9q21.13,78326685,78406529,79844,-,-
BAC7_B23,9,9q21.13,78338484,78443781,105297,-,-
BAC176_C08,9,9q21.13,78341695,78464137,122442,-,-
BAC2_F20,9,9q21.13,78341695,78439617,97922,-,-
BAC88_A07,9,9q21.13,78341698,78449723,108025,-,-
BAC167_D20,9,9q21.13,78347045,78445942,98897,-,-
BAC117_F03,9,9q21.13,78446207,78540155,93948,-,-
BAC129_P20,9,9q21.13,78562778,78681847,119069,-,-
BAC42_K01,9,9q21.13,78563599,78651133,87534,-,-
BAC198_K01,9,9q21.13,78599876,78678860,78984,-,-
BAC69_N10,9,9q21.13,78679759,78774940,95181,-,-
BAC75_B01,9,9q21.13,78711981,78751972,39991,-,-
BAC95_J05,9,9q21.13,78798312,78878553,80241,-,-
BAC168_I20,9,9q21.13,78818654,78933231,114577,-,-
BAC200_J08,9,9q21.13,78821871,78905246,83375,-,-
BAC162_D10,9,9q21.13,78821873,78903887,82014,-,-
BAC197_L16,9,9q21.13,78828708,78965826,137118,-,-
BAC107_O08,9,9q21.13,78830985,78940734,109749,-,-
BAC193_A15,9,9q21.13,78866612,78929560,62948,-,-
BAC117_K07,9,9q21.13,78878628,79011614,132986,-,-
BAC133_D02,9,9q21.13,78962213,79052745,90532,-,-
BAC242_G06,9,9q21.13,78962238,79070935,108697,-,-
BAC65_B19,9,9q21.13,78966193,79052745,86552,-,-
BAC149_E09,9,9q21.13,79052417,79133206,80789,-,-
BAC166_A04,9,9q21.2,79332387,79437383,104996,-,-
BAC78_I22,9,9q21.2,79338289,79428813,90524,-,-
BAC82_O10,9,9q21.2,79426934,79519807,92873,-,-
BAC38_D16,9,9q21.2,79426936,79573197,146261,-,-
BAC117_B04,9,9q21.2,79428802,79525076,96274,-,-
BAC79_D22,9,9q21.2,79465806,79586598,120792,-,-
BAC107_B13,9,9q21.2,79575707,79675040,99333,-,-
BAC181_P20,9,9q21.2,79698498,79809292,110794,-,-
BAC125_H21,9,9q21.2,79711822,79816751,104929,-,-
BAC106_L02,9,9q21.2,79756222,79860323,104101,-,-
BAC175_E11,9,9q21.2,79941670,80029680,88010,-,-
BAC196_E17,9,9q21.2,79941691,80033527,91836,-,-
BAC185_G17,9,9q21.2,80077620,80189041,111421,-,-
BAC57_E16,9,9q21.2,80095045,80197804,102759,-,-
BAC88_L21,9,9q21.2,80192191,80282727,90536,-,-
BAC66_H16,9,9q21.2-9q21.31,80216194,80306925,90731,-,-
BAC230_K06,9,9q21.2-9q21.31,80290490,80373989,83499,-,-
BAC32_K14,9,9q21.2-9q21.31,80290512,80478248,187736,-,-
BAC146_F17,9,9q21.31,80324829,80413519,88690,-,-
BAC161_L21,9,9q21.31,80509120,80599816,90696,-,-
BAC146_I18,9,9q21.31,80516069,80605235,89166,-,-
BAC182_F18,9,9q21.31,80654804,80724141,69337,-,-
BAC142_M03,9,9q21.31,80710292,80821832,111540,-,-
BAC182_P05,9,9q21.31,80761557,80863993,102436,-,-
BAC33_A12,9,9q21.31,80795020,80895109,100089,-,-
BAC103_E08,9,9q21.31,80800176,80895116,94940,-,-
BAC76_F22,9,9q21.31,80998088,81092175,94087,-,-
BAC136_K03,9,9q21.31,81013732,81096406,82674,-,-
BAC46_J15,9,9q21.31,81013770,81148334,134564,-,-
BAC73_G03,9,9q21.31,81061430,81141561,80131,-,-
BAC97_D23,9,9q21.31,81102838,81228091,125253,-,-
BAC120_N15,9,9q21.31,81155563,81269766,114203,-,-
BAC196_F15,9,9q21.31,81155563,81247351,91788,-,-
BAC233_C03,9,9q21.31,81269170,81360033,90863,-,-
BAC49_N02,9,9q21.31,81306439,81388364,81925,-,-
BAC91_J21,9,9q21.31,81313582,81401388,87806,-,-
BAC235_I17,9,9q21.31,81318534,81388364,69830,-,-
BAC5_E01,9,9q21.31,81362173,81483105,120932,-,-
BAC51_C02,9,9q21.31,81438040,81522980,84940,-,-
BAC170_G02,9,9q21.31,81452314,81560961,108647,-,-
BAC155_G01,9,9q21.31,81467981,81573027,105046,-,-
BAC176_I23,9,9q21.31,81501491,81606260,104769,-,-
BAC152_B20,9,9q21.31,81573528,81665558,92030,-,-
BAC75_N14,9,9q21.31,81588115,81681246,93131,-,-
BAC66_L11,9,9q21.31,81756275,81847198,90923,-,-
BAC8_D11,9,9q21.31,81802676,81963063,160387,-,-
BAC11_I04,9,9q21.31,81814428,81922277,107849,-,-
BAC160_L07,9,9q21.31,81847380,81930733,83353,-,-
BAC89_B16,9,9q21.31,81920281,82015078,94797,-,-
BAC42_L05,9,9q21.31,81920282,82053565,133283,-,-
BAC159_A11,9,9q21.31,81938444,82047675,109231,-,-
BAC189_F09,9,9q21.31,81947827,82062306,114479,-,-
BAC197_K21,9,9q21.31,81983296,82053565,70269,-,-
BAC62_L06,9,9q21.31,81985443,82105377,119934,-,-
BAC120_B14,9,9q21.31,82015087,82125941,110854,-,-
BAC42_B17,9,9q21.31,82050641,82163967,113326,-,-
BAC149_P02,9,9q21.31,82232433,82334010,101577,-,-
BAC148_K20,9,9q21.31,82443518,82519328,75810,-,-
BAC182_I19,9,9q21.31,82768770,82839186,70416,-,-
BAC189_I14,9,9q21.31,82769994,82899269,129275,-,-
BAC126_E03,9,9q21.31,82803078,82899269,96191,-,-
BAC71_C03,9,9q21.31,82851069,82941941,90872,-,-
BAC217_I21,9,9q21.31,82918190,83044099,125909,-,-
BAC86_A17,9,9q21.31,82973273,83066836,93563,-,-
BAC175_E23,9,9q21.31,83236801,83334465,97664,-,-
BAC66_J09,9,9q21.31,83244235,83360022,115787,-,-
BAC67_O14,9,9q21.31,83282100,83382026,99926,-,-
BAC88_F12,9,9q21.31,83287994,83388245,100251,-,-
BAC82_K22,9,9q21.31,83294117,83381561,87444,-,-
BAC126_A05,9,9q21.31-9q21.32,83296036,83442379,146343,-,-
BAC122_I24,9,9q21.31-9q21.32,83296092,83442379,146287,-,-
BAC60_J10,9,9q21.31-9q21.32,83369457,83480142,110685,-,-
BAC161_B03,9,9q21.31-9q21.32,83388242,83470525,82283,-,-
BAC35_G21,9,9q21.32,83423809,83506651,82842,-,-
BAC158_B15,9,9q21.32,83499257,83609312,110055,-,-
BAC182_D05,9,9q21.32,83503208,83609301,106093,-,-
BAC11_O17,9,9q21.32,83507100,83668554,161454,-,-
BAC58_L13,9,9q21.32,83507100,83587405,80305,-,-
BAC160_A09,9,9q21.32,83544954,83620153,75199,-,-
BAC187_I01,9,9q21.32,83631064,83708233,77169,-,-
BAC79_M24,9,9q21.32,83728697,83836367,107670,-,-
BAC50_K15,9,9q21.32,83858596,83955921,97325,-,-
BAC78_P04,9,9q21.32,83882593,83997087,114494,-,-
BAC127_E19,9,9q21.32,83913405,84010768,97363,-,-
BAC83_C24,9,9q21.32,84084869,84176867,91998,-,-
BAC200_E15,9,9q21.32,84137017,84231152,94135,-,-
BAC172_E08,9,9q21.32,84195703,84277276,81573,-,-
BAC6_B03,9,9q21.32,84233699,84360914,127215,-,-
BAC240_K22,9,9q21.32,84236810,84310577,73767,-,-
BAC217_A13,9,9q21.32,84319885,84408882,88997,-,-
BAC23_D24,9,9q21.32,84355512,84435730,80218,-,-
BAC149_D13,9,9q21.32,84627736,84731193,103457,-,-
BAC131_M12,9,9q21.32,84691671,84777814,86143,-,-
BAC246_F07,9,9q21.32,84711753,84792108,80355,-,-
BAC40_K19,9,9q21.32,84719404,84870210,150806,yes,-
BAC191_P17,9,9q21.32,84753331,84850733,97402,-,-
BAC149_C19,9,9q21.32,84774116,84899044,124928,yes,-
BAC32_O07,9,9q21.32,84790635,84907446,116811,-,-
BAC18_O02,9,9q21.32,84847823,84958516,110693,-,-
BAC64_J14,9,9q21.32,85048367,85154306,105939,-,-
BAC191_A07,9,9q21.32,85073596,85154304,80708,-,-
BAC127_L15,9,9q21.32,85164088,85250519,86431,-,-
BAC141_L22,9,9q21.32,85213018,85322516,109498,-,-
BAC11_A12,9,9q21.32,85237344,85313652,76308,-,-
BAC125_I04,9,9q21.32,85275106,85353694,78588,-,-
BAC72_L04,9,9q21.32,85292833,85426420,133587,-,-
BAC54_K09,9,9q21.32,85443040,85556172,113132,-,-
BAC15_I15,9,9q21.32,85532863,85643721,110858,-,-
BAC165_J17,9,9q21.32,85550544,85648976,98432,-,-
BAC220_I10,9,9q21.32,85661971,85731922,69951,-,-
BAC159_M11,9,9q21.32,85699456,85797088,97632,-,-
BAC65_A10,9,9q21.32,85706950,85826753,119803,-,-
BAC106_B06,9,9q21.32,85732818,85863775,130957,-,-
BAC222_L01,9,9q21.32,85749040,85843546,94506,-,-
BAC176_B04,9,9q21.32,85765437,85859936,94499,-,-
BAC101_D06,9,9q21.32,85777684,85870703,93019,-,-
BAC84_E19,9,9q21.32,85780640,85860661,80021,-,-
BAC27_G01,9,9q21.32,85805804,85894213,88409,-,-
BAC148_F02,9,9q21.32,85912196,86000529,88333,-,-
BAC200_E14,9,9q21.32,85963957,86059911,95954,-,-
BAC50_E04,9,9q21.32,86002352,86096751,94399,-,-
BAC145_O19,9,9q21.32-9q21.33,86038141,86139867,101726,-,-
BAC81_L23,9,9q21.32-9q21.33,86057480,86153088,95608,-,-
BAC50_N02,9,9q21.32-9q21.33,86059905,86153094,93189,-,-
BAC20_N12,9,9q21.33,86182778,86296019,113241,-,-
BAC220_M12,9,9q21.33,86192529,86283217,90688,-,-
BAC79_A09,9,9q21.33,86269307,86360146,90839,-,-
BAC219_C11,9,9q21.33,86283355,86369117,85762,-,-
BAC143_B12,9,9q21.33,86375338,86486711,111373,-,-
BAC191_K14,9,9q21.33,86434446,86519991,85545,-,-
BAC65_L07,9,9q21.33,86486705,86581272,94567,-,-
BAC103_D13,9,9q21.33,86553221,86630098,76877,-,-
BAC68_D14,9,9q21.33,86556483,86648490,92007,-,-
BAC80_L15,9,9q21.33,86581267,86592797,11530,-,-
BAC231_N09,9,9q21.33,86590918,86672780,81862,-,-
BAC163_H11,9,9q21.33,86735179,86840533,105354,-,-
BAC162_J21,9,9q21.33,86812561,86907509,94948,-,-
BAC218_J06,9,9q21.33,86875813,86972146,96333,-,-
BAC83_E15,9,9q21.33,86943391,87024594,81203,-,-
BAC126_F07,9,9q21.33,86953751,87068115,114364,-,-
BAC126_N23,9,9q21.33,86953751,87068111,114360,-,-
BAC148_N01,9,9q21.33,86973937,87068115,94178,-,-
BAC195_K06,9,9q21.33,86989121,87066789,77668,-,-
BAC177_N01,9,9q21.33,87071114,87173170,102056,-,-
BAC44_K08,9,9q21.33,87073333,87183289,109956,-,-
BAC235_F11,9,9q21.33,87079491,87162806,83315,-,-
BAC24_O04,9,9q21.33,87082149,87266749,184600,-,-
BAC110_L10,9,9q21.33,87098893,87191354,92461,-,-
BAC193_A24,9,9q21.33,87098921,87183298,84377,-,-
BAC244_C04,9,9q21.33,87105979,87173170,67191,-,-
BAC112_I05,9,9q21.33,87107017,87204519,97502,-,-
BAC139_O13,9,9q21.33,87141776,87278945,137169,-,-
BAC57_C08,9,9q21.33,87187053,87318354,131301,-,-
BAC236_N06,9,9q21.33,87241913,87317389,75476,-,-
BAC157_C22,9,9q21.33,87241913,87317387,75474,-,-
BAC168_C05,9,9q21.33,87241913,87339624,97711,-,-
BAC68_P06,9,9q21.33,87266385,87397958,131573,-,-
BAC88_H19,9,9q21.33,87271623,87360872,89249,-,-
BAC103_H15,9,9q21.33,87278966,87363684,84718,-,-
BAC210_A18,9,9q21.33,87294690,87374409,79719,-,-
BAC217_E17,9,9q21.33,87294690,87397958,103268,-,-
BAC112_D04,9,9q21.33,87304563,87390941,86378,-,-
BAC176_B06,9,9q21.33,87324362,87397958,73596,-,-
BAC183_G02,9,9q21.33,87501618,87580239,78621,-,-
BAC32_C07,9,9q21.33,87548678,87574796,26118,-,-
BAC100_O12,9,9q21.33,87878991,87965478,86487,-,-
BAC32_A23,9,9q21.33,87882022,87960039,78017,-,-
BAC86_F16,9,9q21.33,87927338,88036000,108662,-,-
BAC137_M13,9,9q21.33,87927943,87999507,71564,-,-
BAC235_F19,9,9q21.33,87933148,88026563,93415,-,-
BAC165_B09,9,9q21.33,88003324,88102278,98954,-,-
BAC107_N13,9,9q21.33,88003324,88102278,98954,-,-
BAC113_E11,9,9q21.33,88037247,88147457,110210,-,-
BAC31_I07,9,9q21.33,88071314,88169741,98427,-,-
BAC23_F17,9,9q21.33,88085917,88184577,98660,-,-
BAC142_F16,9,9q21.33,88087281,88169745,82464,-,-
BAC56_O03,9,9q21.33,88106870,88270331,163461,-,-
BAC191_A14,9,9q21.33,88145536,88217355,71819,-,-
BAC124_F17,9,9q21.33,88147449,88218034,70585,-,-
BAC122_A04,9,9q21.33,88184765,88289882,105117,-,-
BAC182_D17,9,9q21.33,88188607,88282288,93681,-,-
BAC96_J10,9,9q21.33,88196130,88306686,110556,-,-
BAC43_J05,9,9q21.33,88276058,88383793,107735,-,-
BAC120_N20,9,9q21.33,88285071,88385625,100554,-,-
BAC88_H22,9,9q21.33,88289920,88383793,93873,-,-
BAC162_O19,9,9q21.33,88306742,88385625,78883,-,-
BAC185_N15,9,9q21.33,88413143,88502630,89487,-,-
BAC243_I17,9,9q21.33,88427868,88514452,86584,-,-
BAC8_F14,9,9q21.33,88441397,88514421,73024,-,-
BAC24_C11,9,9q21.33,88488992,88648487,159495,-,-
BAC50_G20,9,9q21.33,88542229,88662358,120129,-,-
BAC219_A23,9,9q21.33,88542456,88640836,98380,-,-
BAC140_B22,9,9q21.33,88542461,88620823,78362,-,-
BAC197_G19,9,9q21.33,88542469,88640836,98367,-,-
BAC188_K19,9,9q21.33,88652384,88744683,92299,-,-
BAC73_O15,9,9q21.33,88655857,88762220,106363,-,-
BAC101_G01,9,9q21.33,88662393,88761255,98862,-,-
BAC38_J20,9,9q21.33,88709580,88870467,160887,-,-
BAC222_G19,9,9q21.33,88766227,88850111,83884,-,-
BAC196_F07,9,9q21.33,88783568,88867397,83829,-,-
BAC244_I03,9,9q21.33,88784272,88858541,74269,-,-
BAC169_B19,9,9q21.33,88839897,88930414,90517,-,-
BAC79_K22,9,9q21.33,88959112,89093954,134842,-,-
BAC83_G20,9,9q21.33,88966110,89057990,91880,-,-
BAC62_P22,9,9q21.33,88993756,89093954,100198,-,-
BAC61_A03,9,9q21.33,89094182,89200478,106296,-,-
BAC73_C02,9,9q21.33,89095819,89218969,123150,-,-
BAC175_L05,9,9q21.33,89098826,89239190,140364,-,-
BAC81_I24,9,9q21.33,89099240,89196075,96835,-,-
BAC166_J06,9,9q21.33,89114771,89233056,118285,-,-
BAC24_I19,9,9q21.33,89288510,89402044,113534,-,-
BAC179_E05,9,9q21.33,89322509,89404187,81678,-,-
BAC244_I10,9,9q21.33,89335914,89422645,86731,-,-
BAC137_O22,9,9q21.33,89340172,89448082,107910,-,-
BAC123_F11,9,9q21.33,89360546,89471958,111412,-,-
BAC83_I03,9,9q21.33,89362904,89505854,142950,-,-
BAC112_J06,9,9q21.33,89422654,89554661,132007,-,-
BAC169_N03,9,9q21.33,89443104,89525881,82777,-,-
BAC90_K20,9,9q21.33,89472511,89552292,79781,-,-
BAC46_D08,9,9q21.33-9q22.1,89518817,89606640,87823,-,-
BAC82_L07,9,9q21.33-9q22.1,89524895,89634302,109407,-,-
BAC192_M24,9,9q21.33-9q22.1,89524895,89606618,81723,-,-
BAC158_L06,9,9q21.33-9q22.1,89532034,89645111,113077,-,-
BAC100_H04,9,9q21.33-9q22.1,89550318,89651094,100776,-,-
BAC178_B24,9,9q21.33-9q22.1,89568063,89654047,85984,-,-
BAC199_G12,9,9q22.1,89725435,89842734,117299,-,-
BAC246_L21,9,9q22.1,89802090,89894647,92557,-,-
BAC194_D05,9,9q22.1,89818083,89914004,95921,-,-
BAC40_I20,9,9q22.1,89894703,89985007,90304,-,-
BAC55_G06,9,9q22.1,89951042,90048581,97539,-,-
BAC1_A18,9,9q22.1,89985047,90072384,87337,-,-
BAC207_D21,9,9q22.1,90001012,90090010,88998,-,-
BAC100_C17,9,9q22.1,90003155,90090660,87505,-,-
BAC174_A17,9,9q22.1,90008330,90092437,84107,-,-
BAC179_I08,9,9q22.1,90015214,90089778,74564,-,-
BAC59_O12,9,9q22.1,90114056,90234438,120382,-,-
BAC208_K02,9,9q22.1,90135754,90239567,103813,-,-
BAC80_J13,9,9q22.1,90135975,90242172,106197,-,-
BAC96_D07,9,9q22.1,90277757,90423942,146185,yes,-
BAC185_O07,9,9q22.1,90283288,90386618,103330,yes,-
BAC168_P07,9,9q22.1,90349150,90456461,107311,-,-
BAC8_F08,9,9q22.1,90603346,90740550,137204,-,-
BAC198_I19,9,9q22.1,90613288,90692979,79691,-,-
BAC78_B19,9,9q22.1,90625979,90725092,99113,-,-
BAC124_C18,9,9q22.1,90773274,90861582,88308,-,-
BAC69_M04,9,9q22.1,90795415,90905472,110057,-,-
BAC240_L23,9,9q22.1,90798406,90881095,82689,-,-
BAC223_D11,9,9q22.1,90868538,90948333,79795,-,-
BAC200_P02,9,9q22.1-9q22.2,90926040,91016881,90841,-,-
BAC223_O15,9,9q22.2,91017035,91089703,72668,-,-
BAC122_G19,9,9q22.2,91017038,91130111,113073,-,-
BAC5_A23,9,9q22.2,91028789,91136542,107753,-,-
BAC221_F08,9,9q22.2,91041104,91116687,75583,-,-
BAC53_E13,9,9q22.2,91181980,91306288,124308,-,-
BAC95_P05,9,9q22.2,91219102,91336014,116912,-,-
BAC104_H03,9,9q22.2,91247085,91336012,88927,-,-
BAC186_L12,9,9q22.2,91250420,91368045,117625,-,-
BAC119_I23,9,9q22.2,91250503,91411253,160750,-,-
BAC117_K02,9,9q22.2,91303266,91471950,168684,-,-
BAC244_O02,9,9q22.2,91348187,91442348,94161,-,-
BAC41_D15,9,9q22.2,91368055,91471950,103895,-,-
BAC144_M12,9,9q22.2,91416136,91496701,80565,-,-
BAC2_P10,9,9q22.2,91725291,91833024,107733,-,-
BAC92_N05,9,9q22.2,91735169,91824425,89256,-,-
BAC84_J03,9,9q22.2,91792743,91947931,155188,-,-
BAC31_H22,9,9q22.2,91792743,91896248,103505,-,-
BAC228_H05,9,9q22.2,91802009,91907719,105710,-,-
BAC143_C02,9,9q22.2,91837900,91947914,110014,-,-
BAC191_E15,9,9q22.2,91847564,91937339,89775,-,-
BAC154_M24,9,9q22.2,91851226,91937339,86113,-,-
BAC169_L05,9,9q22.2,91914232,92012394,98162,-,-
BAC26_A18,9,9q22.2,91982125,92107371,125246,-,-
BAC63_H08,9,9q22.2,91982125,92075846,93721,-,-
BAC233_P10,9,9q22.2,92012513,92132616,120103,-,-
BAC40_B08,9,9q22.2,92029464,92151714,122250,-,-
BAC158_P21,9,9q22.2,92069723,92148788,79065,-,-
BAC34_E10,9,9q22.2,92187000,92343046,156046,-,-
BAC51_N17,9,9q22.2,92188139,92317980,129841,-,-
BAC148_B03,9,9q22.2,92244747,92343046,98299,-,-
BAC43_C16,9,9q22.2,92248777,92343044,94267,-,-
BAC50_C15,9,9q22.2,92252727,92328287,75560,-,-
BAC66_P03,9,9q22.2,92252750,92343046,90296,-,-
BAC28_B08,9,9q22.2,92276371,92398259,121888,-,-
BAC58_N18,9,9q22.2,92380092,92475744,95652,-,-
BAC186_D18,9,9q22.2,92395222,92523511,128289,-,-
BAC250_I21,9,9q22.2,92395253,92488329,93076,-,-
BAC59_N02,9,9q22.2,92466167,92611775,145608,-,-
BAC2_M10,9,9q22.2,92473407,92609121,135714,-,-
BAC119_P20,9,9q22.2,92522362,92628231,105869,-,-
BAC46_I12,9,9q22.2,92557661,92593246,35585,-,-
BAC126_N16,9,9q22.2,92571004,92664096,93092,-,-
BAC126_F05,9,9q22.2,92593244,92673996,80752,-,-
BAC230_K12,9,9q22.2,92593246,92676085,82839,-,-
BAC167_G11,9,9q22.2,92664086,92774368,110282,-,-
BAC176_D16,9,9q22.2,92684954,92781764,96810,-,-
BAC81_G23,9,9q22.2,92809092,92897335,88243,-,-
BAC231_C21,9,9q22.2-9q22.31,92927251,93041140,113889,-,-
BAC152_L03,9,9q22.31,93015204,93091592,76388,-,-
BAC39_E02,9,9q22.31,93015210,93155033,139823,-,-
BAC90_K21,9,9q22.31,93040890,93189933,149043,-,-
BAC92_J21,9,9q22.31,93073466,93159634,86168,-,-
BAC31_G07,9,9q22.31,93081637,93209242,127605,-,-
BAC230_G09,9,9q22.31,93143687,93235530,91843,-,-
BAC141_J08,9,9q22.31,93144194,93235531,91337,-,-
BAC75_M01,9,9q22.31,93155030,93244855,89825,-,-
BAC244_M10,9,9q22.31,93198010,93279910,81900,-,-
BAC70_G06,9,9q22.31,93235544,93320805,85261,-,-
BAC69_P18,9,9q22.31,93317979,93433476,115497,-,-
BAC243_N18,9,9q22.31,93320961,93416511,95550,-,-
BAC23_H09,9,9q22.31,93578122,93696296,118174,-,-
BAC149_N18,9,9q22.31,93584788,93665209,80421,-,-
BAC121_P23,9,9q22.31,93584788,93665209,80421,-,-
BAC107_G17,9,9q22.31,93713641,93862648,149007,-,-
BAC224_L16,9,9q22.31,93746796,93848114,101318,-,-
BAC158_I07,9,9q22.31,93761318,93848728,87410,-,-
BAC158_F07,9,9q22.31,93761319,93848729,87410,-,-
BAC115_C01,9,9q22.31,93802888,93884173,81285,-,-
BAC97_E03,9,9q22.31,93805584,93913859,108275,-,-
BAC1_O04,9,9q22.31,93832068,93963091,131023,-,-
BAC234_O04,9,9q22.31,93863045,93965777,102732,-,-
BAC23_J09,9,9q22.31,93876373,93965881,89508,-,-
BAC62_K22,9,9q22.31,93878630,93965777,87147,-,-
BAC119_P16,9,9q22.31,93909788,94018280,108492,-,-
BAC151_N14,9,9q22.31,93979121,94077993,98872,-,-
BAC33_J14,9,9q22.31,93996613,94079512,82899,-,-
BAC240_C21,9,9q22.31,94025903,94116607,90704,-,-
BAC20_J13,9,9q22.31,94122722,94227474,104752,-,-
BAC125_H07,9,9q22.31,94153066,94315101,162035,-,-
BAC75_E05,9,9q22.31,94171438,94254576,83138,-,-
BAC48_J14,9,9q22.31,94205633,94227462,21829,-,-
BAC151_A23,9,9q22.31,94254573,94369355,114782,-,-
BAC97_I18,9,9q22.31,94300840,94414034,113194,-,-
BAC103_M12,9,9q22.31,94302635,94413982,111347,-,-
BAC46_H14,9,9q22.31,94340041,94421401,81360,-,-
BAC88_O17,9,9q22.31,94395464,94502430,106966,-,-
BAC37_F17,9,9q22.31,94421411,94528385,106974,-,-
BAC205_F10,9,9q22.31,94425038,94502426,77388,-,-
BAC91_G17,9,9q22.31,94470915,94614389,143474,-,-
BAC169_J14,9,9q22.31,94509540,94609228,99688,-,-
BAC124_D20,9,9q22.31,94527169,94627062,99893,-,-
BAC43_F16,9,9q22.31,94528412,94653146,124734,-,-
BAC76_E02,9,9q22.31,94548096,94653144,105048,-,-
BAC28_N10,9,9q22.31,94548096,94626886,78790,-,-
BAC26_C01,9,9q22.31,94591358,94694792,103434,-,-
BAC193_F09,9,9q22.31,94701026,94799840,98814,-,-
BAC175_D02,9,9q22.31,94732926,94820520,87594,-,-
BAC183_B15,9,9q22.31,94854639,95036075,181436,-,-
BAC33_H08,9,9q22.31,94862498,95034934,172436,-,-
BAC120_K05,9,9q22.31,94881972,94992678,110706,-,-
BAC88_K14,9,9q22.31,94926313,95068298,141985,-,-
BAC150_N05,9,9q22.31,94949334,95035804,86470,-,-
BAC152_D04,9,9q22.31,94993342,95068294,74952,-,-
BAC105_F20,9,9q22.31,95036336,95135461,99125,-,-
BAC181_F21,9,9q22.31,95096727,95194490,97763,-,-
BAC56_O17,9,9q22.31,95117010,95204443,87433,-,-
BAC133_A14,9,9q22.31,95118023,95141426,23403,-,-
BAC239_G17,9,9q22.31,95126105,95198875,72770,-,-
BAC65_M19,9,9q22.31,95129455,95212681,83226,-,-
BAC15_F22,9,9q22.31,95235129,95362396,127267,-,-
BAC237_J24,9,9q22.31,95278862,95362396,83534,-,-
BAC159_C09,9,9q22.31,95280409,95362396,81987,-,-
BAC69_P12,9,9q22.31,95327594,95413779,86185,-,-
BAC31_A02,9,9q22.31,95461857,95562838,100981,-,-
BAC190_N11,9,9q22.31,95467387,95547298,79911,-,-
BAC51_N19,9,9q22.31-9q22.32,95563114,95674634,111520,-,-
BAC55_E05,9,9q22.32,95624697,95742647,117950,-,-
BAC137_B23,9,9q22.32,95730852,95818327,87475,-,-
BAC102_J02,9,9q22.32,95732210,95834599,102389,-,-
BAC194_C02,9,9q22.32,95749462,95863699,114237,-,-
BAC160_A13,9,9q22.32,95749462,95842466,93004,-,-
BAC119_G10,9,9q22.32,95788116,95890949,102833,-,-
BAC69_F07,9,9q22.32,95883113,95999020,115907,-,-
BAC54_A21,9,9q22.32,95887903,95986716,98813,-,-
BAC178_O14,9,9q22.32,95908540,95983625,75085,-,-
BAC208_I11,9,9q22.32,96019750,96130897,111147,-,-
BAC221_E17,9,9q22.32,96020739,96089835,69096,-,-
BAC19_P18,9,9q22.32,96022662,96112109,89447,-,-
BAC160_L12,9,9q22.32,96040636,96131088,90452,-,-
BAC2_E18,9,9q22.32,96040636,96135108,94472,-,-
BAC175_G07,9,9q22.32,96135102,96217045,81943,-,-
BAC100_D22,9,9q22.32,96135102,96270425,135323,-,-
BAC128_N07,9,9q22.32,96180343,96297610,117267,-,-
BAC247_G21,9,9q22.32,96207856,96298772,90916,-,-
BAC22_C14,9,9q22.32,96229132,96351364,122232,-,-
BAC58_A09,9,9q22.32,96250792,96351355,100563,-,-
BAC234_F21,9,9q22.32,96261023,96345285,84262,-,-
BAC189_O08,9,9q22.32,96261023,96391083,130060,-,-
BAC222_C01,9,9q22.32,96266377,96361637,95260,-,-
BAC116_H15,9,9q22.32,96302597,96395253,92656,-,-
BAC60_K10,9,9q22.32,96305514,96403270,97756,-,-
BAC72_L08,9,9q22.32,96341735,96451223,109488,-,-
BAC158_B16,9,9q22.32,96351648,96460007,108359,-,-
BAC80_M06,9,9q22.32,96372078,96466510,94432,-,-
BAC59_M01,9,9q22.32,96382067,96496319,114252,-,-
BAC96_K18,9,9q22.32,96409692,96502194,92502,-,-
BAC18_N17,9,9q22.32,96409706,96517472,107766,-,-
BAC88_N21,9,9q22.32,96482330,96565233,82903,-,-
BAC154_M01,9,9q22.32,96604589,96683619,79030,-,-
BAC123_M15,9,9q22.32,96657885,96752086,94201,-,-
BAC65_F20,9,9q22.32,96710750,96822163,111413,-,-
BAC63_C16,9,9q22.32,96742202,96848658,106456,-,-
BAC12_E22,9,9q22.32,96781575,96901045,119470,-,-
BAC182_L02,9,9q22.32,96785968,96864514,78546,-,-
BAC154_P21,9,9q22.32,96822157,96955041,132884,-,-
BAC10_P08,9,9q22.32,96838994,96955041,116047,-,-
BAC39_A12,9,9q22.32,96851357,96977083,125726,-,-
BAC42_H08,9,9q22.32,96864507,96955041,90534,-,-
BAC31_C18,9,9q22.32,96864507,96958761,94254,-,-
BAC57_M21,9,9q22.32,96947483,97049313,101830,-,-
BAC50_C10,9,9q22.32,97192791,97292290,99499,-,-
BAC46_P10,9,9q22.32,97201735,97300288,98553,-,-
BAC189_L22,9,9q22.32,97329296,97418680,89384,-,-
BAC236_C22,9,9q22.32,97356551,97469450,112899,-,-
BAC104_J01,9,9q22.32,97414511,97513172,98661,-,-
BAC192_P19,9,9q22.32,97468694,97575632,106938,-,-
BAC202_B24,9,9q22.32,97564435,97660484,96049,-,-
BAC101_B01,9,9q22.32,97572662,97686308,113646,-,-
BAC134_B15,9,9q22.32,97573021,97660723,87702,-,-
BAC149_H19,9,9q22.32,97581923,97686450,104527,-,-
BAC226_H10,9,9q22.32,97616833,97704444,87611,-,-
BAC227_N06,9,9q22.32,97626712,97704134,77422,-,-
BAC120_E14,9,9q22.32,97626712,97729371,102659,-,-
BAC2_E06,9,9q22.32,97652226,97757841,105615,-,-
BAC218_L15,9,9q22.32,97660718,97759488,98770,-,-
BAC141_L11,9,9q22.32,97687021,97756296,69275,-,-
BAC175_A04,9,9q22.32,97751782,97848528,96746,-,-
BAC115_M03,9,9q22.32,97774199,97896932,122733,-,-
BAC151_D03,9,9q22.32,97800845,97913618,112773,-,-
BAC52_J13,9,9q22.32,97832451,97983895,151444,-,-
BAC176_N24,9,9q22.32,97874925,97983897,108972,-,-
BAC247_F13,9,9q22.32,97913615,98023585,109970,-,-
BAC158_D06,9,9q22.32,97924579,98012047,87468,-,-
BAC195_D07,9,9q22.32,97963640,98038317,74677,-,-
BAC52_F04,9,9q22.32,97964886,98112480,147594,-,-
BAC25_D17,9,9q22.32,97997992,98106006,108014,-,-
BAC46_D02,9,9q22.32,98011496,98092395,80899,-,-
BAC100_J02,9,9q22.32,98019360,98106006,86646,-,-
BAC65_N12,9,9q22.32,98023580,98115761,92181,-,-
BAC77_A02,9,9q22.32,98023591,98115753,92162,-,-
BAC78_M16,9,9q22.32,98035744,98134429,98685,-,-
BAC131_D13,9,9q22.32,98054878,98132408,77530,-,-
BAC196_O17,9,9q22.32-9q22.33,98128058,98216244,88186,-,-
BAC87_F13,9,9q22.33,98209629,98312102,102473,-,-
BAC97_E17,9,9q22.33,98269044,98341264,72220,-,-
BAC117_G21,9,9q22.33,98279858,98392366,112508,-,-
BAC144_I02,9,9q22.33,98312727,98405083,92356,-,-
BAC246_C21,9,9q22.33,98405482,98474655,69173,-,-
BAC169_M06,9,9q22.33,98406499,98523506,117007,-,-
BAC250_C13,9,9q22.33,98407076,98499802,92726,-,-
BAC65_G21,9,9q22.33,98414079,98502231,88152,-,-
BAC146_E19,9,9q22.33,98414911,98501066,86155,-,-
BAC197_B18,9,9q22.33,98419264,98504944,85680,-,-
BAC190_B10,9,9q22.33,98419264,98504944,85680,-,-
BAC157_D01,9,9q22.33,98474649,98560372,85723,-,-
BAC197_H22,9,9q22.33,98505048,98586313,81265,-,-
BAC59_P17,9,9q22.33,98505050,98628985,123935,-,-
BAC242_M02,9,9q22.33,98508071,98611086,103015,-,-
BAC25_M01,9,9q22.33,98632245,98747820,115575,-,-
BAC185_G22,9,9q22.33,98655071,98709405,54334,-,-
BAC110_H16,9,9q22.33,98890109,98979057,88948,-,-
BAC144_E11,9,9q22.33,98901527,98961434,59907,-,-
BAC130_D20,9,9q22.33,98931854,99011037,79183,-,-
BAC230_A18,9,9q22.33,98941099,99025138,84039,-,-
BAC181_F08,9,9q22.33,98997459,99095930,98471,-,-
BAC226_L10,9,9q22.33,99061193,99143952,82759,-,-
BAC189_O16,9,9q22.33,99061193,99160920,99727,-,-
BAC37_L20,9,9q22.33,99185289,99289104,103815,-,-
BAC66_B23,9,9q22.33,99225373,99327465,102092,-,-
BAC75_K08,9,9q22.33,99263443,99354586,91143,-,-
BAC168_N22,9,9q22.33,99419162,99496811,77649,-,-
BAC84_I12,9,9q22.33,99434666,99597351,162685,-,-
BAC143_C09,9,9q22.33,99521947,99600947,79000,-,-
BAC188_C04,9,9q22.33,99568757,99653384,84627,-,-
BAC131_D14,9,9q22.33,99628581,99726475,97894,-,-
BAC73_J19,9,9q22.33,99628627,99766587,137960,-,-
BAC237_F08,9,9q22.33,99693203,99777648,84445,-,-
BAC100_N15,9,9q22.33,99714323,99800267,85944,-,-
BAC148_H17,9,9q22.33,99817966,99952871,134905,-,-
BAC175_D11,9,9q22.33,99823392,99910184,86792,-,-
BAC168_K10,9,9q22.33,99906676,99987083,80407,-,-
BAC177_A11,9,9q22.33,99967529,100083287,115758,-,-
BAC142_D09,9,9q22.33,99967817,100085084,117267,-,-
BAC105_F03,9,9q22.33,99995812,100069258,73446,-,-
BAC129_D13,9,9q22.33,100001125,100098912,97787,-,-
BAC241_N18,9,9q22.33,100069252,100165133,95881,-,-
BAC132_J23,9,9q22.33,100099164,100193136,93972,-,-
BAC113_H17,9,9q22.33,100137932,100240988,103056,-,-
BAC181_J09,9,9q22.33,100192770,100314154,121384,-,-
BAC21_C08,9,9q22.33,100209884,100311621,101737,-,-
BAC37_J24,9,9q22.33,100279942,100386028,106086,-,-
BAC230_G08,9,9q22.33,100319352,100399491,80139,-,-
BAC50_O04,9,9q22.33,100373918,100466971,93053,-,-
BAC158_C08,9,9q22.33,100374693,100466957,92264,-,-
BAC158_D08,9,9q22.33,100374699,100466968,92269,-,-
BAC194_G23,9,9q22.33,100399509,100476283,76774,-,-
BAC144_P01,9,9q22.33,100494364,100587701,93337,-,-
BAC231_M23,9,9q22.33,100560546,100675337,114791,-,-
BAC12_E01,9,9q22.33,100564143,100675339,111196,-,-
BAC226_J09,9,9q22.33,100567587,100678611,111024,-,-
BAC139_J18,9,9q22.33,100581785,100675339,93554,-,-
BAC146_E01,9,9q22.33,100697412,100819669,122257,-,-
BAC244_I22,9,9q22.33,100701829,100803278,101449,-,-
BAC127_P20,9,9q22.33,100707922,100800653,92731,-,-
BAC132_F15,9,9q22.33,100721238,100803278,82040,-,-
BAC240_I16,9,9q22.33,100722797,100800622,77825,-,-
BAC90_D09,9,9q22.33,100803271,100935687,132416,-,-
BAC151_A08,9,9q22.33,100838579,100924017,85438,-,-
BAC226_O21,9,9q22.33,100840698,100916286,75588,-,-
BAC65_I11,9,9q22.33,100874129,100997475,123346,-,-
BAC21_M05,9,9q22.33,100980347,101070542,90195,-,-
BAC161_G06,9,9q22.33,100994022,101070528,76506,-,-
BAC60_L18,9,9q22.33,101032718,101125542,92824,-,-
BAC92_N21,9,9q22.33,101070536,101161088,90552,-,-
BAC42_P10,9,9q22.33,101126557,101220738,94181,-,-
BAC200_D08,9,9q22.33,101189600,101263996,74396,-,-
BAC24_I02,9,9q22.33,101218006,101326548,108542,-,-
BAC85_A07,9,9q22.33,101279368,101406693,127325,-,-
BAC12_A11,9,9q22.33,101294249,101398445,104196,-,-
BAC192_N10,9,9q22.33,101367313,101467285,99972,-,-
BAC59_G12,9,9q22.33,101379962,101492193,112231,-,-
BAC154_O05,9,9q22.33,101406688,101472837,66149,-,-
BAC37_D04,9,9q22.33-9q31.1,101524908,101659377,134469,-,-
BAC33_M11,9,9q22.33-9q31.1,101526654,101628143,101489,-,-
BAC61_M16,9,9q22.33-9q31.1,101533026,101628146,95120,-,-
BAC57_I15,9,9q22.33-9q31.1,101571439,101681297,109858,-,-
BAC110_O14,9,9q31.1,101615085,101719851,104766,-,-
BAC44_C17,9,9q31.1,101637527,101751072,113545,-,-
BAC128_N12,9,9q31.1,101672522,101786911,114389,-,-
BAC197_D02,9,9q31.1,101872633,101952949,80316,-,-
BAC194_J08,9,9q31.1,101872633,101948869,76236,-,-
BAC32_I04,9,9q31.1,102054808,102140574,85766,-,-
BAC154_A09,9,9q31.1,102060307,102127643,67336,-,-
BAC126_N04,9,9q31.1,102118143,102204339,86196,-,-
BAC122_N19,9,9q31.1,102118143,102204353,86210,-,-
BAC126_E08,9,9q31.1,102118143,102204353,86210,-,-
BAC20_F19,9,9q31.1,102135383,102222761,87378,-,-
BAC109_L20,9,9q31.1,102135465,102216577,81112,-,-
BAC97_P18,9,9q31.1,102208869,102304119,95250,-,-
BAC86_J19,9,9q31.1,102216693,102298657,81964,-,-
BAC228_L17,9,9q31.1,102312763,102417275,104512,-,-
BAC42_B19,9,9q31.1,102319398,102443502,124104,-,-
BAC193_I11,9,9q31.1,102390586,102472422,81836,-,-
BAC172_K11,9,9q31.1,102641021,102729902,88881,-,-
BAC122_J22,9,9q31.1,102658980,102750269,91289,-,-
BAC129_N20,9,9q31.1,102781968,102863486,81518,-,-
BAC49_J16,9,9q31.1,102829707,102935940,106233,-,-
BAC167_C21,9,9q31.1,102904218,102994397,90179,-,-
BAC95_K15,9,9q31.1,102935234,103044811,109577,-,-
BAC163_N08,9,9q31.1,103005955,103109676,103721,-,-
BAC97_K18,9,9q31.1,103172762,103259520,86758,-,-
BAC107_A16,9,9q31.1,103366512,103474105,107593,-,-
BAC248_G18,9,9q31.1,103390613,103489591,98978,-,-
BAC75_N07,9,9q31.1,103784537,103883157,98620,-,-
BAC17_F10,9,9q31.1,103812313,103906222,93909,-,-
BAC244_E12,9,9q31.1,103968286,104044255,75969,-,-
BAC77_A16,9,9q31.1,103968292,104045775,77483,-,-
BAC197_N19,9,9q31.1,104090858,104174461,83603,-,-
BAC29_P11,9,9q31.1,104264841,104403496,138655,-,-
BAC200_H13,9,9q31.1,104286814,104372818,86004,-,-
BAC123_F08,9,9q31.1,104321067,104446332,125265,-,-
BAC68_L17,9,9q31.1,104495007,104587843,92836,-,-
BAC199_H18,9,9q31.1,104529745,104607917,78172,-,-
BAC107_D03,9,9q31.1,104830860,104931026,100166,-,-
BAC235_N09,9,9q31.1,104849101,104923718,74617,-,-
BAC40_E15,9,9q31.1,104930141,105039524,109383,-,-
BAC58_D01,9,9q31.1,104930146,105009473,79327,-,-
BAC122_P05,9,9q31.1,105025047,105150036,124989,-,-
BAC86_D21,9,9q31.1,105189616,105343810,154194,-,-
BAC136_D07,9,9q31.1,105330810,105437488,106678,-,-
BAC148_D22,9,9q31.1,105462903,105542367,79464,-,-
BAC86_N02,9,9q31.1,105603042,105722118,119076,-,-
BAC82_E16,9,9q31.1,105783675,105815485,31810,-,-
BAC197_F18,9,9q31.1,105914298,105999133,84835,-,-
BAC145_P24,9,9q31.1,105923905,105999133,75228,-,-
BAC197_I17,9,9q31.1,105995065,106108733,113668,-,-
BAC23_K17,9,9q31.1,106101535,106204184,102649,-,-
BAC239_C13,9,9q31.1,106130988,106214641,83653,-,-
BAC59_M20,9,9q31.1,106279695,106447908,168213,yes,-
BAC127_K19,9,9q31.1,106355052,106449699,94647,-,-
BAC125_G11,9,9q31.1,106410809,106505870,95061,-,-
BAC20_B13,9,9q31.1,106505863,106597258,91395,-,-
BAC22_E04,9,9q31.1,106509347,106605692,96345,-,-
BAC146_I20,9,9q31.1,106610131,106702730,92599,-,-
BAC140_B11,9,9q31.1,106617724,106695145,77421,-,-
BAC145_B05,9,9q31.1,106631753,106734145,102392,-,-
BAC97_A10,9,9q31.1,106661498,106801191,139693,-,-
BAC20_E17,9,9q31.1,106677738,106786938,109200,-,-
BAC184_I03,9,9q31.1,106708636,106764306,55670,-,-
BAC26_A13,9,9q31.1,106766031,106875166,109135,-,-
BAC41_P24,9,9q31.1,106813825,106917653,103828,-,-
BAC211_J22,9,9q31.1,106875439,106961062,85623,-,-
BAC35_O15,9,9q31.1,106880582,106898165,17583,-,-
BAC185_A23,9,9q31.1,106921433,107028373,106940,-,-
BAC22_I07,9,9q31.1,106968857,107121096,152239,-,-
BAC121_M09,9,9q31.1-9q31.2,107118967,107236778,117811,-,-
BAC49_D02,9,9q31.1,107135365,107145419,10054,-,-
BAC102_N22,9,9q31.1-9q31.2,107180548,107318584,138036,-,-
BAC189_B17,9,9q31.2,107227372,107303101,75729,-,-
BAC23_M17,9,9q31.2,107264336,107330027,65691,-,-
BAC30_N04,9,9q31.2,107330024,107409076,79052,-,-
BAC56_C04,9,9q31.2,107332251,107456323,124072,-,-
BAC227_O12,9,9q31.2,107337368,107441446,104078,-,-
BAC165_P10,9,9q31.2,107415858,107494452,78594,-,-
BAC163_C21,9,9q31.2,107441440,107521159,79719,-,-
BAC161_E04,9,9q31.2,107470446,107562390,91944,-,-
BAC26_K13,9,9q31.2,107550718,107646189,95471,-,-
BAC83_D22,9,9q31.2,107698903,107825260,126357,-,-
BAC6_J19,9,9q31.2,107725483,107816746,91263,-,-
BAC234_H16,9,9q31.2,107731662,107816749,85087,-,-
BAC215_J10,9,9q31.2,107751088,107861870,110782,-,-
BAC172_D03,9,9q31.2,107845730,107929353,83623,-,-
BAC204_N06,9,9q31.2,107859290,107949191,89901,-,-
BAC181_D17,9,9q31.2,107906192,108035102,128910,-,-
BAC157_A16,9,9q31.2,108272861,108386754,113893,-,-
BAC161_C12,9,9q31.2,108417774,108512760,94986,-,-
BAC79_A20,9,9q31.2,108555080,108652704,97624,-,-
BAC88_J14,9,9q31.2,108612670,108712789,100119,-,-
BAC172_D10,9,9q31.2,108625127,108739308,114181,-,-
BAC189_I21,9,9q31.2,108774350,108868685,94335,-,-
BAC67_O02,9,9q31.2,108891911,109013991,122080,-,-
BAC70_A13,9,9q31.2,109024044,109117509,93465,-,-
BAC144_H02,9,9q31.2,109025834,109117522,91688,-,-
BAC170_E13,9,9q31.2,109043808,109126456,82648,-,-
BAC122_B16,9,9q31.2,109121539,109210192,88653,-,-
BAC185_M17,9,9q31.2,109260286,109356388,96102,-,-
BAC175_N06,9,9q31.2,109278259,109369252,90993,-,-
BAC67_N23,9,9q31.2,109281813,109377438,95625,-,-
BAC246_D19,9,9q31.2,109351073,109453779,102706,-,-
BAC8_E12,9,9q31.2,109413129,109526055,112926,-,-
BAC220_F04,9,9q31.2,109463685,109549850,86165,-,-
BAC37_I20,9,9q31.2,109481436,109602111,120675,-,-
BAC85_J07,9,9q31.2,109551596,109650101,98505,-,-
BAC191_I22,9,9q31.2,109701260,109784109,82849,-,-
BAC235_N02,9,9q31.2,109728286,109864205,135919,-,-
BAC150_D13,9,9q31.2,109770850,109850415,79565,-,-
BAC200_I15,9,9q31.2,109822998,109915780,92782,-,-
BAC119_C20,9,9q31.2,109878423,109965629,87206,-,-
BAC184_J20,9,9q31.2,109878425,109979844,101419,-,-
BAC56_E05,9,9q31.2,109932886,110078540,145654,-,-
BAC125_C22,9,9q31.2,109992637,110124354,131717,-,-
BAC135_C11,9,9q31.2,109992706,110101505,108799,-,-
BAC75_E22,9,9q31.2,110009226,110104444,95218,-,-
BAC219_H21,9,9q31.2,110113143,110203272,90129,-,-
BAC41_A06,9,9q31.2,110150298,110258115,107817,-,-
BAC97_I10,9,9q31.2,110193558,110295577,102019,-,-
BAC228_F03,9,9q31.2-9q31.3,110207206,110328539,121333,-,-
BAC217_G16,9,9q31.2-9q31.3,110287173,110376314,89141,-,-
BAC184_L20,9,9q31.3,110354393,110451543,97150,-,-
BAC60_N16,9,9q31.3,110408786,110498446,89660,-,-
BAC194_P11,9,9q31.3,110467504,110596359,128855,-,-
BAC126_E19,9,9q31.3,110498435,110576698,78263,-,-
BAC60_A15,9,9q31.3,110563820,110696633,132813,-,-
BAC154_F06,9,9q31.3,110569967,110642725,72758,-,-
BAC145_F08,9,9q31.3,110581434,110681215,99781,-,-
BAC54_F18,9,9q31.3,110612809,110696633,83824,-,-
BAC64_G14,9,9q31.3,110612809,110705486,92677,-,-
BAC55_G18,9,9q31.3,110612809,110774815,162006,-,-
BAC226_I03,9,9q31.3,110638381,110743802,105421,-,-
BAC39_L22,9,9q31.3,110671002,110754442,83440,-,-
BAC90_A22,9,9q31.3,110684234,110766484,82250,-,-
BAC149_B07,9,9q31.3,110745897,110836853,90956,-,-
BAC91_D21,9,9q31.3,110767595,110900400,132805,-,-
BAC226_G17,9,9q31.3,110793364,110904972,111608,-,-
BAC193_D11,9,9q31.3,110797079,110904234,107155,-,-
BAC194_K12,9,9q31.3,110841193,110927449,86256,-,-
BAC104_E23,9,9q31.3,110904967,111042712,137745,-,-
BAC33_N14,9,9q31.3,110927553,111063036,135483,-,-
BAC25_C07,9,9q31.3,110928844,111063043,134199,-,-
BAC19_B19,9,9q31.3,110928849,111045313,116464,-,-
BAC221_B11,9,9q31.3,110961236,111042712,81476,-,-
BAC205_H03,9,9q31.3,110965199,111111447,146248,-,-
BAC233_H09,9,9q31.3,110971105,111053997,82892,-,-
BAC140_N04,9,9q31.3,110992360,111096347,103987,-,-
BAC220_H03,9,9q31.3,111008082,111094957,86875,-,-
BAC232_C06,9,9q31.3,111063034,111133618,70584,-,-
BAC11_L18,9,9q31.3,111098408,111183166,84758,-,-
BAC19_N04,9,9q31.3,111111518,111207141,95623,-,-
BAC124_K21,9,9q31.3,111183171,111262057,78886,-,-
BAC137_M03,9,9q31.3,111187489,111262057,74568,-,-
BAC125_O24,9,9q31.3,111270486,111386676,116190,-,-
BAC102_E22,9,9q31.3,111283563,111385107,101544,-,-
BAC149_H15,9,9q31.3,111283577,111401768,118191,-,-
BAC215_L18,9,9q31.3,111304483,111384933,80450,-,-
BAC122_C13,9,9q31.3,111316064,111416804,100740,-,-
BAC17_O01,9,9q31.3,111480145,111578772,98627,-,-
BAC109_G14,9,9q31.3,111483477,111570580,87103,-,-
BAC160_G07,9,9q31.3,111602125,111708757,106632,-,-
BAC37_D12,9,9q31.3,111607245,111731128,123883,-,-
BAC192_P24,9,9q31.3,111731295,111868432,137137,-,-
BAC122_F10,9,9q31.3,111731295,111844303,113008,-,-
BAC54_A19,9,9q31.3,111748104,111843947,95843,-,-
BAC139_L18,9,9q31.3,111766674,111872177,105503,-,-
BAC117_J04,9,9q31.3,111772263,111875377,103114,-,-
BAC139_D10,9,9q31.3,111793945,111910938,116993,-,-
BAC175_A20,9,9q31.3,111807811,111958389,150578,-,-
BAC186_P05,9,9q31.3,111822464,111906709,84245,-,-
BAC22_K01,9,9q31.3,111822468,111910938,88470,-,-
BAC224_G01,9,9q31.3,111841173,111973845,132672,-,-
BAC226_P15,9,9q31.3,111844295,111919106,74811,-,-
BAC222_D11,9,9q31.3,111885771,111983885,98114,-,-
BAC195_C24,9,9q31.3,111885771,112003343,117572,-,-
BAC195_F15,9,9q31.3,111885771,111973850,88079,-,-
BAC130_I08,9,9q31.3,111946517,112061730,115213,yes,-
BAC51_P15,9,9q31.3,112000051,112108642,108591,yes,-
BAC63_I10,9,9q31.3,112021083,112103035,81952,yes,-
BAC163_P11,9,9q31.3,112074708,112173718,99010,-,-
BAC36_J16,9,9q31.3,112114453,112220965,106512,-,-
BAC196_P09,9,9q31.3,112173731,112262984,89253,-,-
BAC106_L19,9,9q31.3,112182662,112296574,113912,-,-
BAC200_A07,9,9q31.3,112226480,112318747,92267,-,-
BAC58_P13,9,9q31.3,112241512,112347859,106347,-,-
BAC69_N15,9,9q31.3,112487656,112612183,124527,-,-
BAC180_M16,9,9q31.3,112509691,112612183,102492,-,-
BAC106_J20,9,9q31.3,112512590,112648343,135753,-,-
BAC83_E03,9,9q31.3,112522483,112623209,100726,-,-
BAC122_P21,9,9q31.3,112581800,112682292,100492,-,-
BAC117_B13,9,9q31.3,112703289,112814350,111061,-,-
BAC160_B14,9,9q31.3,112719478,112780757,61279,-,-
BAC21_N12,9,9q31.3,112733118,112814882,81764,-,-
BAC120_D16,9,9q31.3,112736620,112838410,101790,-,-
BAC1_K22,9,9q31.3,112779141,112900596,121455,-,-
BAC186_A02,9,9q31.3,112910951,112995084,84133,-,-
BAC34_P02,9,9q31.3,112963970,113171835,207865,-,-
BAC120_B22,9,9q31.3,112968652,113073793,105141,-,-
BAC149_A22,9,9q31.3,112982564,113079523,96959,-,-
BAC235_F23,9,9q31.3,112992439,113070734,78295,-,-
BAC204_J19,9,9q31.3,112998025,113070246,72221,-,-
BAC178_E05,9,9q31.3,112998031,113089456,91425,-,-
BAC40_P23,9,9q31.3,113040642,113171835,131193,-,-
BAC105_K07,9,9q31.3,113126094,113233203,107109,-,-
BAC142_N19,9,9q31.3,113188074,113318573,130499,-,-
BAC160_H04,9,9q31.3,113216821,113322886,106065,-,-
BAC226_G08,9,9q31.3,113233195,113322886,89691,-,-
BAC32_H10,9,9q31.3,113304583,113396003,91420,-,-
BAC95_H07,9,9q31.3,113412260,113501750,89490,-,-
BAC62_F20,9,9q31.3,113432026,113577746,145720,-,-
BAC19_F09,9,9q31.3,113517087,113630821,113734,-,-
BAC197_G04,9,9q31.3,113567722,113661112,93390,-,-
BAC84_H12,9,9q31.3,113567722,113681826,114104,-,-
BAC220_H02,9,9q31.3,113569280,113661112,91832,-,-
BAC50_I10,9,9q31.3,113583430,113692879,109449,-,-
BAC18_B18,9,9q31.3,113643084,113724628,81544,-,-
BAC39_K06,9,9q31.3,113665916,113753329,87413,-,-
BAC176_I17,9,9q31.3,113737278,113810875,73597,-,-
BAC30_L09,9,9q31.3,113754831,113848250,93419,-,-
BAC139_E20,9,9q31.3-9q32,113814695,113903947,89252,-,-
BAC219_F05,9,9q31.3,113816528,113896178,79650,-,-
BAC115_I02,9,9q31.3,113824703,113895945,71242,-,-
BAC162_F22,9,9q31.3-9q32,113850879,113957349,106470,-,-
BAC180_G23,9,9q31.3-9q32,113897990,113985957,87967,-,-
BAC177_J01,9,9q32,113922739,114058795,136056,-,-
BAC60_P10,9,9q32,114039612,114179450,139838,-,-
BAC248_L02,9,9q32,114052546,114124997,72451,-,-
BAC37_B12,9,9q32,114146257,114248666,102409,-,-
BAC190_C02,9,9q32,114199377,114295766,96389,-,-
BAC195_N22,9,9q32,114224010,114314392,90382,-,-
BAC235_C09,9,9q32,114248767,114378210,129443,-,-
BAC38_E18,9,9q32,114248902,114338310,89408,-,-
BAC5_M24,9,9q32,114276325,114411935,135610,-,-
BAC217_N11,9,9q32,114297958,114394567,96609,-,-
BAC226_C06,9,9q32,114314430,114406552,92122,-,-
BAC50_F24,9,9q32,114404845,114531327,126482,-,-
BAC4_N13,9,9q32,114413839,114534558,120719,-,-
BAC135_L17,9,9q32,114507384,114637573,130189,-,-
BAC218_K08,9,9q32,114557948,114680190,122242,-,-
BAC148_F01,9,9q32,114557968,114684193,126225,-,-
BAC219_N05,9,9q32,114564715,114648894,84179,-,-
BAC82_M06,9,9q32,114652208,114739218,87010,-,-
BAC246_L20,9,9q32,114684427,114767761,83334,-,-
BAC171_J22,9,9q32,114729498,114787545,58047,-,-
BAC66_O05,9,9q32,114845855,114895936,50081,-,-
BAC135_G17,9,9q32,114845881,114895939,50058,-,-
BAC110_E04,9,9q32,114940638,115036565,95927,-,-
BAC234_K23,9,9q32,114948467,115074220,125753,-,-
BAC56_I23,9,9q32,114994955,115103712,108757,-,-
BAC155_L13,9,9q32,115122202,115229586,107384,-,-
BAC199_O20,9,9q32,115171104,115302020,130916,-,-
BAC188_P21,9,9q32,115229680,115302020,72340,-,-
BAC148_K22,9,9q32,115229682,115315848,86166,-,-
BAC60_B23,9,9q32,115230391,115342090,111699,-,-
BAC181_O24,9,9q32,115304899,115381026,76127,-,-
BAC221_K13,9,9q32,115363143,115467856,104713,-,-
BAC149_L08,9,9q32,115391007,115517471,126464,-,-
BAC168_G24,9,9q32,115424509,115517461,92952,-,-
BAC181_J14,9,9q32,115428418,115507688,79270,-,-
BAC165_O18,9,9q32,115429277,115519504,90227,-,-
BAC83_H03,9,9q32,115429902,115521987,92085,-,-
BAC173_C04,9,9q32,115430116,115535363,105247,-,-
BAC24_G05,9,9q32,115450340,115561729,111389,-,-
BAC197_O21,9,9q32,115519508,115612501,92993,-,-
BAC213_M05,9,9q32,115543470,115634550,91080,-,-
BAC11_E12,9,9q32,115659449,115796193,136744,-,-
BAC123_L08,9,9q32,115717349,115805446,88097,-,-
BAC97_I06,9,9q32,115784120,115880999,96879,-,-
BAC68_L06,9,9q32,115804719,115900395,95676,-,-
BAC107_C01,9,9q32,115804889,115929974,125085,-,-
BAC40_A18,9,9q32,115804889,115900385,95496,-,-
BAC135_D16,9,9q32,115816355,115888103,71748,-,-
BAC243_M18,9,9q32,115920630,116017223,96593,-,-
BAC168_N11,9,9q32,115996938,116077573,80635,-,-
BAC112_O03,9,9q32,116003024,116097506,94482,-,-
BAC76_L06,9,9q32,116021137,116193332,172195,-,-
BAC60_P18,9,9q32,116076012,116187352,111340,-,-
BAC90_G23,9,9q32,116077851,116187352,109501,-,-
BAC170_O20,9,9q32,116097776,116191576,93800,-,-
BAC110_J05,9,9q32,116191899,116289456,97557,-,-
BAC109_G07,9,9q32,116235785,116381996,146211,-,-
BAC118_B24,9,9q32,116235807,116328060,92253,-,-
BAC92_J14,9,9q32,116275079,116390162,115083,-,-
BAC120_B17,9,9q32,116283176,116403062,119886,-,-
BAC83_C21,9,9q32,116289460,116426435,136975,-,-
BAC167_F20,9,9q32,116301827,116390162,88335,-,-
BAC110_I09,9,9q32,116422760,116567253,144493,-,-
BAC239_P07,9,9q32,116426978,116525995,99017,-,-
BAC192_H04,9,9q32,116460574,116567251,106677,-,-
BAC186_L10,9,9q32,116460574,116578566,117992,-,-
BAC122_O08,9,9q32,116477400,116570883,93483,-,-
BAC135_J19,9,9q32,116477401,116565809,88408,-,-
BAC228_I16,9,9q32,116567387,116650288,82901,-,-
BAC132_M15,9,9q32,116570893,116666808,95915,-,-
BAC224_O04,9,9q32-9q33.1,116617866,116704019,86153,-,-
BAC10_M22,9,9q32-9q33.1,116666815,116756042,89227,-,-
BAC192_O15,9,9q32-9q33.1,116693066,116790872,97806,-,-
BAC84_A15,9,9q32-9q33.1,116699787,116787202,87415,-,-
BAC238_A24,9,9q33.1,116756036,116850847,94811,-,-
BAC244_C16,9,9q33.1,116778066,116861488,83422,-,-
BAC224_O18,9,9q33.1,116913970,117007064,93094,-,-
BAC48_E07,9,9q33.1,117048157,117180416,132259,-,-
BAC139_K14,9,9q33.1,117097410,117170475,73065,-,-
BAC240_D05,9,9q33.1,117283314,117372517,89203,-,-
BAC20_C01,9,9q33.1,117312363,117410646,98283,-,-
BAC8_I15,9,9q33.1,117361403,117472683,111280,-,-
BAC40_K01,9,9q33.1,117577913,117701437,123524,-,-
BAC51_P22,9,9q33.1,117649301,117747079,97778,-,-
BAC19_J09,9,9q33.1,117649512,117814837,165325,-,-
BAC97_D18,9,9q33.1,117775754,117870042,94288,-,-
BAC40_K18,9,9q33.1,117963825,118071355,107530,-,-
BAC60_H10,9,9q33.1,118078634,118180380,101746,-,-
BAC20_B16,9,9q33.1,118345105,118439454,94349,-,-
BAC235_O05,9,9q33.1,118389690,118501104,111414,-,-
BAC150_F23,9,9q33.1,118410087,118507187,97100,-,-
BAC56_I17,9,9q33.1,118501099,118606928,105829,-,-
BAC41_N21,9,9q33.1,118526302,118611778,85476,-,-
BAC238_O09,9,9q33.1,118529463,118680807,151344,-,-
BAC61_K01,9,9q33.1,118532175,118663984,131809,-,-
BAC152_D03,9,9q33.1,118607284,118697146,89862,-,-
BAC119_P19,9,9q33.1,118622535,118726068,103533,-,-
BAC104_L19,9,9q33.1,118769724,118883995,114271,-,-
BAC154_I08,9,9q33.1,118829755,118936362,106607,-,-
BAC189_G04,9,9q33.1,118830739,118916151,85412,-,-
BAC155_F15,9,9q33.1,118835793,118946507,110714,-,-
BAC250_I06,9,9q33.1,118858208,118946507,88299,-,-
BAC218_O05,9,9q33.1,118883991,118946466,62475,-,-
BAC117_K08,9,9q33.1,118891091,118972631,81540,-,-
BAC18_J22,9,9q33.1,118913938,119022968,109030,-,-
BAC57_C05,9,9q33.1,118949033,119048088,99055,-,-
BAC135_I03,9,9q33.1,119022962,119128475,105513,-,-
BAC230_I22,9,9q33.1,119169625,119261535,91910,-,-
BAC67_P01,9,9q33.1,119261756,119361752,99996,-,-
BAC40_G18,9,9q33.1,119291133,119411006,119873,-,-
BAC177_P18,9,9q33.1,119311287,119401727,90440,-,-
BAC177_O13,9,9q33.1,119872062,119959938,87876,-,-
BAC156_L20,9,9q33.1,119927639,120016857,89218,-,-
BAC171_B03,9,9q33.1,119967374,120052427,85053,-,-
BAC33_D01,9,9q33.1,120057517,120145034,87517,-,-
BAC107_G11,9,9q33.1,120198604,120294243,95639,-,-
BAC119_H07,9,9q33.1,120223569,120307993,84424,-,-
BAC147_G05,9,9q33.1,120412883,120508384,95501,-,-
BAC96_N01,9,9q33.1,120457327,120544044,86717,-,-
BAC106_D20,9,9q33.1,120467773,120575209,107436,-,-
BAC224_J16,9,9q33.1,120500078,120597043,96965,-,-
BAC129_J23,9,9q33.1,120589350,120688935,99585,-,-
BAC238_L24,9,9q33.1,120604763,120696988,92225,-,-
BAC22_E11,9,9q33.1,120729445,120902694,173249,-,-
BAC46_C19,9,9q33.1,120803958,120901923,97965,-,-
BAC149_K22,9,9q33.1,120873046,120963230,90184,-,-
BAC220_J09,9,9q33.1,120928421,121005001,76580,-,-
BAC26_C18,9,9q33.1,120948765,121035121,86356,-,-
BAC44_G08,9,9q33.1,120963301,121046342,83041,-,-
BAC26_L19,9,9q33.1,121070636,121203674,133038,-,-
BAC116_L08,9,9q33.1,121152141,121282367,130226,-,-
BAC185_H22,9,9q33.1,121265767,121349504,83737,-,-
BAC65_O18,9,9q33.1,121265958,121349315,83357,-,-
BAC235_A06,9,9q33.1,121624367,121713098,88731,-,-
BAC147_M14,9,9q33.1,121626182,121735643,109461,-,-
BAC176_F11,9,9q33.1,121681039,121806616,125577,-,-
BAC61_I14,9,9q33.1,121686956,121769856,82900,-,-
BAC168_O20,9,9q33.1,121729692,121829606,99914,-,-
BAC76_P23,9,9q33.1-9q33.2,121973739,122104059,130320,-,-
BAC129_D22,9,9q33.1-9q33.2,121977256,122078058,100802,-,-
BAC91_H13,9,9q33.1-9q33.2,121977256,122078058,100802,-,-
BAC23_J21,9,9q33.2,122033676,122104036,70360,-,-
BAC131_D06,9,9q33.2,122050978,122135125,84147,-,-
BAC31_A09,9,9q33.2,122080654,122180288,99634,-,-
BAC237_F02,9,9q33.2,122140627,122226729,86102,-,-
BAC147_A21,9,9q33.2,122142554,122229360,86806,-,-
BAC157_D19,9,9q33.2,122447812,122526161,78349,-,-
BAC60_H05,9,9q33.2,122472931,122566787,93856,-,-
BAC59_B18,9,9q33.2,122600394,122701878,101484,-,-
BAC185_P19,9,9q33.2,122604040,122674696,70656,-,-
BAC46_M20,9,9q33.2,122604107,122695648,91541,-,-
BAC234_P07,9,9q33.2,122661928,122762611,100683,-,-
BAC45_G18,9,9q33.2,122661937,122762607,100670,-,-
BAC43_P06,9,9q33.2,122678791,122823348,144557,-,-
BAC100_E18,9,9q33.2,122767156,122882999,115843,-,-
BAC240_P08,9,9q33.2,122767157,122849668,82511,-,-
BAC33_I16,9,9q33.2,122767177,122849668,82491,-,-
BAC76_B20,9,9q33.2,122841266,122984694,143428,-,-
BAC175_J08,9,9q33.2,122879620,122978632,99012,-,-
BAC122_A07,9,9q33.2,122879896,122990930,111034,-,-
BAC163_B03,9,9q33.2,122980714,123055339,74625,-,-
BAC214_K13,9,9q33.2,123020300,123135618,115318,-,-
BAC142_O20,9,9q33.2,123028921,123156619,127698,-,-
BAC218_J07,9,9q33.2,123046383,123135616,89233,-,-
BAC32_C12,9,9q33.2,123082509,123167576,85067,-,-
BAC234_G20,9,9q33.2,123091392,123167576,76184,-,-
BAC196_K16,9,9q33.2,123113561,123199325,85764,-,-
BAC24_K14,9,9q33.2,123135624,123251342,115718,-,-
BAC150_A16,9,9q33.2,123156938,123305798,148860,-,-
BAC65_B06,9,9q33.2,123235649,123363628,127979,-,-
BAC150_O16,9,9q33.2,123240976,123370402,129426,-,-
BAC117_O22,9,9q33.2,123240976,123348894,107918,-,-
BAC128_O04,9,9q33.2,123246267,123348896,102629,-,-
BAC96_O02,9,9q33.2,123250093,123348896,98803,-,-
BAC94_K06,9,9q33.2,123253316,123348896,95580,-,-
BAC51_K09,9,9q33.2,123348887,123463768,114881,-,-
BAC168_J07,9,9q33.2,123358865,123451998,93133,-,-
BAC148_I20,9,9q33.2,123370780,123515768,144988,-,-
BAC230_H01,9,9q33.2,123393664,123515768,122104,-,-
BAC188_O18,9,9q33.2,123482469,123582132,99663,-,-
BAC227_E08,9,9q33.2,123492197,123595087,102890,-,-
BAC63_C07,9,9q33.2,123643184,123734207,91023,-,-
BAC21_I18,9,9q33.2,123751019,123865163,114144,-,-
BAC241_B04,9,9q33.2,123751733,123841941,90208,-,-
BAC110_B15,9,9q33.2,123764621,123877591,112970,-,-
BAC156_H17,9,9q33.2,123770281,123865126,94845,-,-
BAC56_N17,9,9q33.2,123780817,123901594,120777,-,-
BAC40_D20,9,9q33.2,123797896,123955183,157287,-,-
BAC188_G21,9,9q33.2,123838888,123857807,18919,-,-
BAC125_G08,9,9q33.2,123843447,123956931,113484,-,-
BAC104_L09,9,9q33.2,123865174,123955181,90007,-,-
BAC145_O13,9,9q33.2,123877586,123955194,77608,-,-
BAC143_D17,9,9q33.2,123877586,124002739,125153,-,-
BAC27_M24,9,9q33.2,123912644,124005607,92963,-,-
BAC142_L12,9,9q33.2,123912644,124002681,90037,-,-
BAC102_L03,9,9q33.2,123912645,124002681,90036,-,-
BAC142_O12,9,9q33.2,123912769,124002681,89912,-,-
BAC140_I07,9,9q33.2,123926783,124008768,81985,-,-
BAC130_H19,9,9q33.2,124002732,124087313,84581,-,-
BAC172_J21,9,9q33.2,124011436,124114965,103529,-,-
BAC2_D03,9,9q33.2,124086223,124200819,114596,-,-
BAC238_H20,9,9q33.2,124094147,124199651,105504,-,-
BAC153_I04,9,9q33.2,124103111,124248104,144993,-,-
BAC149_I22,9,9q33.2,124308004,124398559,90555,-,-
BAC110_L04,9,9q33.2,124362685,124377716,15031,-,-
BAC126_F16,9,9q33.2,124366737,124466815,100078,-,-
BAC22_N16,9,9q33.2,124398558,124425030,26472,-,-
BAC175_C15,9,9q33.2,124458346,124554597,96251,-,-
BAC42_C12,9,9q33.2,124466813,124562999,96186,-,-
BAC61_K19,9,9q33.2,124535939,124626667,90728,-,-
BAC91_J11,9,9q33.2,124543630,124637999,94369,-,-
BAC4_N16,9,9q33.2,124592146,124698491,106345,-,-
BAC45_A04,9,9q33.2,124618495,124698193,79698,-,-
BAC26_K15,9,9q33.2,124661375,124784787,123412,-,-
BAC115_A24,9,9q33.2,124698578,124776426,77848,-,-
BAC53_J13,9,9q33.2,124713810,124831942,118132,-,-
BAC2_M06,9,9q33.2,124732335,124849797,117462,-,-
BAC187_J11,9,9q33.2,124842480,124921483,79003,-,-
BAC95_J15,9,9q33.2,124882150,125009528,127378,-,-
BAC182_O02,9,9q33.2,124900331,124983230,82899,-,-
BAC133_C05,9,9q33.2,124900404,125007421,107017,-,-
BAC36_N09,9,9q33.2,124990759,125079573,88814,-,-
BAC127_N07,9,9q33.2,124998491,125101845,103354,-,-
BAC95_D15,9,9q33.2,124998491,125086776,88285,-,-
BAC84_H08,9,9q33.2,125004425,125093984,89559,-,-
BAC151_D24,9,9q33.2,125020088,125093984,73896,-,-
BAC104_C21,9,9q33.2,125066386,125207474,141088,-,-
BAC150_B08,9,9q33.2,125093987,125172605,78618,-,-
BAC235_K15,9,9q33.2,125135087,125207160,72073,-,-
BAC8_O13,9,9q33.2,125162789,125259325,96536,-,-
BAC234_G12,9,9q33.2,125186506,125324949,138443,-,-
BAC188_L18,9,9q33.2,125187897,125282712,94815,-,-
BAC155_B17,9,9q33.2,125228528,125308680,80152,-,-
BAC180_J05,9,9q33.2,125233646,125361152,127506,-,-
BAC117_C16,9,9q33.2,125245005,125361156,116151,-,-
BAC195_E02,9,9q33.2,125249904,125361158,111254,-,-
BAC2_K23,9,9q33.2,125249905,125361746,111841,-,-
BAC154_O11,9,9q33.2,125265319,125371283,105964,-,-
BAC124_M08,9,9q33.2,125273158,125361156,87998,-,-
BAC227_C20,9,9q33.2,125282753,125422313,139560,-,-
BAC120_G15,9,9q33.2,125324942,125403295,78353,-,-
BAC35_J17,9,9q33.2,125377025,125474250,97225,-,-
BAC116_E20,9,9q33.2,125381679,125461445,79766,-,-
BAC122_O03,9,9q33.2,125386679,125503052,116373,-,-
BAC194_K18,9,9q33.2,125571430,125650758,79328,-,-
BAC65_P11,9,9q33.2,125633669,125722448,88779,-,-
BAC234_K17,9,9q33.2-9q33.3,125716664,125800822,84158,-,-
BAC221_P11,9,9q33.3,125890848,125970474,79626,-,-
BAC157_E06,9,9q33.3,125989165,126059964,70799,-,-
BAC116_H01,9,9q33.3,126034381,126130268,95887,-,-
BAC53_O13,9,9q33.3,126151431,126337694,186263,-,-
BAC51_D14,9,9q33.3,126180103,126286853,106750,-,-
BAC95_F08,9,9q33.3,126222807,126319362,96555,-,-
BAC88_K08,9,9q33.3,126350433,126531155,180722,-,-
BAC148_M18,9,9q33.3,126356341,126457210,100869,-,-
BAC34_M01,9,9q33.3,126387671,126493776,106105,-,-
BAC195_N21,9,9q33.3,126412570,126511070,98500,-,-
BAC219_I24,9,9q33.3,126493818,126598673,104855,-,-
BAC150_F22,9,9q33.3,126511065,126601868,90803,-,-
BAC25_G04,9,9q33.3,126513848,126601892,88044,-,-
BAC110_A14,9,9q33.3,126513849,126672710,158861,-,-
BAC182_H08,9,9q33.3,126563447,126654791,91344,-,-
BAC162_G14,9,9q33.3,126563447,126654831,91384,-,-
BAC127_G12,9,9q33.3,126601885,126715423,113538,-,-
BAC180_K02,9,9q33.3,126679963,126776547,96584,-,-
BAC194_M06,9,9q33.3,126679983,126774588,94605,-,-
BAC132_H15,9,9q33.3,126716809,126846927,130118,-,-
BAC28_H22,9,9q33.3,126776796,126913348,136552,-,-
BAC69_D11,9,9q33.3,126780142,126891717,111575,-,-
BAC128_C08,9,9q33.3,126798361,126881014,82653,-,-
BAC53_N09,9,9q33.3,126860979,126964190,103211,-,-
BAC91_P05,9,9q33.3,126867106,126998696,131590,yes,-
BAC83_D03,9,9q33.3,126891716,127009795,118079,yes,-
BAC29_H02,9,9q33.3,126940696,127020681,79985,yes,-
BAC144_D04,9,9q33.3,126953069,127056694,103625,-,-
BAC33_G07,9,9q33.3,127021013,127132289,111276,-,-
BAC21_H16,9,9q33.3,127021013,127132235,111222,-,-
BAC95_O24,9,9q33.3,127038320,127127997,89677,-,-
BAC178_C13,9,9q33.3,127104088,127181919,77831,-,-
BAC217_K08,9,9q33.3,127166364,127254692,88328,-,-
BAC166_O03,9,9q33.3,127172352,127288111,115759,-,-
BAC12_P18,9,9q33.3,127173782,127254692,80910,-,-
BAC250_E12,9,9q33.3,127190545,127279498,88953,-,-
BAC4_J05,9,9q33.3,127190562,127300105,109543,-,-
BAC219_I12,9,9q33.3,127286153,127366865,80712,-,-
BAC122_F18,9,9q33.3,127323994,127411571,87577,-,-
BAC11_I18,9,9q33.3,127345127,127455753,110626,-,-
BAC168_O23,9,9q33.3,127366860,127455753,88893,-,-
BAC107_G15,9,9q33.3,127368158,127466824,98666,-,-
BAC175_I12,9,9q33.3,127400560,127479794,79234,-,-
BAC62_D20,9,9q33.3,127409783,127544942,135159,-,-
BAC23_L12,9,9q33.3,127420150,127500786,80636,-,-
BAC158_G05,9,9q33.3,127427610,127532818,105208,-,-
BAC233_O14,9,9q33.3,127460598,127543587,82989,-,-
BAC63_L05,9,9q33.3,127463592,127552204,88612,-,-
BAC13_C12,9,9q33.3,127652785,127738047,85262,-,-
BAC232_P11,9,9q33.3,127713872,127850659,136787,-,-
BAC18_P20,9,9q33.3,127718378,127822320,103942,-,-
BAC241_B18,9,9q33.3,127718378,127817049,98671,-,-
BAC135_O01,9,9q33.3,127738051,127822330,84279,-,-
BAC219_N09,9,9q33.3,127817182,127975850,158668,-,-
BAC25_D21,9,9q33.3,127841979,127933173,91194,-,-
BAC125_M09,9,9q33.3,127850658,128022980,172322,-,-
BAC235_E22,9,9q33.3,127853508,127962322,108814,-,-
BAC235_C05,9,9q33.3,127868659,127962322,93663,-,-
BAC197_P18,9,9q33.3,127901524,128022980,121456,-,-
BAC70_I10,9,9q33.3,127962367,128053696,91329,-,-
BAC168_D03,9,9q33.3,127978773,128066106,87333,-,-
BAC126_A13,9,9q33.3,128033791,128134160,100369,-,-
BAC122_N16,9,9q33.3,128033800,128134158,100358,-,-
BAC200_C20,9,9q33.3,128064657,128149802,85145,-,-
BAC246_P09,9,9q33.3,128149795,128235266,85471,-,-
BAC5_I02,9,9q33.3,128154258,128235281,81023,-,-
BAC181_P16,9,9q33.3,128220666,128313161,92495,-,-
BAC45_D05,9,9q33.3,128236093,128362287,126194,-,-
BAC193_F12,9,9q33.3,128245605,128352269,106664,-,-
BAC143_G12,9,9q33.3,128260025,128347240,87215,-,-
BAC247_J05,9,9q33.3,128313157,128405158,92001,-,-
BAC92_D07,9,9q33.3,128457771,128590583,132812,-,-
BAC132_E22,9,9q33.3,128479909,128594862,114953,-,-
BAC48_H16,9,9q33.3,128479948,128590606,110658,-,-
BAC161_O18,9,9q33.3,128532044,128641903,109859,-,-
BAC38_K12,9,9q33.3,128572148,128674834,102686,-,-
BAC58_C14,9,9q33.3,128587449,128681424,93975,-,-
BAC65_L03,9,9q33.3,128634928,128706128,71200,-,-
BAC223_D07,9,9q33.3,128634929,128794037,159108,-,-
BAC165_J03,9,9q33.3,128658062,128735202,77140,-,-
BAC24_D06,9,9q33.3,128795687,128897126,101439,-,-
BAC10_O04,9,9q33.3,128798931,128928206,129275,-,-
BAC58_A18,9,9q33.3,128801887,128897126,95239,-,-
BAC222_E14,9,9q33.3,128806861,128928193,121332,-,-
BAC70_D13,9,9q33.3,128813679,128946244,132565,-,-
BAC112_A06,9,9q33.3,128816130,128954909,138779,-,-
BAC241_E03,9,9q33.3,128832766,128941579,108813,-,-
BAC65_E14,9,9q33.3,128851125,128954920,103795,-,-
BAC198_K13,9,9q33.3,128852235,128954920,102685,-,-
BAC139_G17,9,9q33.3,128933477,129012239,78762,-,-
BAC236_L14,9,9q33.3,128962930,129068540,105610,-,-
BAC183_H05,9,9q33.3,129154749,129268079,113330,-,-
BAC217_O14,9,9q33.3-9q34.11,129238272,129397054,158782,-,-
BAC236_D17,9,9q33.3-9q34.11,129246187,129330396,84209,-,-
BAC11_K13,9,9q33.3-9q34.11,129282727,129410336,127609,-,-
BAC176_O03,9,9q33.3-9q34.11,129282727,129382643,99916,-,-
BAC123_A09,9,9q33.3-9q34.11,129282727,129410405,127678,-,-
BAC175_B12,9,9q33.3-9q34.11,129295784,129431281,135497,-,-
BAC23_B05,9,9q34.11,129397264,129494857,97593,-,-
BAC197_A07,9,9q34.11,129424477,129555164,130687,-,-
BAC151_A04,9,9q34.11,129674217,129798821,124604,-,-
BAC73_D02,9,9q34.11,129739712,129851193,111481,-,-
BAC36_C23,9,9q34.11,129753967,129851182,97215,-,-
BAC175_O06,9,9q34.11,129764295,129864741,100446,-,-
BAC199_C08,9,9q34.11,129783682,129864741,81059,-,-
BAC217_L04,9,9q34.11,129805131,129896251,91120,-,-
BAC236_B15,9,9q34.11,129896365,130033262,136897,-,-
BAC96_I05,9,9q34.11,129896444,130043991,147547,-,-
BAC232_J19,9,9q34.11,129896703,130022615,125912,-,-
BAC233_D14,9,9q34.11,129948637,130031700,83063,-,-
BAC78_P12,9,9q34.11,129972323,130055806,83483,-,-
BAC158_H12,9,9q34.11,129972500,130119932,147432,-,-
BAC51_P09,9,9q34.11,130119934,130233721,113787,-,-
BAC96_O08,9,9q34.11,130147026,130308092,161066,-,-
BAC95_F19,9,9q34.11,130152059,130245242,93183,-,-
BAC117_H17,9,9q34.11,130233736,130387882,154146,-,-
BAC41_H21,9,9q34.11,130371384,130494162,122778,-,-
BAC60_I21,9,9q34.11,130383318,130490733,107415,-,-
BAC124_H23,9,9q34.11,130387920,130487152,99232,-,-
BAC180_L05,9,9q34.11,130393804,130498232,104428,-,-
BAC170_G18,9,9q34.11,130406609,130498637,92028,-,-
BAC5_F24,9,9q34.11,130406609,130490756,84147,-,-
BAC114_C15,9,9q34.11,130498241,130593931,95690,-,-
BAC240_M05,9,9q34.11,130531510,130645837,114327,-,-
BAC118_A06,9,9q34.11,130569952,130668083,98131,-,-
BAC220_J19,9,9q34.11,130610809,130707615,96806,-,-
BAC186_J06,9,9q34.11,130610810,130691318,80508,-,-
BAC115_J13,9,9q34.11,130612127,130713771,101644,-,-
BAC57_M12,9,9q34.11,130737393,130882518,145125,-,-
BAC167_O16,9,9q34.11,130775141,130850983,75842,-,-
BAC66_H23,9,9q34.11,130838613,130934101,95488,-,-
BAC226_J22,9,9q34.11,130850732,130934090,83358,-,-
BAC143_J21,9,9q34.11,130926433,131068775,142342,-,-
BAC19_P07,9,9q34.11,130974215,131068773,94558,-,-
BAC137_A02,9,9q34.11,131133785,131206428,72643,-,-
BAC186_E18,9,9q34.11,131137837,131244242,106405,-,-
BAC163_L04,9,9q34.11,131326587,131429601,103014,-,-
BAC195_J09,9,9q34.11,131487011,131603988,116977,yes,-
BAC116_J13,9,9q34.11,131491254,131574648,83394,yes,-
BAC128_B21,9,9q34.11,131504868,131624365,119497,yes,-
BAC196_B10,9,9q34.11,131531231,131615135,83904,yes,-
BAC103_J17,9,9q34.11,131547242,131635513,88271,-,-
BAC243_C18,9,9q34.11,131561563,131704183,142620,-,-
BAC119_O09,9,9q34.11,131581065,131704193,123128,-,-
BAC143_M14,9,9q34.11,131603982,131694466,90484,-,-
BAC153_O13,9,9q34.11,131635528,131754768,119240,-,-
BAC224_O05,9,9q34.11,131635532,131715307,79775,-,-
BAC31_K23,9,9q34.11,131728540,131888239,159699,-,-
BAC167_B08,9,9q34.11,131775206,131856161,80955,-,-
BAC41_P15,9,9q34.11,131775206,131894263,119057,-,-
BAC53_A09,9,9q34.11,131789918,131882110,92192,-,-
BAC199_P21,9,9q34.11,131790001,131880449,90448,-,-
BAC24_P20,9,9q34.11,131826171,131923282,97111,-,-
BAC197_C05,9,9q34.11,131853972,131967438,113466,-,-
BAC195_P01,9,9q34.11,131903112,131989081,85969,-,-
BAC34_E19,9,9q34.11,131923540,132066331,142791,-,-
BAC214_J02,9,9q34.11,131927296,132012839,85543,-,-
BAC221_B09,9,9q34.11,131951858,132048901,97043,-,-
BAC193_P21,9,9q34.11,131951858,132048002,96144,-,-
BAC42_J24,9,9q34.11,132253136,132335202,82066,-,-
BAC142_B18,9,9q34.11,132266880,132364697,97817,-,-
BAC134_H02,9,9q34.11,132319564,132441104,121540,-,-
BAC173_J23,9,9q34.11,132335200,132445526,110326,-,-
BAC26_J04,9,9q34.11,132340651,132466198,125547,-,-
BAC75_O20,9,9q34.11,132364694,132459268,94574,-,-
BAC149_J02,9,9q34.11,132364911,132445521,80610,-,-
BAC102_P15,9,9q34.11,132364911,132458255,93344,-,-
BAC242_J11,9,9q34.11,132373700,132458143,84443,-,-
BAC161_O15,9,9q34.11-9q34.12,132409329,132502961,93632,-,-
BAC68_D08,9,9q34.11-9q34.12,132411721,132510445,98724,-,-
BAC26_P02,9,9q34.11-9q34.12,132466197,132564086,97889,-,-
BAC192_H18,9,9q34.11-9q34.12,132494808,132579578,84770,-,-
BAC34_N02,9,9q34.12,132502985,132579579,76594,-,-
BAC113_B17,9,9q34.12,132555017,132661810,106793,-,-
BAC20_C09,9,9q34.12,132591127,132692593,101466,-,-
BAC149_N16,9,9q34.12,132600256,132704564,104308,-,-
BAC199_H02,9,9q34.12,132608966,132706719,97753,-,-
BAC67_H16,9,9q34.12,132614092,132706715,92623,-,-
BAC83_A05,9,9q34.12,132659622,132727505,67883,-,-
BAC96_P22,9,9q34.12,132676728,132778448,101720,-,-
BAC73_H06,9,9q34.12,132706715,132788153,81438,-,-
BAC162_K15,9,9q34.12-9q34.13,132716474,132823101,106627,-,-
BAC132_H13,9,9q34.12-9q34.13,132793272,132896199,102927,-,-
BAC125_M06,9,9q34.13,132823095,132960255,137160,yes,-
BAC234_G18,9,9q34.13,132827471,132938725,111254,-,-
BAC222_A09,9,9q34.13,132865969,132986542,120573,yes,-
BAC191_D03,9,9q34.13,132916014,133027120,111106,-,-
BAC168_G12,9,9q34.13,132938719,133033706,94987,-,-
BAC62_J16,9,9q34.13,132990779,133080650,89871,-,-
BAC193_B18,9,9q34.13,133084750,133168237,83487,-,-
BAC238_K16,9,9q34.13,133084750,133174104,89354,-,-
BAC84_E02,9,9q34.13,133084750,133174131,89381,-,-
BAC97_H24,9,9q34.13,133095511,133189580,94069,-,-
BAC62_D04,9,9q34.13,133095513,133175964,80451,-,-
BAC71_D11,9,9q34.13,133176002,133297908,121906,-,-
BAC139_B19,9,9q34.13,133189686,133324105,134419,-,-
BAC51_C04,9,9q34.13,133193426,133299767,106341,-,-
BAC151_H14,9,9q34.13,133209368,133294064,84696,-,-
BAC37_H10,9,9q34.13,133209377,133324105,114728,-,-
BAC162_O16,9,9q34.13,133216307,133324104,107797,-,-
BAC54_E05,9,9q34.13,133306592,133391572,84980,-,-
BAC9_C11,9,9q34.13,133322293,133459015,136722,-,-
BAC127_K14,9,9q34.13,133329475,133418542,89067,-,-
BAC109_A13,9,9q34.13,133425089,133569691,144602,-,-
BAC26_C11,9,9q34.13,133468516,133573902,105386,-,-
BAC50_N15,9,9q34.13,133489509,133581452,91943,-,-
BAC173_F13,9,9q34.13,133501536,133579107,77571,-,-
BAC182_F07,9,9q34.13,133515114,133582517,67403,-,-
BAC59_O16,9,9q34.13,133548910,133649207,100297,-,-
BAC242_E03,9,9q34.13,133573960,133656719,82759,-,-
BAC183_E02,9,9q34.13,133573960,133672244,98284,-,-
BAC219_F07,9,9q34.13,133582510,133692039,109529,-,-
BAC60_C21,9,9q34.13,133582510,133672244,89734,-,-
BAC194_I04,9,9q34.13,133582510,133669310,86800,-,-
BAC142_N18,9,9q34.13,133588112,133659967,71855,-,-
BAC101_G03,9,9q34.13,133588112,133692018,103906,-,-
BAC23_D23,9,9q34.13,133659960,133789285,129325,-,-
BAC126_N07,9,9q34.13,133669938,133789283,119345,-,-
BAC141_N22,9,9q34.13,133672284,133758906,86622,-,-
BAC236_C10,9,9q34.13,133672284,133757115,84831,-,-
BAC252_L03,9,9q34.13,133692034,133792128,100094,-,-
BAC219_H04,9,9q34.13,133837168,133904343,67175,-,-
BAC236_L04,9,9q34.13,133844277,133965591,121314,-,-
BAC180_N10,9,9q34.13,133893087,134036632,143545,-,-
BAC139_F20,9,9q34.13,133897291,133982668,85377,-,-
BAC122_C14,9,9q34.13,133902787,134021627,118840,-,-
BAC204_P20,9,9q34.13,133925729,134008082,82353,-,-
BAC222_P10,9,9q34.13,133925791,134021627,95836,-,-
BAC152_B24,9,9q34.13,133993441,134102401,108960,-,-
BAC226_K02,9,9q34.13,134021622,134115166,93544,-,-
BAC143_M05,9,9q34.13,134021656,134118839,97183,-,-
BAC236_G08,9,9q34.13,134022255,134127551,105296,-,-
BAC148_I09,9,9q34.13,134195321,134323502,128181,-,-
BAC140_O11,9,9q34.13,134264722,134339716,74994,-,-
BAC137_H16,9,9q34.13,134272750,134391360,118610,-,-
BAC32_L12,9,9q34.13,134306296,134458104,151808,-,-
BAC240_B04,9,9q34.13,134369964,134458099,88135,-,-
BAC246_A05,9,9q34.13,134369968,134458160,88192,-,-
BAC175_A03,9,9q34.13,134414105,134509951,95846,-,-
BAC195_B03,9,9q34.13,134422371,134509054,86683,-,-
BAC249_A02,9,9q34.13,134497219,134589484,92265,-,-
BAC19_B05,9,9q34.13,134497507,134608042,110535,-,-
BAC101_H16,9,9q34.13,134521433,134622435,101002,-,-
BAC181_G21,9,9q34.13,134537314,134645262,107948,-,-
BAC156_J11,9,9q34.13,134539744,134646193,106449,-,-
BAC106_J18,9,9q34.13,134598833,134697266,98433,-,-
BAC157_B13,9,9q34.13,134608043,134697266,89223,-,-
BAC43_K15,9,9q34.13,134640952,134758310,117358,-,-
BAC80_I18,9,9q34.13,134646393,134741928,95535,-,-
BAC56_H07,9,9q34.13,134697417,134801182,103765,-,-
BAC130_D12,9,9q34.13,134771156,134862197,91041,-,-
BAC107_M18,9,9q34.13-9q34.2,134788232,134901911,113679,-,-
BAC79_E21,9,9q34.13,134788241,134876144,87903,-,-
BAC26_M03,9,9q34.13-9q34.2,134788287,134982659,194372,yes,-
BAC105_J09,9,9q34.13,134800380,134890044,89664,-,-
BAC183_E06,9,9q34.13,134804702,134893729,89027,-,-
BAC108_J10,9,9q34.13-9q34.2,134842951,134995847,152896,-,-
BAC136_K01,9,9q34.13-9q34.2,134859964,134967636,107672,yes,-
BAC107_D14,9,9q34.13-9q34.2,134890189,134982659,92470,yes,-
BAC57_C06,9,9q34.2,135143431,135215410,71979,-,-
BAC64_O10,9,9q34.2,135143917,135257029,113112,-,-
BAC7_M04,9,9q34.2,135222391,135322468,100077,-,-
BAC200_P12,9,9q34.2,135234012,135321024,87012,-,-
BAC44_F01,9,9q34.2,135491203,135604356,113153,yes,-
BAC233_P12,9,9q34.2,135510939,135625755,114816,yes,-
BAC234_A03,9,9q34.2,135527920,135605682,77762,-,-
BAC141_E04,9,9q34.2,135619353,135719292,99939,-,-
BAC214_N09,9,9q34.2,135728064,135826083,98019,-,-
BAC177_J14,9,9q34.2,135739700,135871954,132254,-,-
BAC16_G22,9,9q34.2,135872627,135962108,89481,-,-
BAC230_H09,9,9q34.2,135894411,135990862,96451,-,-
BAC127_H17,9,9q34.2,135905585,136004980,99395,-,-
BAC196_D09,9,9q34.2,135906852,136004981,98129,-,-
BAC237_I04,9,9q34.2,136282184,136388428,106244,-,-
BAC145_F22,9,9q34.2,136287913,136388428,100515,-,-
BAC36_M16,9,9q34.2-9q34.3,136509560,136640299,130739,-,-
BAC246_D20,9,9q34.2,136509560,136592087,82527,-,-
BAC76_I07,9,9q34.2-9q34.3,136529641,136615329,85688,-,-
BAC232_L15,9,9q34.2-9q34.3,136540284,136702919,162635,-,-
BAC190_H09,9,9q34.2-9q34.3,136553341,136646643,93302,-,-
BAC145_P11,9,9q34.2-9q34.3,136590511,136656427,65916,-,-
BAC25_N21,9,9q34.2-9q34.3,136592103,136695547,103444,-,-
BAC148_B08,9,9q34.3,136620875,136724061,103186,-,-
BAC156_D12,9,9q34.3,136844890,136929001,84111,-,-
BAC100_I14,9,9q34.3,136851679,136934826,83147,-,-
BAC151_G19,9,9q34.3,136895947,136980519,84572,-,-
BAC67_L14,9,9q34.3,136929102,137095147,166045,-,-
BAC198_J13,9,9q34.3,136929102,137006025,76923,-,-
BAC71_O06,9,9q34.3,136937144,137053328,116184,-,-
BAC201_H14,9,9q34.3,136937144,137041339,104195,-,-
BAC143_M20,9,9q34.3,136945309,137041235,95926,-,-
BAC177_D14,9,9q34.3,136954092,137041236,87144,-,-
BAC146_I22,9,9q34.3,136969498,137034475,64977,-,-
BAC126_E15,9,9q34.3,137042465,137146642,104177,-,-
BAC215_G07,9,9q34.3,137056854,137139480,82626,-,-
BAC191_K18,9,9q34.3,137085313,137210901,125588,-,-
BAC110_G13,9,9q34.3,137211117,137354696,143579,-,-
BAC168_B04,9,9q34.3,137235966,137348883,112917,-,-
BAC197_P02,9,9q34.3,137446380,137562848,116468,-,-
BAC78_E21,9,9q34.3,137446383,137534290,87907,-,-
BAC113_J06,9,9q34.3,137448749,137542641,93892,-,-
BAC115_P05,9,9q34.3,137448811,137534282,85471,-,-
BAC154_G05,9,9q34.3,137449318,137534293,84975,-,-
BAC58_L06,9,9q34.3,137501442,137588189,86747,-,-
BAC30_E01,9,9q34.3,137592320,137709885,117565,-,-
BAC150_M22,9,9q34.3,137606425,137702624,96199,-,-
BAC122_I12,9,9q34.3,137606425,137702624,96199,-,-
BAC82_I02,9,9q34.3,137631757,137710699,78942,-,-
BAC211_O23,9,9q34.3,137631825,137721821,89996,-,-
BAC152_H13,9,9q34.3,137710030,137832429,122399,-,-
BAC250_J02,9,9q34.3,137741870,137840654,98784,-,-
BAC104_F24,9,9q34.3,137834014,137934720,100706,-,-
BAC167_B02,9,9q34.3,137910229,138007973,97744,-,-
BAC231_J21,9,9q34.3,137917744,138007972,90228,-,-
BAC116_G10,9,9q34.3,138007965,138127932,119967,-,-
BAC145_N03,9,9q34.3,138007965,138152863,144898,-,-
BAC179_E07,9,9q34.3,138007965,138110725,102760,-,-
BAC136_O21,9,9q34.3,138047492,138167538,120046,-,-
BAC163_H04,9,9q34.3,138397633,138501527,103894,-,-
BAC158_O08,9,9q34.3,138413329,138490199,76870,-,-
BAC22_J24,9,9q34.3,138450398,138573475,123077,-,-
BAC56_B05,9,9q34.3,138451902,138462388,10486,-,-
BAC11_C10,9,9q34.3,138494631,138588398,93767,-,-
BAC33_L14,9,9q34.3,138501553,138588398,86845,-,-
BAC231_H17,9,9q34.3,138569183,138655296,86113,-,-
BAC32_M14,9,9q34.3,138602720,138691796,89076,-,-
BAC25_L22,9,9q34.3,138656724,138752625,95901,-,-
BAC149_M10,9,9q34.3,138685829,138769682,83853,yes,-
BAC76_B16,9,9q34.3,138685835,138782580,96745,yes,-
BAC107_F02,9,9q34.3,138752620,138831891,79271,yes,-
BAC92_N09,9,9q34.3,138831943,138986440,154497,yes,-
BAC203_M24,9,9q34.3,138856113,138962427,106314,yes,-
BAC176_M06,9,9q34.3,138897606,138986442,88836,-,-
BAC188_D17,9,9q34.3,138962432,139118852,156420,-,-
BAC40_A16,9,9q34.3,139040633,139171835,131202,yes,-
BAC243_L19,9,9q34.3,139044021,139183085,139064,yes,-
BAC224_C15,9,9q34.3,139097657,139171835,74178,yes,-
BAC219_H11,9,9q34.3,139224723,139352534,127811,-,-
BAC246_F16,9,9q34.3,139456598,139559657,103059,-,-
BAC192_O16,9,9q34.3,139594876,139707797,112921,-,-
BAC248_D02,9,9q34.3,139596446,139702259,105813,-,-
BAC203_P11,9,9q34.3,139597424,139702170,104746,-,-
BAC226_B16,9,9q34.3,139597426,139702259,104833,-,-
BAC40_B13,9,9q34.3,139604995,139702260,97265,-,-
BAC236_B05,9,9q34.3,139604995,139707797,102802,-,-
BAC161_G23,9,9q34.3,139608140,139707795,99655,-,-
BAC144_E02,9,9q34.3,139608140,139702259,94119,-,-
BAC106_C12,9,9q34.3,139634372,139702259,67887,-,-
BAC124_P01,9,9q34.3,139673117,139811682,138565,-,-
BAC167_E09,9,9q34.3,139728341,139808923,80582,-,-
BAC196_F01,9,9q34.3,139739941,139826939,86998,-,-
BAC77_F08,9,9q34.3,139776182,139877468,101286,-,-
BAC46_C06,9,9q34.3,139780215,139876968,96753,-,-
BAC227_E05,9,9q34.3,139805044,139880761,75717,-,-
BAC78_E19,9,9q34.3,139805044,139927787,122743,-,-
BAC118_B23,9,9q34.3,139809464,139916977,107513,-,-
BAC162_I02,9,9q34.3,139811686,139907865,96179,-,-
BAC131_B06,9,9q34.3,139841773,139942731,100958,-,-
BAC148_K17,9,9q34.3,139979345,140087553,108208,-,-
BAC217_M16,9,9q34.3,139994493,140093350,98857,-,-
BAC219_O21,9,9q34.3,140004066,140087574,83508,-,-
BAC150_K07,9,9q34.3,140004066,140090818,86752,-,-
BAC42_G04,9,9q34.3,140004069,140090818,86749,-,-
BAC178_B12,9,9q34.3,140009973,140148397,138424,-,-
BAC185_K16,9,9q34.3,140012331,140091885,79554,-,-
BAC103_N01,9,9q34.3,140046551,140168326,121775,-,-
BAC222_F18,9,9q34.3,140087568,140168326,80758,-,-
BAC188_H13,9,9q34.3,140091880,140168326,76446,-,-
BAC166_O21,9,9q34.3,140123438,140224581,101143,-,-
BAC185_G16,9,9q34.3,140148400,140224556,76156,-,-
BAC185_E24,9,9q34.3,140167766,140245448,77682,-,-
BAC58_K23,10,10p15.3,100940,186798,85858,-,-
BAC44_O07,10,10p15.3,186049,275042,88993,-,-
BAC211_E05,10,10p15.3,187362,275033,87671,-,-
BAC128_F05,10,10p15.3,250629,455996,205367,-,-
BAC228_L16,10,10p15.3,250629,334977,84348,-,-
BAC76_P12,10,10p15.3,253472,422730,169258,-,-
BAC215_G01,10,10p15.3,268639,370898,102259,-,-
BAC168_L21,10,10p15.3,283651,362051,78400,-,-
BAC69_D13,10,10p15.3,284027,412497,128470,-,-
BAC241_H16,10,10p15.3,298434,380161,81727,-,-
BAC21_N16,10,10p15.3,299766,412708,112942,-,-
BAC148_A09,10,10p15.3,334971,445370,110399,-,-
BAC59_F16,10,10p15.3,336911,422730,85819,-,-
BAC37_G17,10,10p15.3,445373,576547,131174,-,-
BAC250_A03,10,10p15.3,523874,636799,112925,-,-
BAC70_M18,10,10p15.3,543352,636788,93436,-,-
BAC142_O18,10,10p15.3,550224,651554,101330,-,-
BAC176_J17,10,10p15.3,608177,730847,122670,-,-
BAC143_B19,10,10p15.3,633698,757277,123579,-,-
BAC161_H04,10,10p15.3,645358,730025,84667,-,-
BAC142_P04,10,10p15.3,660171,749104,88933,-,-
BAC186_N10,10,10p15.3,757995,851276,93281,-,-
BAC219_F18,10,10p15.3,795549,881279,85730,-,-
BAC42_F19,10,10p15.3,854991,1005326,150335,-,-
BAC83_J16,10,10p15.3,895824,998966,103142,-,-
BAC232_L01,10,10p15.3,932949,1022879,89930,-,-
BAC126_P17,10,10p15.3,932949,1071232,138283,-,-
BAC100_J23,10,10p15.3,963568,1071232,107664,-,-
BAC229_P07,10,10p15.3,998975,1086423,87448,-,-
BAC124_B16,10,10p15.3,1003684,1092307,88623,-,-
BAC56_H05,10,10p15.3,1017213,1107963,90750,-,-
BAC171_I14,10,10p15.3,1064921,1136386,71465,-,-
BAC20_F11,10,10p15.3,1071227,1203711,132484,-,-
BAC61_G18,10,10p15.3,1071251,1188984,117733,-,-
BAC182_G02,10,10p15.3,1106214,1202990,96776,-,-
BAC247_B06,10,10p15.3,1107960,1202994,95034,-,-
BAC92_B20,10,10p15.3,1107997,1219734,111737,-,-
BAC210_A11,10,10p15.3,1111020,1219734,108714,-,-
BAC100_B08,10,10p15.3,1201211,1310093,108882,-,-
BAC128_L03,10,10p15.3,1201227,1303744,102517,-,-
BAC54_A11,10,10p15.3,1203001,1290124,87123,-,-
BAC246_N13,10,10p15.3,1203002,1310093,107091,-,-
BAC150_J22,10,10p15.3,1310183,1392185,82002,-,-
BAC76_L23,10,10p15.3,1490498,1598258,107760,-,-
BAC184_B22,10,10p15.3,1516735,1608766,92031,-,-
BAC12_C03,10,10p15.3,1541537,1642195,100658,-,-
BAC34_A23,10,10p15.3,1546945,1642208,95263,-,-
BAC1_L01,10,10p15.3,1553073,1706549,153476,-,-
BAC153_J04,10,10p15.3,1642206,1745630,103424,-,-
BAC157_P08,10,10p15.3,1769434,1863423,93989,-,-
BAC49_F17,10,10p15.3,1777858,1867967,90109,-,-
BAC144_C17,10,10p15.3,1783831,1881941,98110,-,-
BAC192_E11,10,10p15.3,1880740,1973025,92285,-,-
BAC109_C13,10,10p15.3,1973035,2072670,99635,-,-
BAC197_E02,10,10p15.3,1997603,2107948,110345,-,-
BAC66_P16,10,10p15.3,2044248,2137632,93384,-,-
BAC218_N15,10,10p15.3,2064677,2157141,92464,-,-
BAC81_O01,10,10p15.3,2077059,2164634,87575,-,-
BAC102_M11,10,10p15.3,2102355,2191618,89263,-,-
BAC8_F16,10,10p15.3,2107950,2201974,94024,-,-
BAC234_L16,10,10p15.3,2145078,2251406,106328,-,-
BAC12_L06,10,10p15.3,2184978,2265013,80035,-,-
BAC67_P03,10,10p15.3,2202201,2302791,100590,-,-
BAC167_I12,10,10p15.3,2228941,2339937,110996,-,-
BAC68_K17,10,10p15.3,2228969,2331016,102047,-,-
BAC228_B06,10,10p15.3,2237687,2302821,65134,-,-
BAC132_H04,10,10p15.3,2302835,2418813,115978,-,-
BAC211_B21,10,10p15.3,2303856,2420011,116155,-,-
BAC11_F12,10,10p15.3,2335749,2418813,83064,-,-
BAC214_F19,10,10p15.3,2340694,2451823,111129,-,-
BAC88_D03,10,10p15.3,2355592,2451972,96380,-,-
BAC57_F18,10,10p15.3,2366637,2451971,85334,-,-
BAC217_N17,10,10p15.3,2374447,2477418,102971,-,-
BAC239_I21,10,10p15.3,2420676,2516467,95791,-,-
BAC110_K09,10,10p15.3,2425005,2516461,91456,-,-
BAC162_E04,10,10p15.3,2498539,2580988,82449,-,-
BAC162_H02,10,10p15.3,2559314,2629829,70515,-,-
BAC219_D15,10,10p15.3,2580981,2695280,114299,-,-
BAC190_N03,10,10p15.3,2608454,2720602,112148,-,-
BAC66_E05,10,10p15.3,2612764,2704818,92054,-,-
BAC132_F20,10,10p15.3,2663431,2768470,105039,-,-
BAC120_M14,10,10p15.3,2711585,2818438,106853,-,-
BAC247_O19,10,10p15.3,2719593,2803293,83700,-,-
BAC72_E09,10,10p15.3,2726104,2817955,91851,-,-
BAC53_A24,10,10p15.3,2776939,2866677,89738,-,-
BAC145_L24,10,10p15.3,2812667,2872834,60167,-,-
BAC236_E01,10,10p15.3,2827817,2933472,105655,-,-
BAC59_K02,10,10p15.3,2850001,2968505,118504,-,-
BAC133_E05,10,10p15.3,2866670,2948280,81610,-,-
BAC32_P05,10,10p15.3,2866670,2944661,77991,-,-
BAC122_B08,10,10p15.3,2866688,2964787,98099,-,-
BAC238_K11,10,10p15.3-10p15.2,2987118,3090640,103522,-,-
BAC83_H18,10,10p15.3-10p15.2,2987121,3090635,103514,-,-
BAC50_C12,10,10p15.2,3018801,3135131,116330,-,-
BAC89_F05,10,10p15.2,3021572,3135157,113585,-,-
BAC88_D01,10,10p15.2,3165685,3301745,136060,-,-
BAC228_F12,10,10p15.2,3345962,3441721,95759,-,-
BAC222_A20,10,10p15.2,3359794,3374158,14364,-,-
BAC230_B02,10,10p15.2,3448548,3557086,108538,-,-
BAC95_H10,10,10p15.2,3453745,3530412,76667,-,-
BAC39_M08,10,10p15.2,3454279,3566513,112234,-,-
BAC43_N07,10,10p15.2,3462504,3549576,87072,-,-
BAC77_E04,10,10p15.2,3483473,3661208,177735,-,-
BAC92_F08,10,10p15.2,3524733,3623262,98529,-,-
BAC128_E06,10,10p15.2,3534781,3623262,88481,-,-
BAC119_D02,10,10p15.2,3583628,3724394,140766,-,-
BAC114_J20,10,10p15.2,3597155,3701586,104431,-,-
BAC180_B22,10,10p15.2,3631137,3724489,93352,-,-
BAC86_D20,10,10p15.2,3631139,3766358,135219,-,-
BAC45_C09,10,10p15.2-10p15.1,3642045,3802505,160460,-,-
BAC90_G15,10,10p15.2,3688481,3776747,88266,-,-
BAC169_E04,10,10p15.2-10p15.1,3725955,3831363,105408,-,-
BAC158_K16,10,10p15.1,3802738,3889237,86499,-,-
BAC158_H16,10,10p15.1,3802738,3889237,86499,-,-
BAC48_L07,10,10p15.1,3841685,3959364,117679,-,-
BAC74_K19,10,10p15.1,3844284,3960030,115746,-,-
BAC222_H01,10,10p15.1,3849727,3956551,106824,-,-
BAC171_A19,10,10p15.1,3889483,3974278,84795,-,-
BAC46_C09,10,10p15.1,3890763,4048831,158068,-,-
BAC213_M15,10,10p15.1,3903343,4028370,125027,-,-
BAC41_P06,10,10p15.1,3935161,4062038,126877,-,-
BAC115_O02,10,10p15.1,4048842,4140525,91683,-,-
BAC38_N20,10,10p15.1,4062037,4148729,86692,-,-
BAC110_F14,10,10p15.1,4137451,4221742,84291,-,-
BAC182_I22,10,10p15.1,4137451,4226274,88823,-,-
BAC90_N24,10,10p15.1,4144824,4274938,130114,-,-
BAC20_A08,10,10p15.1,4171711,4270473,98762,-,-
BAC152_N10,10,10p15.1,4304863,4394128,89265,-,-
BAC81_E19,10,10p15.1,4377580,4503740,126160,-,-
BAC12_C01,10,10p15.1,4394207,4503779,109572,-,-
BAC77_A15,10,10p15.1,4441726,4564539,122813,-,-
BAC121_J03,10,10p15.1,4595267,4684642,89375,-,-
BAC79_P11,10,10p15.1,4659056,4745691,86635,-,-
BAC60_E14,10,10p15.1,4709240,4838822,129582,-,-
BAC62_B10,10,10p15.1,4828178,4937538,109360,-,-
BAC124_O11,10,10p15.1,4883192,4987629,104437,-,-
BAC38_M18,10,10p15.1,4973728,4990301,16573,-,-
BAC131_E01,10,10p15.1,5043246,5128620,85374,-,-
BAC97_H11,10,10p15.1,5076108,5166410,90302,-,-
BAC52_C15,10,10p15.1,5209315,5328677,119362,yes,-
BAC60_D20,10,10p15.1,5241427,5323005,81578,-,-
BAC40_C07,10,10p15.1,5264625,5354622,89997,-,-
BAC166_G23,10,10p15.1,5312527,5397185,84658,-,-
BAC140_H15,10,10p15.1,5457302,5539331,82029,-,-
BAC145_K13,10,10p15.1,5545338,5679968,134630,-,-
BAC241_N03,10,10p15.1,5588666,5736114,147448,-,-
BAC182_P04,10,10p15.1,5762015,5838617,76602,-,-
BAC206_F24,10,10p15.1,5799919,5896149,96230,-,-
BAC178_N04,10,10p15.1,5905549,5999943,94394,-,-
BAC93_G19,10,10p15.1,5908619,6040807,132188,-,-
BAC76_N09,10,10p15.1,5916008,6028012,112004,-,-
BAC50_K04,10,10p15.1,5960966,6040861,79895,-,-
BAC143_G07,10,10p15.1,5999937,6122242,122305,-,-
BAC162_I13,10,10p15.1,6040972,6123597,82625,-,-
BAC4_B12,10,10p15.1,6041155,6123487,82332,-,-
BAC214_B21,10,10p15.1,6229452,6382545,153093,-,-
BAC95_N10,10,10p15.1,6264543,6383044,118501,-,-
BAC64_A19,10,10p15.1,6264565,6383044,118479,-,-
BAC125_K08,10,10p15.1,6318200,6424777,106577,-,-
BAC96_I09,10,10p15.1,6417220,6547213,129993,-,-
BAC77_A23,10,10p15.1,6443405,6540539,97134,-,-
BAC42_D23,10,10p15.1,6497741,6628393,130652,-,-
BAC170_F05,10,10p15.1,6507791,6616487,108696,-,-
BAC64_G22,10,10p15.1-10p14,6580370,6703950,123580,-,-
BAC50_B17,10,10p15.1-10p14,6611102,6703950,92848,-,-
BAC51_F16,10,10p15.1-10p14,6614285,6761256,146971,-,-
BAC115_P20,10,10p15.1-10p14,6656411,6760506,104095,-,-
BAC202_B18,10,10p15.1-10p14,6680102,6761648,81546,-,-
BAC68_C13,10,10p14,6772091,6873559,101468,-,-
BAC80_A09,10,10p14,6854785,6937923,83138,-,-
BAC122_A08,10,10p14,6885457,6969438,83981,-,-
BAC198_O06,10,10p14,6973101,7006268,33167,-,-
BAC126_F02,10,10p14,6973803,7122196,148393,-,-
BAC118_F10,10,10p14,7078495,7166348,87853,-,-
BAC38_G21,10,10p14,7130313,7278097,147784,-,-
BAC116_L04,10,10p14,7163146,7267656,104510,-,-
BAC116_J12,10,10p14,7208676,7325133,116457,-,-
BAC144_P05,10,10p14,7222547,7339470,116923,-,-
BAC45_N15,10,10p14,7229144,7380551,151407,-,-
BAC96_H10,10,10p14,7235449,7339474,104025,-,-
BAC157_G21,10,10p14,7244626,7315486,70860,-,-
BAC196_H07,10,10p14,7282487,7389072,106585,-,-
BAC197_L18,10,10p14,7327441,7432008,104567,-,-
BAC60_M24,10,10p14,7330567,7439716,109149,-,-
BAC139_C09,10,10p14,7339670,7439710,100040,-,-
BAC190_G11,10,10p14,7389067,7497461,108394,-,-
BAC142_M16,10,10p14,7432000,7519110,87110,-,-
BAC151_N15,10,10p14,7439764,7524609,84845,-,-
BAC188_N22,10,10p14,7502101,7619247,117146,-,-
BAC196_N01,10,10p14,7519137,7619497,100360,-,-
BAC75_N13,10,10p14,7625187,7725876,100689,-,-
BAC108_L02,10,10p14,7643026,7725069,82043,-,-
BAC237_E06,10,10p14,7689210,7823591,134381,-,-
BAC78_K20,10,10p14,7725369,7835778,110409,-,-
BAC165_M12,10,10p14,7725372,7826589,101217,-,-
BAC158_I21,10,10p14,7732070,7823540,91470,-,-
BAC158_F21,10,10p14,7732070,7823539,91469,-,-
BAC129_I19,10,10p14,7846195,7946997,100802,-,-
BAC55_N11,10,10p14,7849548,7964678,115130,-,-
BAC12_F01,10,10p14,7881906,7996657,114751,-,-
BAC13_D06,10,10p14,7972671,8068629,95958,-,-
BAC198_H13,10,10p14,8042792,8150434,107642,-,-
BAC155_N15,10,10p14,8051143,8163348,112205,-,-
BAC82_J24,10,10p14,8068635,8150434,81799,-,-
BAC102_L22,10,10p14,8071690,8162450,90760,-,-
BAC167_F17,10,10p14,8094174,8215088,120914,-,-
BAC106_A13,10,10p14,8114380,8230635,116255,-,-
BAC71_E12,10,10p14,8230392,8327363,96971,-,-
BAC155_J18,10,10p14,8328437,8411291,82854,-,-
BAC33_B03,10,10p14,8433404,8517687,84283,-,-
BAC183_I18,10,10p14,8433405,8546142,112737,-,-
BAC156_N20,10,10p14,8510044,8631639,121595,-,-
BAC185_G24,10,10p14,8697578,8770887,73309,-,-
BAC200_G21,10,10p14,8874100,8956948,82848,-,-
BAC133_F08,10,10p14,8890355,8987003,96648,-,-
BAC91_I21,10,10p14,8992086,9136896,144810,-,-
BAC125_C15,10,10p14,9074756,9170924,96168,-,-
BAC179_H11,10,10p14,9141345,9225138,83793,-,-
BAC176_K17,10,10p14,9583673,9678723,95050,-,-
BAC62_F13,10,10p14,9583739,9666620,82881,-,-
BAC188_D15,10,10p14,9813536,9907235,93699,-,-
BAC135_M11,10,10p14,9849351,9928688,79337,-,-
BAC78_A15,10,10p14,9924339,9953298,28959,-,-
BAC84_F10,10,10p14,10020261,10089485,69224,-,-
BAC232_A23,10,10p14,10043373,10134178,90805,-,-
BAC140_H10,10,10p14,10081777,10184489,102712,-,-
BAC198_F05,10,10p14,10089508,10173006,83498,-,-
BAC82_B21,10,10p14,10099083,10205921,106838,-,-
BAC68_L02,10,10p14,10173000,10277473,104473,-,-
BAC80_P05,10,10p14,10201817,10292202,90385,-,-
BAC142_L22,10,10p14,10225863,10348022,122159,-,-
BAC90_B12,10,10p14,10309569,10383226,73657,-,-
BAC43_A13,10,10p14,10437387,10538466,101079,-,-
BAC224_C22,10,10p14,10452012,10550819,98807,-,-
BAC1_J19,10,10p14,10550163,10644644,94481,-,-
BAC169_K09,10,10p14,10665438,10746978,81540,-,-
BAC34_H03,10,10p14,10730784,10828369,97585,-,-
BAC124_F22,10,10p14,10730785,10875741,144956,-,-
BAC176_P15,10,10p14,10746998,10828476,81478,-,-
BAC221_K15,10,10p14,10815358,10917074,101716,-,-
BAC76_L17,10,10p14,10828395,10917074,88679,-,-
BAC197_I16,10,10p14,10828486,10911657,83171,-,-
BAC244_D12,10,10p14,10869500,10945917,76417,-,-
BAC230_K09,10,10p14,10875956,10969652,93696,-,-
BAC149_O02,10,10p14,11081743,11151964,70221,-,-
BAC189_G16,10,10p14,11091919,11195019,103100,-,-
BAC196_K12,10,10p14,11155206,11229513,74307,-,-
BAC196_P18,10,10p14,11194818,11298940,104122,-,-
BAC64_O06,10,10p14,11202855,11317165,114310,-,-
BAC102_J19,10,10p14,11202864,11309078,106214,-,-
BAC252_G15,10,10p14,11237205,11330868,93663,-,-
BAC53_G08,10,10p14,11325066,11520996,195930,-,-
BAC83_N20,10,10p14,11341416,11451552,110136,-,-
BAC75_O08,10,10p14,11357631,11451327,93696,-,-
BAC83_B05,10,10p14,11361092,11451741,90649,-,-
BAC96_B02,10,10p14,11480010,11573443,93433,-,-
BAC155_L24,10,10p14,11483305,11612424,129119,-,-
BAC161_P01,10,10p14,11743503,11876877,133374,-,-
BAC110_G16,10,10p14,11743833,11876619,132786,-,-
BAC10_O14,10,10p14,11810549,11958239,147690,-,-
BAC182_A21,10,10p14,11829020,11903966,74946,-,-
BAC124_B05,10,10p14,11842316,11958531,116215,-,-
BAC71_L05,10,10p14,11876870,11980164,103294,-,-
BAC238_M03,10,10p14,11909702,11994504,84802,-,-
BAC118_A12,10,10p14,11984683,12126699,142016,-,-
BAC133_B14,10,10p14,12019352,12099572,80220,-,-
BAC72_J19,10,10p14,12032103,12180489,148386,-,-
BAC10_B14,10,10p14,12134642,12244051,109409,-,-
BAC144_I22,10,10p14,12134642,12213257,78615,-,-
BAC171_H13,10,10p14,12136444,12229686,93242,-,-
BAC226_F08,10,10p14,12142356,12214305,71949,-,-
BAC166_K11,10,10p14,12165425,12255073,89648,-,-
BAC56_M02,10,10p14,12176080,12279386,103306,-,-
BAC185_C02,10,10p14-10p13,12229960,12328815,98855,-,-
BAC92_F09,10,10p14-10p13,12255066,12374962,119896,-,-
BAC26_O14,10,10p14-10p13,12285686,12400670,114984,-,-
BAC246_H05,10,10p14-10p13,12298551,12375504,76953,-,-
BAC153_G18,10,10p13,12341827,12473400,131573,-,-
BAC153_H18,10,10p13,12341853,12473400,131547,-,-
BAC100_D13,10,10p13,12375497,12510471,134974,-,-
BAC227_C02,10,10p13,12538998,12643270,104272,-,-
BAC100_A01,10,10p13,12589984,12662018,72034,-,-
BAC57_F21,10,10p13,12597717,12678831,81114,-,-
BAC186_B09,10,10p13,12656915,12757303,100388,-,-
BAC194_O24,10,10p13,12662013,12757035,95022,-,-
BAC193_P18,10,10p13,12675804,12757035,81231,-,-
BAC62_O01,10,10p13,12679143,12757035,77892,-,-
BAC52_E22,10,10p13,12682373,12792633,110260,-,-
BAC135_G02,10,10p13,12701797,12791577,89780,-,-
BAC24_E15,10,10p13,12721904,12845770,123866,-,-
BAC105_K01,10,10p13,12742428,12841924,99496,-,-
BAC162_G06,10,10p13,12757307,12845776,88469,-,-
BAC228_F14,10,10p13,12786754,12905709,118955,-,-
BAC148_B11,10,10p13,12792651,12904695,112044,-,-
BAC90_I20,10,10p13,12813085,12896869,83784,-,-
BAC178_K06,10,10p13,12904686,13025482,120796,-,-
BAC5_A11,10,10p13,12906089,13010899,104810,-,-
BAC22_N02,10,10p13,12948099,13062281,114182,-,-
BAC86_N18,10,10p13,12968495,13080144,111649,-,-
BAC247_I17,10,10p13,12976728,13080930,104202,-,-
BAC31_M06,10,10p13,13000370,13155932,155562,-,-
BAC184_D07,10,10p13,13021354,13111644,90290,-,-
BAC70_F06,10,10p13,13025475,13119652,94177,-,-
BAC193_P04,10,10p13,13042605,13119652,77047,-,-
BAC177_B15,10,10p13,13114136,13197998,83862,-,-
BAC38_P17,10,10p13,13155824,13292319,136495,-,-
BAC85_I19,10,10p13,13198029,13304080,106051,-,-
BAC202_D20,10,10p13,13216201,13303802,87601,-,-
BAC252_C02,10,10p13,13220714,13321726,101012,-,-
BAC69_B03,10,10p13,13244282,13361517,117235,-,-
BAC147_I06,10,10p13,13292764,13394807,102043,-,-
BAC170_D19,10,10p13,13304076,13405259,101183,-,-
BAC218_D14,10,10p13,13311696,13394807,83111,-,-
BAC184_C07,10,10p13,13311698,13412247,100549,-,-
BAC83_L14,10,10p13,13338249,13469110,130861,-,-
BAC59_E01,10,10p13,13338251,13394807,56556,-,-
BAC46_K08,10,10p13,13338308,13492422,154114,-,-
BAC101_P03,10,10p13,13342609,13500174,157565,-,-
BAC201_O10,10,10p13,13390294,13482648,92354,-,-
BAC75_J13,10,10p13,13394964,13481181,86217,-,-
BAC100_M21,10,10p13,13426904,13442698,15794,-,-
BAC247_I07,10,10p13,13525236,13608856,83620,-,-
BAC175_G17,10,10p13,13553812,13642556,88744,-,-
BAC128_L20,10,10p13,13581429,13671872,90443,-,-
BAC57_A05,10,10p13,13608969,13700317,91348,-,-
BAC35_G01,10,10p13,13635079,13758764,123685,-,-
BAC67_H18,10,10p13,13670834,13773515,102681,-,-
BAC157_L09,10,10p13,13691357,13807410,116053,-,-
BAC95_C19,10,10p13,13703758,13807410,103652,-,-
BAC40_P04,10,10p13,13767514,13888447,120933,-,-
BAC88_P10,10,10p13,13862469,13970811,108342,-,-
BAC179_C15,10,10p13,13886356,13976923,90567,-,-
BAC197_G24,10,10p13,13909214,14006069,96855,-,-
BAC150_O12,10,10p13,13938898,14037687,98789,-,-
BAC100_K19,10,10p13,13976915,14067794,90879,-,-
BAC144_K07,10,10p13,13976917,14067794,90877,-,-
BAC104_O19,10,10p13,13976943,14067794,90851,-,-
BAC198_D04,10,10p13,14068164,14148744,80580,-,-
BAC28_F13,10,10p13,14107316,14184660,77344,-,-
BAC160_P19,10,10p13,14112511,14197771,85260,-,-
BAC193_D19,10,10p13,14201567,14283197,81630,-,-
BAC67_F21,10,10p13,14240418,14351709,111291,-,-
BAC1_P06,10,10p13,14240418,14397273,156855,-,-
BAC221_L23,10,10p13,14264395,14377742,113347,-,-
BAC36_J08,10,10p13,14292097,14368855,76758,-,-
BAC156_G09,10,10p13,14327116,14412312,85196,-,-
BAC91_I15,10,10p13,14327116,14442461,115345,-,-
BAC36_O23,10,10p13,14327116,14412312,85196,-,-
BAC148_D18,10,10p13,14327119,14434203,107084,-,-
BAC63_E02,10,10p13,14486725,14595869,109144,-,-
BAC95_J08,10,10p13,14493797,14590655,96858,-,-
BAC145_D17,10,10p13,14499358,14584885,85527,-,-
BAC25_B01,10,10p13,14569562,14676506,106944,-,-
BAC25_M23,10,10p13,14640320,14713943,73623,-,-
BAC99_M21,10,10p13,14680580,14794980,114400,-,-
BAC53_K01,10,10p13,14736903,14816078,79175,-,-
BAC91_D04,10,10p13,14768957,14885607,116650,-,-
BAC132_C16,10,10p13,14870179,14962941,92762,-,-
BAC140_J11,10,10p13,14870681,14990934,120253,-,-
BAC176_J15,10,10p13,14968881,15075669,106788,-,-
BAC184_P13,10,10p13,14975534,15080689,105155,yes,-
BAC136_A01,10,10p13,14987499,15075668,88169,yes,-
BAC165_C03,10,10p13,14990929,15080689,89760,-,-
BAC73_A10,10,10p13,14990949,15109212,118263,-,-
BAC165_B23,10,10p13,14995419,15095643,100224,-,-
BAC235_M07,10,10p13,15127658,15219159,91501,-,-
BAC171_P17,10,10p13,15314191,15397484,83293,-,-
BAC18_F10,10,10p13,15359539,15518718,159179,-,-
BAC172_L03,10,10p13,15364009,15481229,117220,-,-
BAC153_I11,10,10p13,15417948,15503218,85270,-,-
BAC179_C08,10,10p13,15429238,15512293,83055,-,-
BAC159_C03,10,10p13,15455896,15583527,127631,-,-
BAC237_B10,10,10p13,15530955,15606893,75938,-,-
BAC96_F01,10,10p13,15557976,15709371,151395,-,-
BAC180_N02,10,10p13,15663172,15755373,92201,-,-
BAC170_P06,10,10p13,15672698,15750776,78078,-,-
BAC60_L04,10,10p13,15903768,16010694,106926,-,-
BAC180_M10,10,10p13,16016620,16094826,78206,-,-
BAC65_H24,10,10p13,16078087,16181945,103858,-,-
BAC168_O09,10,10p13,16269394,16348861,79467,-,-
BAC199_J19,10,10p13,16271575,16359991,88416,-,-
BAC182_O18,10,10p13,16280302,16381099,100797,-,-
BAC246_E13,10,10p13,16433050,16551417,118367,-,-
BAC246_P04,10,10p13,16433051,16532625,99574,-,-
BAC101_H15,10,10p13,16445244,16572781,127537,-,-
BAC139_F22,10,10p13,16482207,16601514,119307,-,-
BAC116_L03,10,10p13,16561107,16660061,98954,-,-
BAC166_D20,10,10p13,16591616,16706207,114591,-,-
BAC243_M07,10,10p13,16671307,16745820,74513,-,-
BAC166_B10,10,10p13,17123018,17204089,81071,-,-
BAC243_L13,10,10p13-10p12.33,17214374,17302228,87854,-,-
BAC57_M16,10,10p13-10p12.33,17226487,17322452,95965,-,-
BAC145_N12,10,10p13-10p12.33,17241187,17357578,116391,-,-
BAC28_B18,10,10p13-10p12.33,17266758,17388083,121325,-,-
BAC117_K14,10,10p13-10p12.33,17273464,17371470,98006,-,-
BAC134_H05,10,10p13-10p12.33,17283063,17372049,88986,-,-
BAC143_K02,10,10p12.33,17344868,17445087,100219,-,-
BAC103_L17,10,10p12.33,17344868,17445295,100427,-,-
BAC69_F15,10,10p12.33,17347390,17530499,183109,-,-
BAC189_E24,10,10p12.33,17401547,17480648,79101,-,-
BAC107_K04,10,10p12.33,17446318,17528716,82398,-,-
BAC170_E09,10,10p12.33,17560622,17652022,91400,-,-
BAC34_I08,10,10p12.33,17564915,17716948,152033,-,-
BAC130_P18,10,10p12.33,17578455,17683545,105090,-,-
BAC23_O24,10,10p12.33,17579528,17677990,98462,-,-
BAC27_M14,10,10p12.33,17591377,17683557,92180,-,-
BAC82_K06,10,10p12.33,17594192,17681124,86932,-,-
BAC233_G03,10,10p12.33,17683551,17774599,91048,-,-
BAC163_I12,10,10p12.33,17799812,17887274,87462,-,-
BAC241_D02,10,10p12.33,17851048,18209966,358918,-,-
BAC86_O08,10,10p12.33,17939471,18302895,363424,-,-
BAC78_O04,10,10p12.33,17968901,18414944,446043,-,-
BAC58_D23,10,10p12.33,17987079,18346004,358925,-,-
BAC24_O18,10,10p12.33,18250774,18332108,81334,-,-
BAC58_J21,10,10p12.33,18411135,18522795,111660,-,-
BAC160_A18,10,10p12.33,18446738,18545590,98852,-,-
BAC132_D09,10,10p12.33,18450849,18532914,82065,-,-
BAC131_P05,10,10p12.33,18620270,18708667,88397,-,-
BAC46_D14,10,10p12.33,18637231,18773917,136686,-,-
BAC75_D16,10,10p12.33,18640556,18724028,83472,-,-
BAC161_N08,10,10p12.33,18755369,18844674,89305,-,-
BAC148_P21,10,10p12.33,18766362,18844674,78312,-,-
BAC221_B13,10,10p12.33,18766368,18842442,76074,-,-
BAC57_L17,10,10p12.33,18766544,18854232,87688,-,-
BAC76_P15,10,10p12.33,18769591,18869844,100253,-,-
BAC41_L13,10,10p12.33,18854231,19007425,153194,-,-
BAC20_B12,10,10p12.33,18863970,18950228,86258,-,-
BAC5_E05,10,10p12.33,18920454,19029671,109217,-,-
BAC44_E09,10,10p12.33,18972818,19083399,110581,-,-
BAC169_O17,10,10p12.33,18984752,19062151,77399,-,-
BAC90_F09,10,10p12.33,19043907,19162084,118177,-,-
BAC44_E01,10,10p12.33,19071323,19198235,126912,-,-
BAC185_J04,10,10p12.33,19086695,19212691,125996,-,-
BAC7_K04,10,10p12.33,19144566,19162084,17518,-,-
BAC113_E18,10,10p12.33,19298687,19378594,79907,-,-
BAC234_H04,10,10p12.33,19306845,19426135,119290,-,-
BAC117_N15,10,10p12.33,19447541,19531080,83539,-,-
BAC81_E14,10,10p12.33,19458950,19556453,97503,-,-
BAC2_A22,10,10p12.33,19546487,19653191,106704,-,-
BAC196_B17,10,10p12.33,19608052,19690264,82212,-,-
BAC27_N18,10,10p12.33,19640752,19769195,128443,-,-
BAC92_C12,10,10p12.33,19648194,19756846,108652,-,-
BAC60_O22,10,10p12.33,19656420,19777267,120847,-,-
BAC104_A03,10,10p12.33,19707131,19802559,95428,-,-
BAC22_O23,10,10p12.33,19716665,19841542,124877,-,-
BAC230_B14,10,10p12.33,19802033,19883300,81267,-,-
BAC147_N08,10,10p12.33-10p12.32,19883339,19981430,98091,-,-
BAC125_M24,10,10p12.33-10p12.32,19883339,19994819,111480,-,-
BAC95_M11,10,10p12.32,19967861,19981430,13569,-,-
BAC226_F19,10,10p12.32,19967861,20048848,80987,-,-
BAC30_I18,10,10p12.32,19968003,20063725,95722,-,-
BAC33_B14,10,10p12.32,20004746,20097369,92623,-,-
BAC66_O14,10,10p12.32,20047257,20130347,83090,-,-
BAC46_P04,10,10p12.32,20260389,20349489,89100,-,-
BAC102_J03,10,10p12.32,20308333,20406525,98192,-,-
BAC197_A03,10,10p12.32,20315245,20397538,82293,-,-
BAC118_N11,10,10p12.32,20334053,20444169,110116,-,-
BAC168_J19,10,10p12.31,20555229,20647402,92173,-,-
BAC189_A06,10,10p12.31,20591233,20667046,75813,-,-
BAC96_P01,10,10p12.31,20650465,20747994,97529,-,-
BAC95_G02,10,10p12.31,20737934,20840709,102775,-,-
BAC143_K04,10,10p12.31,20763157,20840428,77271,-,-
BAC131_D04,10,10p12.31,20781191,20872362,91171,-,-
BAC173_I15,10,10p12.31,20791015,20866637,75622,-,-
BAC73_F18,10,10p12.31,20952455,21044087,91632,-,-
BAC58_B21,10,10p12.31,20952459,21036890,84431,-,-
BAC57_L06,10,10p12.31,20954076,21059130,105054,-,-
BAC59_A02,10,10p12.31,21045829,21138522,92693,-,-
BAC241_I18,10,10p12.31,21060764,21153692,92928,-,-
BAC48_J13,10,10p12.31,21113896,21206486,92590,-,-
BAC196_E16,10,10p12.31,21150018,21238877,88859,-,-
BAC23_D05,10,10p12.31,21155505,21285595,130090,-,-
BAC60_K07,10,10p12.31,21164241,21311830,147589,-,-
BAC26_N08,10,10p12.31,21245684,21346474,100790,-,-
BAC224_D16,10,10p12.31,21255750,21342244,86494,-,-
BAC89_A15,10,10p12.31,21280127,21396353,116226,-,-
BAC224_G24,10,10p12.31,21346511,21422454,75943,-,-
BAC125_E23,10,10p12.31,21368665,21489020,120355,-,-
BAC145_P22,10,10p12.31,21397751,21489020,91269,-,-
BAC143_I13,10,10p12.31,21442929,21542151,99222,-,-
BAC190_M12,10,10p12.31,21530429,21622284,91855,-,-
BAC160_O07,10,10p12.31,21542145,21673802,131657,-,-
BAC51_O06,10,10p12.31,21574334,21673798,99464,-,-
BAC89_G13,10,10p12.31,21574486,21664033,89547,-,-
BAC144_L07,10,10p12.31,21592156,21664046,71890,-,-
BAC125_G12,10,10p12.31,21592156,21695500,103344,-,-
BAC185_K15,10,10p12.31,21652711,21762594,109883,-,-
BAC228_H08,10,10p12.31,21731695,21829882,98187,-,-
BAC137_A10,10,10p12.31,21733001,21816790,83789,-,-
BAC146_I06,10,10p12.31,21737309,21818582,81273,-,-
BAC58_C18,10,10p12.31,21838315,21999010,160695,-,-
BAC157_P23,10,10p12.31,21898376,22007521,109145,-,-
BAC177_D03,10,10p12.31,21907707,21991320,83613,-,-
BAC205_A05,10,10p12.31,21907715,21988174,80459,-,-
BAC48_O12,10,10p12.31,21957034,22065586,108552,-,-
BAC196_J14,10,10p12.31,22006269,22117907,111638,-,-
BAC133_M05,10,10p12.31,22008510,22111630,103120,-,-
BAC131_F05,10,10p12.31,22013493,22117905,104412,-,-
BAC248_F12,10,10p12.31,22020518,22117335,96817,-,-
BAC147_I19,10,10p12.31,22053504,22135038,81534,-,-
BAC53_K15,10,10p12.31,22117897,22217923,100026,-,-
BAC250_N03,10,10p12.31,22117900,22203212,85312,-,-
BAC67_E03,10,10p12.31,22117900,22203212,85312,-,-
BAC237_D18,10,10p12.31,22117902,22204446,86544,-,-
BAC117_B23,10,10p12.31,22210348,22306999,96651,-,-
BAC154_P03,10,10p12.31,22382074,22468131,86057,-,-
BAC41_C12,10,10p12.31,22382078,22495222,113144,-,-
BAC166_A22,10,10p12.31,22414020,22530648,116628,-,-
BAC43_M16,10,10p12.31,22428942,22548714,119772,-,-
BAC52_K18,10,10p12.31,22548729,22628383,79654,-,-
BAC25_H08,10,10p12.31,22592302,22674919,82617,-,-
BAC52_G20,10,10p12.31,22628397,22763057,134660,-,-
BAC125_D20,10,10p12.31,22668210,22763079,94869,-,-
BAC63_B07,10,10p12.31-10p12.2,22763072,22883075,120003,-,-
BAC59_F11,10,10p12.31-10p12.2,22763078,22966077,202999,-,-
BAC106_I13,10,10p12.31-10p12.2,22791655,22876335,84680,-,-
BAC69_N12,10,10p12.2,22805209,22919970,114761,-,-
BAC32_D15,10,10p12.2,22805215,22900608,95393,-,-
BAC63_D04,10,10p12.2,22859602,22940886,81284,-,-
BAC66_O13,10,10p12.2,22916519,23032836,116317,-,-
BAC57_E02,10,10p12.2,22957747,23049364,91617,-,-
BAC81_G21,10,10p12.2,23037198,23142490,105292,-,-
BAC135_E06,10,10p12.2,23056140,23135722,79582,-,-
BAC63_K07,10,10p12.2,23135719,23251332,115613,-,-
BAC234_E04,10,10p12.2,23139497,23222041,82544,-,-
BAC59_K22,10,10p12.2,23222034,23384248,162214,-,-
BAC241_C02,10,10p12.2,23259487,23344330,84843,-,-
BAC131_E13,10,10p12.2,23375739,23454301,78562,-,-
BAC2_J15,10,10p12.2,23381719,23468714,86995,-,-
BAC102_I19,10,10p12.2,23398320,23534247,135927,-,-
BAC224_P12,10,10p12.2,23420088,23506526,86438,-,-
BAC123_A07,10,10p12.2,23440860,23609491,168631,-,-
BAC97_O09,10,10p12.2,23447613,23537832,90219,-,-
BAC86_J13,10,10p12.2,23459415,23585503,126088,-,-
BAC117_N06,10,10p12.2,23495655,23585503,89848,-,-
BAC68_G07,10,10p12.2,23544841,23684002,139161,-,-
BAC178_N12,10,10p12.2,23578669,23670255,91586,-,-
BAC130_N24,10,10p12.2,23637225,23711923,74698,-,-
BAC76_B11,10,10p12.2,23637623,23743999,106376,-,-
BAC101_I17,10,10p12.2,23645276,23732538,87262,-,-
BAC65_M03,10,10p12.2,23645276,23795234,149958,-,-
BAC143_M06,10,10p12.2,23732531,23865860,133329,-,-
BAC103_M11,10,10p12.2,23763315,23837240,73925,-,-
BAC151_K19,10,10p12.2,23894381,23997728,103347,-,-
BAC69_G16,10,10p12.2,23921086,24038776,117690,-,-
BAC43_K11,10,10p12.2,23935364,24040678,105314,-,-
BAC188_L17,10,10p12.1,24103814,24178010,74196,-,-
BAC41_A01,10,10p12.1,24162240,24257943,95703,-,-
BAC123_N03,10,10p12.1,24204323,24342204,137881,-,-
BAC33_O17,10,10p12.1,24249484,24415650,166166,-,-
BAC222_F07,10,10p12.1,24399866,24492500,92634,-,-
BAC196_B07,10,10p12.1,24457694,24580780,123086,-,-
BAC22_J18,10,10p12.1,24492495,24603724,111229,-,-
BAC125_K16,10,10p12.1,24499996,24634297,134301,-,-
BAC38_H19,10,10p12.1,24513118,24673098,159980,-,-
BAC52_N23,10,10p12.1,24528295,24656062,127767,-,-
BAC140_D02,10,10p12.1,24586306,24678823,92517,-,-
BAC133_N16,10,10p12.1,24656057,24731101,75044,-,-
BAC66_G18,10,10p12.1,24779331,24915095,135764,-,-
BAC141_E23,10,10p12.1,24780160,24883204,103044,-,-
BAC218_G07,10,10p12.1,24830033,24922886,92853,-,-
BAC183_A21,10,10p12.1,24834523,24915110,80587,-,-
BAC235_A21,10,10p12.1,24835067,24927058,91991,-,-
BAC177_F02,10,10p12.1,24892743,24976526,83783,-,-
BAC84_H16,10,10p12.1,24915103,25030201,115098,-,-
BAC124_N05,10,10p12.1,24918549,25059269,140720,-,-
BAC132_M22,10,10p12.1,24918550,25017755,99205,-,-
BAC189_E23,10,10p12.1,24952682,25029862,77180,-,-
BAC67_J04,10,10p12.1,25028968,25153090,124122,-,-
BAC190_I10,10,10p12.1,25061546,25153183,91637,-,-
BAC61_G19,10,10p12.1,25061546,25149679,88133,-,-
BAC36_C21,10,10p12.1,25061560,25187574,126014,-,-
BAC79_A22,10,10p12.1,25061587,25172270,110683,-,-
BAC67_F03,10,10p12.1,25069880,25149679,79799,-,-
BAC109_O02,10,10p12.1,25072583,25170594,98011,-,-
BAC40_P12,10,10p12.1,25073934,25154848,80914,-,-
BAC234_I07,10,10p12.1,25088282,25172357,84075,-,-
BAC12_K13,10,10p12.1,25153188,25248926,95738,-,-
BAC152_J21,10,10p12.1,25172350,25258991,86641,-,-
BAC108_H08,10,10p12.1,25201183,25323599,122416,-,-
BAC107_M12,10,10p12.1,25229795,25365570,135775,-,-
BAC78_N23,10,10p12.1,25259169,25349672,90503,-,-
BAC48_L17,10,10p12.1,25259201,25364920,105719,-,-
BAC111_A15,10,10p12.1,25311336,25436379,125043,-,-
BAC100_A13,10,10p12.1,25343483,25464958,121475,-,-
BAC179_P07,10,10p12.1,25375056,25460158,85102,-,-
BAC176_K14,10,10p12.1,25378937,25477248,98311,-,-
BAC73_P06,10,10p12.1,25390467,25473947,83480,-,-
BAC140_I14,10,10p12.1,25397519,25464958,67439,-,-
BAC116_C14,10,10p12.1,25474994,25578600,103606,-,-
BAC120_M20,10,10p12.1,25571500,25698477,126977,-,-
BAC12_A09,10,10p12.1,25634595,25729610,95015,-,-
BAC165_L03,10,10p12.1,25698472,25809573,111101,-,-
BAC18_B09,10,10p12.1,25729603,25838268,108665,-,-
BAC228_D16,10,10p12.1,26001008,26025076,24068,-,-
BAC15_K07,10,10p12.1,26024654,26116955,92301,-,-
BAC234_N04,10,10p12.1,26066298,26183082,116784,-,-
BAC134_E21,10,10p12.1,26093131,26184602,91471,-,-
BAC178_A15,10,10p12.1,26105530,26227185,121655,-,-
BAC89_M01,10,10p12.1,26184632,26309727,125095,-,-
BAC243_E21,10,10p12.1,26211468,26309729,98261,-,-
BAC38_P03,10,10p12.1,26227181,26327735,100554,-,-
BAC117_E11,10,10p12.1,26236437,26327735,91298,-,-
BAC115_N08,10,10p12.1,26236437,26330772,94335,-,-
BAC175_G19,10,10p12.1,26256472,26335960,79488,-,-
BAC65_G19,10,10p12.1,26324272,26421836,97564,-,-
BAC56_M10,10,10p12.1,26493418,26595801,102383,-,-
BAC167_H12,10,10p12.1,26501052,26591204,90152,-,-
BAC45_G11,10,10p12.1,26575299,26686145,110846,-,-
BAC241_P11,10,10p12.1,26642266,26764531,122265,-,-
BAC43_J18,10,10p12.1,26682613,26770130,87517,-,-
BAC168_C12,10,10p12.1,26728410,26792210,63800,-,-
BAC90_K11,10,10p12.1,26742298,26877874,135576,-,-
BAC166_H02,10,10p12.1,26809026,26893737,84711,-,-
BAC15_K11,10,10p12.1,26809026,26924647,115621,-,-
BAC46_B03,10,10p12.1,26828447,26919248,90801,-,-
BAC75_L07,10,10p12.1,26841794,27004526,162732,-,-
BAC75_N02,10,10p12.1,26893872,26994703,100831,-,-
BAC175_L15,10,10p12.1,26927306,27011627,84321,-,-
BAC72_F11,10,10p12.1,26933011,27025446,92435,-,-
BAC82_G23,10,10p12.1,26985015,27088416,103401,-,-
BAC171_N22,10,10p12.1,26994724,27072802,78078,-,-
BAC200_B01,10,10p12.1,27058866,27080857,21991,-,-
BAC128_E21,10,10p12.1,27072796,27171385,98589,-,-
BAC144_H14,10,10p12.1,27101511,27223265,121754,-,-
BAC222_I09,10,10p12.1,27162017,27244319,82302,-,-
BAC154_A08,10,10p12.1,27171400,27274278,102878,-,-
BAC141_J11,10,10p12.1,27178691,27256746,78055,-,-
BAC228_D23,10,10p12.1,27192539,27274278,81739,-,-
BAC60_P08,10,10p12.1,27211920,27293981,82061,-,-
BAC48_M01,10,10p12.1,27306920,27498702,191782,-,-
BAC127_O10,10,10p12.1,27355236,27472799,117563,-,-
BAC71_P17,10,10p12.1,27360015,27463044,103029,-,-
BAC75_C13,10,10p12.1,27406667,27574568,167901,-,-
BAC69_M21,10,10p12.1,27476574,27574577,98003,-,-
BAC141_B16,10,10p12.1,27487386,27584682,97296,-,-
BAC61_L19,10,10p12.1,27626995,27750967,123972,-,-
BAC78_L12,10,10p12.1,27747003,27848807,101804,-,-
BAC80_L04,10,10p12.1,27813269,27932289,119020,-,-
BAC25_P15,10,10p12.1,27937272,28115134,177862,-,-
BAC52_O21,10,10p12.1,27968867,28085025,116158,-,-
BAC40_J02,10,10p12.1,28172285,28271658,99373,-,-
BAC43_L07,10,10p12.1-10p11.23,28228561,28311021,82460,-,-
BAC51_K22,10,10p12.1-10p11.23,28253076,28415707,162631,-,-
BAC113_K06,10,10p12.1-10p11.23,28278211,28418253,140042,-,-
BAC252_J21,10,10p11.23,28314974,28423143,108169,-,-
BAC140_F22,10,10p11.23,28322199,28418240,96041,-,-
BAC175_C07,10,10p11.23,28418247,28510022,91775,-,-
BAC246_F05,10,10p11.23,28423146,28510022,86876,-,-
BAC43_L22,10,10p11.23,28490508,28625027,134519,-,-
BAC59_M19,10,10p11.23,28510017,28664810,154793,-,-
BAC157_N24,10,10p11.23,28683976,28771349,87373,-,-
BAC165_D19,10,10p11.23,28760363,28840323,79960,-,-
BAC57_A14,10,10p11.23,28760363,28917565,157202,-,-
BAC41_C02,10,10p11.23,28772459,28866032,93573,-,-
BAC124_I19,10,10p11.23,28805870,28885323,79453,-,-
BAC187_L16,10,10p11.23,28941383,29012922,71539,-,-
BAC123_H08,10,10p11.23,28941383,29045515,104132,-,-
BAC155_C17,10,10p11.23,28963876,29045515,81639,-,-
BAC106_J05,10,10p11.23,28978634,29063805,85171,-,-
BAC102_O20,10,10p11.23,29045514,29170196,124682,-,-
BAC249_G24,10,10p11.23,29084036,29182324,98288,-,-
BAC199_P06,10,10p11.23,29201849,29302586,100737,-,-
BAC84_M23,10,10p11.23,29243601,29379948,136347,-,-
BAC114_L17,10,10p11.23,29265739,29385902,120163,-,-
BAC186_L06,10,10p11.23,29295695,29389827,94132,-,-
BAC19_A08,10,10p11.23,29306393,29407652,101259,-,-
BAC224_F07,10,10p11.23,29343873,29439216,95343,-,-
BAC172_D02,10,10p11.23,29343874,29436010,92136,-,-
BAC220_N17,10,10p11.23,29386072,29468538,82466,-,-
BAC227_E12,10,10p11.23,29433334,29522695,89361,-,-
BAC84_N12,10,10p11.23,29436037,29529171,93134,-,-
BAC146_B19,10,10p11.23,29436038,29515926,79888,-,-
BAC81_M15,10,10p11.23,29448364,29588936,140572,-,-
BAC59_H19,10,10p11.23,29532831,29621401,88570,-,-
BAC66_F18,10,10p11.23,29542933,29641075,98142,-,-
BAC229_N17,10,10p11.23,29544149,29653765,109616,-,-
BAC161_M01,10,10p11.23,29578832,29674210,95378,-,-
BAC10_D20,10,10p11.23,29584502,29674318,89816,-,-
BAC91_C10,10,10p11.23,29585505,29676928,91423,-,-
BAC217_H07,10,10p11.23,29602343,29712859,110516,-,-
BAC172_B16,10,10p11.23,29641212,29737687,96475,-,-
BAC155_D15,10,10p11.23,29654115,29754386,100271,-,-
BAC71_I13,10,10p11.23,29676920,29815995,139075,-,-
BAC121_H23,10,10p11.23,29749688,29843750,94062,-,-
BAC36_M07,10,10p11.23,29763653,29853362,89709,-,-
BAC71_D13,10,10p11.23,29787406,29877347,89941,-,-
BAC1_F15,10,10p11.23,29787409,29907290,119881,-,-
BAC218_H05,10,10p11.23,29789861,29869334,79473,-,-
BAC169_I11,10,10p11.23,29848968,29973475,124507,-,-
BAC37_O03,10,10p11.23,29853557,29973475,119918,-,-
BAC116_E14,10,10p11.23,29860013,29973475,113462,-,-
BAC244_F07,10,10p11.23,29871288,29974921,103633,-,-
BAC171_N02,10,10p11.23,29892546,29973461,80915,-,-
BAC49_P03,10,10p11.23,30029816,30125480,95664,-,-
BAC217_G08,10,10p11.23,30048205,30133437,85232,-,-
BAC139_B20,10,10p11.23,30048209,30132578,84369,-,-
BAC238_D11,10,10p11.23,30053341,30145709,92368,-,-
BAC27_N09,10,10p11.23,30078739,30163443,84704,-,-
BAC62_G15,10,10p11.23,30079372,30163436,84064,-,-
BAC56_D04,10,10p11.23,30102291,30211891,109600,-,-
BAC36_C09,10,10p11.23,30238557,30270501,31944,-,-
BAC117_J02,10,10p11.23,30268129,30370423,102294,-,-
BAC26_N12,10,10p11.23,30405793,30504193,98400,-,-
BAC182_M10,10,10p11.23,30474783,30558664,83881,-,-
BAC26_H02,10,10p11.23,30507339,30611823,104484,-,-
BAC120_B19,10,10p11.23,30602027,30718057,116030,-,-
BAC82_J08,10,10p11.23,30624165,30718057,93892,-,-
BAC186_L07,10,10p11.23,30633687,30718057,84370,-,-
BAC51_G20,10,10p11.23,30655690,30759602,103912,-,-
BAC246_A11,10,10p11.23,30655788,30762486,106698,-,-
BAC249_F18,10,10p11.23,30678405,30759602,81197,-,-
BAC100_P03,10,10p11.23,30762129,30856934,94805,-,-
BAC180_O01,10,10p11.23,30762129,30834494,72365,-,-
BAC58_L01,10,10p11.23,30762499,30858328,95829,-,-
BAC250_K04,10,10p11.23,30788042,30865247,77205,-,-
BAC58_H09,10,10p11.23,30791802,30873802,82000,-,-
BAC155_L21,10,10p11.23,30831899,30955258,123359,-,-
BAC40_C03,10,10p11.23,30866103,31025163,159060,-,-
BAC72_D02,10,10p11.23,30891397,30980959,89562,-,-
BAC95_P06,10,10p11.23,31079852,31176629,96777,-,-
BAC155_O08,10,10p11.23,31149297,31218171,68874,-,-
BAC88_G19,10,10p11.23,31163907,31259575,95668,-,-
BAC249_L12,10,10p11.23,31176623,31293225,116602,-,-
BAC147_K22,10,10p11.23-10p11.22,31357892,31419423,61531,-,-
BAC158_L16,10,10p11.23-10p11.22,31357939,31457595,99656,-,-
BAC194_P01,10,10p11.22,31418590,31508513,89923,-,-
BAC45_B07,10,10p11.22,31441299,31542212,100913,-,-
BAC173_A05,10,10p11.22,31457590,31538042,80452,-,-
BAC189_H17,10,10p11.22,31471177,31547657,76480,-,-
BAC66_L01,10,10p11.22,31499392,31596405,97013,-,-
BAC55_D18,10,10p11.22,31548638,31657530,108892,-,-
BAC116_O02,10,10p11.22,31756079,31878298,122219,-,-
BAC252_F23,10,10p11.22,31860382,31995550,135168,-,-
BAC68_L21,10,10p11.22,31904983,32001797,96814,-,-
BAC199_K12,10,10p11.22,31926772,32010473,83701,-,-
BAC228_A10,10,10p11.22,31988140,32047390,59250,-,-
BAC106_I06,10,10p11.22,32028527,32144523,115996,-,-
BAC189_O23,10,10p11.22,32047410,32116007,68597,-,-
BAC83_G23,10,10p11.22,32089205,32190782,101577,-,-
BAC115_N06,10,10p11.22,32107224,32209821,102597,-,-
BAC96_J07,10,10p11.22,32166778,32280652,113874,-,-
BAC103_G13,10,10p11.22,32178437,32279665,101228,-,-
BAC113_K07,10,10p11.22,32195388,32281029,85641,-,-
BAC236_A02,10,10p11.22,32283160,32395312,112152,-,-
BAC183_H12,10,10p11.22,32283160,32435845,152685,-,-
BAC143_M21,10,10p11.22,32333474,32414757,81283,-,-
BAC123_L20,10,10p11.22,32340874,32470178,129304,-,-
BAC235_P17,10,10p11.22,32435837,32514932,79095,-,-
BAC234_E14,10,10p11.22,32435871,32526483,90612,-,-
BAC130_J10,10,10p11.22,32486013,32574049,88036,-,-
BAC151_M09,10,10p11.22,32526478,32609757,83279,-,-
BAC81_H08,10,10p11.22,32547371,32635689,88318,-,-
BAC58_O16,10,10p11.22,32547386,32699956,152570,-,-
BAC59_B10,10,10p11.22,32569263,32737991,168728,-,-
BAC130_L02,10,10p11.22,32652316,32729571,77255,-,-
BAC142_K07,10,10p11.22,32657344,32743665,86321,-,-
BAC77_D12,10,10p11.22,32854546,32997676,143130,-,-
BAC73_L18,10,10p11.22,32907686,33044123,136437,-,-
BAC181_B13,10,10p11.22,32947490,33019011,71521,-,-
BAC171_O14,10,10p11.22,33037989,33159017,121028,-,-
BAC248_I04,10,10p11.22,33043631,33159006,115375,-,-
BAC43_G10,10,10p11.22,33045232,33128932,83700,-,-
BAC48_J05,10,10p11.22,33085013,33221680,136667,-,-
BAC142_J05,10,10p11.22,33120739,33248507,127768,-,-
BAC49_F10,10,10p11.22,33171265,33306183,134918,-,-
BAC102_E06,10,10p11.22,33189136,33306197,117061,-,-
BAC89_N14,10,10p11.22,33236949,33335878,98929,-,-
BAC233_G11,10,10p11.22,33236949,33329548,92599,-,-
BAC62_P06,10,10p11.22,33358131,33444547,86416,-,-
BAC25_M20,10,10p11.22,33372863,33474745,101882,-,-
BAC144_N08,10,10p11.22,33503775,33587988,84213,-,-
BAC184_D21,10,10p11.22,33828160,33913870,85710,-,-
BAC191_N14,10,10p11.22,33881645,33975157,93512,-,-
BAC26_A15,10,10p11.22,33908337,34016907,108570,-,-
BAC213_B20,10,10p11.22,33914282,33994745,80463,-,-
BAC24_C24,10,10p11.22,33920439,34016906,96467,-,-
BAC58_L11,10,10p11.22,33953128,34085988,132860,-,-
BAC166_E06,10,10p11.22,33995745,34076711,80966,-,-
BAC60_D24,10,10p11.22,34005881,34130542,124661,-,-
BAC118_N03,10,10p11.22,34028875,34113760,84885,-,-
BAC95_O23,10,10p11.22,34042585,34135335,92750,-,-
BAC97_H07,10,10p11.22,34094082,34213686,119604,-,-
BAC199_F07,10,10p11.22,34207732,34305597,97865,-,-
BAC106_N05,10,10p11.22,34218517,34322116,103599,-,-
BAC151_G03,10,10p11.22,34242539,34374862,132323,-,-
BAC244_K05,10,10p11.22,34246913,34350128,103215,-,-
BAC41_J13,10,10p11.22,34272161,34397569,125408,-,-
BAC121_P17,10,10p11.22,34353748,34467896,114148,-,-
BAC246_I22,10,10p11.22-10p11.21,34430488,34539131,108643,-,-
BAC162_C14,10,10p11.22-10p11.21,34495056,34572745,77689,-,-
BAC198_I17,10,10p11.21,34512414,34585166,72752,-,-
BAC199_J20,10,10p11.21,34536963,34634386,97423,-,-
BAC83_J15,10,10p11.21,34888913,35045461,156548,-,-
BAC60_N19,10,10p11.21,34907185,35016777,109592,-,-
BAC184_C15,10,10p11.21,34923406,34995151,71745,-,-
BAC241_G07,10,10p11.21,34930598,35010088,79490,-,-
BAC38_N16,10,10p11.21,34941635,35041283,99648,-,-
BAC218_N07,10,10p11.21,34987401,35068811,81410,-,-
BAC116_M24,10,10p11.21,35010101,35107167,97066,-,-
BAC158_P14,10,10p11.21,35022031,35118983,96952,-,-
BAC158_M15,10,10p11.21,35022031,35118983,96952,-,-
BAC52_F09,10,10p11.21,35041277,35129075,87798,-,-
BAC127_P15,10,10p11.21,35045544,35154122,108578,-,-
BAC141_B24,10,10p11.21,35045544,35118643,73099,-,-
BAC233_I23,10,10p11.21,35052974,35147708,94734,-,-
BAC145_I05,10,10p11.21,35056211,35142028,85817,-,-
BAC224_O14,10,10p11.21,35079143,35154122,74979,-,-
BAC32_N06,10,10p11.21,35079143,35203126,123983,-,-
BAC37_O02,10,10p11.21,35101422,35203122,101700,-,-
BAC226_I14,10,10p11.21,35115273,35203126,87853,-,-
BAC121_F12,10,10p11.21,35119335,35213753,94418,-,-
BAC16_G16,10,10p11.21,35235068,35353627,118559,-,-
BAC235_P21,10,10p11.21,35235069,35323635,88566,-,-
BAC167_C02,10,10p11.21,35235069,35373542,138473,-,-
BAC171_K14,10,10p11.21,35238524,35324852,86328,-,-
BAC120_D11,10,10p11.21,35300485,35409363,108878,-,-
BAC1_H10,10,10p11.21,35323151,35419616,96465,-,-
BAC40_G14,10,10p11.21,35360825,35455250,94425,-,-
BAC59_J14,10,10p11.21,35380944,35486248,105304,-,-
BAC223_G11,10,10p11.21,35380970,35498881,117911,-,-
BAC111_N14,10,10p11.21,35381164,35464245,83081,-,-
BAC106_D14,10,10p11.21,35382858,35500746,117888,-,-
BAC62_G19,10,10p11.21,35409637,35487588,77951,-,-
BAC234_D13,10,10p11.21,35447498,35543802,96304,-,-
BAC41_A14,10,10p11.21,35500740,35610199,109459,-,-
BAC38_P12,10,10p11.21,35500747,35588379,87632,-,-
BAC69_J14,10,10p11.21,35588455,35689767,101312,-,-
BAC144_E22,10,10p11.21,35612352,35697705,85353,-,-
BAC84_D05,10,10p11.21,35656627,35752758,96131,-,-
BAC146_O03,10,10p11.21,35658583,35761576,102993,-,-
BAC162_M10,10,10p11.21,35659707,35788236,128529,-,-
BAC143_N21,10,10p11.21,35689760,35788225,98465,-,-
BAC66_K24,10,10p11.21,35764652,35869864,105212,-,-
BAC243_N07,10,10p11.21,35790538,35892192,101654,-,-
BAC241_M11,10,10p11.21,35947801,36042457,94656,-,-
BAC6_L05,10,10p11.21,35980564,36070204,89640,-,-
BAC175_I06,10,10p11.21,36051875,36134907,83032,-,-
BAC149_L05,10,10p11.21,36109230,36203557,94327,-,-
BAC101_M02,10,10p11.21,36110293,36231822,121529,-,-
BAC40_D18,10,10p11.21,36127586,36227990,100404,-,-
BAC249_G23,10,10p11.21,36148566,36267014,118448,-,-
BAC89_O02,10,10p11.21,36351196,36484750,133554,-,-
BAC163_G11,10,10p11.21,36383293,36462284,78991,-,-
BAC32_J06,10,10p11.21,36571317,36687408,116091,-,-
BAC10_H06,10,10p11.21,36590729,36696396,105667,-,-
BAC73_L09,10,10p11.21,36739201,36841310,102109,-,-
BAC76_G12,10,10p11.21,36830084,36944589,114505,-,-
BAC39_J03,10,10p11.21,36836706,36951922,115216,-,-
BAC49_C18,10,10p11.21,36891595,36977394,85799,-,-
BAC10_D12,10,10p11.21,36977115,37079800,102685,-,-
BAC65_N20,10,10p11.21,36977161,37089507,112346,-,-
BAC178_J02,10,10p11.21,37016065,37107846,91781,-,-
BAC81_H14,10,10p11.21,37068476,37183005,114529,-,-
BAC95_M19,10,10p11.21,37079798,37183102,103304,-,-
BAC62_J17,10,10p11.21,37414195,37504475,90280,-,-
BAC106_N04,10,10p11.21,37457975,37498428,40453,-,-
BAC247_O16,10,10p11.21,37471944,37504541,32597,-,-
BAC103_F24,10,10p11.21,37632393,37712298,79905,-,-
BAC218_L17,10,10p11.21,37647947,37742876,94929,-,-
BAC26_D09,10,10p11.21,37667355,37767219,99864,-,-
BAC196_O03,10,10p11.21,37767214,37853072,85858,-,-
BAC150_C08,10,10p11.21,37772193,37856312,84119,-,-
BAC67_P17,10,10p11.21,37859935,37999291,139356,-,-
BAC232_E21,10,10p11.21,38064164,38156064,91900,-,-
BAC227_J02,10,10p11.21,38079022,38156080,77058,-,-
BAC39_B23,10,10p11.21,38079098,38194577,115479,-,-
BAC45_P01,10,10p11.21,38131249,38252670,121421,-,-
BAC109_E01,10,10p11.21,38179376,38274380,95004,-,-
BAC157_E17,10,10p11.21,38194580,38276633,82053,-,-
BAC128_N05,10,10p11.21,38210088,38295351,85263,-,-
BAC69_L05,10,10p11.21,38225749,38346315,120566,-,-
BAC61_C20,10,10p11.21,38239589,38328029,88440,-,-
BAC88_N02,10,10p11.21,38314651,38404221,89570,-,-
BAC244_H12,10,10p11.21,38314661,38384988,70327,-,-
BAC186_O19,10,10p11.21,38331991,38442397,110406,-,-
BAC83_L01,10,10p11.21,38463015,38545698,82683,-,-
BAC191_P04,10,10p11.21,38514769,38633181,118412,-,-
BAC217_M22,10,10p11.21,38531836,38624871,93035,-,-
BAC206_M08,10,10p11.21,38645992,38737147,91155,-,-
BAC168_G07,10,10p11.21,38663488,38775390,111902,-,-
BAC157_N09,10,10q11.21,42105135,42201188,96053,-,-
BAC163_J03,10,10q11.21,42254490,42362731,108241,-,-
BAC129_E13,10,10q11.21,42386066,42468879,82813,-,-
BAC231_L11,10,10q11.21,42386290,42467407,81117,-,-
BAC8_H04,10,10q11.21,42386290,42472195,85905,-,-
BAC31_O05,10,10q11.21,42476368,42565462,89094,-,-
BAC157_B22,10,10q11.21,42497246,42590892,93646,-,-
BAC39_N23,10,10q11.21,42524581,42600178,75597,-,-
BAC81_G16,10,10q11.21,42560161,42742524,182363,-,-
BAC172_O22,10,10q11.21,42603815,42691052,87237,-,-
BAC82_H19,10,10q11.21,42603815,42691052,87237,-,-
BAC181_O14,10,10q11.21,42619260,42719030,99770,-,-
BAC136_L11,10,10q11.21,42668527,42742524,73997,-,-
BAC119_P10,10,10q11.21,42719023,42829626,110603,-,-
BAC26_P16,10,10q11.21,42817292,42904239,86947,-,-
BAC223_K23,10,10q11.21,42833453,42932404,98951,-,-
BAC27_K17,10,10q11.21,42904237,43055157,150920,yes,-
BAC230_K21,10,10q11.21,42904274,42997340,93066,-,-
BAC24_P11,10,10q11.21,42975877,43191882,216005,-,-
BAC8_N09,10,10q11.21,43015761,43182380,166619,-,-
BAC44_K09,10,10q11.21,43017501,43139154,121653,-,-
BAC43_A09,10,10q11.21,43017562,43166671,149109,-,-
BAC154_J06,10,10q11.21,43061495,43148604,87109,-,-
BAC64_H16,10,10q11.21,43152362,43311770,159408,-,-
BAC197_M01,10,10q11.21,43175698,43265006,89308,-,-
BAC234_E20,10,10q11.21,43200994,43265009,64015,-,-
BAC146_I11,10,10q11.21,43338938,43421156,82218,-,-
BAC38_P04,10,10q11.21,43342276,43468030,125754,-,-
BAC247_P11,10,10q11.21,43356371,43442251,85880,-,-
BAC40_P14,10,10q11.21,43421154,43510124,88970,-,-
BAC209_G17,10,10q11.21,43714090,43795609,81519,-,-
BAC22_N18,10,10q11.21,43714090,43819254,105164,-,-
BAC232_H11,10,10q11.21,43726784,43809032,82248,-,-
BAC86_B11,10,10q11.21,43726836,43828728,101892,-,-
BAC243_C04,10,10q11.21,43759872,43855035,95163,-,-
BAC50_N06,10,10q11.21,43759872,43861664,101792,-,-
BAC241_D08,10,10q11.21,43794045,43907734,113689,-,-
BAC246_L22,10,10q11.21,43808188,43892587,84399,-,-
BAC226_G06,10,10q11.21,43904355,43985604,81249,-,-
BAC146_D05,10,10q11.21,43924558,44021520,96962,-,-
BAC141_J04,10,10q11.21,44012183,44163777,151594,-,-
BAC115_B16,10,10q11.21,44030563,44124092,93529,-,-
BAC112_F02,10,10q11.21,44030569,44166687,136118,-,-
BAC120_A22,10,10q11.21,44063999,44166687,102688,-,-
BAC219_E18,10,10q11.21,44071241,44171232,99991,-,-
BAC210_F07,10,10q11.21,44096569,44181728,85159,-,-
BAC142_E16,10,10q11.21,44127972,44232189,104217,-,-
BAC81_A18,10,10q11.21,44167094,44276074,108980,-,-
BAC180_J18,10,10q11.21,44232184,44319984,87800,-,-
BAC68_P08,10,10q11.21,44252915,44358415,105500,-,-
BAC115_B06,10,10q11.21,44293707,44404890,111183,-,-
BAC217_D19,10,10q11.21,44530253,44622974,92721,-,-
BAC105_J18,10,10q11.21,44533657,44623025,89368,-,-
BAC131_G17,10,10q11.21,44642240,44745243,103003,-,-
BAC103_L06,10,10q11.21,44658062,44745243,87181,-,-
BAC154_M10,10,10q11.21,44664438,44748199,83761,-,-
BAC14_K16,10,10q11.21,44702716,44811838,109122,-,-
BAC105_M07,10,10q11.21,44712760,44794556,81796,-,-
BAC90_D13,10,10q11.21,44720251,44811671,91420,-,-
BAC234_M01,10,10q11.21,44745237,44834540,89303,-,-
BAC12_O22,10,10q11.21,44745237,44846783,101546,-,-
BAC184_P19,10,10q11.21,44784845,44876088,91243,-,-
BAC26_C13,10,10q11.21,44811843,44893130,81287,-,-
BAC217_F18,10,10q11.21,44846836,44947528,100692,-,-
BAC198_P12,10,10q11.21,44846836,44919966,73130,-,-
BAC217_B11,10,10q11.21,44846836,44928304,81468,-,-
BAC57_K09,10,10q11.21,44884030,45023888,139858,-,-
BAC64_L18,10,10q11.21,44884030,44972750,88720,-,-
BAC89_J04,10,10q11.21,44919044,45023884,104840,-,-
BAC227_F03,10,10q11.21,44947530,45044557,97027,-,-
BAC131_F19,10,10q11.21,45095038,45268815,173777,-,-
BAC73_O19,10,10q11.21,45098102,45228690,130588,-,-
BAC92_N11,10,10q11.21,45104709,45208698,103989,-,-
BAC229_E07,10,10q11.21,45116354,45204380,88026,-,-
BAC157_L07,10,10q11.21,45116829,45233349,116520,-,-
BAC83_O01,10,10q11.21,45176107,45268815,92708,-,-
BAC80_L01,10,10q11.21,45241945,45341570,99625,-,-
BAC160_G05,10,10q11.21,45285770,45378089,92319,-,-
BAC27_D08,10,10q11.21,45322897,45452793,129896,-,-
BAC106_C17,10,10q11.21,45324096,45435072,110976,-,-
BAC218_N13,10,10q11.21,45361204,45451346,90142,-,-
BAC117_J06,10,10q11.21,45397411,45548147,150736,yes,-
BAC31_H02,10,10q11.21,45427281,45548167,120886,yes,-
BAC39_D24,10,10q11.21,45435166,45542146,106980,yes,-
BAC92_P01,10,10q11.21,45446431,45548170,101739,yes,-
BAC115_I08,10,10q11.21,45456704,45583198,126494,yes,-
BAC157_B07,10,10q11.21,45509390,45599678,90288,-,-
BAC67_D21,10,10q11.21,45516931,45607220,90289,-,-
BAC160_J14,10,10q11.21,45583318,45664679,81361,yes,-
BAC130_D21,10,10q11.21,45625184,45707835,82651,yes,-
BAC141_A15,10,10q11.21-10q11.22,45945294,48429579,2484285,-,-
BAC31_B20,10,10q11.21-10q11.22,45959992,48467636,2507644,-,-
BAC57_M06,10,10q11.21-10q11.22,46062256,46230987,168731,yes,-
BAC82_N13,10,10q11.22,46125254,47162451,1037197,-,-
BAC148_B17,10,10q11.22,46320705,46408357,87652,yes,-
BAC228_E24,10,10q11.22,46538195,48915963,2377768,-,-
BAC134_I06,10,10q11.22,46541092,48918399,2377307,-,-
BAC31_K24,10,10q11.22,46581532,46702652,121120,yes,-
BAC217_P12,10,10q11.22,46586181,46702652,116471,-,-
BAC153_C16,10,10q11.22,46602007,46715484,113477,yes,-
BAC230_H23,10,10q11.22,47081124,47193430,112306,-,-
BAC12_O14,10,10q11.22,47087858,47176138,88280,-,-
BAC31_E05,10,10q11.22,47938048,48126151,188103,yes,-
BAC204_E01,10,10q11.22,47980763,48092750,111987,yes,-
BAC137_O03,10,10q11.22,47999553,48113015,113462,yes,-
BAC125_P22,10,10q11.22,48035663,48143017,107354,yes,-
BAC11_N18,10,10q11.22,48036266,48111172,74906,yes,-
BAC153_F09,10,10q11.22,48190104,48280122,90018,-,-
BAC88_P11,10,10q11.22,48231063,48346905,115842,-,-
BAC88_E20,10,10q11.22,48943489,49052203,108714,yes,-
BAC25_A24,10,10q11.22,49001135,49120103,118968,-,-
BAC132_H14,10,10q11.22,49111490,49211489,99999,-,-
BAC75_G04,10,10q11.22,49122353,49211453,89100,-,-
BAC65_L08,10,10q11.22,49122353,49245278,122925,-,-
BAC218_J01,10,10q11.22,49132797,49245274,112477,-,-
BAC31_C11,10,10q11.22,49139575,49249027,109452,-,-
BAC125_K14,10,10q11.22,49199162,49318981,119819,-,-
BAC105_P10,10,10q11.22,49297794,49426562,128768,-,-
BAC72_G04,10,10q11.22,49322643,49444614,121971,-,-
BAC75_H19,10,10q11.22,49322646,49426562,103916,-,-
BAC150_H04,10,10q11.22,49361335,49449555,88220,-,-
BAC203_O04,10,10q11.22,49361672,49470360,108688,-,-
BAC31_M23,10,10q11.22,49440721,49552619,111898,-,-
BAC81_P17,10,10q11.22,49584200,49729824,145624,-,-
BAC27_P24,10,10q11.22,49613893,49728864,114971,-,-
BAC204_P07,10,10q11.22,49614071,49696067,81996,-,-
BAC115_A18,10,10q11.22,49636476,49811493,175017,-,-
BAC181_I24,10,10q11.22,49689273,49764072,74799,-,-
BAC220_F05,10,10q11.22,49728858,49834527,105669,-,-
BAC168_I15,10,10q11.22,49783658,49853464,69806,-,-
BAC150_E03,10,10q11.22,49813032,49886923,73891,-,-
BAC78_J06,10,10q11.22,49813032,49907217,94185,-,-
BAC229_E16,10,10q11.22,49858677,49975250,116573,-,-
BAC175_D14,10,10q11.22,49861706,49963942,102236,-,-
BAC82_I16,10,10q11.22,49861706,49963942,102236,-,-
BAC221_H22,10,10q11.22,49915673,49995978,80305,-,-
BAC154_D05,10,10q11.22,49920574,49998249,77675,-,-
BAC124_N06,10,10q11.22-10q11.23,49941804,50118796,176992,-,-
BAC186_P11,10,10q11.22,49988960,50076274,87314,-,-
BAC246_D03,10,10q11.22,49996018,50090714,94696,-,-
BAC19_A23,10,10q11.22,49998255,50076111,77856,-,-
BAC187_A05,10,10q11.22,49998262,50090714,92452,-,-
BAC134_P11,10,10q11.22-10q11.23,50066042,50180148,114106,-,-
BAC75_A22,10,10q11.22-10q11.23,50083348,50175630,92282,-,-
BAC185_M12,10,10q11.23,50118802,50200338,81536,-,-
BAC20_D05,10,10q11.23,50323500,50430120,106620,-,-
BAC155_H03,10,10q11.23,50366138,50435629,69491,-,-
BAC182_C22,10,10q11.23,50430127,50528569,98442,-,-
BAC142_A18,10,10q11.23,50471716,50572436,100720,-,-
BAC55_B12,10,10q11.23,50535144,50630903,95759,-,-
BAC114_H10,10,10q11.23,50602225,50690013,87788,-,-
BAC26_H21,10,10q11.23,50795163,51475879,680716,-,-
BAC244_C24,10,10q11.23,50800114,51475894,675780,-,-
BAC129_G07,10,10q11.23,51035915,51459197,423282,-,-
BAC180_L09,10,10q11.23,51141007,51213428,72421,-,-
BAC127_K02,10,10q11.23,51144815,51293005,148190,-,-
BAC100_C21,10,10q11.23,51409630,51532086,122456,-,-
BAC97_A03,10,10q11.23,51441199,51554632,113433,-,-
BAC169_O09,10,10q11.23,51783011,51850205,67194,-,-
BAC81_M04,10,10q11.23,51927168,52066413,139245,-,-
BAC143_K13,10,10q11.23,51955944,52049289,93345,-,-
BAC65_I07,10,10q11.23,52011817,52125625,113808,-,-
BAC149_A15,10,10q11.23,52104238,52188226,83988,-,-
BAC41_D10,10,10q11.23,52255287,52336672,81385,-,-
BAC78_P18,10,10q11.23,52287235,52371630,84395,-,-
BAC218_I11,10,10q11.23,52306143,52384869,78726,-,-
BAC170_P04,10,10q11.23,52306159,52410387,104228,-,-
BAC154_F05,10,10q11.23,52351830,52453708,101878,-,-
BAC143_A09,10,10q11.23,52424594,52514665,90071,-,-
BAC51_G06,10,10q11.23,52453706,52563479,109773,-,-
BAC195_J15,10,10q11.23,52504084,52586485,82401,-,-
BAC217_C01,10,10q11.23,52586687,52682629,95942,-,-
BAC146_N05,10,10q11.23,52589260,52692955,103695,-,-
BAC235_H14,10,10q11.23,52961016,53073342,112326,-,-
BAC5_C13,10,10q11.23,53054118,53145652,91534,-,-
BAC59_M10,10,10q11.23,53073578,53159033,85455,-,-
BAC95_N03,10,10q11.23,53080377,53197390,117013,-,-
BAC151_I06,10,10q11.23,53186886,53269219,82333,-,-
BAC63_J07,10,10q11.23-10q21.1,53272883,53370395,97512,-,-
BAC49_I19,10,10q21.1,53417241,53528370,111129,-,-
BAC33_B20,10,10q21.1,53512711,53640050,127339,-,-
BAC38_N14,10,10q21.1,53542809,53649262,106453,-,-
BAC17_P20,10,10q21.1,53542809,53640049,97240,-,-
BAC77_L12,10,10q21.1,53648985,53736883,87898,-,-
BAC126_J03,10,10q21.1,53783313,53877160,93847,-,-
BAC82_I23,10,10q21.1,53798226,53890167,91941,-,-
BAC117_A01,10,10q21.1,53804848,53904523,99675,-,-
BAC55_B18,10,10q21.1,53904145,54031382,127237,-,-
BAC82_O05,10,10q21.1,54047889,54186194,138305,-,-
BAC27_H20,10,10q21.1,54113029,54208638,95609,-,-
BAC173_L03,10,10q21.1,54113029,54211767,98738,-,-
BAC100_D02,10,10q21.1,54113029,54211798,98769,-,-
BAC46_K24,10,10q21.1,54281619,54383848,102229,-,-
BAC237_D23,10,10q21.1,54315547,54420509,104962,-,-
BAC126_F01,10,10q21.1,54354712,54458072,103360,-,-
BAC126_N19,10,10q21.1,54354712,54458072,103360,-,-
BAC61_L17,10,10q21.1,54442677,54542379,99702,-,-
BAC114_G15,10,10q21.1,54442683,54579129,136446,-,-
BAC115_P22,10,10q21.1,54638708,54722055,83347,-,-
BAC89_O03,10,10q21.1,54676852,54800320,123468,-,-
BAC23_B11,10,10q21.1,55248774,55376988,128214,-,-
BAC166_I04,10,10q21.1,55348751,55431306,82555,-,-
BAC81_I16,10,10q21.1,55399112,55547128,148016,-,-
BAC195_M03,10,10q21.1,55476663,55570793,94130,-,-
BAC150_G11,10,10q21.1,55480025,55570793,90768,-,-
BAC40_D17,10,10q21.1,55482939,55562585,79646,-,-
BAC117_C02,10,10q21.1,55489948,55588816,98868,-,-
BAC51_O16,10,10q21.1,55513598,55585197,71599,-,-
BAC221_E06,10,10q21.1,55562654,55664800,102146,-,-
BAC67_N24,10,10q21.1,55764783,55865051,100268,-,-
BAC41_H02,10,10q21.1,55810907,55905651,94744,-,-
BAC117_G10,10,10q21.1,55816150,55905651,89501,-,-
BAC84_O15,10,10q21.1,55940546,55995967,55421,-,-
BAC122_C16,10,10q21.1,56126414,56215148,88734,-,-
BAC120_N09,10,10q21.1,56317861,56455818,137957,-,-
BAC127_I15,10,10q21.1,56411483,56527096,115613,-,-
BAC179_D23,10,10q21.1,56462373,56546418,84045,-,-
BAC243_A05,10,10q21.1,56552504,56655333,102829,-,-
BAC169_F01,10,10q21.1,56574048,56655097,81049,-,-
BAC160_B13,10,10q21.1,56603742,56697987,94245,-,-
BAC104_F09,10,10q21.1,56604334,56697987,93653,-,-
BAC124_C04,10,10q21.1,56655092,56806205,151113,-,-
BAC19_L05,10,10q21.1,56708326,56797349,89023,-,-
BAC249_C04,10,10q21.1,56937533,57035294,97761,-,-
BAC130_I04,10,10q21.1,57097186,57173556,76370,-,-
BAC82_G21,10,10q21.1,57323090,57396436,73346,-,-
BAC185_L15,10,10q21.1,57495865,57590745,94880,-,-
BAC168_E15,10,10q21.1,57699463,57794760,95297,-,-
BAC113_I05,10,10q21.1,57700876,57781179,80303,-,-
BAC224_E03,10,10q21.1,57865177,57949010,83833,-,-
BAC145_P02,10,10q21.1,57910622,58001384,90762,-,-
BAC5_N12,10,10q21.1,57992527,58074315,81788,-,-
BAC140_E20,10,10q21.1,58030910,58121307,90397,-,-
BAC34_L16,10,10q21.1,58076073,58195512,119439,-,-
BAC194_B23,10,10q21.1,58094224,58168638,74414,-,-
BAC101_I05,10,10q21.1,58105517,58179109,73592,-,-
BAC51_C14,10,10q21.1,58304420,58465261,160841,-,-
BAC15_I01,10,10q21.1,58371549,58512793,141244,-,-
BAC80_P19,10,10q21.1,58417669,58532208,114539,-,-
BAC236_P05,10,10q21.1,58447128,58527579,80451,-,-
BAC110_M01,10,10q21.1,58501520,58592091,90571,-,-
BAC51_M10,10,10q21.1,58512813,58622118,109305,-,-
BAC19_K18,10,10q21.1,58633373,58716620,83247,-,-
BAC55_C09,10,10q21.1,58784947,58879626,94679,-,-
BAC218_M09,10,10q21.1,58935675,59013819,78144,-,-
BAC191_N21,10,10q21.1,59350072,59438457,88385,-,-
BAC36_I18,10,10q21.1,59368430,59463483,95053,-,-
BAC83_P15,10,10q21.1,59400686,59516762,116076,-,-
BAC29_J10,10,10q21.1,59401862,59487329,85467,-,-
BAC109_B12,10,10q21.1,59438406,59525178,86772,-,-
BAC166_F08,10,10q21.1,59463478,59540236,76758,-,-
BAC18_N02,10,10q21.1,59494080,59587610,93530,-,-
BAC153_F01,10,10q21.1,59513430,59608370,94940,-,-
BAC60_M23,10,10q21.1,59523251,59629035,105784,-,-
BAC75_G05,10,10q21.1,59549149,59649844,100695,-,-
BAC226_B13,10,10q21.1,59649854,59731491,81637,-,-
BAC42_E18,10,10q21.1,59773870,59936745,162875,-,-
BAC190_P16,10,10q21.1,59777426,59829484,52058,-,-
BAC27_G06,10,10q21.1,59800978,59906815,105837,-,-
BAC119_P09,10,10q21.1,59972202,60068595,96393,-,-
BAC153_O10,10,10q21.1,60017339,60103735,86396,-,-
BAC54_P24,10,10q21.1,60040684,60161837,121153,-,-
BAC191_L22,10,10q21.1,60055970,60136726,80756,-,-
BAC81_B14,10,10q21.1,60186425,60299921,113496,-,-
BAC69_B08,10,10q21.1,60192286,60299661,107375,-,-
BAC53_B03,10,10q21.1,60225692,60306411,80719,-,-
BAC145_E15,10,10q21.1,60236226,60317604,81378,-,-
BAC127_A20,10,10q21.1,60377666,60463836,86170,-,-
BAC142_B21,10,10q21.1,60465688,60596244,130556,-,-
BAC52_M12,10,10q21.1,60630196,60736904,106708,-,-
BAC37_A05,10,10q21.1-10q21.2,61012162,61203645,191483,-,-
BAC84_B14,10,10q21.1,61016502,61131545,115043,-,-
BAC184_K13,10,10q21.1,61117441,61197009,79568,-,-
BAC237_N22,10,10q21.1-10q21.2,61156014,61254254,98240,-,-
BAC222_O19,10,10q21.1-10q21.2,61159640,61244363,84723,-,-
BAC30_P23,10,10q21.1-10q21.2,61196547,61309634,113087,-,-
BAC2_M02,10,10q21.2,61233096,61318055,84959,-,-
BAC73_N14,10,10q21.2,61254837,61351086,96249,-,-
BAC193_I07,10,10q21.2,61273442,61351127,77685,-,-
BAC224_O06,10,10q21.2,61287521,61367387,79866,-,-
BAC188_G18,10,10q21.2,61296842,61391975,95133,-,-
BAC178_A12,10,10q21.2,61395226,61477318,82092,-,-
BAC199_E18,10,10q21.2,61426415,61543471,117056,-,-
BAC101_P09,10,10q21.2,61443883,61548207,104324,-,-
BAC183_A09,10,10q21.2,61487726,61569769,82043,-,-
BAC106_I19,10,10q21.2,61487736,61582049,94313,-,-
BAC189_F21,10,10q21.2,61508991,61625152,116161,-,-
BAC49_A06,10,10q21.2,61520998,61597074,76076,-,-
BAC199_L03,10,10q21.2,61551815,61636619,84804,-,-
BAC163_P23,10,10q21.2,61834658,61946225,111567,-,-
BAC80_K21,10,10q21.2,61928177,62097701,169524,-,-
BAC169_D19,10,10q21.2,61993216,62077049,83833,-,-
BAC86_D02,10,10q21.2,62000460,62155596,155136,-,-
BAC247_H10,10,10q21.2,62034448,62132668,98220,-,-
BAC37_J06,10,10q21.2,62035241,62132663,97422,-,-
BAC116_G20,10,10q21.2,62054209,62132582,78373,-,-
BAC227_D01,10,10q21.2,62156625,62253843,97218,-,-
BAC66_M07,10,10q21.2,62156625,62249611,92986,-,-
BAC129_G21,10,10q21.2,62197717,62285801,88084,-,-
BAC51_C15,10,10q21.2,62280808,62399863,119055,-,-
BAC203_C19,10,10q21.2,62297033,62394555,97522,-,-
BAC171_B07,10,10q21.2,62399873,62481803,81930,-,-
BAC193_G24,10,10q21.2,62696311,62788476,92165,-,-
BAC181_J19,10,10q21.2,63194592,63295149,100557,-,-
BAC198_M05,10,10q21.2,63297200,63397097,99897,-,-
BAC38_F24,10,10q21.2,63503580,63616307,112727,-,-
BAC83_M19,10,10q21.2,63533742,63669820,136078,-,-
BAC143_O05,10,10q21.2,63587193,63669822,82629,-,-
BAC157_D12,10,10q21.2,63873292,63948161,74869,-,-
BAC157_C12,10,10q21.2,63873292,63948162,74870,-,-
BAC52_E10,10,10q21.2,63887630,63995042,107412,-,-
BAC115_M05,10,10q21.2,63890854,63978028,87174,-,-
BAC125_L05,10,10q21.2,63992080,64088302,96222,-,-
BAC5_O08,10,10q21.2,63992080,64109792,117712,-,-
BAC199_G06,10,10q21.2,64006343,64109172,102829,-,-
BAC234_M04,10,10q21.2,64030079,64130554,100475,-,-
BAC104_M07,10,10q21.2,64145391,64272523,127132,-,-
BAC193_A18,10,10q21.2,64169795,64250538,80743,-,-
BAC167_G13,10,10q21.2,64179656,64272523,92867,-,-
BAC94_B11,10,10q21.2,64228117,64385510,157393,-,-
BAC239_D16,10,10q21.2,64247594,64325753,78159,-,-
BAC4_P01,10,10q21.2,64272569,64341926,69357,-,-
BAC117_D08,10,10q21.2,64385634,64464344,78710,-,-
BAC205_K18,10,10q21.2,64413260,64497156,83896,-,-
BAC184_B07,10,10q21.2,64413260,64528843,115583,-,-
BAC95_E14,10,10q21.2,64450870,64635055,184185,-,-
BAC92_O04,10,10q21.2,64478969,64594683,115714,-,-
BAC123_K19,10,10q21.2,64643250,64795555,152305,-,-
BAC119_D17,10,10q21.2-10q21.3,64671284,64808357,137073,-,-
BAC151_P10,10,10q21.2,64705338,64796287,90949,-,-
BAC90_C22,10,10q21.2,64706669,64796287,89618,-,-
BAC59_A12,10,10q21.2,64707080,64795430,88350,-,-
BAC181_G06,10,10q21.2,64707847,64796289,88442,-,-
BAC194_H03,10,10q21.2-10q21.3,64720357,64808357,88000,-,-
BAC21_J14,10,10q21.2-10q21.3,64781711,64873523,91812,-,-
BAC108_O14,10,10q21.2-10q21.3,64796278,64884652,88374,-,-
BAC125_I02,10,10q21.3,64806110,64876841,70731,-,-
BAC96_L21,10,10q21.3,64808387,64889347,80960,-,-
BAC232_P12,10,10q21.3,64813037,64887166,74129,-,-
BAC62_E13,10,10q21.3,64813038,64913858,100820,-,-
BAC86_P09,10,10q21.3,64831434,64947468,116034,-,-
BAC30_D22,10,10q21.3,64885118,64976021,90903,-,-
BAC176_L09,10,10q21.3,64952388,65047099,94711,-,-
BAC125_L23,10,10q21.3,64952405,65054714,102309,-,-
BAC144_O15,10,10q21.3,64965569,65047399,81830,-,-
BAC68_O20,10,10q21.3,65015303,65141756,126453,-,-
BAC137_G02,10,10q21.3,65047093,65114843,67750,-,-
BAC149_G21,10,10q21.3,65054709,65141012,86303,-,-
BAC116_H10,10,10q21.3,65365440,65466873,101433,-,-
BAC193_L01,10,10q21.3,65499820,65607187,107367,-,-
BAC90_I23,10,10q21.3,65659779,65742739,82960,-,-
BAC64_P20,10,10q21.3,65742734,65830878,88144,-,-
BAC48_M13,10,10q21.3,65773174,65885330,112156,-,-
BAC67_I15,10,10q21.3,65774047,65904803,130756,-,-
BAC76_A14,10,10q21.3,66020100,66095612,75512,-,-
BAC42_D08,10,10q21.3,66020356,66166976,146620,-,-
BAC162_G22,10,10q21.3,66033613,66119401,85788,-,-
BAC43_J19,10,10q21.3,66033613,66138163,104550,-,-
BAC229_E14,10,10q21.3,66085866,66166979,81113,-,-
BAC32_O12,10,10q21.3,66153736,66239977,86241,-,-
BAC244_N06,10,10q21.3,66260437,66328727,68290,-,-
BAC116_D19,10,10q21.3,66390431,66484094,93663,-,-
BAC66_A20,10,10q21.3,66847238,66950752,103514,-,-
BAC149_H09,10,10q21.3,66890444,67019244,128800,-,-
BAC160_O21,10,10q21.3,66892449,66989449,97000,-,-
BAC141_O20,10,10q21.3,67209021,67304023,95002,-,-
BAC34_P05,10,10q21.3,67304177,67455126,150949,-,-
BAC129_P11,10,10q21.3,67610593,67683131,72538,-,-
BAC108_I06,10,10q21.3,67611340,67729359,118019,-,-
BAC15_G04,10,10q21.3,67796347,67914916,118569,-,-
BAC125_P16,10,10q21.3,67882597,68053021,170424,-,-
BAC111_A16,10,10q21.3,68068306,68209825,141519,-,-
BAC192_B15,10,10q21.3,68078700,68175132,96432,-,-
BAC96_G01,10,10q21.3,68247872,68330509,82637,-,-
BAC96_I01,10,10q21.3,68279578,68428692,149114,-,-
BAC139_J08,10,10q21.3,68293173,68388072,94899,-,-
BAC177_M17,10,10q21.3,68462617,68565792,103175,-,-
BAC29_N06,10,10q21.3,68486240,68588030,101790,-,-
BAC169_O19,10,10q21.3,68672583,68761065,88482,-,-
BAC183_D08,10,10q21.3,68837448,68932109,94661,-,-
BAC36_B01,10,10q21.3,68868729,68981200,112471,-,-
BAC244_F23,10,10q21.3,68992072,69088648,96576,-,-
BAC165_P20,10,10q21.3,69013624,69100272,86648,-,-
BAC6_N03,10,10q21.3,69040694,69167985,127291,-,-
BAC91_K09,10,10q21.3,69095749,69181085,85336,-,-
BAC120_B16,10,10q21.3,69153852,69276565,122713,-,-
BAC96_O01,10,10q21.3,69200575,69282806,82231,-,-
BAC39_L10,10,10q21.3,69235080,69340957,105877,-,-
BAC102_M03,10,10q21.3,69252351,69335114,82763,-,-
BAC69_K06,10,10q21.3,69263903,69363834,99931,-,-
BAC95_H03,10,10q21.3,69277229,69347562,70333,-,-
BAC183_F20,10,10q21.3,69282798,69380890,98092,-,-
BAC126_K10,10,10q21.3,69394868,69475766,80898,-,-
BAC129_L08,10,10q21.3,69462223,69550367,88144,-,-
BAC135_P05,10,10q21.3,69462770,69539644,76874,-,-
BAC222_A12,10,10q21.3,69550359,69629659,79300,-,-
BAC148_A18,10,10q21.3,69585096,69671785,86689,-,-
BAC221_N08,10,10q21.3,69628187,69775165,146978,-,-
BAC155_O17,10,10q21.3,69701545,69771286,69741,-,-
BAC73_M05,10,10q21.3,69705644,69823694,118050,-,-
BAC169_F05,10,10q21.3,69823688,69929662,105974,-,-
BAC208_I10,10,10q21.3,69834175,69928027,93852,-,-
BAC57_L15,10,10q21.3,69852344,69933030,80686,-,-
BAC110_C10,10,10q21.3,69880963,69972448,91485,-,-
BAC55_K20,10,10q21.3,69881004,69972434,91430,-,-
BAC79_J19,10,10q21.3,69933155,70082375,149220,-,-
BAC160_P17,10,10q21.3,69999886,70081579,81693,-,-
BAC223_B20,10,10q21.3,70065672,70155160,89488,-,-
BAC155_O04,10,10q21.3,70082636,70170482,87846,-,-
BAC123_F09,10,10q21.3,70153630,70270005,116375,-,-
BAC195_H05,10,10q21.3,70186233,70267125,80892,-,-
BAC195_K05,10,10q21.3,70186341,70267125,80784,-,-
BAC134_O10,10,10q21.3,70192566,70289117,96551,-,-
BAC166_C23,10,10q21.3,70201503,70297357,95854,-,-
BAC118_D13,10,10q21.3,70337096,70435685,98589,-,-
BAC129_E24,10,10q21.3,70358843,70449228,90385,-,-
BAC76_N22,10,10q21.3,70369808,70449407,79599,-,-
BAC135_H24,10,10q21.3,70412793,70495326,82533,-,-
BAC41_F04,10,10q21.3,70443894,70605435,161541,-,-
BAC109_O11,10,10q21.3,70495830,70619846,124016,-,-
BAC97_G09,10,10q21.3,70499820,70603030,103210,-,-
BAC252_M23,10,10q21.3,70521192,70675539,154347,-,-
BAC80_C14,10,10q21.3,70619840,70721327,101487,-,-
BAC21_C16,10,10q21.3,70677051,70828525,151474,-,-
BAC58_N19,10,10q21.3,70699690,70773851,74161,-,-
BAC129_B19,10,10q21.3,70699690,70838480,138790,-,-
BAC73_N19,10,10q21.3,70699695,70837857,138162,-,-
BAC141_E24,10,10q21.3,70722276,70880947,158671,-,-
BAC122_K18,10,10q21.3,70760136,70897182,137046,-,-
BAC192_K11,10,10q21.3,70927185,70997384,70199,-,-
BAC68_A03,10,10q21.3,71006022,71122915,116893,-,-
BAC39_A11,10,10q21.3,71018539,71114448,95909,-,-
BAC190_K01,10,10q21.3,71030570,71114448,83878,-,-
BAC185_I03,10,10q21.3,71080812,71185634,104822,-,-
BAC58_G16,10,10q21.3,71080812,71185592,104780,-,-
BAC189_K16,10,10q21.3,71125179,71255155,129976,-,-
BAC43_I15,10,10q21.3-10q22.1,71185628,71308812,123184,-,-
BAC56_B08,10,10q21.3-10q22.1,71202308,71308856,106548,-,-
BAC154_N08,10,10q21.3-10q22.1,71233538,71308865,75327,-,-
BAC33_G03,10,10q22.1,71343933,71442464,98531,-,-
BAC184_M08,10,10q22.1,71404366,71492511,88145,-,-
BAC1_H19,10,10q22.1,71442453,71573929,131476,yes,-
BAC171_G01,10,10q22.1,71499401,71592832,93431,yes,-
BAC83_F04,10,10q22.1,71513567,71663434,149867,yes,-
BAC56_N01,10,10q22.1,71513588,71628813,115225,yes,-
BAC55_P17,10,10q22.1,71520812,71623674,102862,yes,-
BAC163_G10,10,10q22.1,71538593,71627313,88720,yes,-
BAC239_D20,10,10q22.1,71698501,71788702,90201,-,-
BAC218_G02,10,10q22.1,71698501,71810634,112133,-,-
BAC77_G06,10,10q22.1,71704269,71819839,115570,-,-
BAC107_I11,10,10q22.1,71761714,71909473,147759,-,-
BAC248_E08,10,10q22.1,71781618,71876085,94467,yes,-
BAC115_B09,10,10q22.1,71810903,71919680,108777,yes,-
BAC119_B07,10,10q22.1,71819708,71995636,175928,yes,-
BAC230_E13,10,10q22.1,71847483,71973135,125652,yes,-
BAC196_O19,10,10q22.1,71864649,71952084,87435,-,-
BAC200_B03,10,10q22.1,71876545,71950358,73813,-,-
BAC131_B17,10,10q22.1,71876545,71970743,94198,-,-
BAC32_F02,10,10q22.1,71896409,72032183,135774,-,-
BAC176_A24,10,10q22.1,71912045,72027605,115560,-,-
BAC227_A20,10,10q22.1,71952185,72049996,97811,yes,-
BAC234_K12,10,10q22.1,71970736,72074619,103883,yes,-
BAC190_I11,10,10q22.1,71970736,72049858,79122,yes,-
BAC237_B13,10,10q22.1,72017717,72103876,86159,yes,-
BAC197_F19,10,10q22.1,72027719,72137168,109449,-,-
BAC14_K23,10,10q22.1,72121300,72232661,111361,-,-
BAC246_L16,10,10q22.1,72146331,72253325,106994,-,-
BAC10_M03,10,10q22.1,72147511,72252557,105046,-,-
BAC223_O04,10,10q22.1,72198824,72287510,88686,-,-
BAC150_H02,10,10q22.1,72236935,72361788,124853,-,-
BAC166_L02,10,10q22.1,72239599,72373623,134024,-,-
BAC243_M02,10,10q22.1,72272303,72359662,87359,-,-
BAC25_I05,10,10q22.1,72288864,72374413,85549,-,-
BAC115_A20,10,10q22.1,72330886,72450192,119306,-,-
BAC221_B24,10,10q22.1,72337171,72430015,92844,-,-
BAC219_K19,10,10q22.1,72370767,72494629,123862,-,-
BAC189_P14,10,10q22.1,72408051,72490423,82372,-,-
BAC123_D04,10,10q22.1,72430116,72524415,94299,-,-
BAC89_C09,10,10q22.1,72445300,72541949,96649,-,-
BAC76_M14,10,10q22.1,72490593,72596319,105726,-,-
BAC114_E12,10,10q22.1,72494623,72528135,33512,-,-
BAC102_K16,10,10q22.1,72494623,72588853,94230,-,-
BAC140_A16,10,10q22.1,72495652,72579586,83934,-,-
BAC224_J14,10,10q22.1,72545630,72655734,110104,-,-
BAC49_F04,10,10q22.1,72584910,72807838,222928,-,-
BAC218_N23,10,10q22.1,72596203,72686536,90333,-,-
BAC155_N24,10,10q22.1,72646414,72765423,119009,-,-
BAC11_F08,10,10q22.1,72679236,72793966,114730,-,-
BAC248_F24,10,10q22.1,72686530,72782208,95678,-,-
BAC90_P20,10,10q22.1,72703373,72787177,83804,-,-
BAC116_D13,10,10q22.1,72714325,72812519,98194,-,-
BAC217_F03,10,10q22.1,72920797,73030118,109321,-,-
BAC219_A11,10,10q22.1,72975283,73064611,89328,-,-
BAC65_N01,10,10q22.1,73020825,73116025,95200,-,-
BAC228_G06,10,10q22.1,73108482,73194723,86241,-,-
BAC209_C21,10,10q22.1,73186358,73290867,104509,-,-
BAC144_M14,10,10q22.1,73215065,73314527,99462,-,-
BAC66_P04,10,10q22.1,73226705,73324572,97867,-,-
BAC252_I19,10,10q22.1,73263300,73367748,104448,-,-
BAC10_G05,10,10q22.1,73275038,73422754,147716,-,-
BAC227_J01,10,10q22.1,73278959,73357265,78306,-,-
BAC226_L07,10,10q22.1,73278959,73378741,99782,-,-
BAC73_N17,10,10q22.1,73289052,73370315,81263,-,-
BAC65_D21,10,10q22.1,73361988,73469092,107104,-,-
BAC45_O18,10,10q22.1,73404682,73522032,117350,-,-
BAC191_M20,10,10q22.1,73404740,73497831,93091,-,-
BAC217_B08,10,10q22.1,73410231,73497368,87137,-,-
BAC55_M06,10,10q22.1,73438936,73510159,71223,-,-
BAC184_E03,10,10q22.1,73628330,73703260,74930,-,-
BAC184_F01,10,10q22.1,73630077,73710429,80352,-,-
BAC136_J15,10,10q22.1,73630077,73703256,73179,-,-
BAC24_E10,10,10q22.1,73707224,73846414,139190,-,-
BAC159_C10,10,10q22.1,73707913,73809205,101292,-,-
BAC228_G21,10,10q22.1,73838038,73917449,79411,-,-
BAC4_H11,10,10q22.1,73845656,73936113,90457,-,-
BAC241_I11,10,10q22.1,73904877,74003633,98756,-,-
BAC95_G06,10,10q22.1,73917451,74003631,86180,-,-
BAC46_N02,10,10q22.1,73958729,74102330,143601,-,-
BAC175_C19,10,10q22.1,73976674,74071651,94977,-,-
BAC31_H15,10,10q22.1,74004538,74087426,82888,-,-
BAC177_C24,10,10q22.1,74032324,74118816,86492,-,-
BAC196_G19,10,10q22.1,74113483,74182572,69089,-,-
BAC240_I09,10,10q22.1,74182567,74295071,112504,-,-
BAC22_C23,10,10q22.1,74237780,74335741,97961,-,-
BAC232_P16,10,10q22.1,74295067,74406515,111448,-,-
BAC140_D19,10,10q22.1,74300901,74406515,105614,-,-
BAC221_K02,10,10q22.1,74318864,74415788,96924,-,-
BAC67_F12,10,10q22.1,74318866,74423133,104267,-,-
BAC242_P17,10,10q22.1,74364993,74454963,89970,-,-
BAC40_H14,10,10q22.1,74384322,74484681,100359,-,-
BAC147_J17,10,10q22.1,74423128,74507577,84449,-,-
BAC43_G15,10,10q22.1,74455058,74538413,83355,-,-
BAC217_O10,10,10q22.1-10q22.2,74524388,74622883,98495,-,-
BAC120_E22,10,10q22.2,74702818,74847105,144287,-,-
BAC190_O18,10,10q22.2,74769548,74846742,77194,-,-
BAC172_J16,10,10q22.2,74800857,74876835,75978,-,-
BAC165_J08,10,10q22.2,74814863,74901347,86484,-,-
BAC237_A16,10,10q22.2,75011364,75183309,171945,yes,-
BAC66_D14,10,10q22.2,75053980,75174556,120576,yes,-
BAC187_F11,10,10q22.2,75055947,75131370,75423,yes,-
BAC38_L17,10,10q22.2,75079136,75179953,100817,yes,-
BAC191_A05,10,10q22.2,75093748,75192201,98453,yes,-
BAC34_J21,10,10q22.2,75093748,75260626,166878,-,-
BAC252_O16,10,10q22.2,75093983,75183309,89326,yes,-
BAC32_E21,10,10q22.2,75129775,75250935,121160,-,-
BAC193_L20,10,10q22.2,75136462,75216018,79556,-,-
BAC95_E12,10,10q22.2,75183301,75327535,144234,-,-
BAC52_B14,10,10q22.2,75183312,75288876,105564,-,-
BAC24_E16,10,10q22.2,75250931,75387123,136192,-,-
BAC37_J19,10,10q22.2,75276541,75397816,121275,-,-
BAC43_H16,10,10q22.2,75300029,75394695,94666,-,-
BAC105_J14,10,10q22.2,75309714,75431324,121610,-,-
BAC79_A24,10,10q22.2,75319034,75408666,89632,-,-
BAC219_A05,10,10q22.2,75439041,75530365,91324,-,-
BAC76_C21,10,10q22.2,75459235,75539123,79888,-,-
BAC252_O13,10,10q22.2,75459389,75541530,82141,-,-
BAC154_D03,10,10q22.2,75479499,75552937,73438,-,-
BAC194_F14,10,10q22.2,75501850,75586950,85100,-,-
BAC56_A12,10,10q22.2,75597616,75704496,106880,-,-
BAC18_J19,10,10q22.2,75681683,75777760,96077,-,-
BAC8_A10,10,10q22.2,75707739,75849202,141463,-,-
BAC23_H16,10,10q22.2,75792001,75882203,90202,-,-
BAC232_H09,10,10q22.2,75895502,75997808,102306,-,-
BAC229_G01,10,10q22.2,76096175,76184107,87932,-,-
BAC194_E22,10,10q22.2,76096202,76168046,71844,-,-
BAC24_C06,10,10q22.2,76099578,76184095,84517,-,-
BAC131_L11,10,10q22.2,76101000,76168046,67046,-,-
BAC38_J09,10,10q22.2,76120470,76270909,150439,-,-
BAC23_O11,10,10q22.2,76142933,76276527,133594,-,-
BAC134_D11,10,10q22.2,76152867,76261204,108337,-,-
BAC49_A24,10,10q22.2,76152867,76233674,80807,-,-
BAC193_E21,10,10q22.2,76169031,76270909,101878,-,-
BAC26_E12,10,10q22.2,76233712,76309480,75768,-,-
BAC121_B03,10,10q22.2,76276522,76361544,85022,-,-
BAC40_B01,10,10q22.2,76278014,76412872,134858,-,-
BAC214_B22,10,10q22.2,76309504,76406568,97064,-,-
BAC50_O13,10,10q22.2,76411558,76551123,139565,-,-
BAC106_F19,10,10q22.2,76489540,76573541,84001,-,-
BAC221_P23,10,10q22.2,76551126,76653139,102013,-,-
BAC157_O12,10,10q22.2,76578136,76674759,96623,-,-
BAC149_H01,10,10q22.2,76606654,76712395,105741,-,-
BAC181_L07,10,10q22.2,76607845,76714937,107092,-,-
BAC178_D22,10,10q22.2,76607846,76714937,107091,-,-
BAC128_K08,10,10q22.2,76660667,76743377,82710,-,-
BAC235_O17,10,10q22.2,76674755,76759405,84650,-,-
BAC220_E18,10,10q22.2,76785152,76865097,79945,-,-
BAC171_C15,10,10q22.2,76804656,76909269,104613,-,-
BAC220_P10,10,10q22.2,76804656,76899620,94964,-,-
BAC214_F04,10,10q22.2,76822040,76909917,87877,-,-
BAC105_K02,10,10q22.2,76970072,77067930,97858,-,-
BAC134_P18,10,10q22.2,77010800,77079976,69176,-,-
BAC205_D17,10,10q22.2,77062574,77147013,84439,-,-
BAC30_C15,10,10q22.2,77066901,77169085,102184,-,-
BAC118_B16,10,10q22.2,77072880,77189075,116195,-,-
BAC155_P04,10,10q22.2,77149086,77261600,112514,-,-
BAC185_N01,10,10q22.2,77158534,77244758,86224,-,-
BAC91_C17,10,10q22.2,77222476,77322480,100004,-,-
BAC137_E08,10,10q22.2,77232173,77329934,97761,-,-
BAC172_F14,10,10q22.2-10q22.3,77361873,77472153,110280,-,-
BAC83_K21,10,10q22.2-10q22.3,77372216,77457091,84875,-,-
BAC119_N07,10,10q22.3,77443075,77537870,94795,-,-
BAC184_I04,10,10q22.3,77450243,77553565,103322,-,-
BAC162_I01,10,10q22.3,77469144,77570976,101832,-,-
BAC24_B06,10,10q22.3,77472152,77570976,98824,-,-
BAC100_A09,10,10q22.3,77496318,77586993,90675,-,-
BAC81_K02,10,10q22.3,77496318,77636098,139780,-,-
BAC46_O03,10,10q22.3,77549061,77680151,131090,-,-
BAC176_N13,10,10q22.3,77549241,77650679,101438,-,-
BAC140_H04,10,10q22.3,77642379,77664822,22443,-,-
BAC83_H08,10,10q22.3,77665012,77753980,88968,-,-
BAC140_P18,10,10q22.3,77926407,78008930,82523,-,-
BAC217_N04,10,10q22.3,77945870,78034909,89039,-,-
BAC219_H09,10,10q22.3,78088401,78178787,90386,-,-
BAC80_N14,10,10q22.3,78291828,78384660,92832,-,-
BAC27_J07,10,10q22.3,78309357,78400693,91336,-,-
BAC193_F07,10,10q22.3,78342428,78431864,89436,-,-
BAC219_J04,10,10q22.3,78470365,78556025,85660,-,-
BAC236_J06,10,10q22.3,78529852,78620736,90884,-,-
BAC59_M02,10,10q22.3,78529863,78644313,114450,-,-
BAC57_E06,10,10q22.3,78598349,78684555,86206,-,-
BAC83_E23,10,10q22.3,78620796,78731928,111132,-,-
BAC137_O10,10,10q22.3,78632141,78715140,82999,-,-
BAC46_K22,10,10q22.3,78644377,78739731,95354,-,-
BAC38_M24,10,10q22.3,78712813,78859448,146635,-,-
BAC143_I15,10,10q22.3,78717444,78876183,158739,-,-
BAC25_M17,10,10q22.3,78719443,78837511,118068,-,-
BAC49_H01,10,10q22.3,78757085,78866287,109202,-,-
BAC24_E08,10,10q22.3,78863868,78976961,113093,-,-
BAC170_M02,10,10q22.3,78866381,78976980,110599,-,-
BAC114_O23,10,10q22.3,78953874,79041370,87496,-,-
BAC196_C14,10,10q22.3,78979540,79090040,110500,-,-
BAC200_D06,10,10q22.3,78992032,79118238,126206,-,-
BAC168_J08,10,10q22.3,79073209,79160787,87578,-,-
BAC77_A21,10,10q22.3,79089406,79217437,128031,-,-
BAC223_P04,10,10q22.3,79134351,79212135,77784,-,-
BAC246_N14,10,10q22.3,79140598,79223804,83206,-,-
BAC236_D18,10,10q22.3,79171432,79248990,77558,-,-
BAC75_D03,10,10q22.3,79194164,79314905,120741,-,-
BAC117_M16,10,10q22.3,79207784,79293367,85583,-,-
BAC122_N13,10,10q22.3,79212129,79338942,126813,-,-
BAC68_D09,10,10q22.3,79212129,79318535,106406,-,-
BAC202_C03,10,10q22.3,79217454,79318532,101078,-,-
BAC149_O24,10,10q22.3,79245227,79318533,73306,-,-
BAC153_A15,10,10q22.3,79250878,79372905,122027,-,-
BAC243_M19,10,10q22.3,79264349,79412008,147659,-,-
BAC107_K06,10,10q22.3,79294822,79387439,92617,-,-
BAC59_F13,10,10q22.3,79302076,79389355,87279,-,-
BAC213_I05,10,10q22.3,79338936,79449038,110102,-,-
BAC171_F21,10,10q22.3,79338936,79412008,73072,-,-
BAC81_I13,10,10q22.3,79399359,79517810,118451,-,-
BAC160_P11,10,10q22.3,79470639,79556259,85620,-,-
BAC188_F21,10,10q22.3,79470712,79556250,85538,-,-
BAC150_J18,10,10q22.3,79483638,79557145,73507,-,-
BAC72_L05,10,10q22.3,79485831,79572931,87100,-,-
BAC100_E17,10,10q22.3,79599223,79708854,109631,-,-
BAC135_H17,10,10q22.3,79607523,79715593,108070,-,-
BAC24_F13,10,10q22.3,79611402,79757968,146566,-,-
BAC56_N06,10,10q22.3,79614825,79710085,95260,-,-
BAC130_J20,10,10q22.3,79635452,79764915,129463,-,-
BAC63_K15,10,10q22.3,79635462,79735363,99901,-,-
BAC30_O20,10,10q22.3,79654560,79740657,86097,-,-
BAC113_D10,10,10q22.3,79670599,79753879,83280,-,-
BAC54_O08,10,10q22.3,79670714,79764915,94201,-,-
BAC175_J18,10,10q22.3,79731916,79810260,78344,-,-
BAC15_I03,10,10q22.3,79735793,79842698,106905,-,-
BAC156_D06,10,10q22.3,79798702,79897182,98480,-,-
BAC197_C15,10,10q22.3,79827861,79918731,90870,-,-
BAC150_I10,10,10q22.3,79834461,79979027,144566,-,-
BAC167_B13,10,10q22.3,79878336,79980058,101722,-,-
BAC244_E06,10,10q22.3,79914032,80006634,92602,-,-
BAC165_D12,10,10q22.3,79941269,80019660,78391,-,-
BAC165_F04,10,10q22.3,79941305,80019660,78355,-,-
BAC126_P04,10,10q22.3,80043915,80207675,163760,-,-
BAC71_L01,10,10q22.3,80159580,80257352,97772,-,-
BAC236_N17,10,10q22.3,80172071,80306444,134373,-,-
BAC179_D07,10,10q22.3,80184004,80270569,86565,-,-
BAC127_B22,10,10q22.3,80184030,80295218,111188,-,-
BAC198_P15,10,10q22.3,80192912,80270569,77657,-,-
BAC53_P15,10,10q22.3,80212051,80305438,93387,-,-
BAC110_B11,10,10q22.3,80232686,80365869,133183,-,-
BAC219_B24,10,10q22.3,80257362,80355877,98515,-,-
BAC127_F19,10,10q22.3,80257385,80359885,102500,-,-
BAC36_D10,10,10q22.3,80300723,80396466,95743,-,-
BAC131_G19,10,10q22.3,80306448,80396475,90027,-,-
BAC109_K15,10,10q22.3,80306448,80416057,109609,-,-
BAC120_I15,10,10q22.3,80309154,80460216,151062,-,-
BAC102_H16,10,10q22.3,80343803,80442266,98463,-,-
BAC127_L18,10,10q22.3,80365863,80442266,76403,-,-
BAC42_I21,10,10q22.3,80365867,80505850,139983,-,-
BAC134_O04,10,10q22.3,80377530,80456463,78933,-,-
BAC75_J17,10,10q22.3,80397533,80505251,107718,-,-
BAC27_N06,10,10q22.3,80418981,80505805,86824,-,-
BAC21_D24,10,10q22.3,80451573,80550194,98621,-,-
BAC236_C15,10,10q22.3,80460213,80544560,84347,-,-
BAC29_F23,10,10q22.3,80551823,80661002,109179,-,-
BAC62_L20,10,10q22.3,80603073,80708075,105002,-,-
BAC59_H13,10,10q22.3,80603073,80803457,200384,-,-
BAC57_P04,10,10q22.3,80710830,80864393,153563,-,-
BAC203_H11,10,10q22.3,80796243,80887163,90920,-,-
BAC217_N15,10,10q22.3,80803559,80940241,136682,-,-
BAC148_L18,10,10q22.3,80913504,81001494,87990,-,-
BAC91_E20,10,10q22.3,80920977,81018462,97485,-,-
BAC64_N16,10,10q22.3,80950823,81028710,77887,-,-
BAC41_M06,10,10q22.3,80992218,81099647,107429,-,-
BAC40_N07,10,10q22.3,81020310,81202326,182016,-,-
BAC224_K17,10,10q22.3,81045048,81141898,96850,-,-
BAC152_D24,10,10q22.3,81114193,81552942,438749,-,-
BAC123_P11,10,10q22.3,81129843,81564710,434867,-,-
BAC42_H18,10,10q22.3,81219189,81621094,401905,-,-
BAC135_B16,10,10q22.3,81588225,81672438,84213,-,-
BAC54_O14,10,10q22.3,81747363,81868421,121058,-,-
BAC227_F15,10,10q22.3,81747363,81854422,107059,-,-
BAC119_B08,10,10q22.3,81747363,81886831,139468,-,-
BAC186_N14,10,10q22.3,81806557,81900298,93741,-,-
BAC74_I07,10,10q22.3,81806557,81886832,80275,-,-
BAC12_J16,10,10q22.3,81868638,81967786,99148,-,-
BAC195_P06,10,10q22.3,81886824,81983200,96376,-,-
BAC146_C08,10,10q22.3,81891984,81990218,98234,-,-
BAC38_J16,10,10q22.3-10q23.1,81891984,82023510,131526,-,-
BAC124_D06,10,10q22.3-10q23.1,81917249,82022216,104967,-,-
BAC142_F12,10,10q22.3-10q23.1,81944056,82048760,104704,-,-
BAC166_M23,10,10q22.3-10q23.1,81983242,82055130,71888,-,-
BAC90_G04,10,10q23.1,82023525,82114866,91341,-,-
BAC97_M17,10,10q23.1,82119375,82208654,89279,-,-
BAC117_P03,10,10q23.1,82122811,82238212,115401,-,-
BAC115_B22,10,10q23.1,82140653,82248991,108338,-,-
BAC243_L03,10,10q23.1,82222879,82319110,96231,-,-
BAC37_N05,10,10q23.1,82374676,82487417,112741,-,-
BAC95_F21,10,10q23.1,82493506,82617304,123798,-,-
BAC221_B14,10,10q23.1,82548294,82650826,102532,-,-
BAC177_G24,10,10q23.1,82571214,82650721,79507,-,-
BAC110_C09,10,10q23.1,82610049,82734948,124899,-,-
BAC232_D05,10,10q23.1,82629431,82710834,81403,-,-
BAC80_B07,10,10q23.1,82882782,83007695,124913,-,-
BAC85_D08,10,10q23.1,82985410,83079016,93606,-,-
BAC60_B03,10,10q23.1,82989201,83068388,79187,-,-
BAC39_K22,10,10q23.1,83009869,83095045,85176,-,-
BAC142_L19,10,10q23.1,83113644,83189279,75635,-,-
BAC173_P07,10,10q23.1,83237691,83347575,109884,-,-
BAC246_N08,10,10q23.1,83254635,83347575,92940,-,-
BAC182_A11,10,10q23.1,83319496,83403263,83767,-,-
BAC217_A20,10,10q23.1,83427510,83511097,83587,-,-
BAC235_B08,10,10q23.1,83660815,83738248,77433,-,-
BAC122_J03,10,10q23.1,83675494,83760248,84754,-,-
BAC248_L03,10,10q23.1,83675494,83752802,77308,-,-
BAC179_H06,10,10q23.1,83675494,83771508,96014,-,-
BAC76_J03,10,10q23.1,84000919,84171203,170284,-,-
BAC61_L04,10,10q23.1,84033647,84170966,137319,-,-
BAC88_D07,10,10q23.1,84333178,84430876,97698,-,-
BAC25_C21,10,10q23.1,84400733,84491778,91045,-,-
BAC232_I12,10,10q23.1,84403613,84505229,101616,-,-
BAC30_G19,10,10q23.1,84413712,84492488,78776,-,-
BAC52_I11,10,10q23.1,84474997,84568700,93703,-,-
BAC165_B11,10,10q23.1,84664829,84782573,117744,-,-
BAC109_C17,10,10q23.1,85001821,85092773,90952,-,-
BAC132_M08,10,10q23.1,85036201,85116866,80665,-,-
BAC123_J07,10,10q23.1,85118328,85226117,107789,-,-
BAC197_C11,10,10q23.1,85279672,85363937,84265,-,-
BAC161_M05,10,10q23.1,85303078,85374074,70996,-,-
BAC115_M01,10,10q23.1,85364173,85445418,81245,-,-
BAC11_H18,10,10q23.1,85424330,85553439,129109,-,-
BAC163_G15,10,10q23.1,85743350,85835901,92551,-,-
BAC222_G02,10,10q23.1,85746688,85832932,86244,-,-
BAC137_O16,10,10q23.1,85765086,85859910,94824,-,-
BAC185_E09,10,10q23.1,85859921,85962546,102625,-,-
BAC170_J06,10,10q23.1,85885345,85977153,91808,-,-
BAC189_L03,10,10q23.1,85887597,85977153,89556,-,-
BAC144_F24,10,10q23.1,85898047,86024128,126081,-,-
BAC115_I22,10,10q23.1,85934463,86054563,120100,-,-
BAC88_L12,10,10q23.1,86024250,86114404,90154,-,-
BAC180_L06,10,10q23.1,86029594,86131653,102059,-,-
BAC220_D17,10,10q23.1,86082647,86177815,95168,-,-
BAC46_F13,10,10q23.1,86174799,86263867,89068,-,-
BAC196_D11,10,10q23.1,86177810,86263867,86057,-,-
BAC61_G24,10,10q23.1,86177810,86263867,86057,-,-
BAC215_J08,10,10q23.1,86240388,86345712,105324,-,-
BAC150_M09,10,10q23.1,86260956,86345077,84121,-,-
BAC233_G23,10,10q23.1,86354131,86459977,105846,-,-
BAC145_E14,10,10q23.1,86440545,86598984,158439,-,-
BAC226_J15,10,10q23.1,86470352,86574980,104628,-,-
BAC227_I06,10,10q23.1,86487375,86565254,77879,-,-
BAC167_A16,10,10q23.1,86502086,86575480,73394,-,-
BAC150_E16,10,10q23.1,86772554,86855054,82500,-,-
BAC43_P22,10,10q23.1,86822192,86918972,96780,-,-
BAC199_M10,10,10q23.1,86828521,86905782,77261,-,-
BAC220_E10,10,10q23.1,86855284,86983848,128564,-,-
BAC156_H13,10,10q23.1,86857442,86952399,94957,-,-
BAC80_L12,10,10q23.1,86918079,87041538,123459,-,-
BAC200_O17,10,10q23.1,87098567,87168376,69809,-,-
BAC193_G10,10,10q23.1,87227606,87309603,81997,-,-
BAC90_O17,10,10q23.1,87283647,87397696,114049,-,-
BAC64_K18,10,10q23.1,87283652,87373152,89500,-,-
BAC62_A21,10,10q23.1,87285084,87373153,88069,-,-
BAC230_H07,10,10q23.1,87528482,87611296,82814,-,-
BAC122_G06,10,10q23.1,87614409,87810128,195719,-,-
BAC167_G21,10,10q23.1,87651753,87738130,86377,-,-
BAC226_G09,10,10q23.1,87744886,87836841,91955,-,-
BAC220_F10,10,10q23.1-10q23.2,87887232,87971934,84702,-,-
BAC37_J23,10,10q23.1-10q23.2,87887232,87996485,109253,-,-
BAC119_B14,10,10q23.2,87906872,88042051,135179,-,-
BAC236_D22,10,10q23.2,87927608,87996465,68857,-,-
BAC162_K18,10,10q23.2,87936282,88042051,105769,-,-
BAC91_L07,10,10q23.2,88135360,88247956,112596,-,-
BAC227_C04,10,10q23.2,88152058,88222584,70526,-,-
BAC63_O21,10,10q23.2,88176877,88254895,78018,-,-
BAC230_D17,10,10q23.2,88257470,88333990,76520,-,-
BAC230_N21,10,10q23.2,88273970,88358864,84894,-,-
BAC246_F19,10,10q23.2,88296093,88376417,80324,-,-
BAC100_E23,10,10q23.2,88338398,88443185,104787,-,-
BAC172_L11,10,10q23.2,88361208,88458558,97350,-,-
BAC40_G13,10,10q23.2,88450574,88552362,101788,-,-
BAC69_H08,10,10q23.2,88478140,88578452,100312,-,-
BAC96_O22,10,10q23.2,88552381,88652096,99715,-,-
BAC104_M23,10,10q23.2,88552957,88659323,106366,-,-
BAC69_E03,10,10q23.2,88578446,88652350,73904,-,-
BAC158_M11,10,10q23.2,88599341,88704492,105151,-,-
BAC217_M08,10,10q23.2,88601166,88690650,89484,-,-
BAC218_O21,10,10q23.2,88618529,88704200,85671,-,-
BAC37_F20,10,10q23.2,88652344,88758458,106114,yes,-
BAC150_K01,10,10q23.2,88676664,88760794,84130,yes,-
BAC156_J21,10,10q23.2,88721025,88812371,91346,-,-
BAC141_L16,10,10q23.2,88758456,88868598,110142,yes,-
BAC69_D17,10,10q23.2,88847154,88938083,90929,-,-
BAC179_P08,10,10q23.2,88848530,88946988,98458,-,-
BAC136_C20,10,10q23.2,88874962,89107594,232632,-,-
BAC197_M11,10,10q23.2,88972213,89098525,126312,-,-
BAC230_L10,10,10q23.2,89145558,89234365,88807,-,-
BAC161_H16,10,10q23.2,89216642,89291434,74792,-,-
BAC1_E08,10,10q23.2,89252724,89351869,99145,yes,-
BAC243_H21,10,10q23.2,89329101,89425469,96368,-,-
BAC22_M09,10,10q23.2,89411710,89561120,149410,-,-
BAC113_J16,10,10q23.2,89412132,89535690,123558,-,-
BAC198_G13,10,10q23.2,89480041,89589052,109011,-,-
BAC57_J22,10,10q23.2,89507114,89590787,83673,-,-
BAC175_I02,10,10q23.31,89746206,89836650,90444,-,-
BAC45_I09,10,10q23.31,89764304,89877519,113215,-,-
BAC82_D17,10,10q23.31,89808221,89984530,176309,-,-
BAC168_N19,10,10q23.31,89850843,89987426,136583,-,-
BAC43_N05,10,10q23.31,89874381,90039353,164972,-,-
BAC158_C10,10,10q23.31,89877530,89994800,117270,-,-
BAC135_N04,10,10q23.31,89911468,89987426,75958,-,-
BAC227_O23,10,10q23.31,89979179,90075725,96546,-,-
BAC103_F18,10,10q23.31,90075717,90167506,91789,-,-
BAC26_F03,10,10q23.31,90355396,90477366,121970,-,-
BAC36_A10,10,10q23.31,90388415,90475313,86898,-,-
BAC224_H08,10,10q23.31,90498437,90609372,110935,-,-
BAC145_F01,10,10q23.31,90508380,90588351,79971,-,-
BAC180_A19,10,10q23.31,90544391,90655253,110862,-,-
BAC235_G15,10,10q23.31,90560325,90645363,85038,-,-
BAC160_O11,10,10q23.31,90577696,90650629,72933,-,-
BAC158_E11,10,10q23.31,90650639,90740707,90068,-,-
BAC45_N02,10,10q23.31,90714666,90854179,139513,-,-
BAC226_J18,10,10q23.31,90816960,90885065,68105,-,-
BAC132_P10,10,10q23.31,90846666,90934897,88231,-,-
BAC123_D09,10,10q23.31,90868991,90953407,84416,-,-
BAC139_B18,10,10q23.31,91089976,91195115,105139,-,-
BAC45_B16,10,10q23.31,91099246,91217334,118088,-,-
BAC12_A07,10,10q23.31,91099288,91217375,118087,-,-
BAC120_E20,10,10q23.31,91131162,91212921,81759,-,-
BAC108_L07,10,10q23.31,91131162,91229080,97918,-,-
BAC103_J13,10,10q23.31,91152391,91318137,165746,-,-
BAC66_P07,10,10q23.31,91186762,91281539,94777,-,-
BAC114_A17,10,10q23.31,91252294,91342160,89866,-,-
BAC188_G02,10,10q23.31,91394090,91496633,102543,-,-
BAC89_B12,10,10q23.31,91397508,91491062,93554,-,-
BAC8_P13,10,10q23.31,91429193,91515502,86309,-,-
BAC167_B22,10,10q23.31,91580389,91688718,108329,-,-
BAC35_E01,10,10q23.31,91608887,91696671,87784,-,-
BAC73_J10,10,10q23.31,91692740,91788378,95638,-,-
BAC161_M20,10,10q23.31,91880881,91966278,85397,-,-
BAC220_J15,10,10q23.31,92027271,92129912,102641,-,-
BAC224_O17,10,10q23.31,92120350,92203183,82833,-,-
BAC204_M10,10,10q23.31,92355305,92438931,83626,-,-
BAC143_A24,10,10q23.31,92490750,92596826,106076,-,-
BAC53_B23,10,10q23.31,92526308,92639886,113578,-,-
BAC72_H17,10,10q23.31,92534646,92622948,88302,-,-
BAC68_M22,10,10q23.31,92642695,92748754,106059,-,-
BAC175_L11,10,10q23.31,92712075,92789903,77828,-,-
BAC240_H16,10,10q23.31-10q23.32,92865742,92959182,93440,-,-
BAC184_N01,10,10q23.32,92920732,93036587,115855,-,-
BAC80_B17,10,10q23.32,92962586,93032527,69941,-,-
BAC56_A08,10,10q23.32,93056882,93169980,113098,-,-
BAC222_O02,10,10q23.32,93269137,93352570,83433,-,-
BAC90_M05,10,10q23.32,93270671,93385961,115290,-,-
BAC57_J14,10,10q23.32,93287243,93417324,130081,-,-
BAC247_D20,10,10q23.32,93298285,93374032,75747,-,-
BAC57_M17,10,10q23.32,93440477,93465615,25138,-,-
BAC241_H06,10,10q23.32,93442854,93526391,83537,-,-
BAC66_L08,10,10q23.32,93461219,93579493,118274,-,-
BAC139_D13,10,10q23.32,93614519,93671257,56738,-,-
BAC33_J19,10,10q23.32,93617936,93723971,106035,-,-
BAC115_B17,10,10q23.32,93617938,93696534,78596,-,-
BAC116_N19,10,10q23.32,93624833,93709915,85082,-,-
BAC22_A12,10,10q23.32,93665257,93679716,14459,-,-
BAC50_N17,10,10q23.32,93667161,93765725,98564,-,-
BAC147_I11,10,10q23.32,93668418,93744589,76171,-,-
BAC64_H18,10,10q23.32,93724255,93804970,80715,-,-
BAC154_K09,10,10q23.32,93738806,93825514,86708,-,-
BAC208_O11,10,10q23.32,93739081,93862430,123349,-,-
BAC40_P21,10,10q23.32,93786354,93867451,81097,-,-
BAC187_M19,10,10q23.32,93819816,93903953,84137,-,-
BAC125_E19,10,10q23.32,93850405,93950282,99877,-,-
BAC161_A10,10,10q23.32,93853530,93971229,117699,-,-
BAC90_E11,10,10q23.32,93878153,93971897,93744,-,-
BAC228_M04,10,10q23.32,93900803,93985483,84680,-,-
BAC107_O18,10,10q23.32,93903948,94007311,103363,-,-
BAC150_D01,10,10q23.32,93908363,94016338,107975,-,-
BAC244_D18,10,10q23.32,93908366,94016336,107970,-,-
BAC142_J19,10,10q23.32,93919653,93987945,68292,-,-
BAC72_H15,10,10q23.32,93919654,94003966,84312,-,-
BAC234_A07,10,10q23.32,93926045,94005464,79419,-,-
BAC169_C19,10,10q23.32,93938688,94053089,114401,-,-
BAC25_G11,10,10q23.32,93985477,94053088,67611,-,-
BAC86_C07,10,10q23.32,94006488,94131063,124575,-,-
BAC115_C22,10,10q23.32,94016406,94032983,16577,-,-
BAC184_L04,10,10q23.32,94043951,94131063,87112,-,-
BAC62_D16,10,10q23.32,94084725,94171659,86934,-,-
BAC70_H05,10,10q23.32,94085510,94193677,108167,-,-
BAC169_C09,10,10q23.32-10q23.33,94120474,94215141,94667,-,-
BAC13_D22,10,10q23.33,94224592,94313878,89286,-,-
BAC83_P08,10,10q23.33,94250581,94357266,106685,-,-
BAC71_K11,10,10q23.33,94256346,94391067,134721,-,-
BAC20_O23,10,10q23.33,94322470,94405682,83212,-,-
BAC33_O24,10,10q23.33,94348099,94430823,82724,-,-
BAC175_O15,10,10q23.33,94354141,94447973,93832,-,-
BAC71_A10,10,10q23.33,94430954,94570011,139057,-,-
BAC166_G06,10,10q23.33,94478283,94587400,109117,-,-
BAC241_H08,10,10q23.33,94494571,94588086,93515,-,-
BAC76_J11,10,10q23.33,94537749,94641944,104195,-,-
BAC52_B16,10,10q23.33,94599835,94685801,85966,-,-
BAC123_N21,10,10q23.33,94817172,94927562,110390,-,-
BAC153_C05,10,10q23.33,94866904,94947470,80566,-,-
BAC56_F06,10,10q23.33,94866904,94978489,111585,-,-
BAC219_E23,10,10q23.33,94872273,94964566,92293,-,-
BAC123_B01,10,10q23.33,94872274,94964566,92292,-,-
BAC102_B23,10,10q23.33,94872274,94982280,110006,-,-
BAC96_D12,10,10q23.33,94887380,94964566,77186,-,-
BAC155_K03,10,10q23.33,94887390,94976468,89078,-,-
BAC12_O17,10,10q23.33,94949397,95074898,125501,-,-
BAC249_J09,10,10q23.33,95036627,95133000,96373,-,-
BAC73_I21,10,10q23.33,95109121,95326307,217186,-,-
BAC143_G09,10,10q23.33,95133187,95208805,75618,-,-
BAC228_B11,10,10q23.33,95135631,95236139,100508,-,-
BAC215_N21,10,10q23.33,95382907,95475457,92550,-,-
BAC243_H23,10,10q23.33,95430864,95523940,93076,-,-
BAC20_O08,10,10q23.33,95486027,95522470,36443,-,-
BAC45_J13,10,10q23.33,95518133,95619477,101344,-,-
BAC143_I08,10,10q23.33,95526534,95610528,83994,-,-
BAC163_K08,10,10q23.33,95596362,95704360,107998,-,-
BAC78_H16,10,10q23.33,95667946,95752701,84755,-,-
BAC133_J23,10,10q23.33,95756011,95895533,139522,-,-
BAC82_P09,10,10q23.33,95762103,95890124,128021,-,-
BAC141_H12,10,10q23.33,95766863,95890124,123261,-,-
BAC38_C09,10,10q23.33,95777286,95904138,126852,-,-
BAC89_K15,10,10q23.33,95983058,96078365,95307,-,-
BAC230_D19,10,10q23.33,96067262,96141738,74476,-,-
BAC127_I08,10,10q23.33,96219786,96334846,115060,-,-
BAC240_F16,10,10q23.33,96228063,96317355,89292,-,-
BAC82_G03,10,10q23.33,96238696,96354485,115789,-,-
BAC158_E14,10,10q23.33,96238699,96333855,95156,-,-
BAC171_E23,10,10q23.33,96243323,96334846,91523,-,-
BAC244_P06,10,10q23.33,96299685,96401309,101624,-,-
BAC40_C24,10,10q23.33,96299685,96396677,96992,-,-
BAC132_I14,10,10q23.33,96335166,96452564,117398,-,-
BAC84_B17,10,10q23.33,96374931,96465303,90372,-,-
BAC200_I10,10,10q23.33,96440560,96521121,80561,-,-
BAC134_O13,10,10q23.33,96445270,96559933,114663,-,-
BAC150_O24,10,10q23.33,96460453,96590847,130394,-,-
BAC110_P04,10,10q23.33,96559999,96659251,99252,-,-
BAC151_G23,10,10q23.33,96627892,96709867,81975,-,-
BAC194_K20,10,10q23.33,96642090,96735505,93415,-,-
BAC129_H10,10,10q23.33,96660181,96769578,109397,-,-
BAC117_B01,10,10q23.33,96674601,96889431,214830,-,-
BAC189_P03,10,10q23.33,96775839,96898139,122300,-,-
BAC141_P02,10,10q23.33,96898364,96984622,86258,-,-
BAC139_P05,10,10q23.33,96952807,97066908,114101,-,-
BAC226_M06,10,10q23.33,96987159,97081788,94629,-,-
BAC27_L19,10,10q23.33,97013060,97207484,194424,-,-
BAC242_F04,10,10q23.33,97101264,97207484,106220,-,-
BAC46_L02,10,10q23.33,97342815,97466556,123741,-,-
BAC132_K22,10,10q23.33,97378199,97583212,205013,-,-
BAC43_E10,10,10q23.33,97446987,97534557,87570,-,-
BAC55_B03,10,10q23.33,97843525,97864819,21294,-,-
BAC56_H15,10,10q23.33-10q24.1,97914368,98045041,130673,-,-
BAC107_E03,10,10q23.33-10q24.1,97932441,98019608,87167,-,-
BAC49_D22,10,10q24.1,98019699,98216639,196940,-,-
BAC221_E05,10,10q24.1,98136286,98248099,111813,-,-
BAC36_K23,10,10q24.1,98251322,98386565,135243,-,-
BAC127_G24,10,10q24.1,98298846,98404181,105335,-,-
BAC179_J12,10,10q24.1,98298853,98404181,105328,-,-
BAC149_P15,10,10q24.1,98317143,98404181,87038,-,-
BAC146_B16,10,10q24.1,98341278,98456233,114955,-,-
BAC69_B14,10,10q24.1,98445117,98592360,147243,-,-
BAC95_K13,10,10q24.1,98485328,98634342,149014,-,-
BAC232_B05,10,10q24.1,98528859,98627745,98886,-,-
BAC167_I21,10,10q24.1,98554273,98629178,74905,-,-
BAC75_N10,10,10q24.1,98708675,98861873,153198,-,-
BAC84_A21,10,10q24.1,98723431,98826514,103083,-,-
BAC101_H24,10,10q24.1,98731241,98812424,81183,-,-
BAC97_P08,10,10q24.1,98734960,98826514,91554,-,-
BAC199_L09,10,10q24.1,98822244,98909759,87515,-,-
BAC1_F13,10,10q24.1,98870707,98954628,83921,-,-
BAC239_H01,10,10q24.1,98886290,98977582,91292,-,-
BAC238_L11,10,10q24.1,98887352,99031898,144546,-,-
BAC84_F18,10,10q24.1,98977589,99090135,112546,-,-
BAC43_G16,10,10q24.1,99008742,99127591,118849,-,-
BAC218_C13,10,10q24.1,99014215,99116511,102296,-,-
BAC121_L05,10,10q24.1,99090475,99207597,117122,-,-
BAC106_B16,10,10q24.1,99105413,99203092,97679,-,-
BAC203_L16,10,10q24.1,99144692,99273150,128458,-,-
BAC148_D20,10,10q24.1,99186388,99284197,97809,-,-
BAC159_B06,10,10q24.1,99207845,99301117,93272,-,-
BAC109_P01,10,10q24.1-10q24.2,99342064,99462873,120809,-,-
BAC2_A15,10,10q24.1-10q24.2,99345977,99437805,91828,-,-
BAC114_H13,10,10q24.2,99404333,99510638,106305,-,-
BAC167_O07,10,10q24.2,99415820,99510572,94752,-,-
BAC97_I02,10,10q24.2,99437112,99536032,98920,-,-
BAC14_A07,10,10q24.2,99466345,99562972,96627,-,-
BAC130_A24,10,10q24.2,99618094,99690347,72253,-,-
BAC35_F21,10,10q24.2,99709072,99841371,132299,-,-
BAC169_O18,10,10q24.2,99714357,99820005,105648,-,-
BAC202_O17,10,10q24.2,99721090,99802420,81330,-,-
BAC42_H15,10,10q24.2,99728296,99836608,108312,-,-
BAC228_G24,10,10q24.2,99728320,99817474,89154,-,-
BAC160_D02,10,10q24.2,99729616,99820006,90390,-,-
BAC221_A13,10,10q24.2,99729759,99817424,87665,-,-
BAC143_K01,10,10q24.2,99729759,99817474,87715,-,-
BAC31_I09,10,10q24.2,99759396,99854680,95284,-,-
BAC107_F05,10,10q24.2,99830924,99925239,94315,-,-
BAC196_N08,10,10q24.2,99855877,99974994,119117,-,-
BAC158_H17,10,10q24.2,99925251,100040053,114802,-,-
BAC200_H02,10,10q24.2,100055379,100139748,84369,-,-
BAC118_E13,10,10q24.2,100087989,100179217,91228,-,-
BAC81_P11,10,10q24.2,100087997,100192170,104173,-,-
BAC105_F13,10,10q24.2,100093011,100189213,96202,-,-
BAC217_M02,10,10q24.2,100095558,100208158,112600,-,-
BAC114_P22,10,10q24.2,100095570,100203077,107507,-,-
BAC141_F08,10,10q24.2,100101792,100184661,82869,-,-
BAC68_D06,10,10q24.2,100111503,100221839,110336,-,-
BAC126_J07,10,10q24.2,100113378,100223903,110525,-,-
BAC222_M03,10,10q24.2,100187559,100267745,80186,-,-
BAC232_G01,10,10q24.2,100240489,100321588,81099,-,-
BAC86_B04,10,10q24.2,100288460,100388985,100525,-,-
BAC50_K06,10,10q24.2,100316882,100387132,70250,-,-
BAC76_B09,10,10q24.2,100810003,100957508,147505,-,-
BAC49_B08,10,10q24.2,100819882,100925992,106110,-,-
BAC188_N09,10,10q24.2,100871306,100961622,90316,-,-
BAC249_J02,10,10q24.2,100882830,100966958,84128,-,-
BAC68_J06,10,10q24.2,100886309,100965901,79592,-,-
BAC17_L05,10,10q24.2,101040111,101127109,86998,-,-
BAC75_E16,10,10q24.2,101081695,101180458,98763,-,-
BAC152_J01,10,10q24.2,101178815,101259353,80538,-,-
BAC117_B15,10,10q24.2,101180455,101282211,101756,-,-
BAC156_O17,10,10q24.2,101180486,101282222,101736,-,-
BAC44_I17,10,10q24.2,101242432,101410085,167653,-,-
BAC110_K07,10,10q24.2,101392682,101498439,105757,-,-
BAC139_L08,10,10q24.2,101415455,101491628,76173,-,-
BAC55_F22,10,10q24.2,101447708,101463718,16010,-,-
BAC1_K16,10,10q24.2,101659558,101745201,85643,-,-
BAC19_J23,10,10q24.2,101662965,101745201,82236,-,-
BAC162_G20,10,10q24.2,101674468,101795575,121107,-,-
BAC51_C13,10,10q24.2,101717777,101828175,110398,-,-
BAC106_F04,10,10q24.2,101745195,101864008,118813,-,-
BAC55_G13,10,10q24.2,101766270,101880547,114277,-,-
BAC226_N20,10,10q24.2,101795569,101880547,84978,-,-
BAC170_L19,10,10q24.2,101795573,101881905,86332,-,-
BAC78_N15,10,10q24.2,101808860,101898905,90045,-,-
BAC45_K04,10,10q24.2,101837101,101973567,136466,-,-
BAC41_E05,10,10q24.2-10q24.31,101921626,102011363,89737,-,-
BAC65_D01,10,10q24.2-10q24.31,101922954,102043986,121032,-,-
BAC95_H13,10,10q24.2-10q24.31,101980324,102078103,97779,-,-
BAC166_M04,10,10q24.2-10q24.31,101991884,102091003,99119,-,-
BAC150_N23,10,10q24.2-10q24.31,101992440,102078103,85663,-,-
BAC19_B14,10,10q24.2-10q24.31,101992497,102086077,93580,-,-
BAC151_I22,10,10q24.2-10q24.31,101996384,102091003,94619,-,-
BAC56_I15,10,10q24.31,102011362,102097476,86114,-,-
BAC22_G10,10,10q24.31,102097477,102206095,108618,-,-
BAC224_O12,10,10q24.31,102101203,102188458,87255,-,-
BAC175_A07,10,10q24.31,102130051,102232707,102656,-,-
BAC199_B08,10,10q24.31,102145318,102226634,81316,-,-
BAC161_H14,10,10q24.31,102145335,102224003,78668,-,-
BAC119_E21,10,10q24.31,102272738,102368857,96119,-,-
BAC227_I12,10,10q24.31,102294518,102387000,92482,-,-
BAC252_M20,10,10q24.31,102309346,102425981,116635,-,-
BAC170_K22,10,10q24.31,102387040,102479095,92055,-,-
BAC14_I03,10,10q24.31,102412859,102525857,112998,-,-
BAC152_P01,10,10q24.31,102428860,102525627,96767,-,-
BAC95_A21,10,10q24.31,102466198,102577391,111193,-,-
BAC86_I06,10,10q24.31,102566135,102661340,95205,-,-
BAC247_B02,10,10q24.31,102636891,102717559,80668,-,-
BAC46_K02,10,10q24.31,102697573,102851454,153881,-,-
BAC151_H08,10,10q24.31,102780662,102879507,98845,-,-
BAC146_I05,10,10q24.31,102850966,102953556,102590,-,-
BAC177_H13,10,10q24.31-10q24.32,102874603,103047119,172516,-,-
BAC217_E22,10,10q24.31-10q24.32,102899494,103048450,148956,-,-
BAC78_N14,10,10q24.31,102899641,102984170,84529,-,-
BAC234_F19,10,10q24.31,102904807,102984170,79363,-,-
BAC230_M04,10,10q24.31-10q24.32,102935287,103037185,101898,-,-
BAC65_J06,10,10q24.31-10q24.32,102951889,103039705,87816,-,-
BAC102_H21,10,10q24.32,103116285,103240205,123920,-,-
BAC196_E08,10,10q24.32,103121420,103200746,79326,-,-
BAC234_E13,10,10q24.32,103140161,103258047,117886,-,-
BAC5_C03,10,10q24.32,103169205,103273810,104605,-,-
BAC208_L09,10,10q24.32,103312112,103405625,93513,-,-
BAC225_N13,10,10q24.32,103313622,103403866,90244,-,-
BAC205_P19,10,10q24.32,103313638,103407734,94096,-,-
BAC158_E03,10,10q24.32,103313638,103407735,94097,-,-
BAC235_O15,10,10q24.32,103333707,103406961,73254,-,-
BAC155_O18,10,10q24.32,103344207,103439821,95614,-,-
BAC48_D14,10,10q24.32,103421613,103534816,113203,-,-
BAC151_F08,10,10q24.32,103483027,103545553,62526,-,-
BAC37_M24,10,10q24.32,103485532,103568274,82742,-,-
BAC166_N08,10,10q24.32,103547374,103627403,80029,-,-
BAC34_A15,10,10q24.32,103547374,103634500,87126,-,-
BAC226_O03,10,10q24.32,103579798,103646432,66634,-,-
BAC16_C21,10,10q24.32,103636108,103725407,89299,-,-
BAC30_K20,10,10q24.32,103646544,103742573,96029,-,-
BAC96_J23,10,10q24.32,103659235,103746821,87586,-,-
BAC110_P06,10,10q24.32,103659238,103747878,88640,-,-
BAC53_B18,10,10q24.32,103660012,103746821,86809,-,-
BAC97_L01,10,10q24.32,103725413,103841923,116510,-,-
BAC99_E07,10,10q24.32,103725462,103819475,94013,-,-
BAC65_P02,10,10q24.32,103746814,103833202,86388,-,-
BAC148_G22,10,10q24.32,103764174,103888159,123985,-,-
BAC210_M04,10,10q24.32,103793376,103888602,95226,-,-
BAC117_J24,10,10q24.32,103833197,103949367,116170,-,-
BAC78_J23,10,10q24.32,103841917,103949367,107450,-,-
BAC125_J10,10,10q24.32,103845178,103941641,96463,-,-
BAC95_O07,10,10q24.32,103850148,103949367,99219,-,-
BAC46_B02,10,10q24.32,103872659,103977523,104864,-,-
BAC161_H23,10,10q24.32,103927718,104016685,88967,-,-
BAC92_K21,10,10q24.32,104100273,104216757,116484,-,-
BAC188_E20,10,10q24.32,104101480,104191870,90390,-,-
BAC250_K07,10,10q24.32,104105383,104212588,107205,-,-
BAC69_O21,10,10q24.32,104108570,104213727,105157,-,-
BAC223_J03,10,10q24.32,104120335,104229751,109416,-,-
BAC190_J15,10,10q24.32,104232642,104314036,81394,-,-
BAC234_J22,10,10q24.32,104255997,104381924,125927,-,-
BAC32_H04,10,10q24.32,104314031,104429332,115301,-,-
BAC183_N18,10,10q24.32,104328730,104429003,100273,-,-
BAC68_A18,10,10q24.32,104352204,104435355,83151,-,-
BAC76_A07,10,10q24.32,104451295,104561794,110499,-,-
BAC76_G02,10,10q24.32,104542677,104644926,102249,-,-
BAC233_I04,10,10q24.32,104552192,104650164,97972,-,-
BAC244_H22,10,10q24.32,104565417,104660647,95230,-,-
BAC123_C03,10,10q24.32,104565417,104637955,72538,-,-
BAC97_J06,10,10q24.32,104646103,104757889,111786,-,-
BAC247_J03,10,10q24.32,104660992,104777146,116154,-,-
BAC55_H18,10,10q24.32,104660992,104766725,105733,-,-
BAC59_A01,10,10q24.32-10q24.33,104845925,105005866,159941,-,-
BAC199_H07,10,10q24.32-10q24.33,104855646,104938842,83196,-,-
BAC153_F02,10,10q24.33,104904772,104988364,83592,-,-
BAC97_N02,10,10q24.33,104976816,105065191,88375,-,-
BAC135_I15,10,10q24.33,105011531,105135330,123799,-,-
BAC225_E09,10,10q24.33,105062387,105147713,85326,-,-
BAC42_G06,10,10q24.33,105081827,105174221,92394,-,-
BAC78_D21,10,10q24.33,105147707,105259973,112266,-,-
BAC110_F10,10,10q24.33,105156945,105272944,115999,-,-
BAC59_N09,10,10q24.33,105205998,105282942,76944,-,-
BAC236_D12,10,10q24.33,105261422,105374367,112945,-,-
BAC82_L22,10,10q24.33,105283134,105392401,109267,-,-
BAC61_G14,10,10q24.33,105283134,105435936,152802,-,-
BAC32_L13,10,10q24.33,105283134,105360572,77438,-,-
BAC152_K02,10,10q24.33,105435952,105531609,95657,-,-
BAC145_E13,10,10q24.33,105539921,105632021,92100,-,-
BAC79_A21,10,10q24.33-10q25.1,105572386,105708186,135800,-,-
BAC122_E16,10,10q24.33-10q25.1,105587267,105707227,119960,-,-
BAC122_A19,10,10q25.1,105766143,105865084,98941,-,-
BAC157_E21,10,10q25.1,105771494,105873767,102273,-,-
BAC41_D22,10,10q25.1,105847275,106018848,171573,-,-
BAC162_E06,10,10q25.1,105869847,105969508,99661,-,-
BAC27_G21,10,10q25.1,105906294,106003060,96766,-,-
BAC146_O15,10,10q25.1,105932675,106048573,115898,-,-
BAC76_J23,10,10q25.1,105932675,106023473,90798,-,-
BAC84_K17,10,10q25.1,105975966,106060956,84990,-,-
BAC242_E06,10,10q25.1,105982295,106051063,68768,-,-
BAC153_O11,10,10q25.1,106008156,106117121,108965,-,-
BAC97_B08,10,10q25.1,106048611,106141652,93041,-,-
BAC81_J20,10,10q25.1,106176450,106267922,91472,-,-
BAC217_L10,10,10q25.1,106214053,106300349,86296,-,-
BAC140_B02,10,10q25.1,106223721,106311022,87301,-,-
BAC238_P16,10,10q25.1,106264472,106345032,80560,-,-
BAC102_P16,10,10q25.1,106292738,106462163,169425,-,-
BAC150_D11,10,10q25.1,106361663,106483705,122042,-,-
BAC74_C22,10,10q25.1,106370951,106501286,130335,-,-
BAC205_N06,10,10q25.1,106371070,106441487,70417,-,-
BAC119_L10,10,10q25.1,106387917,106577695,189778,-,-
BAC66_A06,10,10q25.1,106391449,106485200,93751,-,-
BAC124_C12,10,10q25.1,106444497,106544603,100106,-,-
BAC69_O07,10,10q25.1,106501343,106590406,89063,-,-
BAC150_J11,10,10q25.1,106501344,106577678,76334,-,-
BAC247_L20,10,10q25.1,106622761,106718436,95675,-,-
BAC97_N12,10,10q25.1,106700598,106819186,118588,-,-
BAC107_C04,10,10q25.1,106735784,106849301,113517,-,-
BAC25_J05,10,10q25.1,106764251,106886518,122267,-,-
BAC73_E20,10,10q25.1,106771638,106870631,98993,-,-
BAC186_M17,10,10q25.1,106779480,106851357,71877,-,-
BAC76_E12,10,10q25.1,106779576,106878533,98957,-,-
BAC228_C16,10,10q25.1,106779615,106877146,97531,-,-
BAC117_I05,10,10q25.1,106803468,106912929,109461,-,-
BAC179_J16,10,10q25.1,106878527,106945314,66787,-,-
BAC103_O20,10,10q25.1,107038335,107121660,83325,-,-
BAC172_A05,10,10q25.1,107215731,107294992,79261,-,-
BAC22_I18,10,10q25.1,107275212,107401135,125923,-,-
BAC111_J14,10,10q25.1,107343848,107458836,114988,-,-
BAC238_B24,10,10q25.1,107377474,107452915,75441,-,-
BAC243_N22,10,10q25.1,107520211,107643985,123774,-,-
BAC75_P20,10,10q25.1,107550228,107655517,105289,-,-
BAC230_B06,10,10q25.1,107599870,107682180,82310,-,-
BAC185_I02,10,10q25.1,107982170,108089739,107569,-,-
BAC227_C10,10,10q25.1,108213496,108338608,125112,-,-
BAC145_H05,10,10q25.1,108241430,108338608,97178,-,-
BAC82_I09,10,10q25.1,108409336,108506519,97183,-,-
BAC183_J07,10,10q25.1,108506513,108582745,76232,-,-
BAC132_D24,10,10q25.1,108526968,108619278,92310,-,-
BAC119_C19,10,10q25.1,108530257,108619278,89021,-,-
BAC181_B10,10,10q25.1,108532989,108632129,99140,-,-
BAC167_K01,10,10q25.1,108535441,108619278,83837,-,-
BAC233_C15,10,10q25.1,108536445,108643669,107224,-,-
BAC67_C11,10,10q25.1,108554456,108669843,115387,-,-
BAC227_J21,10,10q25.1,108631727,108724280,92553,-,-
BAC37_L14,10,10q25.1,108631812,108730905,99093,-,-
BAC163_O09,10,10q25.1,108638941,108730695,91754,-,-
BAC181_J07,10,10q25.1,108752173,108834653,82480,-,-
BAC18_F12,10,10q25.1,108859483,108958033,98550,-,-
BAC39_D08,10,10q25.1,108943072,109065072,122000,-,-
BAC165_C12,10,10q25.1,109000830,109091983,91153,-,-
BAC162_J02,10,10q25.1,109015996,109118433,102437,-,-
BAC24_L19,10,10q25.1,109055498,109164001,108503,-,-
BAC210_J17,10,10q25.1,109406425,109493598,87173,-,-
BAC61_F07,10,10q25.1,109709671,109815284,105613,-,-
BAC170_H12,10,10q25.1,109721798,109809857,88059,-,-
BAC233_M06,10,10q25.1,109811520,109895829,84309,-,-
BAC188_K12,10,10q25.1,109947972,110047037,99065,-,-
BAC182_M20,10,10q25.1,110158246,110261771,103525,-,-
BAC48_H13,10,10q25.1,110345091,110426547,81456,-,-
BAC1_H20,10,10q25.1,110402187,110521429,119242,-,-
BAC27_J19,10,10q25.1,110450832,110540629,89797,-,-
BAC130_H15,10,10q25.1,110678042,110777814,99772,-,-
BAC52_E12,10,10q25.1,110698261,110793050,94789,-,-
BAC39_O23,10,10q25.1,110725938,110834876,108938,-,-
BAC95_O05,10,10q25.1,111061846,111150865,89019,-,-
BAC52_C16,10,10q25.1,111137757,111172695,34938,-,-
BAC53_I08,10,10q25.1,111150859,111230832,79973,-,-
BAC102_E17,10,10q25.1,111405893,111499277,93384,-,-
BAC242_G11,10,10q25.1,111424432,111532033,107601,-,-
BAC136_A07,10,10q25.1,111433682,111549540,115858,-,-
BAC194_D21,10,10q25.1,111444002,111517798,73796,-,-
BAC71_M11,10,10q25.1,111447967,111533872,85905,-,-
BAC139_L09,10,10q25.1,111453527,111540398,86871,-,-
BAC96_M23,10,10q25.1,111490984,111590261,99277,-,-
BAC155_M23,10,10q25.1,111572234,111656492,84258,-,-
BAC75_A15,10,10q25.1,111600528,111700063,99535,-,-
BAC204_O16,10,10q25.1,111647077,111746378,99301,-,-
BAC198_C07,10,10q25.1,111661294,111732242,70948,-,-
BAC21_F05,10,10q25.1-10q25.2,111726523,111913978,187455,-,-
BAC175_N02,10,10q25.2,111826940,111915441,88501,-,-
BAC214_N04,10,10q25.2,111854440,111913978,59538,-,-
BAC143_M04,10,10q25.2,111913972,112004275,90303,-,-
BAC62_C09,10,10q25.2,111977264,112096641,119377,-,-
BAC137_J14,10,10q25.2,111979398,112075986,96588,-,-
BAC244_N09,10,10q25.2,112099241,112222194,122953,-,-
BAC90_C24,10,10q25.2,112100343,112222194,121851,-,-
BAC191_G14,10,10q25.2,112101857,112180474,78617,-,-
BAC120_F21,10,10q25.2,112131068,112222194,91126,-,-
BAC179_M16,10,10q25.2,112153895,112259508,105613,-,-
BAC82_O14,10,10q25.2,112164420,112261675,97255,-,-
BAC244_L13,10,10q25.2,112238512,112315762,77250,-,-
BAC109_I14,10,10q25.2,112296730,112412462,115732,-,-
BAC161_D10,10,10q25.2,112347698,112480294,132596,-,-
BAC185_K17,10,10q25.2,112347699,112431058,83359,-,-
BAC150_D22,10,10q25.2,112349426,112455828,106402,-,-
BAC53_A10,10,10q25.2,112373072,112469986,96914,-,-
BAC78_C04,10,10q25.2,112444164,112529734,85570,-,-
BAC120_P07,10,10q25.2,112626845,112704518,77673,-,-
BAC60_C03,10,10q25.2,112673255,112796666,123411,-,-
BAC199_K08,10,10q25.2,112740528,112852627,112099,-,-
BAC172_J10,10,10q25.2,112866274,112969191,102917,-,-
BAC181_E08,10,10q25.2,112892838,112976812,83974,-,-
BAC232_L21,10,10q25.2,112892847,112969191,76344,-,-
BAC235_H20,10,10q25.2,113017988,113099918,81930,-,-
BAC150_G06,10,10q25.2,113130381,113221372,90991,-,-
BAC162_G19,10,10q25.2,113160421,113247971,87550,-,-
BAC91_E09,10,10q25.2,113183895,113291303,107408,-,-
BAC39_I23,10,10q25.2,113231304,113375411,144107,-,-
BAC120_E17,10,10q25.2,113239191,113337324,98133,-,-
BAC82_E10,10,10q25.2,113449110,113535671,86561,-,-
BAC145_P16,10,10q25.2,113519150,113633948,114798,-,-
BAC155_L12,10,10q25.2,113641954,113735243,93289,-,-
BAC123_L10,10,10q25.2,113712634,113834367,121733,-,-
BAC170_B17,10,10q25.2,113735453,113812632,77179,-,-
BAC206_C20,10,10q25.2,113735725,113831252,95527,-,-
BAC62_J20,10,10q25.2,113839309,113938998,99689,-,-
BAC70_N10,10,10q25.2,114041441,114155011,113570,-,-
BAC127_F15,10,10q25.2,114058281,114212546,154265,yes,-
BAC81_O02,10,10q25.2,114062754,114180751,117997,yes,-
BAC36_A04,10,10q25.2,114171348,114327130,155782,-,-
BAC73_E08,10,10q25.2,114209629,114300006,90377,-,-
BAC37_A13,10,10q25.2,114212692,114361294,148602,-,-
BAC92_G23,10,10q25.2,114306064,114435294,129230,-,-
BAC77_O02,10,10q25.2,114335433,114435672,100239,-,-
BAC144_A14,10,10q25.2,114389252,114453688,64436,-,-
BAC204_C23,10,10q25.2,114391075,114493510,102435,-,-
BAC44_B01,10,10q25.2,114391079,114499682,108603,-,-
BAC148_B21,10,10q25.2,114444395,114499787,55392,-,-
BAC165_E19,10,10q25.2,114465232,114562421,97189,-,-
BAC146_P15,10,10q25.2,114526812,114631899,105087,-,-
BAC165_J04,10,10q25.2,114556827,114631899,75072,-,-
BAC29_H17,10,10q25.2,114687612,114785318,97706,-,-
BAC66_E01,10,10q25.2,114759873,114882731,122858,-,-
BAC144_E19,10,10q25.2,114771881,114884798,112917,-,-
BAC80_N09,10,10q25.2,114771881,114874305,102424,-,-
BAC41_C18,10,10q25.2-10q25.3,114802463,114904688,102225,-,-
BAC20_H15,10,10q25.2-10q25.3,114827905,114938044,110139,-,-
BAC124_N11,10,10q25.2-10q25.3,114828169,114996883,168714,-,-
BAC22_M08,10,10q25.3,114906227,114990410,84183,-,-
BAC197_B01,10,10q25.3,115057134,115163912,106778,-,-
BAC115_B19,10,10q25.3,115068372,115194547,126175,-,-
BAC232_F14,10,10q25.3,115094699,115189491,94792,-,-
BAC230_M09,10,10q25.3,115141956,115228089,86133,-,-
BAC247_I15,10,10q25.3,115141957,115234412,92455,-,-
BAC223_K21,10,10q25.3,115171070,115263162,92092,-,-
BAC181_L02,10,10q25.3,115212108,115305750,93642,-,-
BAC154_C10,10,10q25.3,115237611,115312180,74569,-,-
BAC189_N05,10,10q25.3,115252407,115358906,106499,-,-
BAC244_A07,10,10q25.3,115280444,115363550,83106,-,-
BAC46_A16,10,10q25.3,115309290,115415533,106243,-,-
BAC122_I21,10,10q25.3,115346398,115424945,78547,-,-
BAC161_P06,10,10q25.3,115366335,115462912,96577,-,-
BAC45_L14,10,10q25.3,115370722,115479807,109085,-,-
BAC252_A03,10,10q25.3,115417324,115532453,115129,-,-
BAC248_O05,10,10q25.3,115418009,115522901,104892,-,-
BAC95_E05,10,10q25.3,115436552,115522901,86349,-,-
BAC161_L09,10,10q25.3,115447115,115530300,83185,-,-
BAC65_D02,10,10q25.3,115462977,115578925,115948,-,-
BAC127_P04,10,10q25.3,115502032,115599605,97573,-,-
BAC46_H19,10,10q25.3,115523870,115704285,180415,-,-
BAC34_L18,10,10q25.3,115529368,115654802,125434,-,-
BAC67_K08,10,10q25.3,115576462,115681188,104726,-,-
BAC21_P04,10,10q25.3,115599677,115754705,155028,-,-
BAC103_D12,10,10q25.3,115609925,115744308,134383,-,-
BAC51_M13,10,10q25.3,115654796,115745144,90348,-,-
BAC86_P08,10,10q25.3,115682464,115788105,105641,-,-
BAC186_N19,10,10q25.3,115710657,115783060,72403,-,-
BAC116_H17,10,10q25.3,115772904,115871617,98713,-,-
BAC126_I19,10,10q25.3,115811898,115899081,87183,-,-
BAC115_H24,10,10q25.3,115928643,116026422,97779,-,-
BAC140_M14,10,10q25.3,115956797,116049156,92359,-,-
BAC151_G22,10,10q25.3,115960829,116049161,88332,-,-
BAC150_D05,10,10q25.3,115970806,116104019,133213,-,-
BAC24_J22,10,10q25.3,115991325,116091704,100379,-,-
BAC236_M22,10,10q25.3,115994390,116113299,118909,-,-
BAC67_M21,10,10q25.3,116011676,116106582,94906,-,-
BAC129_F24,10,10q25.3,116049153,116144358,95205,-,-
BAC123_N09,10,10q25.3,116054470,116174242,119772,-,-
BAC131_B20,10,10q25.3,116191923,116291047,99124,-,-
BAC190_A12,10,10q25.3,116202879,116321529,118650,-,-
BAC90_I13,10,10q25.3,116365144,116461187,96043,-,-
BAC151_G02,10,10q25.3,116426493,116510153,83660,-,-
BAC182_I21,10,10q25.3,116521815,116621191,99376,-,-
BAC121_J09,10,10q25.3,116594148,116693636,99488,-,-
BAC169_E10,10,10q25.3,116630612,116693275,62663,-,-
BAC115_G21,10,10q25.3,116717848,116812921,95073,-,-
BAC117_D05,10,10q25.3,116747116,116879189,132073,-,-
BAC124_F15,10,10q25.3,116755472,116873968,118496,-,-
BAC166_F01,10,10q25.3,116805537,116890241,84704,-,-
BAC49_B04,10,10q25.3,116838496,116993931,155435,-,-
BAC236_I13,10,10q25.3,116905256,117008453,103197,-,-
BAC172_A23,10,10q25.3,117202313,117285776,83463,-,-
BAC180_B04,10,10q25.3,117245934,117358380,112446,-,-
BAC60_A23,10,10q25.3,117327343,117422602,95259,-,-
BAC76_C24,10,10q25.3,117433068,117575339,142271,-,-
BAC86_L08,10,10q25.3,117442328,117527808,85480,-,-
BAC247_N15,10,10q25.3,117470894,117562359,91465,-,-
BAC165_H14,10,10q25.3,117521631,117609691,88060,-,-
BAC23_K19,10,10q25.3,117546715,117691745,145030,-,-
BAC165_N05,10,10q25.3,117688985,117758166,69181,-,-
BAC37_M19,10,10q25.3,117702898,117792131,89233,-,-
BAC68_L11,10,10q25.3,117765550,117860945,95395,-,-
BAC162_K10,10,10q25.3,117765765,117850748,84983,-,-
BAC240_J01,10,10q25.3,117778470,117907122,128652,-,-
BAC252_B16,10,10q25.3,117832638,117941076,108438,-,-
BAC113_D17,10,10q25.3,117864081,117969354,105273,-,-
BAC191_L12,10,10q25.3,117931218,118017439,86221,-,-
BAC194_K03,10,10q25.3,118000250,118079707,79457,-,-
BAC148_B22,10,10q25.3,118079701,118174747,95046,-,-
BAC102_P06,10,10q25.3,118195308,118295398,100090,-,-
BAC231_C09,10,10q25.3,118230529,118336943,106414,-,-
BAC181_P24,10,10q25.3,118247459,118326580,79121,-,-
BAC31_P04,10,10q25.3,118268291,118353813,85522,-,-
BAC250_P05,10,10q25.3,118347003,118408439,61436,-,-
BAC82_P15,10,10q25.3,118347003,118437391,90388,-,-
BAC193_A01,10,10q25.3,118361719,118465360,103641,-,-
BAC97_J21,10,10q25.3,118430812,118521523,90711,-,-
BAC1_M22,10,10q25.3,118437507,118528035,90528,-,-
BAC246_O15,10,10q25.3,118450391,118540808,90417,-,-
BAC113_N04,10,10q25.3,118457287,118541413,84126,-,-
BAC196_C02,10,10q25.3,118541589,118634253,92664,-,-
BAC204_M07,10,10q25.3,118649778,118738436,88658,-,-
BAC39_D19,10,10q25.3,118691385,118830898,139513,-,-
BAC123_O11,10,10q25.3,118745447,118839018,93571,-,-
BAC38_D05,10,10q25.3,118749916,118846456,96540,-,-
BAC79_J09,10,10q25.3,118749919,118850763,100844,-,-
BAC55_A16,10,10q25.3,118765497,118858881,93384,-,-
BAC200_F22,10,10q25.3,118794411,118908385,113974,-,-
BAC166_M01,10,10q25.3,118842222,118944616,102394,-,-
BAC111_E23,10,10q25.3,118890418,118987016,96598,-,-
BAC81_I23,10,10q25.3,118891737,118996961,105224,-,-
BAC29_J06,10,10q25.3,118906131,119016602,110471,-,-
BAC65_E01,10,10q25.3,118912142,119005446,93304,-,-
BAC126_G07,10,10q25.3,118913564,119020152,106588,-,-
BAC122_J10,10,10q25.3,118913580,119019934,106354,-,-
BAC251_J03,10,10q25.3-10q26.11,119035064,119206106,171042,-,-
BAC121_B17,10,10q25.3-10q26.11,119071899,119182928,111029,-,-
BAC107_C10,10,10q25.3-10q26.11,119079037,119162530,83493,-,-
BAC143_H05,10,10q25.3-10q26.11,119091521,119211447,119926,-,-
BAC52_I06,10,10q25.3-10q26.11,119096534,119186912,90378,-,-
BAC129_P21,10,10q25.3-10q26.11,119098533,119186912,88379,-,-
BAC39_O02,10,10q26.11,119141790,119264239,122449,-,-
BAC125_L21,10,10q26.11,119154689,119245845,91156,-,-
BAC89_E05,10,10q26.11,119159486,119315615,156129,-,-
BAC55_N04,10,10q26.11,119162839,119245823,82984,-,-
BAC177_C15,10,10q26.11,119187199,119270422,83223,-,-
BAC133_C08,10,10q26.11,119199418,119281892,82474,-,-
BAC92_B19,10,10q26.11,119210633,119299995,89362,-,-
BAC158_A05,10,10q26.11,119245946,119349298,103352,-,-
BAC158_N04,10,10q26.11,119245951,119349297,103346,-,-
BAC194_E23,10,10q26.11,119269213,119410127,140914,-,-
BAC249_P02,10,10q26.11,119320423,119421415,100992,-,-
BAC57_B06,10,10q26.11,119328877,119477779,148902,-,-
BAC33_H05,10,10q26.11,119328884,119421435,92551,-,-
BAC203_G10,10,10q26.11,119429808,119523842,94034,-,-
BAC121_D07,10,10q26.11,119523914,119618784,94870,-,-
BAC148_C10,10,10q26.11,119639859,119725272,85413,-,-
BAC42_A08,10,10q26.11,119744139,119833579,89440,-,-
BAC234_P22,10,10q26.11,119744139,119834644,90505,-,-
BAC176_G07,10,10q26.11,119744161,119833584,89423,-,-
BAC161_O11,10,10q26.11,119840015,119917989,77974,-,-
BAC117_O09,10,10q26.11,119855857,119970745,114888,-,-
BAC240_L19,10,10q26.11,120041565,120143181,101616,-,-
BAC44_P18,10,10q26.11,120096425,120182196,85771,-,-
BAC175_G03,10,10q26.11,120164571,120263596,99025,-,-
BAC76_M19,10,10q26.11,120172579,120287164,114585,-,-
BAC96_H07,10,10q26.11,120183589,120263596,80007,-,-
BAC83_C06,10,10q26.11,120202330,120292233,89903,-,-
BAC88_B02,10,10q26.11,120260304,120349110,88806,-,-
BAC151_J16,10,10q26.11,120274535,120364045,89510,-,-
BAC240_O17,10,10q26.11,120292437,120377943,85506,-,-
BAC99_K13,10,10q26.11,120364258,120446232,81974,-,-
BAC37_O08,10,10q26.11,120414286,120527244,112958,-,-
BAC135_E24,10,10q26.11,120446229,120506684,60455,-,-
BAC95_B17,10,10q26.11,120446720,120579881,133161,-,-
BAC121_M16,10,10q26.11,120446720,120579358,132638,-,-
BAC72_P10,10,10q26.11,120450884,120564579,113695,-,-
BAC19_F11,10,10q26.11,120469327,120601623,132296,-,-
BAC176_D22,10,10q26.11,120622413,120709139,86726,-,-
BAC186_L03,10,10q26.11,120652630,120741028,88398,-,-
BAC235_N20,10,10q26.11,120653139,120740983,87844,-,-
BAC222_O16,10,10q26.11,120653172,120789181,136009,-,-
BAC146_P09,10,10q26.11,120699936,120795013,95077,-,-
BAC24_C12,10,10q26.11,120755867,120850599,94732,-,-
BAC116_G02,10,10q26.11,120764676,120865771,101095,-,-
BAC110_D14,10,10q26.11,120827385,120952755,125370,-,-
BAC250_M12,10,10q26.11,120863313,120959528,96215,-,-
BAC108_D05,10,10q26.11,120865766,120959419,93653,-,-
BAC116_D01,10,10q26.11,120960553,121055870,95317,-,-
BAC193_K13,10,10q26.11,120960553,121080496,119943,-,-
BAC21_E17,10,10q26.11,120960553,121042728,82175,-,-
BAC197_O02,10,10q26.11,121055865,121161049,105184,-,-
BAC26_G12,10,10q26.11,121139350,121235554,96204,-,-
BAC57_D24,10,10q26.11,121161044,121254775,93731,-,-
BAC159_D08,10,10q26.11,121161433,121243818,82385,-,-
BAC60_J15,10,10q26.11,121173618,121264814,91196,-,-
BAC81_O19,10,10q26.11,121249087,121343077,93990,-,-
BAC233_D03,10,10q26.11,121254871,121326435,71564,-,-
BAC190_F04,10,10q26.11,121261134,121312963,51829,-,-
BAC104_C06,10,10q26.11,121284452,121368460,84008,-,-
BAC147_G07,10,10q26.11,121312996,121385941,72945,-,-
BAC71_B10,10,10q26.11,121312996,121388468,75472,-,-
BAC226_B03,10,10q26.11,121432496,121533183,100687,-,-
BAC155_H19,10,10q26.11,121495844,121585683,89839,-,-
BAC88_E05,10,10q26.11-10q26.12,121562098,121713174,151076,-,-
BAC71_F11,10,10q26.11-10q26.12,121698491,121811155,112664,-,-
BAC80_L09,10,10q26.12,121700114,121785902,85788,-,-
BAC92_L22,10,10q26.12,121717217,121818579,101362,-,-
BAC132_B02,10,10q26.12,121721196,121808441,87245,-,-
BAC4_D24,10,10q26.12,121769039,121872156,103117,-,-
BAC233_C07,10,10q26.12,121818571,121904559,85988,-,-
BAC141_E03,10,10q26.12,121829995,121912594,82599,-,-
BAC55_B16,10,10q26.12,121845527,121959278,113751,-,-
BAC120_D23,10,10q26.12,121988064,122068469,80405,-,-
BAC130_O10,10,10q26.12,122026927,122111037,84110,-,-
BAC222_C07,10,10q26.12,122155949,122249462,93513,-,-
BAC198_L11,10,10q26.12,122196027,122274294,78267,-,-
BAC150_C20,10,10q26.12,122283007,122341982,58975,-,-
BAC177_C19,10,10q26.12,122289045,122398778,109733,-,-
BAC117_M23,10,10q26.12,122332501,122422955,90454,-,-
BAC131_B23,10,10q26.12,122332552,122419936,87384,-,-
BAC43_N19,10,10q26.12,122360628,122501412,140784,-,-
BAC81_K01,10,10q26.12,122406128,122501417,95289,-,-
BAC50_J10,10,10q26.12,122423005,122541163,118158,-,-
BAC234_P09,10,10q26.12,122466687,122539135,72448,-,-
BAC100_D19,10,10q26.12,122626140,122790899,164759,-,-
BAC35_M12,10,10q26.12,122627526,122722083,94557,-,-
BAC244_E01,10,10q26.12,122638041,122710309,72268,-,-
BAC157_I10,10,10q26.12,122657861,122776125,118264,-,-
BAC67_B24,10,10q26.12,122698767,122837075,138308,-,-
BAC252_J14,10,10q26.12,122720909,122831150,110241,-,-
BAC241_J05,10,10q26.12,122722988,122829359,106371,-,-
BAC34_O09,10,10q26.12,122740311,122829540,89229,-,-
BAC217_B23,10,10q26.12,122752244,122829359,77115,-,-
BAC250_E18,10,10q26.12,122829549,122910717,81168,-,-
BAC105_G21,10,10q26.12,122959212,123063655,104443,-,-
BAC36_J24,10,10q26.12,122975949,123050955,75006,-,-
BAC178_M08,10,10q26.12,122988495,123075871,87376,-,-
BAC199_F03,10,10q26.12-10q26.13,123044815,123140481,95666,-,-
BAC196_F19,10,10q26.12-10q26.13,123063653,123167610,103957,-,-
BAC162_C23,10,10q26.13,123101514,123219980,118466,-,-
BAC97_O07,10,10q26.13,123115846,123207783,91937,-,-
BAC80_I04,10,10q26.13,123117667,123197264,79597,-,-
BAC61_J03,10,10q26.13,123132485,123219978,87493,-,-
BAC247_G18,10,10q26.13,123132487,123219951,87464,-,-
BAC218_E11,10,10q26.13,123194345,123298554,104209,-,-
BAC236_E20,10,10q26.13,123220185,123319167,98982,-,-
BAC176_I18,10,10q26.13,123264290,123370229,105939,-,-
BAC181_I16,10,10q26.13,123270057,123370229,100172,-,-
BAC233_P03,10,10q26.13,123310485,123421302,110817,-,-
BAC11_G10,10,10q26.13,123318180,123460850,142670,-,-
BAC190_H16,10,10q26.13,123319165,123404789,85624,-,-
BAC154_E03,10,10q26.13,123319500,123421777,102277,-,-
BAC144_A20,10,10q26.13,123370422,123460850,90428,-,-
BAC243_O09,10,10q26.13,123405052,123482921,77869,-,-
BAC150_G09,10,10q26.13,123428398,123510717,82319,-,-
BAC248_E06,10,10q26.13,123500736,123573482,72746,-,-
BAC54_C10,10,10q26.13,123522475,123621234,98759,-,-
BAC4_G24,10,10q26.13,123565177,123672120,106943,-,-
BAC57_L14,10,10q26.13,123574673,123699053,124380,-,-
BAC197_E17,10,10q26.13,123583123,123672455,89332,-,-
BAC106_I23,10,10q26.13,123680563,123788204,107641,-,-
BAC50_B16,10,10q26.13,123699051,123788204,89153,-,-
BAC165_A16,10,10q26.13,123727728,123809382,81654,-,-
BAC237_I18,10,10q26.13,123792604,123879495,86891,-,-
BAC247_F10,10,10q26.13,123810843,123893169,82326,-,-
BAC123_O04,10,10q26.13,123823601,123908120,84519,-,-
BAC81_A17,10,10q26.13,123839150,123957921,118771,-,-
BAC53_P22,10,10q26.13,123879954,123955005,75051,-,-
BAC155_N10,10,10q26.13,123901952,124007722,105770,-,-
BAC82_K12,10,10q26.13,123908222,123986388,78166,-,-
BAC80_I07,10,10q26.13,123908254,124007455,99201,-,-
BAC242_E01,10,10q26.13,123909133,124007722,98589,-,-
BAC134_B16,10,10q26.13,123909160,123981644,72484,-,-
BAC32_H22,10,10q26.13,123921756,124105412,183656,-,-
BAC175_O19,10,10q26.13,123955003,124051096,96093,-,-
BAC29_F20,10,10q26.13,124007741,124085162,77421,-,-
BAC126_M02,10,10q26.13,124051090,124182388,131298,-,-
BAC41_J07,10,10q26.13,124051090,124133772,82682,-,-
BAC82_B02,10,10q26.13,124102427,124199427,97000,-,-
BAC52_K16,10,10q26.13,124102427,124188374,85947,-,-
BAC67_P18,10,10q26.13,124139564,124220160,80596,-,-
BAC218_F24,10,10q26.13,124242971,124329500,86529,-,-
BAC91_H11,10,10q26.13,124249611,124370979,121368,-,-
BAC80_C05,10,10q26.13,124258147,124387134,128987,-,-
BAC118_O08,10,10q26.13,124259338,124375529,116191,-,-
BAC234_G09,10,10q26.13,124259338,124375694,116356,-,-
BAC122_I02,10,10q26.13,124259340,124387134,127794,-,-
BAC86_F04,10,10q26.13,124278110,124439277,161167,-,-
BAC250_B23,10,10q26.13,124278135,124370979,92844,-,-
BAC223_O05,10,10q26.13,124387129,124470927,83798,-,-
BAC244_H15,10,10q26.13,124412917,124499265,86348,-,-
BAC122_L08,10,10q26.13,124418596,124554057,135461,-,-
BAC126_A04,10,10q26.13,124418597,124554057,135460,-,-
BAC191_H22,10,10q26.13,124487875,124616418,128543,-,-
BAC197_M07,10,10q26.13,124574223,124608865,34642,-,-
BAC81_J02,10,10q26.13,124590710,124755715,165005,-,-
BAC34_B15,10,10q26.13,124735224,124910452,175228,-,-
BAC34_B16,10,10q26.13,124735228,124910452,175224,-,-
BAC34_A16,10,10q26.13,124735228,124910452,175224,-,-
BAC79_F20,10,10q26.13,124737451,124839510,102059,-,-
BAC17_A05,10,10q26.13,124740364,124839378,99014,-,-
BAC83_G17,10,10q26.13,124922090,125002571,80481,-,-
BAC225_F07,10,10q26.13,125014633,125111431,96798,-,-
BAC20_P23,10,10q26.13,125056306,125165683,109377,-,-
BAC73_C09,10,10q26.13,125070567,125173062,102495,-,-
BAC82_B09,10,10q26.13,125110620,125239955,129335,-,-
BAC224_E05,10,10q26.13,125163331,125298566,135235,-,-
BAC49_D07,10,10q26.13,125164887,125384351,219464,-,-
BAC39_E23,10,10q26.13,125165702,125273955,108253,-,-
BAC53_N17,10,10q26.13,125229180,125389436,160256,-,-
BAC110_K04,10,10q26.13,125239948,125351441,111493,-,-
BAC78_J15,10,10q26.13,125264132,125361755,97623,-,-
BAC178_G11,10,10q26.13,125268434,125345224,76790,-,-
BAC127_I16,10,10q26.13,125298560,125414048,115488,-,-
BAC144_N18,10,10q26.13,125302707,125458456,155749,-,-
BAC144_I14,10,10q26.13,125384510,125454110,69600,-,-
BAC101_C14,10,10q26.13,125384514,125483787,99273,-,-
BAC191_O09,10,10q26.13,125412374,125543146,130772,-,-
BAC26_J22,10,10q26.13,125423142,125616243,193101,-,-
BAC188_B12,10,10q26.13,125463043,125572230,109187,-,-
BAC78_N11,10,10q26.13,125466004,125566075,100071,-,-
BAC222_O17,10,10q26.13,125476533,125572230,95697,-,-
BAC165_E02,10,10q26.13,125543140,125640574,97434,-,-
BAC40_E04,10,10q26.13,125698828,125828197,129369,-,-
BAC163_N05,10,10q26.13,125736701,125828225,91524,-,-
BAC34_F22,10,10q26.13,126005016,126095842,90826,-,-
BAC126_O11,10,10q26.13,126010195,126108928,98733,-,-
BAC150_N21,10,10q26.13,126023497,126102424,78927,-,-
BAC46_P13,10,10q26.13,126071292,126184322,113030,-,-
BAC26_L08,10,10q26.13,126109435,126265326,155891,-,-
BAC129_C15,10,10q26.13,126167358,126321242,153884,-,-
BAC29_G11,10,10q26.13,126174544,126294236,119692,-,-
BAC149_I16,10,10q26.13,126175994,126259162,83168,-,-
BAC221_F12,10,10q26.13,126210010,126294203,84193,-,-
BAC116_N11,10,10q26.13,126217568,126301397,83829,-,-
BAC27_P23,10,10q26.13,126237352,126386063,148711,-,-
BAC248_D06,10,10q26.13,126265349,126337388,72039,-,-
BAC181_N10,10,10q26.13,126298509,126413472,114963,-,-
BAC167_C18,10,10q26.13,126339047,126451646,112599,-,-
BAC140_J19,10,10q26.13,126404055,126485281,81226,-,-
BAC63_G06,10,10q26.13,126446689,126535241,88552,-,-
BAC39_J24,10,10q26.13,126446725,126535241,88516,-,-
BAC169_E14,10,10q26.13,126525644,126622087,96443,-,-
BAC97_B15,10,10q26.13,126535235,126643687,108452,-,-
BAC140_E02,10,10q26.13,126613410,126712915,99505,-,-
BAC134_O01,10,10q26.13,126622719,126786326,163607,-,-
BAC144_O01,10,10q26.13,126662681,126748232,85551,-,-
BAC48_I12,10,10q26.13,126688077,126783871,95794,-,-
BAC141_N02,10,10q26.13,126699481,126784173,84692,-,-
BAC184_H17,10,10q26.13,126699510,126784110,84600,-,-
BAC25_O17,10,10q26.13,126713273,126804107,90834,-,-
BAC227_M18,10,10q26.13,126785735,126859885,74150,-,-
BAC96_K06,10,10q26.13,126902050,127016209,114159,-,-
BAC196_O20,10,10q26.13,126908107,127011787,103680,-,-
BAC156_C21,10,10q26.13,126933226,127057209,123983,-,-
BAC36_G06,10,10q26.13,127036971,127144412,107441,-,-
BAC115_F04,10,10q26.13,127042256,127148006,105750,-,-
BAC35_D17,10,10q26.13,127069131,127173872,104741,-,-
BAC88_A04,10,10q26.13,127070298,127173845,103547,-,-
BAC248_F10,10,10q26.13,127070301,127173885,103584,-,-
BAC21_O05,10,10q26.13,127162340,127263120,100780,-,-
BAC61_M03,10,10q26.13,127237870,127333122,95252,-,-
BAC57_I09,10,10q26.13,127239450,127329849,90399,-,-
BAC42_F11,10,10q26.13-10q26.2,127327422,127482703,155281,-,-
BAC120_F20,10,10q26.13-10q26.2,127333116,127519143,186027,-,-
BAC246_L06,10,10q26.13-10q26.2,127350095,127442505,92410,-,-
BAC84_L23,10,10q26.13-10q26.2,127373831,127461927,88096,-,-
BAC130_H10,10,10q26.13-10q26.2,127397469,127485992,88523,-,-
BAC166_O23,10,10q26.2,127408063,127495591,87528,-,-
BAC119_G14,10,10q26.2,127552750,127715844,163094,-,-
BAC218_J11,10,10q26.2,127662872,127811044,148172,-,-
BAC128_B04,10,10q26.2,127674720,127766923,92203,-,-
BAC102_F09,10,10q26.2,127689332,127805630,116298,-,-
BAC73_A23,10,10q26.2,127739770,127841656,101886,-,-
BAC23_I11,10,10q26.2,127766915,127862992,96077,-,-
BAC61_C18,10,10q26.2,127805625,127919769,114144,-,-
BAC147_K08,10,10q26.2,127817958,127896535,78577,-,-
BAC218_G20,10,10q26.2,127866804,127956311,89507,-,-
BAC247_B24,10,10q26.2,127894641,127969614,74973,-,-
BAC95_F07,10,10q26.2,127901200,128002953,101753,-,-
BAC121_B23,10,10q26.2,127907353,128043971,136618,-,-
BAC101_M08,10,10q26.2,127923401,128018938,95537,-,-
BAC199_J08,10,10q26.2,127979456,128050715,71259,-,-
BAC23_O15,10,10q26.2,127992284,128101913,109629,-,-
BAC142_H16,10,10q26.2,128011372,128097760,86388,-,-
BAC179_O07,10,10q26.2,128034981,128143367,108386,-,-
BAC49_M04,10,10q26.2,128035063,128109503,74440,-,-
BAC65_J10,10,10q26.2,128069661,128148116,78455,-,-
BAC158_O17,10,10q26.2,128109560,128193240,83680,-,-
BAC160_P03,10,10q26.2,128137728,128246591,108863,-,-
BAC25_H23,10,10q26.2,128246622,128394051,147429,-,-
BAC126_K08,10,10q26.2,128282583,128376478,93895,-,-
BAC156_I10,10,10q26.2,128282623,128397674,115051,-,-
BAC235_E02,10,10q26.2,128295296,128390390,95094,-,-
BAC118_C12,10,10q26.2,128295454,128397675,102221,-,-
BAC90_F11,10,10q26.2,128324720,128417570,92850,-,-
BAC92_P14,10,10q26.2,128337494,128498762,161268,-,-
BAC24_G07,10,10q26.2,128410283,128495290,85007,-,-
BAC199_J02,10,10q26.2,128708836,128789423,80587,-,-
BAC191_L06,10,10q26.2,128716138,128811406,95268,-,-
BAC72_D11,10,10q26.2,128725735,128795752,70017,-,-
BAC141_C24,10,10q26.2,128785465,128891354,105889,-,-
BAC162_E09,10,10q26.2,128848406,128970390,121984,-,-
BAC100_I08,10,10q26.2,128858713,128946660,87947,-,-
BAC96_B24,10,10q26.2,128890591,128988387,97796,-,-
BAC96_F07,10,10q26.2,128942650,129050592,107942,-,-
BAC200_H08,10,10q26.2,129039933,129139189,99256,-,-
BAC141_N17,10,10q26.2,129077639,129152538,74899,-,-
BAC49_M17,10,10q26.2,129081496,129161883,80387,-,-
BAC107_B11,10,10q26.2,129081736,129173177,91441,-,-
BAC160_M09,10,10q26.2,129081766,129159836,78070,-,-
BAC31_I15,10,10q26.2,129120984,129221353,100369,-,-
BAC219_G11,10,10q26.2,129121032,129200388,79356,-,-
BAC230_G02,10,10q26.2,129122104,129221359,99255,-,-
BAC175_E24,10,10q26.2,129139182,129244644,105462,-,-
BAC30_I09,10,10q26.2,129195932,129276220,80288,-,-
BAC175_H09,10,10q26.2,129271192,129345005,73813,-,-
BAC10_D21,10,10q26.2,129464798,129645839,181041,-,-
BAC105_I21,10,10q26.2,129464808,129556362,91554,-,-
BAC250_K01,10,10q26.2,129471216,129561763,90547,-,-
BAC50_I20,10,10q26.2,129531565,129620115,88550,-,-
BAC154_P22,10,10q26.2,129556357,129632348,75991,-,-
BAC244_P07,10,10q26.2,129664044,129760322,96278,-,-
BAC97_D05,10,10q26.2,129674377,129802331,127954,-,-
BAC36_J09,10,10q26.2,129674548,129768581,94033,-,-
BAC83_A16,10,10q26.2,129674666,129774914,100248,-,-
BAC236_O11,10,10q26.2,129678223,129774914,96691,-,-
BAC167_G16,10,10q26.2,129682056,129760322,78266,-,-
BAC120_C03,10,10q26.2,129699802,129802364,102562,-,-
BAC151_I18,10,10q26.2,129742986,129823723,80737,-,-
BAC198_J10,10,10q26.2,129760313,129846642,86329,-,-
BAC64_D10,10,10q26.2,129800128,129909471,109343,-,-
BAC228_K23,10,10q26.2,129811326,129894984,83658,-,-
BAC151_F15,10,10q26.2,129856448,129941841,85393,-,-
BAC66_P18,10,10q26.2,129916093,130021269,105176,-,-
BAC60_I17,10,10q26.2,129924923,130069043,144120,-,-
BAC62_E12,10,10q26.2,129995425,130075431,80006,-,-
BAC241_N16,10,10q26.2,130002814,130089243,86429,-,-
BAC92_L05,10,10q26.2,130002814,130106554,103740,-,-
BAC163_H15,10,10q26.2,130081589,130170681,89092,-,-
BAC234_F22,10,10q26.2,130089253,130211547,122294,-,-
BAC165_P15,10,10q26.2,130102937,130211547,108610,-,-
BAC230_D09,10,10q26.2,130105304,130184153,78849,-,-
BAC132_P17,10,10q26.2,130106548,130224677,118129,-,-
BAC193_F11,10,10q26.2,130115422,130211545,96123,-,-
BAC154_C11,10,10q26.2,130170005,130258415,88410,-,-
BAC165_M21,10,10q26.2,130211545,130306803,95258,-,-
BAC177_L09,10,10q26.2,130219236,130310542,91306,-,-
BAC105_G06,10,10q26.2,130270046,130437121,167075,-,-
BAC95_G16,10,10q26.2,130290646,130385941,95295,-,-
BAC176_N16,10,10q26.2,130314360,130413787,99427,-,-
BAC157_J06,10,10q26.2,130371578,130454529,82951,-,-
BAC9_B16,10,10q26.2,130376038,130483727,107689,-,-
BAC143_G22,10,10q26.2,130384509,130497238,112729,-,-
BAC196_P16,10,10q26.2-10q26.3,130412231,130521994,109763,-,-
BAC222_E05,10,10q26.2,130412281,130497158,84877,-,-
BAC92_D03,10,10q26.2-10q26.3,130434087,130536435,102348,-,-
BAC143_H21,10,10q26.2-10q26.3,130456866,130547894,91028,-,-
BAC140_A04,10,10q26.3,130521986,130538720,16734,-,-
BAC80_H20,10,10q26.3,130547892,130628439,80547,-,-
BAC186_H02,10,10q26.3,130570032,130651573,81541,-,-
BAC42_H14,10,10q26.3,130579465,130655246,75781,-,-
BAC165_E04,10,10q26.3,130590682,130670493,79811,-,-
BAC53_D16,10,10q26.3,130621931,130725072,103141,-,-
BAC139_L20,10,10q26.3,130631419,130725090,93671,-,-
BAC182_N07,10,10q26.3,130655243,130754961,99718,-,-
BAC59_A18,10,10q26.3,130655243,130752130,96887,-,-
BAC31_P22,10,10q26.3,130670487,130752129,81642,-,-
BAC12_E17,10,10q26.3,130671850,130768932,97082,-,-
BAC97_B19,10,10q26.3,130710379,130800921,90542,-,-
BAC221_J23,10,10q26.3,130713450,130811259,97809,-,-
BAC158_K04,10,10q26.3,130723608,130822481,98873,-,-
BAC158_H04,10,10q26.3,130723608,130822478,98870,-,-
BAC161_M15,10,10q26.3,130755035,130825612,70577,-,-
BAC247_D23,10,10q26.3,130755036,130851341,96305,-,-
BAC27_E05,10,10q26.3,130755037,130853143,98106,-,-
BAC152_M02,10,10q26.3,130822473,130913670,91197,-,-
BAC158_O20,10,10q26.3,130827905,130923620,95715,-,-
BAC55_K01,10,10q26.3,130851352,130952871,101519,-,-
BAC73_F10,10,10q26.3,130872013,130973939,101926,-,-
BAC88_H15,10,10q26.3,130934014,131015107,81093,-,-
BAC34_H12,10,10q26.3,130936853,131082457,145604,-,-
BAC29_C17,10,10q26.3,130960041,131120701,160660,-,-
BAC171_F17,10,10q26.3,131020706,131101234,80528,-,-
BAC23_J07,10,10q26.3,131030928,131156544,125616,-,-
BAC68_L10,10,10q26.3,131141519,131252404,110885,-,-
BAC34_M24,10,10q26.3,131183712,131264580,80868,-,-
BAC83_D01,10,10q26.3,131190289,131316523,126234,-,-
BAC134_H18,10,10q26.3,131211289,131342985,131696,-,-
BAC8_O16,10,10q26.3,131287661,131427932,140271,-,-
BAC135_L15,10,10q26.3,131287690,131385371,97681,-,-
BAC38_B12,10,10q26.3,131336939,131419607,82668,-,-
BAC101_C04,10,10q26.3,131342979,131486998,144019,-,-
BAC67_G02,10,10q26.3,131396882,131486994,90112,-,-
BAC178_H10,10,10q26.3,131405800,131486998,81198,-,-
BAC78_G17,10,10q26.3,131419659,131518874,99215,-,-
BAC80_J04,10,10q26.3,131428043,131569662,141619,-,-
BAC240_G16,10,10q26.3,131454522,131575893,121371,-,-
BAC236_G23,10,10q26.3,131546162,131639027,92865,-,-
BAC155_E14,10,10q26.3,131557606,131684615,127009,-,-
BAC67_N18,10,10q26.3,131639126,131751979,112853,-,-
BAC148_F18,10,10q26.3,131662452,131759532,97080,-,-
BAC71_L19,10,10q26.3,131676379,131775970,99591,-,-
BAC242_N09,10,10q26.3,131691458,131766362,74904,-,-
BAC247_I13,10,10q26.3,131763637,131847237,83600,-,-
BAC145_B07,10,10q26.3,131763637,131852627,88990,-,-
BAC194_G08,10,10q26.3,131763642,131855680,92038,-,-
BAC107_C06,10,10q26.3,131766355,131884575,118220,-,-
BAC180_L16,10,10q26.3,131766362,131893537,127175,-,-
BAC126_M20,10,10q26.3,131773944,131855680,81736,-,-
BAC237_P17,10,10q26.3,131793197,131871454,78257,-,-
BAC167_I18,10,10q26.3,131795431,131887802,92371,-,-
BAC224_O01,10,10q26.3,131847236,131941797,94561,-,-
BAC36_F09,10,10q26.3,131850981,131926253,75272,-,-
BAC27_F15,10,10q26.3,131873224,132023381,150157,-,-
BAC124_N24,10,10q26.3,131976590,132081912,105322,-,-
BAC217_G12,10,10q26.3,132004994,132085587,80593,-,-
BAC218_E22,10,10q26.3,132062938,132149723,86785,-,-
BAC52_F02,10,10q26.3,132078278,132201952,123674,-,-
BAC151_C10,10,10q26.3,132081906,132171092,89186,-,-
BAC37_N06,10,10q26.3,132288584,132382582,93998,-,-
BAC219_D08,10,10q26.3,132288592,132368063,79471,-,-
BAC162_O21,10,10q26.3,132300530,132382582,82052,-,-
BAC61_P22,10,10q26.3,132300530,132471251,170721,-,-
BAC65_C14,10,10q26.3,132300566,132458024,157458,-,-
BAC46_F15,10,10q26.3,132300568,132471228,170660,-,-
BAC62_J22,10,10q26.3,132315924,132435714,119790,-,-
BAC220_P08,10,10q26.3,132348065,132427171,79106,-,-
BAC242_N06,10,10q26.3,132387856,132472808,84952,-,-
BAC70_H19,10,10q26.3,132425217,132522534,97317,-,-
BAC123_P05,10,10q26.3,132483383,132615868,132485,-,-
BAC142_H04,10,10q26.3,132489063,132595090,106027,-,-
BAC113_F05,10,10q26.3,132502840,132609511,106671,-,-
BAC115_H14,10,10q26.3,132595084,132688199,93115,-,-
BAC154_B04,10,10q26.3,132595200,132686548,91348,-,-
BAC222_I10,10,10q26.3,132601755,132686548,84793,-,-
BAC147_E01,10,10q26.3,132639142,132766606,127464,-,-
BAC242_L07,10,10q26.3,132735522,132834473,98951,-,-
BAC176_K21,10,10q26.3,132735522,132842583,107061,-,-
BAC25_K22,10,10q26.3,132763006,132887044,124038,-,-
BAC228_J13,10,10q26.3,132763011,132887044,124033,-,-
BAC162_E10,10,10q26.3,132777809,132872258,94449,-,-
BAC38_F20,10,10q26.3,132796719,132887074,90355,-,-
BAC25_B16,10,10q26.3,132891067,132988298,97231,-,-
BAC119_F04,10,10q26.3,132891635,133002014,110379,-,-
BAC65_L15,10,10q26.3,132895874,133025399,129525,-,-
BAC224_K22,10,10q26.3,132911654,132988298,76644,-,-
BAC27_N12,10,10q26.3,132960290,133084607,124317,-,-
BAC157_A14,10,10q26.3,132971591,133068507,96916,-,-
BAC18_D18,10,10q26.3,132981124,133071775,90651,-,-
BAC13_F08,10,10q26.3,133036764,133123908,87144,-,-
BAC239_M08,10,10q26.3,133046253,133135991,89738,-,-
BAC147_C11,10,10q26.3,133068502,133170342,101840,-,-
BAC2_L19,10,10q26.3,133312512,133430109,117597,-,-
BAC211_N24,10,10q26.3,133312571,133413626,101055,-,-
BAC160_M16,10,10q26.3,133351881,133472125,120244,-,-
BAC181_D04,10,10q26.3,133352900,133476183,123283,-,-
BAC100_C15,10,10q26.3,133405156,133507670,102514,-,-
BAC246_M11,10,10q26.3,133405160,133495454,90294,-,-
BAC163_H10,10,10q26.3,133411320,133527517,116197,-,-
BAC189_D04,10,10q26.3,133606640,133697146,90506,-,-
BAC40_K12,10,10q26.3,133607657,133717872,110215,-,-
BAC135_F22,10,10q26.3,133667187,133756068,88881,-,-
BAC244_D10,10,10q26.3,133682154,133873058,190904,yes,-
BAC162_M01,10,10q26.3,133716290,133869047,152757,-,-
BAC44_H06,10,10q26.3,133719803,133849387,129584,-,-
BAC172_A16,10,10q26.3,133898656,134012397,113741,-,-
BAC77_J04,10,10q26.3,133898664,133990557,91893,-,-
BAC145_I13,10,10q26.3,133945049,134094526,149477,-,-
BAC226_B23,10,10q26.3,133990561,134082413,91852,-,-
BAC234_A18,10,10q26.3,133990570,134095230,104660,-,-
BAC186_M02,10,10q26.3,133990570,134082334,91764,-,-
BAC168_G03,10,10q26.3,134003706,134082413,78707,-,-
BAC115_B05,10,10q26.3,134012612,134082413,69801,-,-
BAC217_K14,10,10q26.3,134095258,134200247,104989,-,-
BAC97_P13,10,10q26.3,134118662,134263685,145023,-,-
BAC235_J19,10,10q26.3,134184322,134282182,97860,-,-
BAC75_N12,10,10q26.3,134203650,134319506,115856,-,-
BAC243_F02,10,10q26.3,134203653,134291243,87590,-,-
BAC151_O19,10,10q26.3,134231395,134319550,88155,-,-
BAC194_F03,10,10q26.3,134244513,134333136,88623,-,-
BAC14_C08,10,10q26.3,134248401,134333158,84757,-,-
BAC217_O08,10,10q26.3,134248404,134366912,118508,-,-
BAC57_B21,10,10q26.3,134291258,134397235,105977,-,-
BAC252_J11,10,10q26.3,134292294,134397384,105090,-,-
BAC165_C07,10,10q26.3,134335517,134429032,93515,-,-
BAC81_F18,10,10q26.3,134407236,134514837,107601,-,-
BAC163_G05,10,10q26.3,134442073,134556023,113950,-,-
BAC64_B03,10,10q26.3,134496478,134592363,95885,-,-
BAC118_O03,10,10q26.3,134604089,134693987,89898,-,-
BAC202_K12,10,10q26.3,134821889,134919733,97844,yes,-
BAC112_E04,10,10q26.3,134856285,134965048,108763,yes,-
BAC102_F18,10,10q26.3,134969493,135058484,88991,-,-
BAC239_N17,10,10q26.3,135076227,135163550,87323,-,-
BAC239_L11,10,10q26.3,135097432,135187030,89598,-,-
BAC194_M12,10,10q26.3,135107130,135203905,96775,yes,-
BAC80_N10,10,10q26.3,135134431,135306424,171993,yes,-
BAC41_M17,10,10q26.3,135139390,135256012,116622,yes,-
BAC158_I11,10,10q26.3,135163594,135270385,106791,-,-
BAC158_F11,10,10q26.3,135163601,135270385,106784,yes,-
BAC92_F14,10,10q26.3,135228071,135309800,81729,-,-
BAC248_L05,10,10q26.3,135281207,135358637,77430,-,-
BAC131_J11,10,10q26.3,135288905,135360779,71874,-,-
BAC43_P11,11,11p15.5,202605,345513,142908,yes,-
BAC165_D01,11,11p15.5,202674,299570,96896,yes,-
BAC200_K24,11,11p15.5,257732,338908,81176,-,-
BAC119_H18,11,11p15.5,633661,746816,113155,-,-
BAC51_E20,11,11p15.5,651917,733879,81962,-,-
BAC238_O14,11,11p15.5,651918,733879,81961,-,-
BAC107_F16,11,11p15.5,651918,746816,94898,-,-
BAC169_F13,11,11p15.5,760926,888187,127261,yes,-
BAC120_G22,11,11p15.5,802542,928313,125771,yes,-
BAC240_J08,11,11p15.5,802554,897479,94925,yes,-
BAC143_M13,11,11p15.5,853886,959791,105905,yes,-
BAC157_A21,11,11p15.5,900211,914400,14189,-,-
BAC96_I14,11,11p15.5,982365,1053568,71203,yes,-
BAC247_G04,11,11p15.5,1053862,1117696,63834,yes,-
BAC108_C12,11,11p15.5,1185172,1279000,93828,yes,-
BAC1_P04,11,11p15.5,1199581,1306144,106563,yes,-
BAC168_H15,11,11p15.5,1201737,1295904,94167,yes,-
BAC226_D23,11,11p15.5,1201737,1289988,88251,yes,-
BAC38_M12,11,11p15.5,1247226,1400636,153410,-,-
BAC90_E10,11,11p15.5,1247368,1341561,94193,yes,-
BAC29_G15,11,11p15.5,1253755,1433951,180196,-,-
BAC180_J06,11,11p15.5,1259043,1343211,84168,-,-
BAC22_N20,11,11p15.5,1259045,1400636,141591,-,-
BAC121_J14,11,11p15.5,1270204,1376601,106397,-,-
BAC66_K20,11,11p15.5,1341569,1427823,86254,-,-
BAC48_J12,11,11p15.5,1358026,1466954,108928,yes,-
BAC252_L09,11,11p15.5,1400648,1514530,113882,-,-
BAC197_K23,11,11p15.5,1507270,1610070,102800,-,-
BAC218_E01,11,11p15.5,1514523,1610110,95587,-,-
BAC241_B14,11,11p15.5,2242207,2320851,78644,-,-
BAC240_C16,11,11p15.5,2327796,2414450,86654,-,-
BAC141_G07,11,11p15.5,2476345,2552565,76220,-,-
BAC115_C19,11,11p15.5,2476345,2575290,98945,-,-
BAC193_G23,11,11p15.5,2501587,2616827,115240,-,-
BAC65_D14,11,11p15.5,2533061,2627888,94827,-,-
BAC158_D19,11,11p15.5,2550081,2634834,84753,-,-
BAC133_C15,11,11p15.5,2617510,2698879,81369,-,-
BAC247_F11,11,11p15.5,2631228,2711912,80684,-,-
BAC53_F15,11,11p15.5,2667339,2753577,86238,-,-
BAC149_P17,11,11p15.5-11p15.4,2712191,2861405,149214,-,-
BAC60_J23,11,11p15.4,2811179,2898536,87357,-,-
BAC73_G24,11,11p15.4,2812494,2941798,129304,-,-
BAC21_B04,11,11p15.4,2898560,3031536,132976,-,-
BAC176_A03,11,11p15.4,2941792,3014337,72545,-,-
BAC189_P09,11,11p15.4,2957224,3023805,66581,-,-
BAC191_A20,11,11p15.4,3031559,3092007,60448,-,-
BAC56_J11,11,11p15.4,3093298,3228831,135533,yes,-
BAC78_A06,11,11p15.4,3144391,3228831,84440,yes,-
BAC161_G01,11,11p15.4,3224802,3351992,127190,-,-
BAC72_D01,11,11p15.4,3241605,3391783,150178,-,-
BAC233_O11,11,11p15.4,3264435,3387989,123554,-,-
BAC171_F01,11,11p15.4,3340445,3435293,94848,-,-
BAC109_I13,11,11p15.4,3346885,3501383,154498,-,-
BAC84_D17,11,11p15.4,3346904,3513492,166588,-,-
BAC14_F17,11,11p15.4,3351984,3420746,68762,-,-
BAC20_K20,11,11p15.4,3351986,3454739,102753,-,-
BAC57_K18,11,11p15.4,3354268,3480419,126151,-,-
BAC228_O10,11,11p15.4,3360441,3470516,110075,-,-
BAC137_C19,11,11p15.4,3454809,3526918,72109,-,-
BAC192_M06,11,11p15.4,3460023,3546611,86588,-,-
BAC131_E07,11,11p15.4,3547888,3685296,137408,-,-
BAC171_E20,11,11p15.4,3569330,3685258,115928,-,-
BAC166_P08,11,11p15.4,3717850,3847261,129411,-,-
BAC144_M18,11,11p15.4,3738409,3827710,89301,-,-
BAC78_J13,11,11p15.4,3762418,3880120,117702,-,-
BAC193_P15,11,11p15.4,3764653,3875172,110519,-,-
BAC199_H01,11,11p15.4,3788920,3866140,77220,-,-
BAC175_G02,11,11p15.4,3800861,3884981,84120,-,-
BAC33_J24,11,11p15.4,3816654,3946666,130012,-,-
BAC144_L01,11,11p15.4,3828419,3929741,101322,-,-
BAC162_N03,11,11p15.4,3875349,3975649,100300,-,-
BAC167_A03,11,11p15.4,4050877,4136858,85981,-,-
BAC184_G17,11,11p15.4,4051809,4136771,84962,-,-
BAC124_D03,11,11p15.4,4066033,4162796,96763,-,-
BAC11_D04,11,11p15.4,4112808,4205217,92409,-,-
BAC123_J05,11,11p15.4,4195271,4301834,106563,-,-
BAC29_L19,11,11p15.4,4218001,4331940,113939,-,-
BAC53_D10,11,11p15.4,4420535,4518170,97635,-,-
BAC32_N03,11,11p15.4,4434682,4581086,146404,-,-
BAC56_G14,11,11p15.4,4475724,4575565,99841,-,-
BAC176_E08,11,11p15.4,4512829,4591515,78686,-,-
BAC29_J02,11,11p15.4,4575862,4661202,85340,-,-
BAC178_H04,11,11p15.4,4674443,4751285,76842,-,-
BAC41_J24,11,11p15.4,4727755,4823420,95665,-,-
BAC161_B23,11,11p15.4,4751452,4830262,78810,-,-
BAC110_L17,11,11p15.4,4891275,4994934,103659,-,-
BAC224_J17,11,11p15.4,4931319,4989419,58100,-,-
BAC135_A24,11,11p15.4,5007872,5097526,89654,-,-
BAC147_C15,11,11p15.4,5147061,5263968,116907,-,-
BAC76_H18,11,11p15.4,5303161,5398853,95692,-,-
BAC181_O19,11,11p15.4,5343571,5445522,101951,-,-
BAC75_O15,11,11p15.4,5380695,5401234,20539,-,-
BAC56_E21,11,11p15.4,5426418,5548346,121928,-,-
BAC217_I15,11,11p15.4,5471073,5575550,104477,-,-
BAC219_I23,11,11p15.4,5561026,5663900,102874,-,-
BAC218_K20,11,11p15.4,5561028,5661711,100683,-,-
BAC160_D10,11,11p15.4,5561038,5674713,113675,-,-
BAC195_H13,11,11p15.4,5568376,5674712,106336,-,-
BAC48_B18,11,11p15.4,5689353,5811705,122352,-,-
BAC232_P19,11,11p15.4,5713451,5799726,86275,-,-
BAC50_L05,11,11p15.4,5812984,5888960,75976,-,-
BAC73_N21,11,11p15.4,6007627,6114693,107066,-,-
BAC211_M22,11,11p15.4,6020153,6091155,71002,-,-
BAC160_D06,11,11p15.4,6046148,6140406,94258,-,-
BAC24_A15,11,11p15.4,6061686,6161684,99998,-,-
BAC8_P06,11,11p15.4,6161679,6325391,163712,-,-
BAC27_F21,11,11p15.4,6276097,6383149,107052,-,-
BAC162_N08,11,11p15.4,6277091,6375212,98121,-,-
BAC204_G14,11,11p15.4,6278056,6417830,139774,-,-
BAC124_A22,11,11p15.4,6320285,6483758,163473,-,-
BAC91_J13,11,11p15.4,6421371,6508657,87286,-,-
BAC169_D04,11,11p15.4,6483752,6553020,69268,-,-
BAC219_F22,11,11p15.4,6504588,6627905,123317,-,-
BAC241_K05,11,11p15.4,6581992,6691426,109434,-,-
BAC103_J23,11,11p15.4,6627996,6713575,85579,-,-
BAC235_H11,11,11p15.4,6648908,6742627,93719,-,-
BAC223_L03,11,11p15.4,6648908,6756287,107379,-,-
BAC242_F06,11,11p15.4,6666624,6742627,76003,-,-
BAC168_N05,11,11p15.4,6672244,6793279,121035,-,-
BAC34_F14,11,11p15.4,6770141,6881067,110926,-,-
BAC67_K23,11,11p15.4,6857839,6969658,111819,-,-
BAC74_I13,11,11p15.4,6869266,6947968,78702,-,-
BAC141_B11,11,11p15.4,6911206,7001523,90317,-,-
BAC217_G10,11,11p15.4,6911242,6998372,87130,-,-
BAC156_O10,11,11p15.4,7023581,7127477,103896,-,-
BAC223_F10,11,11p15.4,7135879,7212750,76871,-,-
BAC5_I05,11,11p15.4,7175387,7257298,81911,-,-
BAC202_C18,11,11p15.4,7221349,7300433,79084,-,-
BAC26_A03,11,11p15.4,7273322,7440589,167267,-,-
BAC22_H24,11,11p15.4,7307169,7409587,102418,-,-
BAC129_E17,11,11p15.4,7502029,7577940,75911,-,-
BAC21_B19,11,11p15.4,7503212,7626625,123413,-,-
BAC43_O19,11,11p15.4,7537793,7628529,90736,-,-
BAC143_P23,11,11p15.4,7645688,7729578,83890,-,-
BAC168_D11,11,11p15.4,7816425,7887473,71048,-,-
BAC158_K21,11,11p15.4,7880639,7945049,64410,-,-
BAC172_K20,11,11p15.4,7926128,8010318,84190,-,-
BAC96_J11,11,11p15.4,8046171,8145763,99592,-,-
BAC196_A07,11,11p15.4,8083930,8157293,73363,-,-
BAC50_M18,11,11p15.4,8083934,8182626,98692,-,-
BAC110_N01,11,11p15.4,8088049,8234784,146735,-,-
BAC204_L24,11,11p15.4,8134582,8221469,86887,-,-
BAC217_G04,11,11p15.4,8156008,8260856,104848,-,-
BAC242_A01,11,11p15.4,8172941,8284253,111312,-,-
BAC167_A06,11,11p15.4,8182650,8272559,89909,-,-
BAC232_C21,11,11p15.4,8219823,8317889,98066,-,-
BAC83_L13,11,11p15.4,8237055,8349542,112487,-,-
BAC186_O15,11,11p15.4,8245736,8378386,132650,-,-
BAC141_J09,11,11p15.4,8254949,8347632,92683,-,-
BAC237_A08,11,11p15.4,8286643,8369310,82667,-,-
BAC1_E15,11,11p15.4,8298522,8380860,82338,-,-
BAC117_M06,11,11p15.4,8298522,8388052,89530,-,-
BAC204_N19,11,11p15.4,8298525,8378070,79545,-,-
BAC114_D12,11,11p15.4,8298531,8386947,88416,-,-
BAC178_P06,11,11p15.4,8317884,8408619,90735,-,-
BAC195_A16,11,11p15.4,8317891,8409960,92069,-,-
BAC133_N24,11,11p15.4,8368922,8443866,74944,-,-
BAC178_K21,11,11p15.4,8408701,8495825,87124,-,-
BAC246_C04,11,11p15.4,8408701,8495821,87120,-,-
BAC234_D03,11,11p15.4,8415788,8495830,80042,-,-
BAC59_A15,11,11p15.4,8569209,8655957,86748,-,-
BAC239_B08,11,11p15.4,8600507,8740679,140172,-,-
BAC121_B05,11,11p15.4,8611979,8758078,146099,-,-
BAC198_G17,11,11p15.4,8621539,8738419,116880,-,-
BAC165_G11,11,11p15.4,8621539,8720637,99098,-,-
BAC125_H23,11,11p15.4,8623829,8724058,100229,-,-
BAC238_I16,11,11p15.4,8658336,8752094,93758,-,-
BAC32_E11,11,11p15.4,8658336,8758074,99738,-,-
BAC126_O01,11,11p15.4,8666712,8758078,91366,-,-
BAC32_K13,11,11p15.4,8666716,8786558,119842,-,-
BAC198_G03,11,11p15.4,8729562,8817248,87686,-,-
BAC43_P09,11,11p15.4,8736721,8869268,132547,-,-
BAC176_G06,11,11p15.4,8758072,8859247,101175,-,-
BAC90_L19,11,11p15.4,8794822,8895690,100868,-,-
BAC77_O06,11,11p15.4,8816988,8927555,110567,-,-
BAC232_E11,11,11p15.4,8841939,8927131,85192,-,-
BAC56_C10,11,11p15.4,8879751,9041368,161617,-,-
BAC46_F23,11,11p15.4,8886544,9024816,138272,-,-
BAC144_E20,11,11p15.4,8886844,8991977,105133,-,-
BAC185_G10,11,11p15.4,8908629,9015396,106767,-,-
BAC101_J02,11,11p15.4,8913172,8998478,85306,-,-
BAC228_B07,11,11p15.4,8913173,8989349,76176,-,-
BAC244_I13,11,11p15.4,8915433,9024820,109387,-,-
BAC222_L05,11,11p15.4,8915433,9017556,102123,-,-
BAC1_E20,11,11p15.4,8924764,9015396,90632,-,-
BAC7_O18,11,11p15.4,9058073,9242656,184583,-,-
BAC107_I12,11,11p15.4,9094528,9220137,125609,-,-
BAC135_E13,11,11p15.4,9123216,9220137,96921,-,-
BAC92_L17,11,11p15.4,9125377,9242656,117279,-,-
BAC40_A20,11,11p15.4,9125399,9266218,140819,-,-
BAC190_G09,11,11p15.4,9155413,9242545,87132,-,-
BAC59_J13,11,11p15.4,9202402,9295470,93068,-,-
BAC241_F16,11,11p15.4,9296675,9383772,87097,-,-
BAC214_B15,11,11p15.4,9308261,9381603,73342,-,-
BAC227_F05,11,11p15.4,9330527,9425719,95192,-,-
BAC168_A24,11,11p15.4,9398035,9507108,109073,-,-
BAC196_C04,11,11p15.4,9488260,9565420,77160,-,-
BAC73_B04,11,11p15.4,9557509,9648560,91051,-,-
BAC240_D12,11,11p15.4,9570051,9702238,132187,-,-
BAC189_I12,11,11p15.4,9596006,9668692,72686,-,-
BAC246_H24,11,11p15.4,9607084,9698577,91493,-,-
BAC76_I06,11,11p15.4,9700684,9814352,113668,-,-
BAC68_C24,11,11p15.4,9714192,9858207,144015,-,-
BAC101_M19,11,11p15.4,9780662,9906258,125596,-,-
BAC24_M09,11,11p15.4,9819672,9910116,90444,-,-
BAC11_F18,11,11p15.4,9819672,9910047,90375,-,-
BAC53_M05,11,11p15.4,9874040,10016159,142119,-,-
BAC156_E17,11,11p15.4,9910110,10016554,106444,-,-
BAC56_H14,11,11p15.4,9941717,10022193,80476,-,-
BAC97_A12,11,11p15.4,10022513,10120338,97825,-,-
BAC27_B21,11,11p15.4,10025018,10170250,145232,-,-
BAC11_C15,11,11p15.4,10050075,10170250,120175,-,-
BAC127_C19,11,11p15.4,10160337,10268240,107903,-,-
BAC60_I03,11,11p15.4,10167125,10287485,120360,-,-
BAC153_L05,11,11p15.4,10177509,10278900,101391,-,-
BAC191_B06,11,11p15.4,10206812,10328105,121293,-,-
BAC134_J07,11,11p15.4,10212940,10287485,74545,-,-
BAC167_I14,11,11p15.4,10310056,10391639,81583,-,-
BAC118_G11,11,11p15.4,10321545,10407771,86226,-,-
BAC152_D22,11,11p15.4,10405908,10498100,92192,-,-
BAC39_O17,11,11p15.4,10420343,10510024,89681,-,-
BAC123_F24,11,11p15.4,10433663,10583178,149515,-,-
BAC105_G17,11,11p15.4,10489774,10601941,112167,-,-
BAC198_O17,11,11p15.4,10504162,10615599,111437,-,-
BAC252_G23,11,11p15.4,10546304,10664530,118226,-,-
BAC60_D22,11,11p15.4-11p15.3,10601935,10767551,165616,-,-
BAC84_L04,11,11p15.4-11p15.3,10615593,10741919,126326,-,-
BAC115_G24,11,11p15.3,10701868,10821449,119581,-,-
BAC156_N18,11,11p15.3,10740249,10856934,116685,-,-
BAC100_D21,11,11p15.3,10779155,10894781,115626,-,-
BAC81_E15,11,11p15.3,10782082,10899323,117241,-,-
BAC95_N04,11,11p15.3,10821492,10933002,111510,-,-
BAC247_A11,11,11p15.3,10824310,10918767,94457,-,-
BAC23_A11,11,11p15.3,10835309,10938246,102937,-,-
BAC188_J20,11,11p15.3,11003196,11101117,97921,-,-
BAC124_L07,11,11p15.3,11003196,11101117,97921,-,-
BAC232_K17,11,11p15.3,11037717,11132814,95097,-,-
BAC73_A08,11,11p15.3,11084876,11195014,110138,-,-
BAC143_D11,11,11p15.3,11167650,11230435,62785,-,-
BAC85_J23,11,11p15.3,11331765,11435104,103339,-,-
BAC133_K10,11,11p15.3,11336986,11437712,100726,-,-
BAC232_H17,11,11p15.3,11377909,11502626,124717,-,-
BAC183_C20,11,11p15.3,11382756,11457916,75160,-,-
BAC84_J14,11,11p15.3,11433329,11542306,108977,-,-
BAC107_I05,11,11p15.3,11437803,11554802,116999,-,-
BAC8_A16,11,11p15.3,11453576,11563045,109469,-,-
BAC132_D20,11,11p15.3,11619080,11708204,89124,-,-
BAC1_L10,11,11p15.3,11673768,11804294,130526,-,-
BAC88_B15,11,11p15.3,11732178,11892157,159979,-,-
BAC37_M16,11,11p15.3,11741855,11857730,115875,-,-
BAC177_F11,11,11p15.3,11742628,11829288,86660,-,-
BAC80_P11,11,11p15.3,11778620,11870467,91847,-,-
BAC220_L19,11,11p15.3,11791694,11884279,92585,-,-
BAC26_G24,11,11p15.3,11857727,11955384,97657,-,-
BAC137_G18,11,11p15.3,11857735,11971333,113598,-,-
BAC20_H05,11,11p15.3,11922069,12061934,139865,-,-
BAC183_P04,11,11p15.3,11949499,12045935,96436,-,-
BAC153_O19,11,11p15.3,11967007,12064447,97440,-,-
BAC191_F21,11,11p15.3,11990725,12086444,95719,-,-
BAC161_N19,11,11p15.3,12064440,12163547,99107,-,-
BAC198_H03,11,11p15.3,12070055,12156379,86324,-,-
BAC109_K16,11,11p15.3,12071264,12166032,94768,-,-
BAC125_I10,11,11p15.3,12071264,12149126,77862,-,-
BAC165_I08,11,11p15.3,12073351,12186666,113315,-,-
BAC142_P18,11,11p15.3,12095634,12192946,97312,-,-
BAC194_L24,11,11p15.3,12095640,12226902,131262,-,-
BAC79_B20,11,11p15.3,12116993,12256083,139090,-,-
BAC182_B14,11,11p15.3,12141947,12248906,106959,-,-
BAC115_F12,11,11p15.3,12238622,12339379,100757,-,-
BAC193_C14,11,11p15.3,12450460,12546125,95665,-,-
BAC196_J09,11,11p15.3,12453416,12546124,92708,-,-
BAC83_P04,11,11p15.3,12453417,12546120,92703,-,-
BAC147_O08,11,11p15.3,12458497,12538698,80201,-,-
BAC159_M05,11,11p15.3,12462673,12546062,83389,-,-
BAC66_J23,11,11p15.3,12500926,12588244,87318,-,-
BAC58_J12,11,11p15.3-11p15.2,12568692,12695488,126796,-,-
BAC185_I04,11,11p15.2,12693644,12792810,99166,-,-
BAC68_K10,11,11p15.2,12761489,12858699,97210,-,-
BAC71_I16,11,11p15.2,12858712,12952429,93717,-,-
BAC89_H08,11,11p15.2,12876127,12981398,105271,-,-
BAC34_M06,11,11p15.2,12876127,12956848,80721,-,-
BAC147_D17,11,11p15.2,12877561,12972236,94675,-,-
BAC56_N12,11,11p15.2,12911787,13004551,92764,-,-
BAC161_A18,11,11p15.2,12980392,13070068,89676,-,-
BAC144_I07,11,11p15.2,12980399,13086928,106529,-,-
BAC224_M07,11,11p15.2,12986548,13086926,100378,-,-
BAC150_G02,11,11p15.2,13033431,13120189,86758,-,-
BAC34_H07,11,11p15.2,13158178,13254142,95964,-,-
BAC167_C15,11,11p15.2,13168305,13274418,106113,-,-
BAC147_N19,11,11p15.2,13187341,13274426,87085,-,-
BAC199_H04,11,11p15.2,13235302,13335228,99926,-,-
BAC31_P16,11,11p15.2,13304876,13441978,137102,-,-
BAC28_P11,11,11p15.2,13354068,13449757,95689,-,-
BAC185_O23,11,11p15.2,13466949,13549300,82351,-,-
BAC71_D02,11,11p15.2,13485994,13584971,98977,-,-
BAC136_K02,11,11p15.2,13584032,13671317,87285,-,-
BAC25_P24,11,11p15.2,13590251,13681560,91309,-,-
BAC101_C10,11,11p15.2,13714307,13854069,139762,-,-
BAC49_K19,11,11p15.2,13714357,13904071,189714,-,-
BAC133_M01,11,11p15.2,13723010,13802396,79386,-,-
BAC82_C10,11,11p15.2,13723011,13829401,106390,-,-
BAC179_D12,11,11p15.2,13776212,13886173,109961,-,-
BAC107_D19,11,11p15.2,13829405,13939841,110436,-,-
BAC15_G02,11,11p15.2,13829405,13948957,119552,-,-
BAC154_O03,11,11p15.2,13948244,14031020,82776,-,-
BAC56_N07,11,11p15.2,14054661,14150878,96217,-,-
BAC84_N17,11,11p15.2,14085149,14187195,102046,-,-
BAC229_J13,11,11p15.2,14167642,14256268,88626,-,-
BAC59_H02,11,11p15.2,14200253,14345097,144844,-,-
BAC144_O06,11,11p15.2,14410834,14479853,69019,-,-
BAC43_O05,11,11p15.2,14492942,14637260,144318,-,-
BAC35_I01,11,11p15.2,14795743,14902268,106525,-,-
BAC135_L21,11,11p15.2,14956341,15055818,99477,-,-
BAC61_C09,11,11p15.2,15078318,15203136,124818,-,-
BAC188_K09,11,11p15.2,15119989,15203133,83144,-,-
BAC229_P15,11,11p15.2,15120937,15203132,82195,-,-
BAC145_L16,11,11p15.2,15259619,15361220,101601,-,-
BAC55_L22,11,11p15.2,15259621,15341713,82092,-,-
BAC143_N07,11,11p15.2,15538397,15623727,85330,-,-
BAC22_C09,11,11p15.2,15563712,15655738,92026,-,-
BAC178_O23,11,11p15.2,15577147,15698369,121222,-,-
BAC190_N14,11,11p15.2,15622675,15720908,98233,-,-
BAC51_E09,11,11p15.2,15750378,15848758,98380,-,-
BAC82_I03,11,11p15.2,15859558,15962857,103299,-,-
BAC68_J10,11,11p15.1,16468834,16594197,125363,-,-
BAC28_L18,11,11p15.1,16491357,16574708,83351,-,-
BAC235_L20,11,11p15.1,16528018,16594184,66166,-,-
BAC143_D06,11,11p15.1,16667066,16766479,99413,-,-
BAC5_N03,11,11p15.1,16698148,16806708,108560,-,-
BAC73_N20,11,11p15.1,16698217,16810171,111954,-,-
BAC155_K12,11,11p15.1,16699310,16784383,85073,-,-
BAC148_J13,11,11p15.1,16749212,16829127,79915,-,-
BAC27_L05,11,11p15.1,16749212,16890513,141301,-,-
BAC17_D20,11,11p15.1,16784378,16896006,111628,-,-
BAC92_F12,11,11p15.1,16831379,16917050,85671,-,-
BAC115_J18,11,11p15.1,16832048,16982498,150450,-,-
BAC170_A04,11,11p15.1,16871153,16982498,111345,-,-
BAC242_E11,11,11p15.1,16887419,16982498,95079,-,-
BAC144_O23,11,11p15.1,16888486,16982498,94012,-,-
BAC88_L19,11,11p15.1,16888502,17024604,136102,-,-
BAC249_E09,11,11p15.1,16907446,17008999,101553,-,-
BAC36_K15,11,11p15.1,16947445,17057105,109660,-,-
BAC89_O10,11,11p15.1,16982724,17072042,89318,-,-
BAC40_F17,11,11p15.1,16982724,17163237,180513,-,-
BAC115_C05,11,11p15.1,17057275,17179648,122373,-,-
BAC159_P08,11,11p15.1,17098757,17200053,101296,-,-
BAC172_N21,11,11p15.1,17107460,17248074,140614,-,-
BAC22_E08,11,11p15.1,17115355,17223695,108340,-,-
BAC8_O02,11,11p15.1,17133376,17248073,114697,-,-
BAC175_P20,11,11p15.1,17163229,17248084,84855,-,-
BAC201_L02,11,11p15.1,17172319,17267440,95121,-,-
BAC236_D08,11,11p15.1,17292615,17381881,89266,-,-
BAC155_G16,11,11p15.1,17296627,17376540,79913,-,-
BAC33_E03,11,11p15.1,17322649,17439572,116923,-,-
BAC78_H14,11,11p15.1,17342325,17424931,82606,-,-
BAC123_K10,11,11p15.1,17347651,17494032,146381,-,-
BAC100_A24,11,11p15.1,17410778,17508288,97510,-,-
BAC41_F24,11,11p15.1,17490729,17628156,137427,-,-
BAC175_O04,11,11p15.1,17508281,17603651,95370,-,-
BAC117_E21,11,11p15.1,17517132,17626174,109042,-,-
BAC175_A18,11,11p15.1,17532109,17629367,97258,-,-
BAC90_G07,11,11p15.1,17599739,17696959,97220,-,-
BAC123_E19,11,11p15.1,17645247,17751352,106105,-,-
BAC117_M09,11,11p15.1,17690652,17904411,213759,-,-
BAC152_P16,11,11p15.1,17709956,17806435,96479,-,-
BAC97_I07,11,11p15.1,17832791,17906646,73855,-,-
BAC247_F18,11,11p15.1,17853545,17966621,113076,-,-
BAC51_C19,11,11p15.1,18016770,18129187,112417,-,-
BAC75_H12,11,11p15.1,18070615,18191685,121070,-,-
BAC145_A06,11,11p15.1,18137798,18227207,89409,-,-
BAC20_B14,11,11p15.1,18144343,18243948,99605,-,-
BAC197_B07,11,11p15.1,18173135,18253741,80606,-,-
BAC79_M21,11,11p15.1,18173162,18260971,87809,-,-
BAC230_P21,11,11p15.1,18191739,18292651,100912,-,-
BAC130_P21,11,11p15.1,18353168,18459274,106106,-,-
BAC117_D15,11,11p15.1,18365111,18489527,124416,-,-
BAC165_O19,11,11p15.1,18378215,18456682,78467,-,-
BAC241_L04,11,11p15.1,18382577,18460238,77661,-,-
BAC101_J07,11,11p15.1,18427046,18611165,184119,-,-
BAC200_L13,11,11p15.1,18497142,18602631,105489,-,-
BAC119_M19,11,11p15.1,18562774,18696266,133492,-,-
BAC227_D17,11,11p15.1,18611262,18702088,90826,-,-
BAC237_L05,11,11p15.1,18614635,18698045,83410,-,-
BAC56_I13,11,11p15.1,18730697,18834997,104300,-,-
BAC143_C17,11,11p15.1,18735971,18834997,99026,-,-
BAC151_J15,11,11p15.1,18769155,18849857,80702,-,-
BAC80_D07,11,11p15.1,19002747,19114947,112200,-,-
BAC177_D15,11,11p15.1,19111755,19207730,95975,-,-
BAC175_K13,11,11p15.1,19114942,19197014,82072,-,-
BAC65_M23,11,11p15.1,19131146,19249766,118620,-,-
BAC194_E20,11,11p15.1,19140311,19242513,102202,-,-
BAC66_C11,11,11p15.1,19244305,19359621,115316,-,-
BAC221_L11,11,11p15.1,19260462,19346537,86075,-,-
BAC125_H14,11,11p15.1,19260462,19371502,111040,-,-
BAC115_N05,11,11p15.1,19346899,19492357,145458,-,-
BAC68_C21,11,11p15.1,19467438,19601645,134207,-,-
BAC22_K05,11,11p15.1,19485859,19579050,93191,-,-
BAC21_P02,11,11p15.1,19491183,19587892,96709,-,-
BAC197_O07,11,11p15.1,19502945,19587924,84979,-,-
BAC176_J06,11,11p15.1,19522116,19625696,103580,-,-
BAC96_G22,11,11p15.1,19546349,19640904,94555,-,-
BAC218_L21,11,11p15.1,19546361,19637106,90745,-,-
BAC22_J04,11,11p15.1,19546410,19653765,107355,-,-
BAC104_P19,11,11p15.1,19650046,19778726,128680,-,-
BAC154_O06,11,11p15.1,19670519,19773323,102804,-,-
BAC171_H21,11,11p15.1,19676974,19746808,69834,-,-
BAC149_K23,11,11p15.1,19676974,19756169,79195,-,-
BAC177_K23,11,11p15.1,19709471,19817852,108381,-,-
BAC237_L22,11,11p15.1,19758425,19859984,101559,-,-
BAC1_K02,11,11p15.1,19817846,19982397,164551,-,-
BAC137_K18,11,11p15.1,19822562,19971461,148899,-,-
BAC16_C17,11,11p15.1,19857598,19960285,102687,-,-
BAC134_L02,11,11p15.1,19887807,19971501,83694,-,-
BAC26_N16,11,11p15.1,19897339,19976792,79453,-,-
BAC121_I17,11,11p15.1,19962372,20053890,91518,-,-
BAC250_I22,11,11p15.1,19982390,20076189,93799,-,-
BAC92_B15,11,11p15.1,20020481,20128205,107724,-,-
BAC40_D24,11,11p15.1,20020486,20125949,105463,-,-
BAC178_H18,11,11p15.1,20076277,20201447,125170,-,-
BAC178_G18,11,11p15.1,20076277,20201447,125170,-,-
BAC234_G21,11,11p15.1,20170315,20268534,98219,-,-
BAC150_J12,11,11p15.1,20210406,20287242,76836,-,-
BAC180_E22,11,11p15.1,20235313,20329922,94609,-,-
BAC252_G04,11,11p15.1,20489777,20580430,90653,-,-
BAC145_A05,11,11p15.1,20573246,20722981,149735,-,-
BAC116_B19,11,11p15.1,20596511,20682890,86379,-,-
BAC238_L09,11,11p15.1,20685286,20769567,84281,-,-
BAC169_E01,11,11p15.1,20722974,20840290,117316,-,-
BAC23_J08,11,11p15.1,20722974,20826248,103274,-,-
BAC250_F22,11,11p15.1,20749963,20826248,76285,-,-
BAC53_C05,11,11p15.1,20840751,20947244,106493,-,-
BAC236_H23,11,11p15.1,20995445,21083729,88284,-,-
BAC162_N19,11,11p15.1,21114523,21191016,76493,-,-
BAC237_A04,11,11p15.1,21138311,21224495,86184,-,-
BAC163_L08,11,11p15.1,21183596,21271989,88393,-,-
BAC20_A06,11,11p15.1,21224559,21318218,93659,-,-
BAC177_G07,11,11p15.1,21399914,21511762,111848,-,-
BAC194_N02,11,11p15.1,21421281,21508364,87083,-,-
BAC55_K10,11,11p14.3,22116517,22333639,217122,-,-
BAC70_F05,11,11p14.3,22256668,22336436,79768,-,-
BAC103_M17,11,11p14.3,22772511,22887463,114952,-,-
BAC115_L03,11,11p14.3,22831286,22914018,82732,-,-
BAC55_A07,11,11p14.3,22914186,23020407,106221,-,-
BAC241_M13,11,11p14.3,23254791,23346628,91837,-,-
BAC43_L04,11,11p14.3,23298569,23388330,89761,-,-
BAC166_P20,11,11p14.3,23404979,23484325,79346,-,-
BAC90_E18,11,11p14.3,23422886,23527116,104230,-,-
BAC219_M16,11,11p14.3,23596525,23679655,83130,-,-
BAC158_C15,11,11p14.3,23663076,23750901,87825,-,-
BAC158_D15,11,11p14.3,23663078,23750901,87823,-,-
BAC107_L17,11,11p14.3,23924227,24024820,100593,-,-
BAC190_I12,11,11p14.3,23953680,24081250,127570,-,-
BAC181_P12,11,11p14.3,24336076,24417585,81509,-,-
BAC64_O14,11,11p14.3,24681351,24777149,95798,-,-
BAC246_F10,11,11p14.3,24764339,24832574,68235,-,-
BAC38_G15,11,11p14.3,24765331,24861744,96413,-,-
BAC173_B11,11,11p14.3,24853113,24961391,108278,-,-
BAC236_G22,11,11p14.3,24934552,25052730,118178,-,-
BAC31_K14,11,11p14.3,25513114,25591122,78008,-,-
BAC35_B03,11,11p14.3,25548062,25631087,83025,-,-
BAC184_J08,11,11p14.3,25715933,25824419,108486,-,-
BAC8_F06,11,11p14.3,25778574,25878067,99493,-,-
BAC50_A07,11,11p14.3,25824876,25919731,94855,-,-
BAC43_A14,11,11p14.2,26178663,26330973,152310,-,-
BAC247_A07,11,11p14.2,26303378,26395304,91926,-,-
BAC181_N05,11,11p14.2,26368332,26443726,75394,-,-
BAC191_J08,11,11p14.2,26379107,26454337,75230,-,-
BAC34_K23,11,11p14.2,26572134,26700982,128848,-,-
BAC120_J22,11,11p14.2,26629848,26726057,96209,-,-
BAC184_F22,11,11p14.2,26726066,26828591,102525,-,-
BAC194_I07,11,11p14.2,26744807,26833153,88346,-,-
BAC163_D07,11,11p14.2,26973955,27067842,93887,-,-
BAC119_I22,11,11p14.2,27104817,27176166,71349,-,-
BAC68_K12,11,11p14.2-11p14.1,27108692,27217833,109141,-,-
BAC154_L07,11,11p14.2-11p14.1,27173122,27249893,76771,-,-
BAC137_I04,11,11p14.2-11p14.1,27180554,27244351,63797,-,-
BAC31_L11,11,11p14.1,27217828,27357877,140049,-,-
BAC141_N01,11,11p14.1,27257297,27357877,100580,-,-
BAC126_K12,11,11p14.1,27336465,27356440,19975,-,-
BAC237_F16,11,11p14.1,27393403,27473861,80458,-,-
BAC10_K16,11,11p14.1,27401243,27503056,101813,-,-
BAC190_L11,11,11p14.1,27408510,27495204,86694,-,-
BAC217_H22,11,11p14.1,27408510,27503369,94859,-,-
BAC247_E12,11,11p14.1,27415978,27498108,82130,-,-
BAC147_N06,11,11p14.1,27415978,27502948,86970,-,-
BAC175_I14,11,11p14.1,27415978,27502948,86970,-,-
BAC85_F01,11,11p14.1,27591398,27688163,96765,-,-
BAC59_P22,11,11p14.1,27717125,27800305,83180,-,-
BAC196_J08,11,11p14.1,27792112,27891671,99559,-,-
BAC219_N10,11,11p14.1,27867818,27960013,92195,-,-
BAC236_F09,11,11p14.1,27933337,28011431,78094,-,-
BAC20_O10,11,11p14.1,27995163,28078441,83278,-,-
BAC29_I19,11,11p14.1,28079417,28109313,29896,-,-
BAC241_K17,11,11p14.1,28449803,28551758,101955,-,-
BAC182_L16,11,11p14.1,28451837,28551568,99731,-,-
BAC192_K09,11,11p14.1,28493356,28589412,96056,-,-
BAC160_J10,11,11p14.1,28583353,28657853,74500,-,-
BAC231_C01,11,11p14.1,28739093,28816505,77412,-,-
BAC148_L02,11,11p14.1,28834118,28912355,78237,-,-
BAC52_H06,11,11p14.1,28979215,29086281,107066,-,-
BAC65_I22,11,11p14.1,29009935,29115216,105281,-,-
BAC196_P21,11,11p14.1,29170502,29279532,109030,-,-
BAC249_N20,11,11p14.1,29264081,29359833,95752,-,-
BAC41_K13,11,11p14.1,29466484,29531892,65408,-,-
BAC26_K21,11,11p14.1,29685059,29796714,111655,-,-
BAC37_A24,11,11p14.1,30076328,30178369,102041,-,-
BAC125_I20,11,11p14.1,30300502,30392652,92150,-,-
BAC23_O22,11,11p14.1,30300502,30412700,112198,-,-
BAC50_D13,11,11p14.1,30363345,30511124,147779,-,-
BAC18_P08,11,11p14.1,30397535,30544483,146948,-,-
BAC66_B16,11,11p14.1,30450509,30591392,140883,-,-
BAC250_D02,11,11p14.1,30705383,30795368,89985,-,-
BAC233_L01,11,11p14.1,30782321,30852993,70672,-,-
BAC227_J05,11,11p14.1,30823653,30873046,49393,-,-
BAC188_O14,11,11p13,31027330,31113119,85789,-,-
BAC12_F07,11,11p13,31347677,31454417,106740,-,-
BAC127_F16,11,11p13,31371329,31450655,79326,-,-
BAC215_M16,11,11p13,31491213,31576061,84848,-,-
BAC194_D24,11,11p13,31572376,31649453,77077,-,-
BAC125_C06,11,11p13,31681346,31822924,141578,-,-
BAC69_O16,11,11p13,31746883,31872730,125847,-,-
BAC39_I13,11,11p13,31791843,31912125,120282,-,-
BAC168_C20,11,11p13,31866554,31962058,95504,-,-
BAC81_G14,11,11p13,31872800,31997272,124472,-,-
BAC127_I06,11,11p13,31946782,31966838,20056,-,-
BAC182_O16,11,11p13,31952981,32059599,106618,-,-
BAC53_I09,11,11p13,31952985,32128175,175190,-,-
BAC106_I20,11,11p13,32037093,32173064,135971,-,-
BAC222_O23,11,11p13,32037111,32119029,81918,-,-
BAC199_E24,11,11p13,32059592,32145705,86113,-,-
BAC219_M07,11,11p13,32101435,32192448,91013,-,-
BAC167_E17,11,11p13,32128208,32232190,103982,-,-
BAC31_P03,11,11p13,32158065,32290977,132912,-,-
BAC107_J13,11,11p13,32161300,32282615,121315,-,-
BAC119_M16,11,11p13,32178960,32274463,95503,-,-
BAC149_K11,11,11p13,32185693,32292927,107234,-,-
BAC70_B14,11,11p13,32185695,32313795,128100,-,-
BAC147_D20,11,11p13,32221214,32285541,64327,-,-
BAC112_H01,11,11p13,32292921,32408975,116054,-,-
BAC186_A20,11,11p13,32368094,32445364,77270,-,-
BAC21_H02,11,11p13,32415154,32528974,113820,-,-
BAC2_H05,11,11p13,32445831,32561664,115833,-,-
BAC213_H04,11,11p13,32458154,32554232,96078,-,-
BAC124_F18,11,11p13,32482364,32575943,93579,-,-
BAC134_B20,11,11p13,32529105,32610724,81619,-,-
BAC176_N22,11,11p13,32561666,32642176,80510,-,-
BAC55_N02,11,11p13,32578773,32683425,104652,-,-
BAC160_K23,11,11p13,32644582,32724743,80161,-,-
BAC248_L18,11,11p13,32738581,32853109,114528,-,-
BAC148_H12,11,11p13,32765060,32872576,107516,-,-
BAC250_F02,11,11p13,32902710,32989944,87234,-,-
BAC14_A15,11,11p13,33024672,33165724,141052,-,-
BAC92_M19,11,11p13,33038755,33173661,134906,-,-
BAC115_O03,11,11p13,33084837,33200253,115416,-,-
BAC69_N17,11,11p13,33113623,33200253,86630,-,-
BAC26_D12,11,11p13,33267653,33368872,101219,-,-
BAC193_G13,11,11p13,33273598,33372507,98909,-,-
BAC66_G23,11,11p13,33323751,33474897,151146,-,-
BAC181_O01,11,11p13,33327292,33400217,72925,-,-
BAC84_K04,11,11p13,33360108,33453817,93709,-,-
BAC61_D10,11,11p13,33374806,33547121,172315,-,-
BAC73_K03,11,11p13,33402435,33520087,117652,-,-
BAC199_F05,11,11p13,33417010,33504268,87258,-,-
BAC214_P02,11,11p13,33491625,33504268,12643,-,-
BAC231_I15,11,11p13,33555703,33639633,83930,-,-
BAC31_N18,11,11p13,33586445,33695820,109375,-,-
BAC107_E14,11,11p13,33697774,33805657,107883,-,-
BAC12_F24,11,11p13,33741847,33894358,152511,-,-
BAC70_K08,11,11p13,33761949,33889356,127407,-,-
BAC199_A06,11,11p13,33805470,33885676,80206,-,-
BAC39_K11,11,11p13,33805474,33908762,103288,-,-
BAC152_E08,11,11p13,33841549,33936701,95152,-,-
BAC127_J02,11,11p13,33908754,34007555,98801,-,-
BAC167_D24,11,11p13,33912247,34006914,94667,-,-
BAC100_N19,11,11p13,33913101,34008461,95360,-,-
BAC163_C15,11,11p13,34023616,34104560,80944,-,-
BAC221_G02,11,11p13,34026431,34104560,78129,-,-
BAC24_K17,11,11p13,34043974,34159762,115788,-,-
BAC66_B03,11,11p13,34069346,34178858,109512,-,-
BAC161_E20,11,11p13,34084683,34188996,104313,-,-
BAC101_B17,11,11p13,34126755,34279173,152418,-,-
BAC196_J05,11,11p13,34160705,34264977,104272,-,-
BAC65_N15,11,11p13,34160743,34294994,134251,-,-
BAC244_E04,11,11p13,34178853,34241302,62449,-,-
BAC235_C19,11,11p13,34197172,34298926,101754,-,-
BAC33_F08,11,11p13,34197172,34294982,97810,-,-
BAC39_N22,11,11p13,34197179,34297064,99885,-,-
BAC172_N13,11,11p13,34221853,34314285,92432,-,-
BAC103_H19,11,11p13,34325090,34366482,41392,-,-
BAC25_I14,11,11p13,34472921,34574436,101515,-,-
BAC222_A06,11,11p13,34476720,34543483,66763,-,-
BAC222_C22,11,11p13,34492682,34579973,87291,-,-
BAC67_N12,11,11p13,34497513,34622938,125425,-,-
BAC147_O19,11,11p13,34511145,34595308,84163,-,-
BAC19_L09,11,11p13,34544575,34630512,85937,-,-
BAC97_I05,11,11p13,34595583,34688302,92719,-,-
BAC224_K21,11,11p13,34605268,34685687,80419,-,-
BAC95_L15,11,11p13,34614193,34719696,105503,-,-
BAC149_L02,11,11p13,34630518,34717806,87288,-,-
BAC50_B15,11,11p13,34659911,34761579,101668,-,-
BAC192_N07,11,11p13,34719704,34803670,83966,-,-
BAC229_K05,11,11p13,34854109,34976123,122014,-,-
BAC168_H17,11,11p13,34879298,34989255,109957,-,-
BAC196_H14,11,11p13,34943314,35024342,81028,-,-
BAC147_O09,11,11p13,34961185,35048567,87382,-,-
BAC74_H02,11,11p13,35270471,35423830,153359,-,-
BAC178_F10,11,11p13,35298525,35384737,86212,-,-
BAC160_G09,11,11p13,35301755,35407502,105747,-,-
BAC80_F13,11,11p13,35308901,35390165,81264,-,-
BAC196_I21,11,11p13,35322541,35407504,84963,-,-
BAC179_J06,11,11p13,35328805,35408206,79401,-,-
BAC143_G16,11,11p13,35465713,35493678,27965,-,-
BAC132_B14,11,11p13,35508718,35592993,84275,-,-
BAC86_K07,11,11p13,35562176,35673030,110854,-,-
BAC82_D19,11,11p13,35592988,35681385,88397,-,-
BAC57_A08,11,11p13,35593034,35702313,109279,-,-
BAC100_F17,11,11p13,35652553,35781186,128633,-,-
BAC208_A14,11,11p13,35783249,35867166,83917,-,-
BAC168_P04,11,11p13,35786553,35874546,87993,-,-
BAC56_O04,11,11p13,35794804,35910227,115423,-,-
BAC230_C22,11,11p13,35841441,35932004,90563,-,-
BAC2_N23,11,11p13,36053638,36159356,105718,-,-
BAC115_H20,11,11p13,36057525,36146437,88912,-,-
BAC189_E12,11,11p13,36112627,36213328,100701,-,-
BAC162_J07,11,11p13,36112627,36213341,100714,-,-
BAC118_F12,11,11p13,36141923,36240026,98103,-,-
BAC131_B16,11,11p13,36142329,36217955,75626,-,-
BAC224_D10,11,11p13-11p12,36366174,36461686,95512,-,-
BAC114_J07,11,11p12,36401978,36560990,159012,-,-
BAC77_C04,11,11p12,36463798,36554504,90706,-,-
BAC88_J03,11,11p12,36573493,36683276,109783,-,-
BAC160_O16,11,11p12,36683292,36783714,100422,-,-
BAC133_G14,11,11p12,36867362,36946077,78715,-,-
BAC68_C08,11,11p12,36897512,36987863,90351,-,-
BAC106_C06,11,11p12,37735336,37939737,204401,-,-
BAC61_C05,11,11p12,37801534,37894044,92510,-,-
BAC193_C06,11,11p12,37883678,37974114,90436,-,-
BAC234_L08,11,11p12,37924013,38009666,85653,-,-
BAC108_I16,11,11p12,37932768,38037686,104918,-,-
BAC55_P19,11,11p12,37960998,38065560,104562,-,-
BAC66_E07,11,11p12,37961041,38062789,101748,-,-
BAC236_K16,11,11p12,37962941,38036265,73324,-,-
BAC44_N08,11,11p12,37974122,38065731,91609,-,-
BAC101_I06,11,11p12,38038200,38127744,89544,-,-
BAC179_L16,11,11p12,38052291,38127744,75453,-,-
BAC112_E02,11,11p12,38151934,38232797,80863,-,-
BAC82_M16,11,11p12,38161228,38271441,110213,-,-
BAC107_B10,11,11p12,38271434,38360382,88948,-,-
BAC82_C17,11,11p12,38300064,38390637,90573,-,-
BAC118_M04,11,11p12,38532985,38615122,82137,-,-
BAC140_B07,11,11p12,38563160,38648384,85224,-,-
BAC240_K16,11,11p12,38577137,38646667,69530,-,-
BAC42_D17,11,11p12,38600835,38720570,119735,-,-
BAC148_K11,11,11p12,38646694,38761362,114668,-,-
BAC106_J03,11,11p12,38710072,38833562,123490,-,-
BAC70_A16,11,11p12,38775499,38912071,136572,-,-
BAC200_A22,11,11p12,38930285,39038415,108130,-,-
BAC78_O23,11,11p12,38947335,39036839,89504,-,-
BAC230_B08,11,11p12,39121045,39199979,78934,-,-
BAC144_F03,11,11p12,39145725,39225080,79355,-,-
BAC102_O04,11,11p12,39153353,39239866,86513,-,-
BAC46_C02,11,11p12,39225097,39319207,94110,-,-
BAC62_G10,11,11p12,39325785,39395209,69424,-,-
BAC27_J17,11,11p12,39445335,39565742,120407,-,-
BAC49_K06,11,11p12,39468134,39563736,95602,-,-
BAC184_K06,11,11p12,39504567,39611889,107322,-,-
BAC54_L20,11,11p12,39590921,39695473,104552,-,-
BAC28_P16,11,11p12,39611890,39714391,102501,-,-
BAC133_F22,11,11p12,39620432,39700101,79669,-,-
BAC187_H15,11,11p12,39750293,39838178,87885,-,-
BAC105_C18,11,11p12,39758378,39858466,100088,-,-
BAC175_J15,11,11p12,39772844,39850311,77467,-,-
BAC75_D22,11,11p12,39887138,39965968,78830,-,-
BAC189_H05,11,11p12,39968941,40077800,108859,-,-
BAC226_D02,11,11p12,40068485,40169043,100558,-,-
BAC34_M08,11,11p12,40071728,40161386,89658,-,-
BAC143_E23,11,11p12,40090754,40170880,80126,-,-
BAC248_P18,11,11p12,40185971,40270771,84800,-,-
BAC134_B11,11,11p12,40195209,40296676,101467,-,-
BAC176_N06,11,11p12,40211049,40304678,93629,-,-
BAC200_H17,11,11p12,40381457,40465243,83786,-,-
BAC179_I17,11,11p12,40408169,40508949,100780,-,-
BAC144_E14,11,11p12,40613445,40695399,81954,-,-
BAC219_N24,11,11p12,40842213,40922111,79898,-,-
BAC149_K16,11,11p12,40952694,41035000,82306,-,-
BAC114_P21,11,11p12,40953531,41113187,159656,-,-
BAC135_K01,11,11p12,41224943,41303375,78432,-,-
BAC52_A18,11,11p12,41339511,41451536,112025,-,-
BAC117_K19,11,11p12,41397965,41422727,24762,-,-
BAC197_G02,11,11p12,41462236,41585293,123057,-,-
BAC12_L18,11,11p12,41483204,41585306,102102,-,-
BAC85_N09,11,11p12,41489458,41573894,84436,-,-
BAC33_M13,11,11p12,41497929,41589929,92000,-,-
BAC125_E20,11,11p12,41659731,41765750,106019,-,-
BAC105_O06,11,11p12,41659731,41765749,106018,-,-
BAC76_E17,11,11p12,41860341,41991871,131530,-,-
BAC13_O04,11,11p12,42000787,42101366,100579,-,-
BAC243_L24,11,11p12,42014064,42131758,117694,-,-
BAC131_J07,11,11p12,42220771,42333757,112986,-,-
BAC58_O08,11,11p12,42271358,42436009,164651,-,-
BAC71_N18,11,11p12,42336175,42419722,83547,-,-
BAC104_H19,11,11p12,42339579,42434622,95043,-,-
BAC85_K14,11,11p12,42376548,42480827,104279,-,-
BAC75_A05,11,11p12,42434651,42520209,85558,-,-
BAC19_E23,11,11p12,42582533,42719520,136987,-,-
BAC247_C11,11,11p12,42880936,42975668,94732,-,-
BAC131_J23,11,11p12,42926327,43048512,122185,-,-
BAC61_O05,11,11p12,43056985,43176783,119798,-,-
BAC240_J14,11,11p12,43095281,43176601,81320,-,-
BAC219_M21,11,11p12,43111352,43221108,109756,-,-
BAC17_P19,11,11p12-11p11.2,43281185,43417304,136119,-,-
BAC240_A04,11,11p12,43289954,43303429,13475,-,-
BAC113_E05,11,11p12-11p11.2,43347058,43450967,103909,-,-
BAC155_A19,11,11p11.2,43443434,43529516,86082,-,-
BAC126_E16,11,11p11.2,43443437,43588622,145185,-,-
BAC150_M11,11,11p11.2,43460410,43569642,109232,-,-
BAC186_J17,11,11p11.2,43467264,43549212,81948,-,-
BAC154_N24,11,11p11.2,43638404,43652046,13642,-,-
BAC241_F14,11,11p11.2,43734441,43859416,124975,-,-
BAC32_E10,11,11p11.2,43763831,43883554,119723,-,-
BAC32_O09,11,11p11.2,43826545,43948169,121624,-,-
BAC132_C10,11,11p11.2,43933082,44059988,126906,-,-
BAC120_O05,11,11p11.2,43948294,44039011,90717,-,-
BAC33_A07,11,11p11.2,43948294,44035344,87050,-,-
BAC40_A06,11,11p11.2,43948294,44043599,95305,-,-
BAC175_J12,11,11p11.2,43999732,44090191,90459,-,-
BAC100_K11,11,11p11.2,44018958,44102456,83498,-,-
BAC92_N01,11,11p11.2,44039033,44139748,100715,-,-
BAC108_H13,11,11p11.2,44039042,44127638,88596,-,-
BAC188_P05,11,11p11.2,44060000,44172222,112222,-,-
BAC240_B23,11,11p11.2,44129057,44224929,95872,-,-
BAC12_H05,11,11p11.2,44154226,44301842,147616,-,-
BAC95_C08,11,11p11.2,44163572,44281839,118267,-,-
BAC51_F17,11,11p11.2,44212145,44312052,99907,-,-
BAC63_C01,11,11p11.2,44212145,44298461,86316,-,-
BAC139_O04,11,11p11.2,44215161,44299893,84732,-,-
BAC219_G10,11,11p11.2,44230002,44298216,68214,-,-
BAC115_G22,11,11p11.2,44293852,44387235,93383,-,-
BAC103_A12,11,11p11.2,44301836,44390029,88193,-,-
BAC82_F14,11,11p11.2,44313049,44407767,94718,-,-
BAC182_J20,11,11p11.2,44337546,44419221,81675,-,-
BAC168_P12,11,11p11.2,44396090,44502942,106852,-,-
BAC240_H19,11,11p11.2,44408056,44502942,94886,-,-
BAC247_L19,11,11p11.2,44410769,44501526,90757,-,-
BAC49_C11,11,11p11.2,44410905,44549076,138171,-,-
BAC24_J03,11,11p11.2,44425281,44539602,114321,-,-
BAC167_H05,11,11p11.2,44478162,44610420,132258,-,-
BAC53_G03,11,11p11.2,44479495,44603380,123885,-,-
BAC157_H16,11,11p11.2,44479510,44569519,90009,-,-
BAC32_K23,11,11p11.2,44595816,44720371,124555,-,-
BAC48_H14,11,11p11.2,44595816,44681861,86045,-,-
BAC120_G24,11,11p11.2,44599250,44710242,110992,-,-
BAC96_N24,11,11p11.2,44599250,44764283,165033,-,-
BAC55_G03,11,11p11.2,44603375,44720723,117348,-,-
BAC197_G21,11,11p11.2,44608703,44699130,90427,-,-
BAC233_J03,11,11p11.2,44673379,44778951,105572,-,-
BAC109_A17,11,11p11.2,44699121,44776729,77608,-,-
BAC36_K02,11,11p11.2,44699150,44793933,94783,-,-
BAC69_G10,11,11p11.2,44720742,44804553,83811,-,-
BAC195_B01,11,11p11.2,44720746,44811156,90410,-,-
BAC240_J10,11,11p11.2,44766299,44866414,100115,-,-
BAC167_F24,11,11p11.2,44803579,44901969,98390,-,-
BAC11_D10,11,11p11.2,44804661,44916728,112067,-,-
BAC5_G04,11,11p11.2,44809709,44913702,103993,-,-
BAC72_M04,11,11p11.2,44853491,44980182,126691,-,-
BAC127_I17,11,11p11.2,44866438,44980204,113766,-,-
BAC88_P19,11,11p11.2,44913782,45005317,91535,-,-
BAC176_B12,11,11p11.2,44925134,45018139,93005,-,-
BAC114_A21,11,11p11.2,44937468,45047699,110231,-,-
BAC238_M22,11,11p11.2,45005380,45092500,87120,-,-
BAC147_K04,11,11p11.2,45018133,45129843,111710,-,-
BAC228_E10,11,11p11.2,45018162,45099557,81395,-,-
BAC220_C20,11,11p11.2,45043617,45133724,90107,-,-
BAC230_D21,11,11p11.2,45047751,45165274,117523,-,-
BAC170_J16,11,11p11.2,45100365,45180637,80272,-,-
BAC5_M01,11,11p11.2,45108296,45225596,117300,-,-
BAC6_H11,11,11p11.2,45133850,45301623,167773,-,-
BAC127_F18,11,11p11.2,45163034,45255517,92483,-,-
BAC150_P02,11,11p11.2,45165269,45242666,77397,-,-
BAC56_I24,11,11p11.2,45206413,45325662,119249,-,-
BAC224_H14,11,11p11.2,45242660,45317024,74364,-,-
BAC55_D16,11,11p11.2,45291691,45404850,113159,-,-
BAC130_J08,11,11p11.2,45359913,45375755,15842,-,-
BAC232_L03,11,11p11.2,45371811,45456831,85020,-,-
BAC220_I18,11,11p11.2,45371841,45456831,84990,-,-
BAC119_M24,11,11p11.2,45371841,45470263,98422,-,-
BAC230_M21,11,11p11.2,45388638,45486891,98253,-,-
BAC202_N18,11,11p11.2,45388918,45517110,128192,-,-
BAC12_L23,11,11p11.2,45438851,45527881,89030,-,-
BAC34_O21,11,11p11.2,45457270,45638001,180731,-,-
BAC55_G08,11,11p11.2,45457283,45565533,108250,-,-
BAC232_D01,11,11p11.2,45479867,45592147,112280,-,-
BAC195_B13,11,11p11.2,45479876,45567942,88066,-,-
BAC224_B17,11,11p11.2,45486916,45570100,83184,-,-
BAC181_J20,11,11p11.2,45521921,45638006,116085,-,-
BAC149_P19,11,11p11.2,45698146,45765700,67554,-,-
BAC223_K13,11,11p11.2,45769990,45856227,86237,-,-
BAC66_A17,11,11p11.2,45808187,45930810,122623,-,-
BAC58_O19,11,11p11.2,45844027,45945118,101091,-,-
BAC80_H06,11,11p11.2,45861929,45941547,79618,-,-
BAC21_E14,11,11p11.2,45998990,46077350,78360,-,-
BAC196_K03,11,11p11.2,46112441,46193924,81483,-,-
BAC150_N06,11,11p11.2,46123434,46251762,128328,-,-
BAC105_E12,11,11p11.2,46195917,46214917,19000,-,-
BAC242_E08,11,11p11.2,46221362,46309249,87887,-,-
BAC196_F05,11,11p11.2,46251755,46355765,104010,-,-
BAC191_P21,11,11p11.2,46265444,46355765,90321,-,-
BAC31_E02,11,11p11.2,46346531,46440420,93889,-,-
BAC124_L22,11,11p11.2,46353538,46470495,116957,-,-
BAC135_F05,11,11p11.2,46353660,46440423,86763,-,-
BAC133_M17,11,11p11.2,46353662,46440421,86759,-,-
BAC135_M18,11,11p11.2,46361845,46485998,124153,-,-
BAC90_P10,11,11p11.2,46393689,46519140,125451,-,-
BAC108_B17,11,11p11.2,46470500,46602562,132062,-,-
BAC176_O20,11,11p11.2,46486271,46599588,113317,-,-
BAC233_F09,11,11p11.2,46537978,46664503,126525,-,-
BAC244_L04,11,11p11.2,46538601,46627767,89166,-,-
BAC168_H05,11,11p11.2,46580009,46670735,90726,-,-
BAC96_D13,11,11p11.2,46580009,46670735,90726,-,-
BAC149_A04,11,11p11.2,46604107,46729738,125631,-,-
BAC12_M07,11,11p11.2,46615893,46745884,129991,-,-
BAC151_G14,11,11p11.2,46632437,46726552,94115,-,-
BAC75_B20,11,11p11.2,46733360,46836098,102738,-,-
BAC92_P24,11,11p11.2,46741919,46845908,103989,-,-
BAC197_C17,11,11p11.2,46806546,46925898,119352,-,-
BAC106_O07,11,11p11.2,46854516,46981301,126785,-,-
BAC64_D07,11,11p11.2,46854969,46975377,120408,-,-
BAC88_M09,11,11p11.2,46869617,46977676,108059,-,-
BAC67_J22,11,11p11.2,46998470,47101286,102816,-,-
BAC106_D11,11,11p11.2,47049018,47178379,129361,-,-
BAC33_M02,11,11p11.2,47180772,47266990,86218,-,-
BAC225_B10,11,11p11.2,47219779,47308293,88514,-,-
BAC162_A16,11,11p11.2,47230891,47322345,91454,-,-
BAC195_B09,11,11p11.2,47230897,47322345,91448,-,-
BAC184_K10,11,11p11.2,47279700,47299051,19351,-,-
BAC180_D19,11,11p11.2,47282002,47429974,147972,-,-
BAC231_E07,11,11p11.2,47299160,47381307,82147,-,-
BAC56_B17,11,11p11.2,47372555,47499583,127028,-,-
BAC143_H22,11,11p11.2,47421466,47492494,71028,-,-
BAC246_O09,11,11p11.2,47435078,47553634,118556,-,-
BAC12_K19,11,11p11.2,47576653,47657388,80735,-,-
BAC78_O05,11,11p11.2,47576932,47683084,106152,-,-
BAC191_F01,11,11p11.2,47585188,47662056,76868,-,-
BAC109_H05,11,11p11.2,47585282,47703320,118038,-,-
BAC156_E02,11,11p11.2,47623223,47706347,83124,-,-
BAC64_G02,11,11p11.2,47662116,47777069,114953,-,-
BAC118_O02,11,11p11.2,47662117,47777069,114952,-,-
BAC226_A24,11,11p11.2,47688509,47794712,106203,-,-
BAC147_K20,11,11p11.2,47688509,47808963,120454,-,-
BAC137_I14,11,11p11.2,47698912,47811934,113022,-,-
BAC48_K01,11,11p11.2,47703323,47853245,149922,-,-
BAC143_N05,11,11p11.2,47734153,47777069,42916,-,-
BAC34_B17,11,11p11.2,47762843,47920107,157264,-,-
BAC34_B18,11,11p11.2,47762843,47920107,157264,-,-
BAC34_A18,11,11p11.2,47762843,47920107,157264,-,-
BAC162_M20,11,11p11.2,47850551,47916321,65770,-,-
BAC235_A19,11,11p11.2,47866369,47947565,81196,-,-
BAC57_B15,11,11p11.2,47902582,47947585,45003,-,-
BAC86_F20,11,11p11.2,47916315,48038734,122419,-,-
BAC70_P17,11,11p11.2,47933650,48057283,123633,-,-
BAC243_G07,11,11p11.2,47933704,48027203,93499,-,-
BAC140_M01,11,11p11.2,47947578,48026927,79349,-,-
BAC224_D23,11,11p11.2,47947578,48030197,82619,-,-
BAC90_O19,11,11p11.2,47984940,48079304,94364,-,-
BAC69_J15,11,11p11.2,48028049,48131923,103874,-,-
BAC78_M24,11,11p11.2,48030192,48104229,74037,-,-
BAC16_I18,11,11p11.2,48059932,48159135,99203,-,-
BAC41_J21,11,11p11.2,48118772,48217276,98504,-,-
BAC186_M07,11,11p11.2,48206101,48307387,101286,-,-
BAC223_J11,11,11p11.2,48276941,48363499,86558,-,-
BAC156_K19,11,11p11.2,48276963,48363507,86544,-,-
BAC69_G02,11,11p11.2,48277351,48409658,132307,-,-
BAC122_D06,11,11p11.2,48399490,48504476,104986,-,-
BAC183_A19,11,11p11.12,48906925,49010447,103522,-,-
BAC161_J04,11,11p11.12,48909711,48995462,85751,-,-
BAC162_A14,11,11p11.12,49023685,49172218,148533,-,-
BAC124_I12,11,11p11.12,49023685,49106576,82891,-,-
BAC167_F14,11,11p11.12,49168616,49255395,86779,-,-
BAC176_O11,11,11p11.12,49195172,49304891,109719,-,-
BAC173_E24,11,11p11.12,49286633,49364369,77736,-,-
BAC88_G24,11,11p11.12,49340433,49433033,92600,-,-
BAC118_D02,11,11p11.12,49526925,49628822,101897,-,-
BAC241_F05,11,11p11.12,49584605,49618652,34047,-,-
BAC43_O17,11,11p11.12,49755702,49864994,109292,-,-
BAC59_H09,11,11p11.12,49786235,49878646,92411,-,-
BAC127_O07,11,11p11.12,50100030,50244662,144632,-,-
BAC144_O10,11,11p11.12,50100902,50244116,143214,-,-
BAC95_B24,11,11p11.12,50117953,50203852,85899,-,-
BAC34_G05,11,11p11.12,50131431,50244662,113231,-,-
BAC183_A17,11,11p11.12,51239191,51321382,82191,-,-
BAC76_C04,11,11p11.12,51239191,51347237,108046,-,-
BAC244_P10,11,11q11,54767580,54858139,90559,-,-
BAC67_E01,11,11q11,54952344,55076085,123741,-,-
BAC30_C19,11,11q11,54952344,55045987,93643,-,-
BAC144_P19,11,11q11,55213347,55353532,140185,-,-
BAC162_K16,11,11q11,55287236,55385026,97790,-,-
BAC163_C16,11,11q11,55346825,55436174,89349,-,-
BAC34_B14,11,11q11,55418599,55513710,95111,-,-
BAC34_B13,11,11q11,55418599,55513710,95111,-,-
BAC112_E03,11,11q11,55431414,55523050,91636,-,-
BAC145_E20,11,11q11,55802750,55887440,84690,-,-
BAC24_N13,11,11q11,55946806,56069070,122264,-,-
BAC248_J05,11,11q11,55966138,56071867,105729,-,-
BAC227_D19,11,11q11,56174645,56235781,61136,-,-
BAC42_D02,11,11q11-11q12.1,56267928,56415000,147072,-,-
BAC125_I15,11,11q11,56291649,56398729,107080,-,-
BAC231_E01,11,11q12.1,56453005,56547640,94635,-,-
BAC52_G09,11,11q12.1,56456616,56547640,91024,-,-
BAC91_C14,11,11q12.1,56643772,56735800,92028,-,-
BAC233_O15,11,11q12.1,56791644,56915661,124017,-,-
BAC198_P24,11,11q12.1,56818653,56907668,89015,-,-
BAC159_J07,11,11q12.1,56859880,56974946,115066,-,-
BAC200_L14,11,11q12.1,56915672,57006834,91162,-,-
BAC157_E13,11,11q12.1,56944751,57037243,92492,-,-
BAC157_F13,11,11q12.1,56944751,57037243,92492,-,-
BAC192_H15,11,11q12.1,56974980,57055789,80809,-,-
BAC132_J09,11,11q12.1,57007059,57087007,79948,-,-
BAC58_P22,11,11q12.1,57022268,57116800,94532,-,-
BAC127_M24,11,11q12.1,57051950,57154442,102492,-,-
BAC228_P19,11,11q12.1,57192749,57290464,97715,-,-
BAC177_M15,11,11q12.1,57255783,57336973,81190,-,-
BAC190_D10,11,11q12.1,57313830,57400374,86544,-,-
BAC26_F24,11,11q12.1,57336967,57499081,162114,-,-
BAC123_I04,11,11q12.1,57347565,57372674,25109,-,-
BAC128_A12,11,11q12.1,57476960,57628268,151308,-,-
BAC43_C21,11,11q12.1,57499110,57616847,117737,-,-
BAC88_B21,11,11q12.1,57505845,57614566,108721,-,-
BAC15_G05,11,11q12.1,57621331,57714449,93118,-,-
BAC168_L07,11,11q12.1,57622847,57712751,89904,-,-
BAC224_I10,11,11q12.1,57642930,57721909,78979,-,-
BAC42_D10,11,11q12.1,57675628,57778788,103160,-,-
BAC48_N11,11,11q12.1,57736698,57834744,98046,-,-
BAC55_J11,11,11q12.1,57840563,57946710,106147,-,-
BAC41_O23,11,11q12.1,57893409,58040011,146602,-,-
BAC167_J09,11,11q12.1,57908007,58025275,117268,-,-
BAC140_L02,11,11q12.1,57930942,58025608,94666,-,-
BAC96_O03,11,11q12.1,57931251,58054893,123642,-,-
BAC51_E03,11,11q12.1,57946703,58046834,100131,-,-
BAC231_M15,11,11q12.1,57946703,58046856,100153,-,-
BAC110_O16,11,11q12.1,57953840,58077045,123205,-,-
BAC19_J13,11,11q12.1,58019139,58131399,112260,-,-
BAC167_B20,11,11q12.1,58137074,58209175,72101,-,-
BAC125_P07,11,11q12.1,58150864,58244203,93339,-,-
BAC204_N15,11,11q12.1,58154358,58251035,96677,-,-
BAC27_H12,11,11q12.1,58456348,58533887,77539,-,-
BAC199_I09,11,11q12.1,58487772,58583853,96081,-,-
BAC247_I02,11,11q12.1,58583877,58690841,106964,-,-
BAC82_M23,11,11q12.1,58589854,58717085,127231,-,-
BAC252_P01,11,11q12.1,58605185,58681970,76785,-,-
BAC131_F17,11,11q12.1,58626314,58721908,95594,-,-
BAC108_F17,11,11q12.1,58633017,58750540,117523,-,-
BAC144_M15,11,11q12.1,58749546,58845202,95656,-,-
BAC167_C23,11,11q12.1,58768757,58848506,79749,-,-
BAC158_H18,11,11q12.1,58773728,58849939,76211,-,-
BAC11_E05,11,11q12.1,58924507,59021376,96869,-,-
BAC169_J16,11,11q12.1,58980605,59083013,102408,-,-
BAC50_K14,11,11q12.1,58980638,59120521,139883,-,-
BAC217_O01,11,11q12.1,59056996,59174562,117566,-,-
BAC150_H08,11,11q12.1,59116248,59190301,74053,-,-
BAC203_G19,11,11q12.1,59116358,59230302,113944,-,-
BAC213_N15,11,11q12.1,59136716,59230289,93573,-,-
BAC52_K15,11,11q12.1,59201247,59366868,165621,-,-
BAC197_M24,11,11q12.1,59318802,59425756,106954,-,-
BAC187_G19,11,11q12.1,59443122,59524666,81544,-,-
BAC218_M10,11,11q12.1,59478796,59568876,90080,-,-
BAC170_K20,11,11q12.1,59520839,59609014,88175,-,-
BAC129_J13,11,11q12.1,59524692,59632512,107820,-,-
BAC222_E07,11,11q12.1-11q12.2,59650721,59738895,88174,-,-
BAC108_P13,11,11q12.1-11q12.2,59654018,59769413,115395,-,-
BAC201_C03,11,11q12.2,59720903,59811055,90152,-,-
BAC124_P23,11,11q12.2,59732428,59750757,18329,-,-
BAC240_E20,11,11q12.2,59751017,59840236,89219,-,-
BAC167_I01,11,11q12.2,59898411,60010922,112511,-,-
BAC53_N04,11,11q12.2,59968519,60070240,101721,-,-
BAC252_F03,11,11q12.2,59968578,60127224,158646,-,-
BAC97_E21,11,11q12.2,60054161,60171813,117652,-,-
BAC162_K05,11,11q12.2,60161978,60273121,111143,-,-
BAC58_N08,11,11q12.2,60191579,60285706,94127,-,-
BAC50_L17,11,11q12.2,60197376,60285380,88004,-,-
BAC59_O02,11,11q12.2,60215333,60296589,81256,-,-
BAC57_D06,11,11q12.2,60215553,60341196,125643,-,-
BAC10_F02,11,11q12.2,60244798,60341177,96379,-,-
BAC156_G24,11,11q12.2,60262442,60368179,105737,-,-
BAC59_E09,11,11q12.2,60296585,60406164,109579,-,-
BAC173_G09,11,11q12.2,60308064,60406141,98077,-,-
BAC184_A16,11,11q12.2,60330694,60423155,92461,-,-
BAC217_L03,11,11q12.2,60368173,60509089,140916,-,-
BAC24_H23,11,11q12.2,60448331,60561073,112742,-,-
BAC141_I20,11,11q12.2,60450747,60561078,110331,-,-
BAC101_B24,11,11q12.2,60450747,60561078,110331,-,-
BAC107_A07,11,11q12.2,60450748,60561078,110330,-,-
BAC143_L21,11,11q12.2,60455343,60523198,67855,-,-
BAC103_J24,11,11q12.2,60481989,60593652,111663,-,-
BAC218_F01,11,11q12.2,60481989,60589182,107193,-,-
BAC234_B14,11,11q12.2,60509249,60622299,113050,-,-
BAC239_F02,11,11q12.2,60658659,60731719,73060,-,-
BAC152_J13,11,11q12.2,60669716,60809454,139738,-,-
BAC78_D17,11,11q12.2,60670872,60809526,138654,-,-
BAC252_O23,11,11q12.2,60676991,60835787,158796,-,-
BAC220_C10,11,11q12.2,60709165,60731710,22545,-,-
BAC125_C02,11,11q12.2,60731715,60835787,104072,-,-
BAC59_G15,11,11q12.2,60731715,60865966,134251,-,-
BAC141_G17,11,11q12.2,60744083,60866278,122195,-,-
BAC218_H19,11,11q12.2,60744083,60835787,91704,-,-
BAC80_C11,11,11q12.2,60744083,60850631,106548,-,-
BAC108_J08,11,11q12.2,60744083,60845951,101868,-,-
BAC60_D12,11,11q12.2,60809547,60935550,126003,-,-
BAC237_C16,11,11q12.2,60925426,61037288,111862,-,-
BAC228_K18,11,11q12.2,60948179,61037743,89564,-,-
BAC51_M12,11,11q12.2,60993473,61097443,103970,-,-
BAC168_H09,11,11q12.2,60993473,61081947,88474,-,-
BAC228_A08,11,11q12.2,61021993,61101158,79165,-,-
BAC54_N04,11,11q12.2,61046636,61163928,117292,-,-
BAC163_O17,11,11q12.2,61061063,61194718,133655,-,-
BAC54_O02,11,11q12.2,61065611,61157232,91621,-,-
BAC151_P15,11,11q12.2,61089894,61247090,157196,-,-
BAC171_L17,11,11q12.2,61120273,61233051,112778,-,-
BAC148_E24,11,11q12.2,61121595,61205874,84279,-,-
BAC36_K05,11,11q12.2,61222569,61318879,96310,-,-
BAC234_A15,11,11q12.2,61222570,61366814,144244,-,-
BAC89_L12,11,11q12.2,61266029,61366813,100784,-,-
BAC202_G12,11,11q12.3,61405410,61521092,115682,-,-
BAC123_K09,11,11q12.3,61486538,61575463,88925,-,-
BAC147_H23,11,11q12.3,61486664,61574759,88095,-,-
BAC119_D21,11,11q12.3,61510892,61698715,187823,-,-
BAC83_K20,11,11q12.3,61555616,61644748,89132,-,-
BAC51_H12,11,11q12.3,61574038,61684616,110578,-,-
BAC57_I21,11,11q12.3,61575381,61680581,105200,-,-
BAC67_E11,11,11q12.3,61612398,61717096,104698,-,-
BAC122_G15,11,11q12.3,61730311,61828948,98637,-,-
BAC89_A18,11,11q12.3,61795257,61905839,110582,-,-
BAC144_M22,11,11q12.3,61806248,61907258,101010,-,-
BAC19_H11,11,11q12.3,61822312,61898749,76437,-,-
BAC57_D17,11,11q12.3,61886107,62000859,114752,-,-
BAC172_E22,11,11q12.3,61905860,62000666,94806,-,-
BAC62_N15,11,11q12.3,61905928,62000666,94738,-,-
BAC192_C24,11,11q12.3,61944030,62020846,76816,-,-
BAC113_L12,11,11q12.3,61960514,62042289,81775,-,-
BAC195_K21,11,11q12.3,62039070,62105530,66460,-,-
BAC232_H10,11,11q12.3,62039115,62156577,117462,-,-
BAC119_M18,11,11q12.3,62042397,62132923,90526,-,-
BAC163_K11,11,11q12.3,62048588,62132925,84337,-,-
BAC241_O17,11,11q12.3,62076910,62161946,85036,-,-
BAC59_N05,11,11q12.3,62157261,62288225,130964,-,-
BAC167_H15,11,11q12.3,62157697,62266082,108385,-,-
BAC238_A22,11,11q12.3,62274511,62359499,84988,-,-
BAC139_J02,11,11q12.3,62359502,62450874,91372,-,-
BAC125_M10,11,11q12.3,62381937,62565031,183094,-,-
BAC101_L11,11,11q12.3,62387911,62503891,115980,-,-
BAC46_P14,11,11q12.3,62423293,62529127,105834,-,-
BAC118_I15,11,11q12.3,62426104,62516295,90191,-,-
BAC244_B20,11,11q12.3,62461385,62550676,89291,-,-
BAC58_N02,11,11q12.3,62529145,62625121,95976,-,-
BAC53_M06,11,11q12.3,62772556,62906333,133777,-,-
BAC148_M03,11,11q12.3,62785724,62890120,104396,-,-
BAC141_J01,11,11q12.3,62843763,62928786,85023,-,-
BAC73_P22,11,11q12.3,62909783,62984971,75188,-,-
BAC179_B10,11,11q12.3,62953205,63029522,76317,-,-
BAC69_G07,11,11q12.3-11q13.1,63004404,63118510,114106,-,-
BAC154_E07,11,11q12.3-11q13.1,63076052,63151335,75283,-,-
BAC33_F11,11,11q13.1,63122377,63238416,116039,-,-
BAC91_B01,11,11q13.1,63123412,63238344,114932,-,-
BAC167_B15,11,11q13.1,63238591,63335216,96625,-,-
BAC127_O22,11,11q13.1,63239028,63347296,108268,-,-
BAC57_E14,11,11q13.1,63243426,63335216,91790,-,-
BAC200_C15,11,11q13.1,63409399,63546906,137507,-,-
BAC139_H14,11,11q13.1,63455820,63576306,120486,-,-
BAC233_K23,11,11q13.1,63476401,63599426,123025,-,-
BAC25_G21,11,11q13.1,63624447,63717076,92629,-,-
BAC125_G02,11,11q13.1,63753861,63859502,105641,-,-
BAC40_N16,11,11q13.1,63787459,63908850,121391,-,-
BAC228_L09,11,11q13.1,63831959,63913853,81894,-,-
BAC184_P15,11,11q13.1,63846502,63913844,67342,-,-
BAC168_P14,11,11q13.1,63859551,63943994,84443,-,-
BAC196_F14,11,11q13.1,63859565,63943994,84429,-,-
BAC58_G24,11,11q13.1,63945646,64048801,103155,-,-
BAC248_P10,11,11q13.1,64154447,64241706,87259,-,-
BAC63_J11,11,11q13.1,64172454,64280400,107946,-,-
BAC224_B24,11,11q13.1,64198843,64274424,75581,-,-
BAC26_N22,11,11q13.1,64280461,64388226,107765,-,-
BAC76_D03,11,11q13.1,64300845,64414894,114049,-,-
BAC135_L23,11,11q13.1,64315784,64414895,99111,-,-
BAC136_O20,11,11q13.1,64319150,64414895,95745,-,-
BAC248_E18,11,11q13.1,64383154,64458121,74967,-,-
BAC169_I08,11,11q13.1,64458131,64575245,117114,-,-
BAC42_N19,11,11q13.1,64461343,64575240,113897,-,-
BAC198_O20,11,11q13.1,64498399,64590349,91950,-,-
BAC155_D03,11,11q13.1,64498399,64575242,76843,-,-
BAC189_L10,11,11q13.1,64501583,64575245,73662,-,-
BAC43_L12,11,11q13.1,64530951,64620412,89461,-,-
BAC242_L09,11,11q13.1,64530971,64626374,95403,-,-
BAC122_I18,11,11q13.1,64569404,64660684,91280,-,-
BAC11_F14,11,11q13.1,64569421,64659858,90437,-,-
BAC224_N15,11,11q13.1,64622941,64714361,91420,-,-
BAC55_F18,11,11q13.1,64660682,64736163,75481,-,-
BAC158_H07,11,11q13.1,64669250,64776040,106790,-,-
BAC151_D22,11,11q13.1,64689817,64813482,123665,-,-
BAC215_G08,11,11q13.1,64689817,64777029,87212,-,-
BAC181_O11,11,11q13.1,64696596,64776037,79441,-,-
BAC60_A08,11,11q13.1,64714378,64804498,90120,-,-
BAC224_A12,11,11q13.1,64736173,64825115,88942,-,-
BAC215_K06,11,11q13.1,64736173,64824689,88516,-,-
BAC157_F17,11,11q13.1,64788751,64875777,87026,-,-
BAC58_L14,11,11q13.1,64813950,64897958,84008,-,-
BAC143_G02,11,11q13.1,64854010,64962048,108038,-,-
BAC192_C22,11,11q13.1,64879877,64969213,89336,-,-
BAC15_G14,11,11q13.1,64936818,65013819,77001,-,-
BAC151_O03,11,11q13.1,65111809,65159146,47337,-,-
BAC148_J09,11,11q13.1,65127466,65279190,151724,-,-
BAC217_K21,11,11q13.1,65127474,65317081,189607,-,-
BAC59_J05,11,11q13.1,65128280,65299101,170821,-,-
BAC217_C22,11,11q13.1,65190076,65288791,98715,-,-
BAC50_G15,11,11q13.1,65190076,65288560,98484,-,-
BAC233_K02,11,11q13.1,65190189,65288598,98409,-,-
BAC143_M07,11,11q13.1,65212404,65357138,144734,-,-
BAC204_C20,11,11q13.1,65230489,65346942,116453,-,-
BAC101_H10,11,11q13.1,65269151,65357138,87987,-,-
BAC69_J17,11,11q13.1,65323447,65425645,102198,-,-
BAC222_D23,11,11q13.1,65357177,65461803,104626,-,-
BAC66_D01,11,11q13.1,65403319,65515824,112505,-,-
BAC239_M19,11,11q13.1,65414440,65482435,67995,-,-
BAC183_B10,11,11q13.1,65510828,65603718,92890,-,-
BAC128_J04,11,11q13.1,65515983,65629945,113962,-,-
BAC219_D04,11,11q13.1,65621706,65715677,93971,-,-
BAC149_E07,11,11q13.1,65695994,65804304,108310,-,-
BAC110_A03,11,11q13.1,65707348,65836667,129319,-,-
BAC230_G18,11,11q13.1,65804298,65901775,97477,-,-
BAC27_H09,11,11q13.1,65804298,65940673,136375,-,-
BAC220_K14,11,11q13.1,65849022,65940727,91705,-,-
BAC143_P11,11,11q13.1,65868340,65940724,72384,-,-
BAC136_D15,11,11q13.1,65882787,65982313,99526,-,-
BAC147_P09,11,11q13.1,65951675,66033297,81622,-,-
BAC143_P08,11,11q13.1,65951675,66033299,81624,-,-
BAC101_I12,11,11q13.1,65951675,66033297,81622,-,-
BAC175_C16,11,11q13.1,66033394,66114833,81439,-,-
BAC50_C08,11,11q13.1,66052393,66197937,145544,-,-
BAC109_I10,11,11q13.1,66065947,66197857,131910,-,-
BAC157_P11,11,11q13.1,66115819,66197925,82106,-,-
BAC15_K19,11,11q13.1,66122153,66230112,107959,-,-
BAC152_F12,11,11q13.1,66124457,66233019,108562,-,-
BAC147_A06,11,11q13.1,66197931,66324599,126668,-,-
BAC154_H06,11,11q13.1,66198241,66299590,101349,-,-
BAC236_F19,11,11q13.1,66200947,66283935,82988,-,-
BAC179_E20,11,11q13.1,66200947,66276812,75865,-,-
BAC250_A11,11,11q13.1,66200948,66283935,82987,-,-
BAC120_N21,11,11q13.1,66232526,66328388,95862,-,-
BAC91_O15,11,11q13.1,66284177,66391875,107698,-,-
BAC118_P21,11,11q13.1,66296606,66434541,137935,-,-
BAC70_B06,11,11q13.1,66299585,66394127,94542,-,-
BAC163_O02,11,11q13.1,66316904,66411162,94258,-,-
BAC90_A15,11,11q13.1,66391148,66485535,94387,-,-
BAC168_N20,11,11q13.1,66417946,66513824,95878,-,-
BAC90_H13,11,11q13.1,66638305,66737307,99002,-,-
BAC12_J15,11,11q13.1,66650785,66832038,181253,-,-
BAC224_K01,11,11q13.1,66742671,66839705,97034,-,-
BAC200_M17,11,11q13.1,66758215,66839688,81473,-,-
BAC2_A18,11,11q13.1,66758216,66857568,99352,-,-
BAC181_E04,11,11q13.1,66839707,66942002,102295,-,-
BAC150_L16,11,11q13.1,66941997,67042635,100638,-,-
BAC230_O01,11,11q13.1-11q13.2,67058464,67116154,57690,-,-
BAC58_B02,11,11q13.2,67109930,67252095,142165,-,-
BAC50_L24,11,11q13.2,67150837,67292370,141533,-,-
BAC156_P24,11,11q13.2,67155927,67292385,136458,-,-
BAC151_O21,11,11q13.2,67174143,67283244,109101,-,-
BAC180_D05,11,11q13.2,67226014,67352369,126355,-,-
BAC31_A01,11,11q13.2,67264740,67362958,98218,-,-
BAC124_J11,11,11q13.2,67264888,67361318,96430,-,-
BAC229_N11,11,11q13.2,67272569,67346957,74388,-,-
BAC27_P21,11,11q13.2,67362968,67482707,119739,-,-
BAC157_A01,11,11q13.2,67377864,67468005,90141,-,-
BAC113_B06,11,11q13.2,67405023,67482707,77684,-,-
BAC20_F02,11,11q13.2,67429015,67549856,120841,-,-
BAC219_A24,11,11q13.2,67455616,67518174,62558,-,-
BAC244_N17,11,11q13.2,67468037,67549866,81829,-,-
BAC67_F19,11,11q13.2,67475944,67616614,140670,-,-
BAC62_C18,11,11q13.2,67488405,67586400,97995,-,-
BAC134_L13,11,11q13.2,67502880,67599345,96465,-,-
BAC95_O03,11,11q13.2,67518167,67621513,103346,-,-
BAC62_L14,11,11q13.2,67518209,67667582,149373,-,-
BAC109_K23,11,11q13.2,67586430,67632362,45932,-,-
BAC36_M14,11,11q13.2,67600084,67728039,127955,-,-
BAC27_B19,11,11q13.2,67738539,67889064,150525,-,-
BAC239_M14,11,11q13.2,67738539,67812258,73719,-,-
BAC230_E03,11,11q13.2,67753603,67839758,86155,-,-
BAC69_G20,11,11q13.2,67846040,67974433,128393,-,-
BAC39_K02,11,11q13.2,67853135,67981392,128257,-,-
BAC158_L05,11,11q13.2,67889062,67986456,97394,-,-
BAC142_C10,11,11q13.2,67889086,68005543,116457,-,-
BAC128_I07,11,11q13.2,67893854,68049984,156130,-,-
BAC150_L20,11,11q13.2,67974775,68068678,93903,-,-
BAC45_M04,11,11q13.2,68012663,68149118,136455,-,-
BAC225_P14,11,11q13.2,68108879,68235844,126965,-,-
BAC69_E17,11,11q13.2,68136916,68236703,99787,-,-
BAC97_N07,11,11q13.2,68179350,68292780,113430,-,-
BAC52_M17,11,11q13.2,68290712,68407000,116288,-,-
BAC241_H14,11,11q13.2,68300969,68406690,105721,-,-
BAC238_L22,11,11q13.2,68318256,68398038,79782,-,-
BAC72_K16,11,11q13.2,68335602,68456740,121138,-,-
BAC129_D18,11,11q13.2,68456762,68519150,62388,-,-
BAC134_L07,11,11q13.2,68552447,68672701,120254,-,-
BAC186_F15,11,11q13.2,68576372,68672689,96317,-,-
BAC234_L07,11,11q13.2,68672693,68754017,81324,-,-
BAC134_M09,11,11q13.2,68673438,68768466,95028,-,-
BAC102_F21,11,11q13.2,68699126,68792545,93419,-,-
BAC115_D17,11,11q13.2,68912342,69040539,128197,-,-
BAC228_B05,11,11q13.2,68912357,68980813,68456,-,-
BAC252_F11,11,11q13.2,68946033,69070159,124126,-,-
BAC198_H02,11,11q13.2,68953563,69057916,104353,-,-
BAC147_A22,11,11q13.2,68979500,69061696,82196,-,-
BAC133_C10,11,11q13.2,68979741,69058898,79157,-,-
BAC38_K22,11,11q13.2,68979950,69117309,137359,-,-
BAC39_F05,11,11q13.2,68979951,69057916,77965,-,-
BAC40_E24,11,11q13.2,69072913,69195570,122657,-,-
BAC67_N13,11,11q13.2,69081284,69195569,114285,-,-
BAC220_G02,11,11q13.2,69118629,69195501,76872,-,-
BAC41_F11,11,11q13.2-11q13.3,69152010,69282447,130437,-,-
BAC185_M24,11,11q13.3,69236764,69325643,88879,-,-
BAC165_E11,11,11q13.3,69236764,69325641,88877,-,-
BAC72_K08,11,11q13.3,69266903,69383149,116246,-,-
BAC223_N03,11,11q13.3,69266904,69371817,104913,-,-
BAC82_M03,11,11q13.3,69385486,69499328,113842,-,-
BAC53_M10,11,11q13.3,69425729,69544378,118649,-,-
BAC44_N13,11,11q13.3,69463992,69575186,111194,-,-
BAC155_C18,11,11q13.3,69575757,69703796,128039,-,-
BAC27_F22,11,11q13.3,69596413,69703797,107384,-,-
BAC117_E22,11,11q13.3,69623428,69754710,131282,-,-
BAC26_N11,11,11q13.3,69652430,69766585,114155,-,-
BAC42_B01,11,11q13.3,69708927,69823456,114529,-,-
BAC45_K11,11,11q13.3,69731885,69854988,123103,-,-
BAC158_G15,11,11q13.3,69766582,69875483,108901,-,-
BAC111_B16,11,11q13.3,69796745,69890591,93846,-,-
BAC235_H03,11,11q13.3,69823455,69934505,111050,-,-
BAC180_M15,11,11q13.3,69884798,70001174,116376,-,-
BAC75_E17,11,11q13.3,69888378,70001121,112743,-,-
BAC65_O02,11,11q13.3,69893725,70001178,107453,-,-
BAC179_C16,11,11q13.3,69934499,70029893,95394,-,-
BAC19_C11,11,11q13.3,70008700,70035051,26351,-,-
BAC179_F19,11,11q13.3,70034742,70150240,115498,-,-
BAC166_G22,11,11q13.3,70049602,70080902,31300,-,-
BAC129_D19,11,11q13.3,70090080,70170064,79984,-,-
BAC90_M10,11,11q13.3,70097402,70222480,125078,-,-
BAC103_N04,11,11q13.3,70197926,70326037,128111,-,-
BAC184_O04,11,11q13.3,70197929,70297033,99104,-,-
BAC160_P02,11,11q13.3,70292292,70374073,81781,-,-
BAC150_P20,11,11q13.3,70323804,70440259,116455,-,-
BAC145_B20,11,11q13.3,70351032,70440259,89227,-,-
BAC30_M05,11,11q13.3,70519734,70691140,171406,-,-
BAC120_I21,11,11q13.3,70528549,70650107,121558,-,-
BAC199_N20,11,11q13.3,70569257,70656531,87274,-,-
BAC14_A21,11,11q13.3,70579575,70689082,109507,-,-
BAC64_J02,11,11q13.3-11q13.4,70644729,70809893,165164,-,-
BAC118_M14,11,11q13.4,70744298,70834479,90181,-,-
BAC193_H18,11,11q13.4,70766294,70852020,85726,-,-
BAC155_K04,11,11q13.4,70796552,70893001,96449,-,-
BAC143_L11,11,11q13.4,70873931,70993716,119785,-,-
BAC151_B15,11,11q13.4,70886112,70985184,99072,-,-
BAC139_G23,11,11q13.4,70896845,70993716,96871,-,-
BAC65_O14,11,11q13.4,70903517,70987727,84210,-,-
BAC35_K14,11,11q13.4,71004042,71094398,90356,-,-
BAC157_I06,11,11q13.4,71099013,71189915,90902,-,-
BAC42_A13,11,11q13.4,71118781,71275957,157176,-,-
BAC45_I13,11,11q13.4,71127439,71239961,112522,-,-
BAC200_I18,11,11q13.4,71129472,71209088,79616,-,-
BAC146_A12,11,11q13.4,71134640,71245561,110921,-,-
BAC21_P23,11,11q13.4,71240690,71429874,189184,-,-
BAC252_N19,11,11q13.4,71265458,71365665,100207,-,-
BAC144_D05,11,11q13.4,71317555,71402996,85441,-,-
BAC193_O15,11,11q13.4,71358077,71474082,116005,-,-
BAC58_C04,11,11q13.4,71411424,71507064,95640,-,-
BAC162_L15,11,11q13.4,71456216,71546120,89904,-,-
BAC234_K06,11,11q13.4,71467608,71579609,112001,-,-
BAC200_L04,11,11q13.4,71490545,71599694,109149,-,-
BAC34_M21,11,11q13.4,71490545,71579609,89064,-,-
BAC113_N06,11,11q13.4,71586170,71796338,210168,-,-
BAC108_N13,11,11q13.4,71636704,71730101,93397,-,-
BAC166_B11,11,11q13.4,71641304,71731720,90416,-,-
BAC189_H22,11,11q13.4,71658228,71799961,141733,-,-
BAC78_N05,11,11q13.4,71699167,71808222,109055,-,-
BAC10_F08,11,11q13.4,71739250,71938153,198903,-,-
BAC63_L03,11,11q13.4,71757416,71830611,73195,-,-
BAC148_J16,11,11q13.4,71808437,71895402,86965,-,-
BAC203_N24,11,11q13.4,71827731,71906289,78558,-,-
BAC31_D13,11,11q13.4,71840972,71925337,84365,-,-
BAC148_O24,11,11q13.4,71840976,71930398,89422,-,-
BAC18_I02,11,11q13.4,71906899,72047468,140569,-,-
BAC188_N18,11,11q13.4,71925471,72041472,116001,-,-
BAC113_B04,11,11q13.4,71925485,72047468,121983,-,-
BAC211_I13,11,11q13.4,71948288,72045467,97179,-,-
BAC36_P22,11,11q13.4,72005646,72179119,173473,-,-
BAC158_K17,11,11q13.4,72005649,72141728,136079,-,-
BAC123_K01,11,11q13.4,72152603,72293712,141109,-,-
BAC76_G19,11,11q13.4,72199680,72307812,108132,-,-
BAC236_B07,11,11q13.4,72204216,72324568,120352,-,-
BAC236_O14,11,11q13.4,72205300,72307652,102352,-,-
BAC193_N04,11,11q13.4,72210699,72322423,111724,-,-
BAC55_C08,11,11q13.4,72259291,72377381,118090,-,-
BAC50_K03,11,11q13.4,72424886,72510289,85403,-,-
BAC168_L24,11,11q13.4,72453839,72580328,126489,-,-
BAC122_I20,11,11q13.4,72466842,72581479,114637,-,-
BAC231_K07,11,11q13.4,72704816,72786080,81264,-,-
BAC171_O13,11,11q13.4,72704822,72816290,111468,-,-
BAC168_H19,11,11q13.4,72706113,72790814,84701,-,-
BAC243_G04,11,11q13.4,72714261,72817065,102804,-,-
BAC226_P06,11,11q13.4,72739931,72816290,76359,-,-
BAC226_P05,11,11q13.4,72739931,72816290,76359,-,-
BAC237_N10,11,11q13.4,72856788,72956722,99934,-,-
BAC29_N22,11,11q13.4,72864129,72966742,102613,-,-
BAC172_N10,11,11q13.4,72877762,72956722,78960,-,-
BAC184_I22,11,11q13.4,72880480,72966741,86261,-,-
BAC171_M09,11,11q13.4,72908201,72986032,77831,-,-
BAC120_B08,11,11q13.4,72936183,73085841,149658,-,-
BAC227_O18,11,11q13.4,72956715,73043226,86511,-,-
BAC241_C13,11,11q13.4,72964144,73053590,89446,-,-
BAC96_I02,11,11q13.4,72969512,73095148,125636,-,-
BAC54_O07,11,11q13.4,72984468,73094856,110388,-,-
BAC82_F01,11,11q13.4,72999340,73106908,107568,-,-
BAC236_G11,11,11q13.4,72999340,73078975,79635,-,-
BAC38_P02,11,11q13.4,73003961,73097331,93370,-,-
BAC156_N14,11,11q13.4,73082768,73186186,103418,-,-
BAC194_H17,11,11q13.4,73095222,73202174,106952,-,-
BAC90_G12,11,11q13.4,73137835,73236674,98839,-,-
BAC190_G04,11,11q13.4,73141605,73262134,120529,-,-
BAC26_D10,11,11q13.4,73186218,73291721,105503,-,-
BAC179_D19,11,11q13.4,73218072,73298650,80578,-,-
BAC176_D03,11,11q13.4,73225471,73298725,73254,-,-
BAC244_A17,11,11q13.4,73243812,73323777,79965,-,-
BAC130_D16,11,11q13.4,73293174,73425362,132188,-,-
BAC57_M09,11,11q13.4,73331534,73449113,117579,-,-
BAC104_H08,11,11q13.4,73404098,73560076,155978,-,-
BAC137_B18,11,11q13.4,73533151,73617605,84454,-,-
BAC37_O20,11,11q13.4,73566966,73680512,113546,-,-
BAC197_M15,11,11q13.4,73579160,73669505,90345,-,-
BAC165_C04,11,11q13.4,73581505,73689389,107884,-,-
BAC77_M08,11,11q13.4,73581505,73661558,80053,-,-
BAC82_E15,11,11q13.4,73625987,73724464,98477,-,-
BAC103_A13,11,11q13.4,73639226,73750458,111232,-,-
BAC117_J11,11,11q13.4,73698299,73785911,87612,-,-
BAC53_P17,11,11q13.4,73749890,73863560,113670,-,-
BAC50_O10,11,11q13.4,73852683,73880039,27356,-,-
BAC49_D11,11,11q13.4,73903140,73989862,86722,-,-
BAC175_J07,11,11q13.4,73917318,74003402,86084,-,-
BAC22_A23,11,11q13.4,73940770,74051878,111108,-,-
BAC27_K01,11,11q13.4,73940797,74076992,136195,-,-
BAC235_O20,11,11q13.4,73947343,74035341,87998,-,-
BAC176_C01,11,11q13.4,73951810,74035543,83733,-,-
BAC96_G07,11,11q13.4,74008504,74093873,85369,-,-
BAC72_G01,11,11q13.4,74038743,74123597,84854,-,-
BAC144_L03,11,11q13.4,74054894,74142551,87657,-,-
BAC95_P10,11,11q13.4,74179497,74295454,115957,-,-
BAC238_I21,11,11q13.4,74200279,74295137,94858,-,-
BAC165_F24,11,11q13.4,74256966,74345576,88610,-,-
BAC183_F15,11,11q13.4,74295131,74383185,88054,-,-
BAC194_E19,11,11q13.4,74303979,74392925,88946,-,-
BAC147_P13,11,11q13.4,74319134,74399283,80149,-,-
BAC184_K01,11,11q13.4,74319159,74404165,85006,-,-
BAC54_M11,11,11q13.4,74400166,74508480,108314,-,-
BAC149_C04,11,11q13.4,74402854,74419599,16745,-,-
BAC96_N12,11,11q13.4,74425330,74523451,98121,-,-
BAC84_J02,11,11q13.4,74487715,74627946,140231,-,-
BAC53_F03,11,11q13.4,74489126,74590522,101396,-,-
BAC58_B11,11,11q13.4,74498683,74658892,160209,-,-
BAC196_I18,11,11q13.4,74508473,74603836,95363,-,-
BAC234_F10,11,11q13.4,74509314,74596315,87001,-,-
BAC139_A03,11,11q13.4,74509426,74601352,91926,-,-
BAC136_C02,11,11q13.4,74523612,74601411,77799,-,-
BAC184_E11,11,11q13.4,74572555,74694347,121792,-,-
BAC110_C07,11,11q13.4,74617055,74724282,107227,-,-
BAC180_P02,11,11q13.4,74658897,74750772,91875,-,-
BAC182_G05,11,11q13.4,74659628,74752617,92989,-,-
BAC56_J04,11,11q13.4,74694340,74825420,131080,-,-
BAC110_M08,11,11q13.4,74728509,74830613,102104,-,-
BAC95_B23,11,11q13.4-11q13.5,74847648,74967641,119993,-,-
BAC232_A13,11,11q13.4-11q13.5,74865702,74983887,118185,-,-
BAC165_D16,11,11q13.4-11q13.5,74877388,75008905,131517,-,-
BAC146_G11,11,11q13.5,74918813,75008905,90092,-,-
BAC41_N02,11,11q13.5,75037221,75158696,121475,-,-
BAC27_G16,11,11q13.5,75051207,75145470,94263,-,-
BAC211_G20,11,11q13.5,75051240,75143555,92315,-,-
BAC166_L12,11,11q13.5,75059069,75152009,92940,-,-
BAC58_E18,11,11q13.5,75067139,75144431,77292,-,-
BAC89_J18,11,11q13.5,75073196,75169569,96373,-,-
BAC9_C24,11,11q13.5,75089848,75171899,82051,-,-
BAC67_E09,11,11q13.5,75133608,75219377,85769,-,-
BAC18_P14,11,11q13.5,75133611,75221782,88171,-,-
BAC105_B03,11,11q13.5,75166278,75253481,87203,-,-
BAC228_F23,11,11q13.5,75166335,75318925,152590,-,-
BAC116_D07,11,11q13.5,75229903,75330653,100750,-,-
BAC62_M15,11,11q13.5,75300837,75427745,126908,-,-
BAC180_G11,11,11q13.5,75367356,75457887,90531,-,-
BAC161_J16,11,11q13.5,75436713,75511612,74899,-,-
BAC196_B20,11,11q13.5,75551086,75668594,117508,-,-
BAC189_O10,11,11q13.5,75551086,75661454,110368,-,-
BAC144_O05,11,11q13.5,75551086,75703069,151983,-,-
BAC75_H07,11,11q13.5,75619939,75759918,139979,-,-
BAC175_D08,11,11q13.5,75619939,75715720,95781,-,-
BAC211_M16,11,11q13.5,75631310,75717955,86645,-,-
BAC248_H22,11,11q13.5,75634804,75716029,81225,-,-
BAC83_K15,11,11q13.5,75654545,75766203,111658,-,-
BAC142_P20,11,11q13.5,75711338,75776906,65568,-,-
BAC226_N14,11,11q13.5,75739388,75842251,102863,-,-
BAC199_P12,11,11q13.5,75746237,75830520,84283,-,-
BAC103_K01,11,11q13.5,75757262,75870245,112983,-,-
BAC178_P05,11,11q13.5,75890755,75982057,91302,-,-
BAC23_G18,11,11q13.5,75890755,76009086,118331,-,-
BAC20_E11,11,11q13.5,75903124,76047707,144583,-,-
BAC222_F09,11,11q13.5,75921060,76006179,85119,-,-
BAC144_K18,11,11q13.5,75999160,76120317,121157,-,-
BAC143_G18,11,11q13.5,76009186,76120317,111131,-,-
BAC22_H12,11,11q13.5,76034617,76194733,160116,-,-
BAC195_G16,11,11q13.5,76064575,76185109,120534,-,-
BAC240_D20,11,11q13.5,76066358,76161149,94791,-,-
BAC120_J21,11,11q13.5,76082329,76187201,104872,-,-
BAC168_O16,11,11q13.5,76119955,76199997,80042,-,-
BAC31_M05,11,11q13.5,76120345,76269567,149222,-,-
BAC149_C13,11,11q13.5,76262267,76348133,85866,-,-
BAC38_D14,11,11q13.5,76297407,76458335,160928,-,-
BAC123_D11,11,11q13.5,76318606,76447231,128625,-,-
BAC224_G08,11,11q13.5,76433900,76536082,102182,-,-
BAC157_P04,11,11q13.5,76454123,76536073,81950,-,-
BAC49_D16,11,11q13.5,76547857,76660508,112651,-,-
BAC208_L21,11,11q13.5,76592522,76670998,78476,-,-
BAC100_H12,11,11q13.5,76611714,76692155,80441,-,-
BAC120_L18,11,11q13.5-11q14.1,76611714,76708527,96813,-,-
BAC52_D20,11,11q13.5-11q14.1,76653850,76814726,160876,-,-
BAC249_N23,11,11q14.1,76702433,76795094,92661,-,-
BAC110_C15,11,11q14.1,76712160,76868977,156817,-,-
BAC158_I15,11,11q14.1,76731592,76860928,129336,-,-
BAC158_F15,11,11q14.1,76731592,76860929,129337,-,-
BAC102_F08,11,11q14.1,76836891,76969068,132177,-,-
BAC198_F22,11,11q14.1,76869034,76960958,91924,-,-
BAC75_K16,11,11q14.1,76869599,76984034,114435,-,-
BAC148_G09,11,11q14.1,76899750,76979258,79508,-,-
BAC52_N04,11,11q14.1,76902892,77016384,113492,-,-
BAC182_A09,11,11q14.1,76963162,77048317,85155,-,-
BAC26_G23,11,11q14.1,77016378,77107582,91204,-,-
BAC146_C20,11,11q14.1,77073143,77177191,104048,-,-
BAC40_E13,11,11q14.1,77073143,77198656,125513,-,-
BAC116_P11,11,11q14.1,77146850,77248862,102012,-,-
BAC82_D01,11,11q14.1,77154121,77254987,100866,-,-
BAC30_D14,11,11q14.1,77158643,77248858,90215,-,-
BAC133_O08,11,11q14.1,77194422,77378153,183731,-,-
BAC151_C03,11,11q14.1,77289758,77377154,87396,-,-
BAC205_H01,11,11q14.1,77292354,77366897,74543,-,-
BAC179_A17,11,11q14.1,77378437,77474362,95925,-,-
BAC97_I08,11,11q14.1,77409629,77498289,88660,-,-
BAC89_I11,11,11q14.1,77456783,77549530,92747,-,-
BAC48_P08,11,11q14.1,77458599,77587911,129312,-,-
BAC66_A11,11,11q14.1,77498561,77633090,134529,-,-
BAC170_B04,11,11q14.1,77549644,77650250,100606,-,-
BAC155_F08,11,11q14.1,77552288,77647255,94967,-,-
BAC77_D02,11,11q14.1,77565236,77657013,91777,-,-
BAC103_P06,11,11q14.1,77579876,77657310,77434,-,-
BAC29_D08,11,11q14.1,77579876,77591523,11647,-,-
BAC139_I10,11,11q14.1,77590724,77695341,104617,-,-
BAC122_O15,11,11q14.1,77590724,77695341,104617,-,-
BAC190_P07,11,11q14.1,77590972,77695341,104369,-,-
BAC234_P06,11,11q14.1,77591519,77695341,103822,-,-
BAC6_J18,11,11q14.1,77818147,77907837,89690,-,-
BAC252_A06,11,11q14.1,77832058,77957550,125492,-,-
BAC70_N07,11,11q14.1,77854340,78005439,151099,-,-
BAC115_C17,11,11q14.1,77901494,77990401,88907,-,-
BAC147_H21,11,11q14.1,77976999,78082122,105123,-,-
BAC184_M06,11,11q14.1,78052319,78169909,117590,-,-
BAC233_N19,11,11q14.1,78086405,78169868,83463,-,-
BAC129_H18,11,11q14.1,78162773,78271507,108734,-,-
BAC146_P03,11,11q14.1,78164509,78254580,90071,-,-
BAC83_N22,11,11q14.1,78169931,78271506,101575,-,-
BAC128_A10,11,11q14.1,78181490,78273832,92342,-,-
BAC6_K23,11,11q14.1,78181502,78272910,91408,-,-
BAC23_N10,11,11q14.1,78228847,78320679,91832,-,-
BAC51_I18,11,11q14.1,78271523,78429068,157545,-,-
BAC165_L01,11,11q14.1,78273826,78354270,80444,-,-
BAC92_I04,11,11q14.1,78273826,78355691,81865,-,-
BAC227_I02,11,11q14.1,78327588,78454249,126661,-,-
BAC191_J07,11,11q14.1,78355684,78457642,101958,-,-
BAC59_E05,11,11q14.1,78464722,78568843,104121,-,-
BAC195_A11,11,11q14.1,78467601,78557859,90258,-,-
BAC150_P03,11,11q14.1,78492931,78613836,120905,-,-
BAC240_O19,11,11q14.1,78502259,78582183,79924,-,-
BAC20_D20,11,11q14.1,78502289,78622808,120519,-,-
BAC62_G03,11,11q14.1,78544063,78622865,78802,-,-
BAC55_L11,11,11q14.1,78604920,78709253,104333,-,-
BAC97_K23,11,11q14.1,78645189,78733647,88458,-,-
BAC83_K12,11,11q14.1,78662847,78777534,114687,-,-
BAC160_M04,11,11q14.1,78681385,78782342,100957,-,-
BAC64_A18,11,11q14.1,78694290,78809043,114753,-,-
BAC180_L07,11,11q14.1,78734370,78823496,89126,-,-
BAC135_O19,11,11q14.1,78763410,78865177,101767,-,-
BAC194_C21,11,11q14.1,78925311,79013829,88518,-,-
BAC161_J17,11,11q14.1,78925311,79029515,104204,-,-
BAC175_O22,11,11q14.1,78934173,78989720,55547,-,-
BAC148_E10,11,11q14.1,78976252,79082691,106439,-,-
BAC23_N24,11,11q14.1,79082724,79188766,106042,-,-
BAC32_O08,11,11q14.1,79268014,79377310,109296,-,-
BAC128_F21,11,11q14.1,79355801,79464008,108207,-,-
BAC66_L03,11,11q14.1,79512237,79594411,82174,-,-
BAC31_K12,11,11q14.1,79519333,79620815,101482,-,-
BAC124_M17,11,11q14.1,79793281,79897577,104296,-,-
BAC110_A13,11,11q14.1,79807360,79926022,118662,-,-
BAC194_H01,11,11q14.1,79914063,80037519,123456,-,-
BAC115_J02,11,11q14.1,79984986,80128925,143939,-,-
BAC92_M04,11,11q14.1,80015974,80120947,104973,-,-
BAC80_G05,11,11q14.1,80107907,80205746,97839,-,-
BAC29_D24,11,11q14.1,80136864,80237781,100917,-,-
BAC125_H19,11,11q14.1,80209674,80283151,73477,-,-
BAC186_M12,11,11q14.1,80222085,80309816,87731,-,-
BAC168_B12,11,11q14.1,80314002,80406369,92367,-,-
BAC235_B16,11,11q14.1,80417279,80507270,89991,-,-
BAC222_K22,11,11q14.1,80565213,80658768,93555,-,-
BAC75_I14,11,11q14.1,80599534,80719197,119663,-,-
BAC106_F18,11,11q14.1,80655446,80739691,84245,-,-
BAC150_B21,11,11q14.1,80689950,80768136,78186,-,-
BAC46_M17,11,11q14.1,80719198,80870914,151716,-,-
BAC154_H22,11,11q14.1,80897410,80995179,97769,-,-
BAC160_O14,11,11q14.1,80957434,81034016,76582,-,-
BAC80_J14,11,11q14.1,81134133,81211441,77308,-,-
BAC84_M22,11,11q14.1,81174884,81265960,91076,-,-
BAC220_I22,11,11q14.1,81237646,81316954,79308,-,-
BAC163_O03,11,11q14.1,81251337,81337240,85903,-,-
BAC234_B24,11,11q14.1,81281029,81364974,83945,-,-
BAC34_F09,11,11q14.1,81408787,81504793,96006,-,-
BAC179_N21,11,11q14.1,81720000,81813876,93876,-,-
BAC38_D17,11,11q14.1,81882940,81980823,97883,-,-
BAC244_H10,11,11q14.1,82003109,82085284,82175,-,-
BAC175_A11,11,11q14.1,82017865,82111890,94025,-,-
BAC75_K03,11,11q14.1,82018145,82125321,107176,-,-
BAC163_L15,11,11q14.1,82022427,82112547,90120,-,-
BAC153_M13,11,11q14.1,82069771,82146342,76571,-,-
BAC234_M24,11,11q14.1,82072060,82191817,119757,-,-
BAC69_C21,11,11q14.1,82112540,82268562,156022,-,-
BAC156_G07,11,11q14.1,82112543,82191817,79274,-,-
BAC165_E21,11,11q14.1,82112567,82191817,79250,-,-
BAC74_C04,11,11q14.1,82193992,82304769,110777,-,-
BAC201_A16,11,11q14.1,82212992,82298969,85977,-,-
BAC154_B02,11,11q14.1,82268019,82353292,85273,-,-
BAC118_N10,11,11q14.1,82349936,82445891,95955,-,-
BAC127_M02,11,11q14.1,82376707,82507475,130768,-,-
BAC165_B18,11,11q14.1,82384074,82470976,86902,-,-
BAC131_I13,11,11q14.1,82384352,82470981,86629,-,-
BAC61_E15,11,11q14.1,82440672,82549011,108339,-,-
BAC155_P15,11,11q14.1,82465169,82546999,81830,-,-
BAC225_F17,11,11q14.1,82640403,82740399,99996,-,-
BAC84_G22,11,11q14.1,82656162,82757606,101444,-,-
BAC84_E22,11,11q14.1,82685526,82699491,13965,-,-
BAC130_J14,11,11q14.1,82701090,82800540,99450,-,-
BAC119_L15,11,11q14.1,82757603,82850155,92552,-,-
BAC22_G22,11,11q14.1,82813455,82917017,103562,-,-
BAC230_P08,11,11q14.1,83081576,83212337,130761,-,-
BAC157_J10,11,11q14.1,83082741,83173441,90700,-,-
BAC112_J01,11,11q14.1,83086429,83167876,81447,-,-
BAC50_E07,11,11q14.1,83593917,83676703,82786,-,-
BAC128_C22,11,11q14.1,83725514,83817544,92030,-,-
BAC80_G18,11,11q14.1,83944527,84035286,90759,-,-
BAC150_F05,11,11q14.1,84253261,84340739,87478,-,-
BAC132_J20,11,11q14.1,84255077,84339401,84324,-,-
BAC197_D22,11,11q14.1,84260432,84364210,103778,-,-
BAC135_B04,11,11q14.1,84415188,84503134,87946,-,-
BAC246_P08,11,11q14.1,84469062,84479356,10294,-,-
BAC190_N06,11,11q14.1,84745530,84844110,98580,-,-
BAC18_D19,11,11q14.1,84844549,84973687,129138,-,-
BAC167_G02,11,11q14.1,84856371,84962851,106480,-,-
BAC113_I23,11,11q14.1,84870897,84991538,120641,-,-
BAC214_C05,11,11q14.1,84870898,84985897,114999,-,-
BAC26_L12,11,11q14.1,84896890,84991568,94678,-,-
BAC145_B17,11,11q14.1,84952654,85045518,92864,-,-
BAC38_C17,11,11q14.1,85004901,85073059,68158,-,-
BAC95_P07,11,11q14.1,85106938,85189978,83040,-,-
BAC100_I01,11,11q14.1,85119073,85231742,112669,-,-
BAC217_F13,11,11q14.1-11q14.2,85259229,85350333,91104,-,-
BAC117_N20,11,11q14.1-11q14.2,85296715,85380854,84139,-,-
BAC10_J18,11,11q14.2,85337198,85432680,95482,-,-
BAC60_P11,11,11q14.2,85454737,85558457,103720,-,-
BAC127_P08,11,11q14.2,85505867,85610909,105042,-,-
BAC1_O20,11,11q14.2,85580835,85680155,99320,-,-
BAC140_J02,11,11q14.2,85595222,85680155,84933,-,-
BAC199_O24,11,11q14.2,85606919,85699626,92707,-,-
BAC246_O03,11,11q14.2,85821648,85903379,81731,-,-
BAC189_C23,11,11q14.2,85849937,85939804,89867,-,-
BAC242_O17,11,11q14.2,85864824,85875519,10695,-,-
BAC224_F03,11,11q14.2,85962690,86049065,86375,-,-
BAC66_P14,11,11q14.2,86011550,86173928,162378,-,-
BAC26_A17,11,11q14.2,86065316,86178856,113540,-,-
BAC197_I08,11,11q14.2,86424977,86532052,107075,-,-
BAC38_N11,11,11q14.2,86470844,86619526,148682,-,-
BAC97_C19,11,11q14.2,86520032,86659774,139742,-,-
BAC191_C04,11,11q14.2,86640755,86725547,84792,-,-
BAC156_H08,11,11q14.2,86645247,86743748,98501,-,-
BAC12_G13,11,11q14.2,86739898,86841920,102022,-,-
BAC114_E22,11,11q14.2,86852674,86960321,107647,-,-
BAC37_P15,11,11q14.2,86870120,86972553,102433,-,-
BAC51_D08,11,11q14.2,86920544,86998523,77979,-,-
BAC95_N17,11,11q14.2,86969218,87105177,135959,-,-
BAC192_J18,11,11q14.2,86997487,87071476,73989,-,-
BAC180_L18,11,11q14.2,87165497,87291068,125571,-,-
BAC105_K16,11,11q14.2,87208725,87291066,82341,-,-
BAC37_L04,11,11q14.2,87440367,87552093,111726,-,-
BAC182_H04,11,11q14.2,87445041,87519911,74870,-,-
BAC103_J14,11,11q14.2,87615179,87700874,85695,-,-
BAC100_E08,11,11q14.2,87741383,87887614,146231,-,-
BAC195_P12,11,11q14.2-11q14.3,87805109,87915994,110885,-,-
BAC107_L06,11,11q14.3,87909801,88046708,136907,-,-
BAC148_J24,11,11q14.3,88043459,88144365,100906,-,-
BAC137_G06,11,11q14.3,88155027,88243882,88855,-,-
BAC84_C12,11,11q14.3,88207255,88305634,98379,-,-
BAC166_C22,11,11q14.3,88243954,88347980,104026,-,-
BAC83_L20,11,11q14.3,88542560,88619697,77137,-,-
BAC224_E15,11,11q14.3,88865617,88950917,85300,-,-
BAC88_I11,11,11q14.3,89041738,89124953,83215,-,-
BAC158_D04,11,11q14.3,89666066,89752522,86456,-,-
BAC149_O04,11,11q14.3,89842160,89930158,87998,-,-
BAC146_G19,11,11q14.3,90156291,90230710,74419,-,-
BAC167_K21,11,11q14.3,90714556,90805166,90610,-,-
BAC141_G08,11,11q14.3,90867055,90909040,41985,-,-
BAC135_I24,11,11q14.3,91133412,91233492,100080,-,-
BAC76_O05,11,11q14.3,91224456,91386593,162137,-,-
BAC232_I03,11,11q14.3,91485941,91602268,116327,-,-
BAC184_B04,11,11q14.3,91555160,91647480,92320,-,-
BAC41_N15,11,11q14.3,91590957,91675124,84167,-,-
BAC132_N20,11,11q14.3,91722212,91807282,85070,-,-
BAC33_P24,11,11q14.3,91725677,91845847,120170,-,-
BAC109_A19,11,11q14.3,91983609,92101327,117718,-,-
BAC90_N17,11,11q14.3,92028651,92157115,128464,-,-
BAC223_B22,11,11q14.3,92039350,92125322,85972,-,-
BAC54_P14,11,11q14.3,92125316,92226182,100866,-,-
BAC77_K16,11,11q14.3-11q21,92197832,92315940,118108,-,-
BAC117_E19,11,11q14.3-11q21,92258602,92383982,125380,-,-
BAC65_B03,11,11q21,92315934,92383978,68044,-,-
BAC151_P02,11,11q21,92585479,92676971,91492,-,-
BAC161_O07,11,11q21,92622464,92691819,69355,-,-
BAC147_H13,11,11q21,92629180,92716709,87529,-,-
BAC135_C20,11,11q21,92685672,92817238,131566,-,-
BAC95_C24,11,11q21,92716704,92816638,99934,-,-
BAC50_M02,11,11q21,92777098,92888192,111094,-,-
BAC150_P14,11,11q21,92783273,92869303,86030,-,-
BAC220_K22,11,11q21,92816682,92914393,97711,-,-
BAC244_B08,11,11q21,92834658,92920261,85603,-,-
BAC31_K13,11,11q21,92847111,92981646,134535,-,-
BAC119_J11,11,11q21,92935604,93012209,76605,-,-
BAC165_M04,11,11q21,93137443,93268324,130881,-,-
BAC150_D02,11,11q21,93137443,93219397,81954,-,-
BAC177_L18,11,11q21,93172014,93257709,85695,-,-
BAC177_F08,11,11q21,93172014,93257709,85695,-,-
BAC40_O05,11,11q21,93174371,93257709,83338,-,-
BAC222_C09,11,11q21,93183967,93263306,79339,-,-
BAC199_N15,11,11q21,93257714,93346972,89258,-,-
BAC238_B03,11,11q21,93276944,93366140,89196,-,-
BAC28_H15,11,11q21,93276948,93385697,108749,-,-
BAC137_N20,11,11q21,93283076,93366140,83064,-,-
BAC222_D03,11,11q21,93413454,93498411,84957,-,-
BAC82_H10,11,11q21,93429616,93544165,114549,-,-
BAC120_E11,11,11q21,93458230,93596143,137913,-,-
BAC66_H17,11,11q21,93485838,93564623,78785,-,-
BAC222_M06,11,11q21,93498492,93673643,175151,-,-
BAC81_G20,11,11q21,93561018,93609595,48577,-,-
BAC80_E17,11,11q21,93564618,93673921,109303,-,-
BAC51_E08,11,11q21,93732930,93826424,93494,-,-
BAC19_K19,11,11q21,93817243,93949801,132558,-,-
BAC86_G10,11,11q21,93824395,93949801,125406,-,-
BAC237_N14,11,11q21,93843298,93938809,95511,-,-
BAC150_A12,11,11q21,93901757,93913531,11774,-,-
BAC103_E17,11,11q21,93946472,94076485,130013,-,-
BAC143_C03,11,11q21,93991126,94090790,99664,-,-
BAC182_B09,11,11q21,93996385,94081020,84635,-,-
BAC194_L04,11,11q21,94015674,94097972,82298,-,-
BAC50_D05,11,11q21,94043795,94207469,163674,-,-
BAC175_A12,11,11q21,94196708,94348869,152161,-,-
BAC225_L03,11,11q21,94244519,94331052,86533,-,-
BAC22_M22,11,11q21,94259160,94355922,96762,-,-
BAC117_J21,11,11q21,94327945,94396387,68442,-,-
BAC218_P09,11,11q21,94355642,94447829,92187,-,-
BAC180_C16,11,11q21,94420793,94519243,98450,-,-
BAC59_D06,11,11q21,94454198,94538979,84781,-,-
BAC186_A21,11,11q21,94475519,94554745,79226,-,-
BAC203_K08,11,11q21,94485449,94570969,85520,-,-
BAC153_K19,11,11q21,94501908,94574392,72484,-,-
BAC53_O07,11,11q21,94717124,94808832,91708,-,-
BAC90_E12,11,11q21,94736193,94850799,114606,-,-
BAC193_E05,11,11q21,94777187,94875193,98006,-,-
BAC96_I23,11,11q21,94868584,94942196,73612,-,-
BAC44_I02,11,11q21,94886069,95013298,127229,-,-
BAC143_P15,11,11q21,94975603,95068335,92732,-,-
BAC90_H24,11,11q21,95091726,95179516,87790,-,-
BAC101_E08,11,11q21,95132482,95216601,84119,-,-
BAC228_H16,11,11q21,95218867,95321944,103077,-,-
BAC224_P04,11,11q21,95240253,95341259,101006,-,-
BAC139_K02,11,11q21,95245797,95322561,76764,-,-
BAC168_A19,11,11q21,95304069,95396261,92192,-,-
BAC63_D05,11,11q21,95340736,95452228,111492,-,-
BAC26_C09,11,11q21,95341253,95452490,111237,-,-
BAC144_K19,11,11q21,95341323,95428297,86974,-,-
BAC116_B21,11,11q21,95369808,95459556,89748,-,-
BAC69_H18,11,11q21,95411396,95503283,91887,-,-
BAC218_J02,11,11q21,95412795,95503282,90487,-,-
BAC52_O14,11,11q21,95480742,95559669,78927,-,-
BAC43_J23,11,11q21,95722477,95798845,76368,-,-
BAC200_O16,11,11q21,95763504,95882012,118508,-,-
BAC172_G10,11,11q21,95827984,95909043,81059,-,-
BAC252_N21,11,11q21,95837711,95909043,71332,-,-
BAC185_B07,11,11q21,96057807,96146200,88393,-,-
BAC171_J21,11,11q21,96262566,96359906,97340,-,-
BAC135_D08,11,11q21,96469471,96540656,71185,-,-
BAC151_I15,11,11q21,96469473,96533706,64233,-,-
BAC224_E09,11,11q21-11q22.1,96674850,96754957,80107,-,-
BAC25_E05,11,11q22.1,96838189,96960824,122635,-,-
BAC93_B24,11,11q22.1,96838207,96921705,83498,-,-
BAC6_D19,11,11q22.1,97008241,97114247,106006,-,-
BAC68_K09,11,11q22.1,97158038,97286442,128404,-,-
BAC167_G18,11,11q22.1,97184672,97268344,83672,-,-
BAC67_J06,11,11q22.1,97232360,97313937,81577,-,-
BAC42_E07,11,11q22.1,97268400,97397909,129509,-,-
BAC5_O14,11,11q22.1,97403950,97484678,80728,-,-
BAC65_K06,11,11q22.1,97409182,97511337,102155,-,-
BAC137_M08,11,11q22.1,97635592,97715370,79778,-,-
BAC27_G12,11,11q22.1,97782752,97927292,144540,-,-
BAC46_K03,11,11q22.1,97874662,97949595,74933,-,-
BAC135_F02,11,11q22.1,97902570,97992740,90170,-,-
BAC178_P13,11,11q22.1,97909086,97994537,85451,-,-
BAC115_K04,11,11q22.1,97927579,98013170,85591,-,-
BAC178_P04,11,11q22.1,97927579,98013478,85899,-,-
BAC182_O20,11,11q22.1,97994533,98093194,98661,-,-
BAC246_D13,11,11q22.1,98819776,98912795,93019,-,-
BAC76_P11,11,11q22.1,98897955,99029239,131284,-,-
BAC193_I18,11,11q22.1,98916145,99005085,88940,-,-
BAC29_C14,11,11q22.1,99050984,99143507,92523,-,-
BAC194_D07,11,11q22.1,99295127,99385108,89981,-,-
BAC27_P05,11,11q22.1,99334636,99452253,117617,-,-
BAC226_E10,11,11q22.1,99337480,99438608,101128,-,-
BAC85_D17,11,11q22.1,99602746,99674613,71867,-,-
BAC185_D09,11,11q22.1,99845873,99928071,82198,-,-
BAC121_N12,11,11q22.1,99906852,99997578,90726,-,-
BAC100_H09,11,11q22.1,99915091,100015284,100193,-,-
BAC82_C21,11,11q22.1,99997634,100119374,121740,-,-
BAC177_P09,11,11q22.1,100024211,100149504,125293,-,-
BAC33_A09,11,11q22.1,100098668,100222440,123772,-,-
BAC91_G18,11,11q22.1,100126897,100206159,79262,-,-
BAC139_K06,11,11q22.1,100243874,100342271,98397,-,-
BAC145_I24,11,11q22.1,100321844,100412601,90757,-,-
BAC46_E14,11,11q22.1,100398920,100518719,119799,-,-
BAC95_K06,11,11q22.1,100436495,100544464,107969,-,-
BAC179_G04,11,11q22.1,100458590,100544583,85993,-,-
BAC12_L24,11,11q22.1,100545947,100594439,48492,-,-
BAC179_P02,11,11q22.1,100591326,100696723,105397,-,-
BAC136_O03,11,11q22.1,100591788,100702097,110309,-,-
BAC175_B16,11,11q22.1,100616555,100709610,93055,-,-
BAC227_A01,11,11q22.1,100774905,100839124,64219,-,-
BAC252_A02,11,11q22.1,100804546,100894894,90348,-,-
BAC59_F15,11,11q22.1,100864079,100953082,89003,-,-
BAC149_O06,11,11q22.1,100879138,100960051,80913,-,-
BAC110_K10,11,11q22.1,100904365,100996614,92249,-,-
BAC145_J24,11,11q22.1,101087412,101169704,82292,-,-
BAC197_G09,11,11q22.1,101116523,101212678,96155,-,-
BAC33_K23,11,11q22.1,101187028,101281410,94382,-,-
BAC67_K02,11,11q22.1,101252913,101349326,96413,-,-
BAC90_N21,11,11q22.1,101273068,101372252,99184,-,-
BAC60_H07,11,11q22.1,101315394,101443848,128454,-,-
BAC55_C01,11,11q22.1,101335895,101471580,135685,-,-
BAC62_O07,11,11q22.1,101335906,101471564,135658,-,-
BAC108_O16,11,11q22.1,101368110,101463625,95515,-,-
BAC113_K10,11,11q22.1,101373862,101463809,89947,-,-
BAC35_A02,11,11q22.1,101373960,101482468,108508,-,-
BAC133_J20,11,11q22.1,101495517,101589595,94078,-,-
BAC78_I09,11,11q22.2,101658447,101751328,92881,-,-
BAC147_J19,11,11q22.2,101696920,101777318,80398,-,-
BAC23_N03,11,11q22.2,101751322,101875178,123856,-,-
BAC26_I09,11,11q22.2,101779455,101867022,87567,-,-
BAC141_O05,11,11q22.2,101800758,101880281,79523,-,-
BAC237_K20,11,11q22.2,101806449,101867022,60573,-,-
BAC240_C20,11,11q22.2,102056142,102154888,98746,-,-
BAC195_J08,11,11q22.2,102152492,102212279,59787,-,-
BAC149_I03,11,11q22.2,102226823,102339335,112512,-,-
BAC127_K07,11,11q22.2,102287617,102385363,97746,-,-
BAC185_E13,11,11q22.2,102299331,102385363,86032,-,-
BAC18_C04,11,11q22.3,102403654,102535968,132314,-,-
BAC105_J12,11,11q22.3,102446066,102564768,118702,-,-
BAC198_B06,11,11q22.3,102680530,102767110,86580,-,-
BAC170_M20,11,11q22.3,102705965,102810362,104397,-,-
BAC230_P22,11,11q22.3,102716877,102816567,99690,-,-
BAC230_J15,11,11q22.3,102818299,102906954,88655,-,-
BAC130_B11,11,11q22.3,102944704,103043266,98562,-,-
BAC221_E21,11,11q22.3,103003184,103123562,120378,-,-
BAC252_L11,11,11q22.3,103007661,103109465,101804,-,-
BAC183_G04,11,11q22.3,103107396,103195441,88045,-,-
BAC26_N04,11,11q22.3,103223297,103315894,92597,-,-
BAC86_P06,11,11q22.3,103224048,103313220,89172,-,-
BAC126_H11,11,11q22.3,103386136,103468014,81878,-,-
BAC34_K22,11,11q22.3,103397748,103489527,91779,-,-
BAC84_G12,11,11q22.3,103399293,103506653,107360,-,-
BAC56_A18,11,11q22.3,103567541,103723084,155543,-,-
BAC189_D01,11,11q22.3,104265490,104345035,79545,-,-
BAC45_N18,11,11q22.3,104303109,104404151,101042,-,-
BAC33_A19,11,11q22.3,104345054,104454206,109152,-,-
BAC204_O13,11,11q22.3,104395882,104472932,77050,-,-
BAC192_L19,11,11q22.3,104476177,104561520,85343,-,-
BAC53_J15,11,11q22.3,104525872,104644313,118441,-,-
BAC44_C18,11,11q22.3,104534472,104632117,97645,-,-
BAC132_B23,11,11q22.3,104632119,104736262,104143,-,-
BAC82_D03,11,11q22.3,104843029,104959389,116360,-,-
BAC233_J08,11,11q22.3,104877689,104987386,109697,-,-
BAC93_D11,11,11q22.3,104932668,105018260,85592,-,-
BAC142_K02,11,11q22.3,105035949,105127383,91434,-,-
BAC218_L23,11,11q22.3,105168113,105225612,57499,-,-
BAC119_O13,11,11q22.3,105421723,105552485,130762,-,-
BAC134_K07,11,11q22.3,105667276,105767349,100073,-,-
BAC19_D11,11,11q22.3,106021363,106130631,109268,-,-
BAC13_I22,11,11q22.3,106288580,106385952,97372,-,-
BAC123_P24,11,11q22.3,106356291,106432061,75770,-,-
BAC193_P23,11,11q22.3,106389501,106474406,84905,-,-
BAC51_J06,11,11q22.3,106470332,106553812,83480,-,-
BAC152_E21,11,11q22.3,106505100,106595023,89923,-,-
BAC19_C06,11,11q22.3,106704344,106791014,86670,-,-
BAC5_K06,11,11q22.3,106757332,106865150,107818,-,-
BAC65_C16,11,11q22.3,106787909,106914486,126577,-,-
BAC60_E20,11,11q22.3,106791009,106892565,101556,-,-
BAC33_L23,11,11q22.3,106801452,106930303,128851,-,-
BAC122_P19,11,11q22.3,106886530,107015584,129054,-,-
BAC36_M05,11,11q22.3,106931507,107058170,126663,-,-
BAC225_D08,11,11q22.3,107058290,107158067,99777,-,-
BAC42_A06,11,11q22.3,107180477,107252428,71951,-,-
BAC43_L17,11,11q22.3,107180973,107284489,103516,-,-
BAC124_I24,11,11q22.3,107188855,107276904,88049,-,-
BAC30_N16,11,11q22.3,107188855,107270153,81298,-,-
BAC147_I24,11,11q22.3,107207891,107316524,108633,-,-
BAC193_H08,11,11q22.3,107207892,107281794,73902,-,-
BAC88_G11,11,11q22.3,107377382,107498378,120996,-,-
BAC11_D16,11,11q22.3,107441794,107567664,125870,-,-
BAC63_F05,11,11q22.3,107470357,107582488,112131,-,-
BAC162_B08,11,11q22.3,107498412,107586418,88006,-,-
BAC85_C07,11,11q22.3,107504752,107629988,125236,-,-
BAC177_M11,11,11q22.3,107742744,107861048,118304,-,-
BAC153_C01,11,11q22.3,107758026,107859029,101003,-,-
BAC193_J06,11,11q22.3,107818119,107903322,85203,-,-
BAC62_I09,11,11q22.3,107818239,107906409,88170,-,-
BAC230_B19,11,11q22.3,107894391,107910979,16588,-,-
BAC57_G16,11,11q22.3,107920449,108000673,80224,-,-
BAC247_F12,11,11q22.3,107979591,108065987,86396,-,-
BAC197_C21,11,11q22.3,108163969,108250319,86350,-,-
BAC81_H16,11,11q22.3,108251317,108425167,173850,-,-
BAC80_H17,11,11q22.3,108291397,108413297,121900,-,-
BAC49_O19,11,11q22.3,108293025,108385319,92294,-,-
BAC155_F22,11,11q22.3,108299564,108389863,90299,-,-
BAC227_I08,11,11q22.3,108311704,108451032,139328,-,-
BAC171_F15,11,11q22.3,108320449,108414660,94211,-,-
BAC196_P07,11,11q22.3,108651414,108737632,86218,-,-
BAC46_I06,11,11q22.3,108683001,108790223,107222,-,-
BAC36_O05,11,11q22.3,108734889,108890230,155341,-,-
BAC195_M16,11,11q22.3,108761180,108834406,73226,-,-
BAC41_P08,11,11q22.3,108811153,108945513,134360,-,-
BAC39_F09,11,11q22.3,108887619,108971222,83603,-,-
BAC50_O03,11,11q22.3,108966029,109057527,91498,-,-
BAC40_F16,11,11q22.3,109010512,109030473,19961,-,-
BAC158_P23,11,11q22.3,109063065,109157528,94463,-,-
BAC37_I13,11,11q22.3,109080048,109189573,109525,-,-
BAC178_I10,11,11q22.3,109177046,109271193,94147,-,-
BAC33_D18,11,11q22.3,109201761,109319173,117412,-,-
BAC244_L01,11,11q22.3,109307507,109384530,77023,-,-
BAC40_A03,11,11q22.3,109351483,109466350,114867,-,-
BAC86_J03,11,11q22.3,109364932,109477802,112870,-,-
BAC121_H13,11,11q22.3,109376511,109461381,84870,-,-
BAC94_C15,11,11q22.3,109391218,109503823,112605,-,-
BAC104_K20,11,11q22.3,109423370,109522467,99097,-,-
BAC246_O01,11,11q22.3,109453580,109549182,95602,-,-
BAC55_K03,11,11q22.3,109474518,109640526,166008,-,-
BAC81_B09,11,11q22.3,109532105,109614500,82395,-,-
BAC76_J14,11,11q22.3,109549174,109640418,91244,-,-
BAC199_B17,11,11q22.3,109559020,109642439,83419,-,-
BAC62_M07,11,11q22.3,109614494,109723365,108871,-,-
BAC15_G01,11,11q22.3,109626064,109750605,124541,-,-
BAC81_P01,11,11q22.3,109640541,109778044,137503,-,-
BAC41_F17,11,11q22.3,109642438,109749407,106969,-,-
BAC156_N17,11,11q22.3,109676497,109773400,96903,-,-
BAC127_E11,11,11q22.3,109872901,109958735,85834,-,-
BAC115_H09,11,11q22.3-11q23.1,109976255,110064307,88052,-,-
BAC190_A13,11,11q23.1,110033390,110150726,117336,-,-
BAC196_I07,11,11q23.1,110048066,110136897,88831,-,-
BAC22_L05,11,11q23.1,110064456,110167691,103235,-,-
BAC227_F21,11,11q23.1,110340440,110443360,102920,-,-
BAC247_N20,11,11q23.1,110346844,110451332,104488,-,-
BAC247_N21,11,11q23.1,110346845,110451342,104497,-,-
BAC67_H04,11,11q23.1,110373266,110477946,104680,-,-
BAC218_K21,11,11q23.1,110377442,110443349,65907,-,-
BAC107_P14,11,11q23.1,110526985,110604801,77816,-,-
BAC114_O21,11,11q23.1,110535467,110643429,107962,-,-
BAC168_C13,11,11q23.1,110539371,110630205,90834,-,-
BAC52_P04,11,11q23.1,110693707,110769534,75827,-,-
BAC158_J11,11,11q23.1,110748026,110846534,98508,-,-
BAC109_L17,11,11q23.1,110754165,110853275,99110,-,-
BAC144_K13,11,11q23.1,110758357,110858772,100415,-,-
BAC95_K10,11,11q23.1,110845183,110926295,81112,-,-
BAC31_C01,11,11q23.1,110859136,110957757,98621,-,-
BAC92_P05,11,11q23.1,110860693,110937966,77273,-,-
BAC131_H15,11,11q23.1,110922643,111008089,85446,-,-
BAC38_J19,11,11q23.1,110925812,111079614,153802,-,-
BAC152_M16,11,11q23.1,111003830,111097623,93793,-,-
BAC150_M03,11,11q23.1,111039901,111136881,96980,-,-
BAC24_C13,11,11q23.1,111135370,111234350,98980,-,-
BAC233_G05,11,11q23.1,111243062,111335209,92147,-,-
BAC213_B18,11,11q23.1,111243073,111332901,89828,-,-
BAC64_F11,11,11q23.1,111251724,111335144,83420,-,-
BAC51_B11,11,11q23.1,111268992,111409159,140167,-,-
BAC78_J10,11,11q23.1,111268992,111362591,93599,-,-
BAC40_M16,11,11q23.1,111332893,111440556,107663,-,-
BAC101_E12,11,11q23.1,111400553,111486500,85947,-,-
BAC95_M12,11,11q23.1,111409207,111514040,104833,-,-
BAC26_O23,11,11q23.1,111418228,111514789,96561,-,-
BAC162_P20,11,11q23.1,111486495,111594045,107550,-,-
BAC31_C08,11,11q23.1,111584450,111691763,107313,-,-
BAC237_A21,11,11q23.1,111605003,111686665,81662,-,-
BAC23_N12,11,11q23.1,111661838,111817989,156151,-,-
BAC61_M08,11,11q23.1,111717175,111817929,100754,-,-
BAC187_P22,11,11q23.1,111717378,111792309,74931,-,-
BAC166_K03,11,11q23.1,111742076,111834032,91956,-,-
BAC140_B03,11,11q23.1,111817265,111911910,94645,-,-
BAC44_H02,11,11q23.1,111817306,111911854,94548,-,-
BAC134_O15,11,11q23.1,111832014,111965621,133607,-,-
BAC241_L12,11,11q23.1,111849342,111936807,87465,-,-
BAC110_B09,11,11q23.1,111891853,111980627,88774,-,-
BAC81_N13,11,11q23.1,111897724,111984033,86309,-,-
BAC234_P24,11,11q23.1,111899741,111989651,89910,-,-
BAC137_B10,11,11q23.1,111905607,111983371,77764,-,-
BAC41_J12,11,11q23.1,111968440,111995038,26598,-,-
BAC83_O20,11,11q23.1,111995033,112067594,72561,-,-
BAC149_M13,11,11q23.1,112027498,112115801,88303,-,-
BAC39_D06,11,11q23.1,112065772,112165901,100129,-,-
BAC96_B08,11,11q23.1,112067588,112193661,126073,-,-
BAC15_A19,11,11q23.1,112079605,112199087,119482,-,-
BAC43_H06,11,11q23.1,112107932,112222712,114780,-,-
BAC31_E10,11,11q23.1,112149529,112251637,102108,-,-
BAC123_N17,11,11q23.1,112195316,112308656,113340,-,-
BAC235_B12,11,11q23.1,112199086,112308845,109759,-,-
BAC44_L10,11,11q23.1,112229597,112354739,125142,-,-
BAC51_E19,11,11q23.1,112301644,112400467,98823,-,-
BAC117_G16,11,11q23.1,112321128,112393567,72439,-,-
BAC53_D12,11,11q23.1,112412710,112527875,115165,-,-
BAC88_G06,11,11q23.1,112524577,112653781,129204,-,-
BAC24_A10,11,11q23.1,112534170,112644885,110715,-,-
BAC183_F14,11,11q23.1,112691781,112795361,103580,-,-
BAC177_O12,11,11q23.1,112708007,112798763,90756,-,-
BAC8_C04,11,11q23.1,112723213,112798803,75590,-,-
BAC74_N08,11,11q23.1-11q23.2,112766760,112844874,78114,-,-
BAC238_B14,11,11q23.2,112845143,112929376,84233,-,-
BAC198_N06,11,11q23.2,112941407,113058552,117145,-,-
BAC232_J15,11,11q23.2,112945003,113026500,81497,-,-
BAC124_N10,11,11q23.2,112945004,113084690,139686,-,-
BAC151_C23,11,11q23.2,113091850,113173572,81722,-,-
BAC40_N08,11,11q23.2,113131658,113249242,117584,-,-
BAC126_O22,11,11q23.2,113180049,113368186,188137,-,-
BAC238_I14,11,11q23.2,113195962,113282667,86705,-,-
BAC63_K21,11,11q23.2,113195964,113284410,88446,-,-
BAC105_D18,11,11q23.2,113282659,113398715,116056,-,-
BAC188_B21,11,11q23.2,113282659,113398715,116056,-,-
BAC25_B22,11,11q23.2,113282659,113310575,27916,-,-
BAC51_G15,11,11q23.2,113334279,113434655,100376,-,-
BAC42_P20,11,11q23.2,113396637,113517693,121056,-,-
BAC111_B17,11,11q23.2,113401308,113542939,141631,-,-
BAC39_B14,11,11q23.2,113434759,113541628,106869,-,-
BAC195_D13,11,11q23.2,113437270,113520682,83412,-,-
BAC110_O11,11,11q23.2,113517687,113659638,141951,-,-
BAC194_N12,11,11q23.2,113543334,113639344,96010,-,-
BAC235_D14,11,11q23.2,113555898,113666834,110936,-,-
BAC46_H06,11,11q23.2,113558849,113581613,22764,-,-
BAC225_N18,11,11q23.2,113572137,113661043,88906,-,-
BAC65_M10,11,11q23.2,113639348,113764228,124880,-,-
BAC153_K09,11,11q23.2,113680858,113793107,112249,-,-
BAC183_E04,11,11q23.2,113680862,113753929,73067,-,-
BAC252_K17,11,11q23.2,113696225,113807569,111344,-,-
BAC135_C08,11,11q23.2,113780209,113848322,68113,-,-
BAC132_G19,11,11q23.2,113901667,114019182,117515,-,-
BAC151_N16,11,11q23.2,113971210,114068720,97510,-,-
BAC145_I11,11,11q23.2,114164662,114244378,79716,-,-
BAC21_P05,11,11q23.2,114301422,114391333,89911,-,-
BAC31_B11,11,11q23.2,114391625,114475059,83434,-,-
BAC64_I12,11,11q23.2,114475063,114575031,99968,-,-
BAC145_B21,11,11q23.2,114519197,114614196,94999,-,-
BAC176_I24,11,11q23.2,114525041,114606110,81069,-,-
BAC195_O14,11,11q23.2,114533244,114632257,99013,-,-
BAC55_G10,11,11q23.2,114553621,114650043,96422,-,-
BAC189_M11,11,11q23.2,114668719,114785662,116943,-,-
BAC204_L01,11,11q23.2,114681397,114707266,25869,-,-
BAC155_C04,11,11q23.2,114877072,114958342,81270,-,-
BAC113_F06,11,11q23.2,115115037,115223443,108406,-,-
BAC68_A10,11,11q23.2,115164619,115294508,129889,-,-
BAC78_L20,11,11q23.2,115182608,115336955,154347,-,-
BAC204_K10,11,11q23.2,115252305,115336892,84587,-,-
BAC153_O15,11,11q23.2,115261908,115336955,75047,-,-
BAC137_I06,11,11q23.2,115279914,115367536,87622,-,-
BAC161_E02,11,11q23.2,115293566,115376084,82518,-,-
BAC241_B01,11,11q23.2-11q23.3,115328258,115415421,87163,-,-
BAC134_G03,11,11q23.2-11q23.3,115354638,115437380,82742,-,-
BAC168_A12,11,11q23.2-11q23.3,115359270,115458973,99703,-,-
BAC200_D04,11,11q23.3,115430706,115514474,83768,-,-
BAC155_I20,11,11q23.3,115486632,115514474,27842,-,-
BAC145_H08,11,11q23.3,115566409,115659213,92804,-,-
BAC241_N14,11,11q23.3,115584532,115659214,74682,-,-
BAC219_B18,11,11q23.3,115712643,115790558,77915,-,-
BAC149_E11,11,11q23.3,115713100,115816497,103397,-,-
BAC153_O09,11,11q23.3,115733557,115816495,82938,-,-
BAC60_F17,11,11q23.3,115738198,115843723,105525,-,-
BAC110_O02,11,11q23.3,115805225,115915616,110391,-,-
BAC192_H05,11,11q23.3,115848831,115967425,118594,-,-
BAC5_P14,11,11q23.3,115848845,115993603,144758,-,-
BAC168_P13,11,11q23.3,115861600,115954846,93246,-,-
BAC36_M23,11,11q23.3,115967418,116085724,118306,-,-
BAC156_K15,11,11q23.3,116281137,116365969,84832,-,-
BAC117_H21,11,11q23.3,116353702,116459979,106277,-,-
BAC83_K13,11,11q23.3,116365978,116460158,94180,-,-
BAC40_N12,11,11q23.3,116380816,116465731,84915,-,-
BAC137_K08,11,11q23.3,116410137,116519356,109219,-,-
BAC102_F19,11,11q23.3,116438203,116548274,110071,-,-
BAC44_A14,11,11q23.3,116544738,116651518,106780,-,-
BAC55_H15,11,11q23.3,116554303,116651609,97306,-,-
BAC248_H16,11,11q23.3,116554303,116679418,125115,-,-
BAC186_M20,11,11q23.3,116580705,116679421,98716,-,-
BAC147_B18,11,11q23.3,116587730,116679421,91691,-,-
BAC180_I21,11,11q23.3,116712070,116731641,19571,-,-
BAC193_N06,11,11q23.3,116714443,116796051,81608,-,-
BAC188_L08,11,11q23.3,116803423,116886935,83512,-,-
BAC167_O23,11,11q23.3,116803423,116886967,83544,-,-
BAC132_P13,11,11q23.3,116809165,116921975,112810,-,-
BAC145_N18,11,11q23.3,116818967,116903121,84154,-,-
BAC232_B03,11,11q23.3,116855214,116956272,101058,-,-
BAC61_N04,11,11q23.3,116861389,116951365,89976,-,-
BAC39_K08,11,11q23.3,116886962,117041487,154525,-,-
BAC68_D04,11,11q23.3,116926272,117094377,168105,-,-
BAC106_C13,11,11q23.3,116946917,117181465,234548,-,-
BAC246_F17,11,11q23.3,116951819,117041477,89658,-,-
BAC49_L19,11,11q23.3,116978033,117066278,88245,-,-
BAC251_M06,11,11q23.3,116989315,117077949,88634,-,-
BAC248_K22,11,11q23.3,117002935,117078365,75430,-,-
BAC233_C04,11,11q23.3,117019279,117108318,89039,-,-
BAC194_L13,11,11q23.3,117069612,117161519,91907,-,-
BAC105_A12,11,11q23.3,117092220,117179275,87055,-,-
BAC185_J03,11,11q23.3,117092224,117155713,63489,-,-
BAC243_P15,11,11q23.3,117114554,117155644,41090,-,-
BAC178_B09,11,11q23.3,117186479,117276076,89597,-,-
BAC163_F04,11,11q23.3,117187179,117284324,97145,-,-
BAC92_L20,11,11q23.3,117187179,117273355,86176,-,-
BAC167_M05,11,11q23.3,117331886,117423764,91878,-,-
BAC215_O06,11,11q23.3,117354073,117428380,74307,-,-
BAC52_C19,11,11q23.3,117361031,117454465,93434,-,-
BAC153_G06,11,11q23.3,117477039,117565538,88499,-,-
BAC162_K20,11,11q23.3,117510536,117597185,86649,-,-
BAC80_G11,11,11q23.3,117551891,117634936,83045,-,-
BAC240_F04,11,11q23.3,117652507,117758169,105662,-,-
BAC178_N24,11,11q23.3,117659531,117748620,89089,-,-
BAC122_E20,11,11q23.3,117684936,117780495,95559,-,-
BAC83_K04,11,11q23.3,117690927,117778266,87339,-,-
BAC64_I15,11,11q23.3,117779067,117881244,102177,-,-
BAC140_D05,11,11q23.3,117780592,117881243,100651,-,-
BAC181_K06,11,11q23.3,117780603,117876748,96145,-,-
BAC128_J06,11,11q23.3,117784891,117951336,166445,-,-
BAC237_O14,11,11q23.3,117824544,117909150,84606,-,-
BAC191_F02,11,11q23.3,117914426,118012173,97747,-,-
BAC64_E10,11,11q23.3,117914426,117998263,83837,-,-
BAC116_P12,11,11q23.3,117914432,118108467,194035,-,-
BAC243_K23,11,11q23.3,117994176,118108528,114352,-,-
BAC111_D08,11,11q23.3,117997524,118091451,93927,-,-
BAC40_I22,11,11q23.3,117999116,118082300,83184,-,-
BAC172_B02,11,11q23.3,118026547,118107421,80874,-,-
BAC127_L11,11,11q23.3,118162413,118264542,102129,-,-
BAC169_K22,11,11q23.3,118174506,118257662,83156,-,-
BAC249_H04,11,11q23.3,118192500,118307701,115201,-,-
BAC226_H01,11,11q23.3,118289644,118391717,102073,-,-
BAC238_D03,11,11q23.3,118486859,118624275,137416,-,-
BAC121_J22,11,11q23.3,118487741,118593602,105861,-,-
BAC27_F11,11,11q23.3,118487757,118625471,137714,-,-
BAC105_L08,11,11q23.3,118487758,118593602,105844,-,-
BAC151_L14,11,11q23.3,118493327,118617427,124100,-,-
BAC80_O23,11,11q23.3,118501536,118617427,115891,-,-
BAC144_L11,11,11q23.3,118561496,118593602,32106,-,-
BAC149_O12,11,11q23.3,118593848,118680070,86222,-,-
BAC125_H22,11,11q23.3,118624287,118729015,104728,-,-
BAC141_J03,11,11q23.3,118635604,118737936,102332,-,-
BAC237_D17,11,11q23.3,118643013,118728351,85338,-,-
BAC191_A24,11,11q23.3,118647870,118729018,81148,-,-
BAC192_L05,11,11q23.3,118653803,118737936,84133,-,-
BAC158_L17,11,11q23.3,118717497,118800381,82884,-,-
BAC78_D18,11,11q23.3,118717498,118862825,145327,-,-
BAC193_D08,11,11q23.3,118800419,118896856,96437,-,-
BAC34_I17,11,11q23.3,118803428,118917694,114266,-,-
BAC1_M16,11,11q23.3,118803428,118896856,93428,-,-
BAC7_A02,11,11q23.3,118862538,118998820,136282,-,-
BAC179_L08,11,11q23.3,118862832,118917697,54865,-,-
BAC233_E15,11,11q23.3,118917702,119001561,83859,-,-
BAC110_L15,11,11q23.3,118936788,119044363,107575,-,-
BAC186_L04,11,11q23.3,118966603,119095820,129217,-,-
BAC8_F17,11,11q23.3,118966701,119138627,171926,-,-
BAC32_N04,11,11q23.3,118980889,119155425,174536,-,-
BAC86_G05,11,11q23.3,118995040,119079098,84058,-,-
BAC148_E20,11,11q23.3,119001555,119058324,56769,-,-
BAC237_C17,11,11q23.3,119044377,119136856,92479,-,-
BAC160_A24,11,11q23.3,119089618,119172786,83168,-,-
BAC125_L15,11,11q23.3,119136860,119247914,111054,-,-
BAC12_P11,11,11q23.3,119138644,119294449,155805,-,-
BAC25_C05,11,11q23.3,119138653,119332938,194285,-,-
BAC188_J05,11,11q23.3,119155495,119275998,120503,-,-
BAC52_J12,11,11q23.3,119168726,119296249,127523,-,-
BAC176_M17,11,11q23.3,119177574,119276074,98500,-,-
BAC158_M18,11,11q23.3,119233088,119328776,95688,-,-
BAC184_M22,11,11q23.3,119254561,119400570,146009,-,-
BAC102_N08,11,11q23.3,119281179,119366510,85331,-,-
BAC64_A03,11,11q23.3,119344025,119438932,94907,-,-
BAC177_E23,11,11q23.3,119380494,119440239,59745,-,-
BAC60_N23,11,11q23.3,119381930,119527743,145813,-,-
BAC40_F18,11,11q23.3,119420461,119521578,101117,-,-
BAC160_C03,11,11q23.3,119431615,119534921,103306,-,-
BAC247_G19,11,11q23.3,119447715,119568901,121186,-,-
BAC59_C06,11,11q23.3,119465702,119597769,132067,-,-
BAC100_L02,11,11q23.3,119481580,119604654,123074,-,-
BAC113_E02,11,11q23.3,119509403,119650946,141543,-,-
BAC69_C02,11,11q23.3,119528759,119633004,104245,-,-
BAC129_F05,11,11q23.3,119544194,119622209,78015,-,-
BAC219_H08,11,11q23.3,119568895,119670162,101267,-,-
BAC195_J07,11,11q23.3,119647580,119729079,81499,-,-
BAC196_I05,11,11q23.3,119709122,119792409,83287,-,-
BAC54_O18,11,11q23.3,119729076,119873567,144491,-,-
BAC58_C07,11,11q23.3,119743009,119916532,173523,-,-
BAC2_H07,11,11q23.3,119792403,119939314,146911,-,-
BAC10_C07,11,11q23.3,119792406,119939323,146917,-,-
BAC96_C14,11,11q23.3,119821386,119939323,117937,-,-
BAC33_G14,11,11q23.3,119867165,119954446,87281,-,-
BAC100_E13,11,11q23.3,119873784,119954446,80662,-,-
BAC208_A04,11,11q23.3,119875957,120009157,133200,-,-
BAC124_L14,11,11q23.3,119882270,119968143,85873,-,-
BAC220_A20,11,11q23.3,119882301,119994757,112456,-,-
BAC210_B09,11,11q23.3,119890837,119967922,77085,-,-
BAC27_B13,11,11q23.3,119935109,120057981,122872,-,-
BAC149_G19,11,11q23.3,119992741,120133795,141054,-,-
BAC38_H16,11,11q23.3,120017350,120133795,116445,-,-
BAC229_D08,11,11q23.3,120032142,120129635,97493,-,-
BAC176_L17,11,11q23.3,120042192,120131984,89792,-,-
BAC48_L14,11,11q23.3,120133890,120239771,105881,-,-
BAC66_E18,11,11q23.3,120178455,120259598,81143,-,-
BAC73_E17,11,11q23.3,120257418,120365515,108097,-,-
BAC2_J03,11,11q23.3,120268782,120355010,86228,-,-
BAC233_A03,11,11q23.3,120341796,120425660,83864,-,-
BAC194_I11,11,11q23.3,120361086,120451070,89984,-,-
BAC179_D10,11,11q23.3,120472516,120576167,103651,-,-
BAC56_P15,11,11q23.3,120489641,120590638,100997,-,-
BAC23_D17,11,11q23.3-11q24.1,120688139,120781671,93532,-,-
BAC41_A11,11,11q24.1,120715175,120802499,87324,-,-
BAC88_H14,11,11q24.1,120734802,120863437,128635,-,-
BAC149_H03,11,11q24.1,120787607,120863451,75844,-,-
BAC205_E08,11,11q24.1,120829050,120953327,124277,-,-
BAC220_M20,11,11q24.1,120845413,120953160,107747,-,-
BAC63_E17,11,11q24.1,120855344,120953557,98213,-,-
BAC18_C09,11,11q24.1,120863446,120964194,100748,-,-
BAC222_B24,11,11q24.1,120955053,121043490,88437,-,-
BAC126_O20,11,11q24.1,121014827,121168505,153678,-,-
BAC113_M22,11,11q24.1,121043661,121130743,87082,-,-
BAC2_P21,11,11q24.1,121070871,121182770,111899,-,-
BAC238_H03,11,11q24.1,121130737,121232707,101970,-,-
BAC180_F04,11,11q24.1,121178818,121259890,81072,-,-
BAC52_N17,11,11q24.1,121248940,121343884,94944,-,-
BAC158_N13,11,11q24.1,121402202,121501199,98997,-,-
BAC172_F19,11,11q24.1,121517765,121629926,112161,-,-
BAC140_G20,11,11q24.1,121528179,121623856,95677,-,-
BAC247_D08,11,11q24.1,121677931,121815969,138038,-,-
BAC158_P19,11,11q24.1,121694955,121766821,71866,-,-
BAC171_I07,11,11q24.1,121714496,121819525,105029,-,-
BAC59_D23,11,11q24.1,121780742,121855365,74623,-,-
BAC1_K18,11,11q24.1,121855358,121977333,121975,-,-
BAC80_H04,11,11q24.1,121858050,121943230,85180,-,-
BAC132_N18,11,11q24.1,121962235,122058675,96440,-,-
BAC102_J04,11,11q24.1,121974255,122097162,122907,-,-
BAC37_C15,11,11q24.1,121977214,122076290,99076,-,-
BAC58_L07,11,11q24.1,122008507,122168184,159677,-,-
BAC135_G14,11,11q24.1,122076433,122170852,94419,-,-
BAC22_J14,11,11q24.1,122102727,122169562,66835,-,-
BAC152_H20,11,11q24.1,122168241,122247511,79270,-,-
BAC100_G19,11,11q24.1,122214865,122330199,115334,-,-
BAC169_M10,11,11q24.1,122381286,122479612,98326,-,-
BAC243_C12,11,11q24.1,122403540,122488184,84644,-,-
BAC8_D04,11,11q24.1,122497235,122592899,95664,-,-
BAC222_P23,11,11q24.1,122533008,122627391,94383,-,-
BAC61_E23,11,11q24.1,122588204,122723173,134969,-,-
BAC76_N17,11,11q24.1,122606342,122738371,132029,-,-
BAC123_N19,11,11q24.1,122699319,122808955,109636,-,-
BAC38_K09,11,11q24.1,122721036,122835731,114695,-,-
BAC126_E24,11,11q24.1,122735708,122877028,141320,-,-
BAC33_E20,11,11q24.1,122735708,122843107,107399,-,-
BAC50_I05,11,11q24.1,122738406,122843111,104705,-,-
BAC16_B07,11,11q24.1,122738509,122811269,72760,-,-
BAC195_J03,11,11q24.1,122756999,122859927,102928,-,-
BAC190_I13,11,11q24.1,122781158,122877584,96426,-,-
BAC126_K24,11,11q24.1,122808947,122980453,171506,-,-
BAC116_H02,11,11q24.1,122808947,122903431,94484,-,-
BAC106_H19,11,11q24.1,122816091,122989824,173733,-,-
BAC79_A11,11,11q24.1,122835771,122958904,123133,-,-
BAC150_F11,11,11q24.1,122874155,122976975,102820,-,-
BAC11_L16,11,11q24.1,122877577,122989828,112251,-,-
BAC192_F07,11,11q24.1,122892264,122986054,93790,-,-
BAC154_O10,11,11q24.1,122898807,122980453,81646,-,-
BAC23_E10,11,11q24.1,122993104,123099833,106729,-,-
BAC150_G10,11,11q24.1,122996519,123088669,92150,-,-
BAC173_H01,11,11q24.1,122996519,123088661,92142,-,-
BAC72_F10,11,11q24.1,123006312,123091777,85465,-,-
BAC197_A21,11,11q24.1,123006464,123105352,98888,-,-
BAC194_M10,11,11q24.1,123204911,123288315,83404,-,-
BAC154_F23,11,11q24.1-11q24.2,123425572,123539087,113515,-,-
BAC78_J07,11,11q24.1-11q24.2,123462178,123593655,131477,-,-
BAC92_L16,11,11q24.2,123563170,123647916,84746,-,-
BAC130_O22,11,11q24.2,123588179,123674228,86049,-,-
BAC226_J24,11,11q24.2,123765972,123855298,89326,-,-
BAC201_M05,11,11q24.2,123855359,123952040,96681,-,-
BAC161_O16,11,11q24.2,123883917,123985838,101921,-,-
BAC229_J01,11,11q24.2,123901211,123970467,69256,-,-
BAC59_P24,11,11q24.2,123901500,124037216,135716,-,-
BAC122_M24,11,11q24.2,123904174,124006635,102461,-,-
BAC10_P11,11,11q24.2,123979427,124084761,105334,-,-
BAC31_M09,11,11q24.2,123985835,124072618,86783,-,-
BAC36_K08,11,11q24.2,124002714,124084761,82047,-,-
BAC45_P10,11,11q24.2,124005630,124162382,156752,-,-
BAC33_M09,11,11q24.2,124023981,124165926,141945,-,-
BAC151_L06,11,11q24.2,124038954,124162438,123484,-,-
BAC195_L23,11,11q24.2,124042453,124158725,116272,-,-
BAC91_B03,11,11q24.2,124081509,124162080,80571,-,-
BAC22_M12,11,11q24.2,124089691,124170697,81006,-,-
BAC107_H10,11,11q24.2,124213381,124318929,105548,-,-
BAC244_A06,11,11q24.2,124236239,124331983,95744,-,-
BAC56_M14,11,11q24.2,124396961,124483650,86689,-,-
BAC111_N19,11,11q24.2,124543478,124632875,89397,-,-
BAC173_K04,11,11q24.2,124576073,124657796,81723,-,-
BAC96_O19,11,11q24.2,124609998,124747210,137212,-,-
BAC46_M15,11,11q24.2,124632126,124746506,114380,-,-
BAC176_G20,11,11q24.2,124660047,124750041,89994,-,-
BAC5_H20,11,11q24.2,124660047,124747210,87163,-,-
BAC171_I16,11,11q24.2,124660454,124752852,92398,-,-
BAC218_A09,11,11q24.2,124660587,124740952,80365,-,-
BAC233_K18,11,11q24.2,124746518,124861607,115089,-,-
BAC24_G13,11,11q24.2,124747204,124909839,162635,-,-
BAC82_K20,11,11q24.2,124752998,124840502,87504,-,-
BAC10_B05,11,11q24.2,124775501,124849556,74055,-,-
BAC250_C10,11,11q24.2,124783455,124876313,92858,-,-
BAC229_A06,11,11q24.2,124790683,124851732,61049,-,-
BAC53_B22,11,11q24.2,124811527,124898326,86799,-,-
BAC124_J21,11,11q24.2,124917777,125062831,145054,-,-
BAC195_N19,11,11q24.2,124971095,125057538,86443,-,-
BAC35_I16,11,11q24.2,124971097,125069160,98063,-,-
BAC25_P09,11,11q24.2,124975558,125059807,84249,-,-
BAC46_C05,11,11q24.2,124998505,125083855,85350,-,-
BAC83_I22,11,11q24.2,125073786,125186903,113117,-,-
BAC154_K01,11,11q24.2,125121372,125208382,87010,-,-
BAC84_C09,11,11q24.2,125121372,125233808,112436,-,-
BAC18_N04,11,11q24.2,125146783,125298077,151294,-,-
BAC21_K12,11,11q24.2,125193552,125303188,109636,-,-
BAC129_P02,11,11q24.2,125272929,125404989,132060,-,-
BAC249_F12,11,11q24.2,125440034,125535761,95727,-,-
BAC161_G14,11,11q24.2,125449352,125581068,131716,-,-
BAC165_J12,11,11q24.2,125465604,125564636,99032,-,-
BAC69_P06,11,11q24.2,125473849,125594433,120584,-,-
BAC148_E22,11,11q24.2,125477539,125581068,103529,-,-
BAC221_E11,11,11q24.2,125492227,125581068,88841,-,-
BAC153_O02,11,11q24.2,125500535,125580971,80436,-,-
BAC121_I16,11,11q24.2,125579463,125691221,111758,-,-
BAC111_G24,11,11q24.2,125602186,125729834,127648,-,-
BAC158_M07,11,11q24.2,125691448,125797401,105953,-,-
BAC169_A06,11,11q24.2,125721821,125813494,91673,-,-
BAC219_D20,11,11q24.2,125797742,125884470,86728,-,-
BAC161_A04,11,11q24.2,125843429,125926281,82852,-,-
BAC168_B05,11,11q24.2,125862723,125985934,123211,-,-
BAC140_A07,11,11q24.2,125875149,125975928,100779,-,-
BAC57_F11,11,11q24.2,125875149,125950328,75179,-,-
BAC95_F12,11,11q24.2,125879225,126000095,120870,-,-
BAC221_F05,11,11q24.2,125909890,125986056,76166,-,-
BAC234_O09,11,11q24.2,125916315,125994367,78052,-,-
BAC18_L24,11,11q24.2,125926315,126033306,106991,-,-
BAC117_G14,11,11q24.2,125932752,126050962,118210,-,-
BAC24_B15,11,11q24.2,125964877,126089375,124498,-,-
BAC230_C14,11,11q24.2,125985929,126089377,103448,-,-
BAC167_J03,11,11q24.2,125986092,126068123,82031,-,-
BAC55_O08,11,11q24.2,126002623,126165508,162885,-,-
BAC86_G22,11,11q24.2,126028184,126125694,97510,-,-
BAC58_H20,11,11q24.2,126051408,126140421,89013,-,-
BAC155_J23,11,11q24.2,126056733,126140421,83688,-,-
BAC167_A15,11,11q24.2,126285521,126375019,89498,-,-
BAC62_E07,11,11q24.2,126288898,126413350,124452,-,-
BAC46_E03,11,11q24.2,126314122,126440049,125927,-,-
BAC19_D23,11,11q24.2,126350490,126440113,89623,-,-
BAC180_B08,11,11q24.2,126372250,126464864,92614,-,-
BAC25_C04,11,11q24.2,126506801,126645634,138833,-,-
BAC15_I02,11,11q24.2,126515079,126616995,101916,-,-
BAC171_H19,11,11q24.2,126575757,126664333,88576,-,-
BAC219_O06,11,11q24.2,126609103,126722897,113794,-,-
BAC13_A24,11,11q24.2,126655408,126771982,116574,-,-
BAC40_C16,11,11q24.2,126671037,126819533,148496,-,-
BAC121_O09,11,11q24.2,126900926,127007191,106265,-,-
BAC29_B04,11,11q24.2,127007252,127123117,115865,-,-
BAC165_N13,11,11q24.2,127008872,127114128,105256,-,-
BAC241_E08,11,11q24.2,127129043,127226868,97825,-,-
BAC157_H08,11,11q24.2,127132138,127210100,77962,-,-
BAC81_P09,11,11q24.2,127259572,127355003,95431,-,-
BAC181_J03,11,11q24.2,127288887,127373211,84324,-,-
BAC151_B01,11,11q24.2,127288887,127379827,90940,-,-
BAC235_A24,11,11q24.2,127292091,127388204,96113,-,-
BAC66_O01,11,11q24.2-11q24.3,127354050,127477439,123389,-,-
BAC43_M04,11,11q24.2-11q24.3,127358780,127477391,118611,-,-
BAC55_K17,11,11q24.3,127405129,127504990,99861,-,-
BAC65_L21,11,11q24.3,127435094,127526028,90934,-,-
BAC148_M16,11,11q24.3,127447550,127541796,94246,-,-
BAC151_C17,11,11q24.3,127480620,127574809,94189,-,-
BAC42_E19,11,11q24.3,127601161,127754382,153221,-,-
BAC190_A15,11,11q24.3,127670807,127768379,97572,-,-
BAC39_G22,11,11q24.3,127719002,127805341,86339,-,-
BAC172_N17,11,11q24.3,127777812,127877115,99303,-,-
BAC37_J21,11,11q24.3,127800421,127907113,106692,-,-
BAC53_C02,11,11q24.3,127876410,128037724,161314,-,-
BAC12_P05,11,11q24.3,127906269,128000334,94065,-,-
BAC89_K12,11,11q24.3,127906274,127982448,76174,-,-
BAC69_M11,11,11q24.3,127906296,127988581,82285,-,-
BAC235_N03,11,11q24.3,127907287,127982029,74742,-,-
BAC239_G16,11,11q24.3,127907287,127973563,66276,-,-
BAC226_O20,11,11q24.3,127982591,128080182,97591,-,-
BAC103_F17,11,11q24.3,127999256,128080183,80927,-,-
BAC76_F15,11,11q24.3,128034821,128148130,113309,-,-
BAC200_A17,11,11q24.3,128037718,128121838,84120,-,-
BAC184_B21,11,11q24.3,128039202,128142476,103274,-,-
BAC130_B03,11,11q24.3,128043016,128118780,75764,-,-
BAC142_K09,11,11q24.3,128061292,128178954,117662,-,-
BAC133_J10,11,11q24.3,128175703,128334583,158880,-,-
BAC71_F16,11,11q24.3,128281325,128358432,77107,-,-
BAC184_P16,11,11q24.3,128321304,128415102,93798,-,-
BAC187_C03,11,11q24.3,128419577,128506009,86432,-,-
BAC180_P11,11,11q24.3,128529155,128642895,113740,-,-
BAC36_A18,11,11q24.3,128641839,128777060,135221,-,-
BAC167_P19,11,11q24.3,128670684,128769604,98920,-,-
BAC153_K01,11,11q24.3,128685507,128819287,133780,-,-
BAC128_G08,11,11q24.3,128709871,128810073,100202,-,-
BAC40_O14,11,11q24.3,128716397,128810084,93687,-,-
BAC222_E11,11,11q24.3,128745345,128841304,95959,-,-
BAC61_F13,11,11q24.3,128777251,128794276,17025,-,-
BAC57_F12,11,11q24.3,128819343,128970578,151235,-,-
BAC154_N09,11,11q24.3,128827208,128905236,78028,-,-
BAC57_B17,11,11q24.3,128854327,128975272,120945,-,-
BAC155_I14,11,11q24.3,128967862,129070734,102872,-,-
BAC21_O18,11,11q24.3,128970680,129066394,95714,-,-
BAC133_K18,11,11q24.3,128987797,129066065,78268,-,-
BAC92_F19,11,11q24.3,128987798,129107157,119359,-,-
BAC240_K15,11,11q24.3,128988933,129066394,77461,-,-
BAC178_F04,11,11q24.3,129004026,129082729,78703,-,-
BAC55_G17,11,11q24.3,129048399,129154464,106065,-,-
BAC45_K12,11,11q24.3,129082797,129193217,110420,-,-
BAC128_B10,11,11q24.3,129107151,129234105,126954,-,-
BAC25_A23,11,11q24.3,129234651,129347848,113197,-,-
BAC54_K07,11,11q24.3,129276647,129347866,71219,-,-
BAC134_D09,11,11q24.3,129276647,129367572,90925,-,-
BAC121_P08,11,11q24.3,129307776,129461709,153933,-,-
BAC158_A06,11,11q24.3,129344194,129465219,121025,-,-
BAC76_I22,11,11q24.3,129348157,129441602,93445,-,-
BAC25_I19,11,11q24.3,129367566,129496842,129276,-,-
BAC222_P09,11,11q24.3,129507737,129591689,83952,-,-
BAC91_E19,11,11q24.3,129512630,129608563,95933,-,-
BAC136_O16,11,11q24.3,129512656,129591714,79058,-,-
BAC123_F05,11,11q24.3,129549056,129678740,129684,-,-
BAC217_E13,11,11q24.3,129625172,129734586,109414,-,-
BAC37_G01,11,11q24.3,129646135,129751474,105339,-,-
BAC53_O06,11,11q24.3,129739013,129876891,137878,-,-
BAC173_G12,11,11q24.3,129751575,129853119,101544,-,-
BAC179_D21,11,11q24.3,129784354,129876891,92537,-,-
BAC1_E16,11,11q24.3,129831414,129924241,92827,-,-
BAC181_B09,11,11q24.3,129831479,129949862,118383,-,-
BAC43_M19,11,11q24.3,129884943,130053701,168758,-,-
BAC237_M12,11,11q24.3,129924236,130013457,89221,-,-
BAC4_M23,11,11q24.3,129943922,130068836,124914,-,-
BAC161_A14,11,11q24.3,129982378,130097019,114641,-,-
BAC115_J10,11,11q24.3,129982379,130068818,86439,-,-
BAC113_N05,11,11q24.3,130003857,130161689,157832,-,-
BAC36_B04,11,11q24.3,130013452,130133049,119597,-,-
BAC195_D22,11,11q24.3,130021152,130133053,111901,-,-
BAC76_H04,11,11q24.3,130068826,130161477,92651,-,-
BAC106_P12,11,11q24.3,130070415,130161477,91062,-,-
BAC38_O10,11,11q24.3,130099588,130186798,87210,-,-
BAC96_J21,11,11q24.3,130112219,130247147,134928,-,-
BAC100_C01,11,11q24.3,130122433,130228570,106137,-,-
BAC155_B05,11,11q24.3,130149381,130228570,79189,-,-
BAC163_C01,11,11q24.3,130161472,130260936,99464,-,-
BAC42_A18,11,11q24.3-11q25,130280429,130446564,166135,-,-
BAC18_N13,11,11q25,130445506,130560105,114599,-,-
BAC165_D11,11,11q25,130446732,130545099,98367,-,-
BAC1_B18,11,11q25,130480275,130575754,95479,-,-
BAC41_N16,11,11q25,130545094,130688792,143698,-,-
BAC83_B07,11,11q25,130582039,130688432,106393,-,-
BAC181_G07,11,11q25,130594150,130691414,97264,-,-
BAC156_H07,11,11q25,130601341,130688797,87456,-,-
BAC159_F08,11,11q25,130627467,130718443,90976,-,-
BAC26_L22,11,11q25,130704755,130841132,136377,-,-
BAC60_H01,11,11q25,130718438,130811265,92827,-,-
BAC109_D06,11,11q25,130718476,130818430,99954,-,-
BAC153_H03,11,11q25,130764763,130854967,90204,-,-
BAC157_K24,11,11q25,130818977,130905529,86552,-,-
BAC158_K06,11,11q25,130825129,130938280,113151,-,-
BAC16_K11,11,11q25,130962759,131050758,87999,-,-
BAC142_O15,11,11q25,131025137,131106805,81668,-,-
BAC53_O17,11,11q25,131032468,131122395,89927,-,-
BAC233_C18,11,11q25,131034170,131140632,106462,-,-
BAC172_E11,11,11q25,131050770,131134572,83802,-,-
BAC236_L19,11,11q25,131123938,131226636,102698,-,-
BAC200_H24,11,11q25,131232105,131351185,119080,-,-
BAC189_P10,11,11q25,131256620,131355826,99206,-,-
BAC162_I11,11,11q25,131283249,131364821,81572,-,-
BAC184_C11,11,11q25,131308782,131384217,75435,-,-
BAC36_B20,11,11q25,131506978,131598679,91701,-,-
BAC191_L10,11,11q25,131534637,131632417,97780,-,-
BAC156_L18,11,11q25,131539014,131607533,68519,-,-
BAC148_I01,11,11q25,131559122,131651539,92417,-,-
BAC178_I02,11,11q25,131589449,131677037,87588,-,-
BAC90_G24,11,11q25,131612834,131702877,90043,-,-
BAC186_A17,11,11q25,131635706,131751057,115351,-,-
BAC30_J09,11,11q25,131639048,131743774,104726,-,-
BAC92_F16,11,11q25,131762329,131862850,100521,-,-
BAC248_L10,11,11q25,131862842,131935018,72176,-,-
BAC101_M22,11,11q25,131862843,132048125,185282,-,-
BAC49_L23,11,11q25,131973185,132086753,113568,-,-
BAC100_E10,11,11q25,131987550,132074550,87000,-,-
BAC49_F08,11,11q25,132039332,132149054,109722,-,-
BAC65_E19,11,11q25,132089797,132162711,72914,-,-
BAC176_D05,11,11q25,132110057,132197983,87926,-,-
BAC142_N08,11,11q25,132115417,132207986,92569,-,-
BAC126_F18,11,11q25,132120993,132249499,128506,-,-
BAC131_O17,11,11q25,132163005,132261046,98041,-,-
BAC60_N06,11,11q25,132170963,132287262,116299,-,-
BAC42_C05,11,11q25,132207989,132389796,181807,-,-
BAC199_A24,11,11q25,132442811,132523380,80569,-,-
BAC133_C24,11,11q25,132442811,132595203,152392,-,-
BAC175_I04,11,11q25,132449913,132532632,82719,-,-
BAC65_D19,11,11q25,132481572,132589407,107835,-,-
BAC62_H17,11,11q25,132495638,132641710,146072,-,-
BAC85_J15,11,11q25,132565429,132646757,81328,-,-
BAC149_C22,11,11q25,132761351,132836794,75443,-,-
BAC114_E20,11,11q25,132793706,132918172,124466,-,-
BAC42_E08,11,11q25,132861254,133005016,143762,-,-
BAC146_K21,11,11q25,132918685,133017655,98970,-,-
BAC247_E08,11,11q25,132997052,133116344,119292,-,-
BAC180_M20,11,11q25,133061998,133151341,89343,-,-
BAC60_M12,11,11q25,133117651,133213205,95554,-,-
BAC91_K14,11,11q25,133182682,133286783,104101,-,-
BAC100_I07,11,11q25,133275195,133428726,153531,-,-
BAC172_E14,11,11q25,133309616,133397345,87729,-,-
BAC250_P01,11,11q25,133411516,133538802,127286,-,-
BAC144_O18,11,11q25,133450112,133546060,95948,-,-
BAC78_F09,11,11q25,133469210,133586343,117133,-,-
BAC81_D03,11,11q25,133480247,133659208,178961,-,-
BAC84_K03,11,11q25,133486846,133595470,108624,-,-
BAC53_C09,11,11q25,133499921,133572969,73048,-,-
BAC134_M14,11,11q25,133521690,133624387,102697,-,-
BAC152_P12,11,11q25,133564805,133653778,88973,-,-
BAC39_M19,11,11q25,133709652,133839844,130192,-,-
BAC42_O21,11,11q25,133723141,133840301,117160,-,-
BAC154_O07,11,11q25,133725993,133816722,90729,-,-
BAC134_I02,11,11q25,133728223,133829031,100808,-,-
BAC30_C17,11,11q25,133742076,133850413,108337,-,-
BAC177_F23,11,11q25,133770014,133850403,80389,-,-
BAC248_D08,11,11q25,133770014,133850413,80399,-,-
BAC40_A04,11,11q25,133770014,133859470,89456,-,-
BAC95_L12,11,11q25,133770014,133858274,88260,-,-
BAC66_I07,11,11q25,133980135,134140598,160463,-,-
BAC252_P17,11,11q25,134010885,134102843,91958,-,-
BAC178_K10,11,11q25,134013073,134127574,114501,-,-
BAC182_L09,11,11q25,134029276,134140978,111702,-,-
BAC123_H19,11,11q25,134068516,134140965,72449,-,-
BAC242_L19,11,11q25,134097622,134176622,79000,-,-
BAC76_D17,11,11q25,134102837,134198566,95729,-,-
BAC67_P23,11,11q25,134127568,134252376,124808,-,-
BAC67_E22,11,11q25,134128753,134225572,96819,-,-
BAC68_E05,11,11q25,134133709,134218850,85141,-,-
BAC60_E06,11,11q25,134140599,134225572,84973,-,-
BAC234_F11,11,11q25,134142749,134225572,82823,-,-
BAC58_G22,11,11q25,134190232,134322109,131877,-,-
BAC109_M11,11,11q25,134246422,134324136,77714,-,-
BAC237_C21,11,11q25,134278595,134374274,95679,-,-
BAC171_H11,11,11q25,134278595,134369247,90652,-,-
BAC81_C07,11,11q25,134314228,134429120,114892,-,-
BAC52_O18,12,12p13.33,16623,132017,115394,-,-
BAC235_E15,12,12p13.33,45314,145998,100684,-,-
BAC247_M18,12,12p13.33,165842,250367,84525,-,-
BAC179_J19,12,12p13.33,183679,257363,73684,-,-
BAC109_E06,12,12p13.33,224552,335537,110985,-,-
BAC126_J11,12,12p13.33,238015,323555,85540,-,-
BAC125_J01,12,12p13.33,238015,323555,85540,-,-
BAC144_J15,12,12p13.33,259368,355086,95718,-,-
BAC39_D11,12,12p13.33,280748,380707,99959,-,-
BAC80_A03,12,12p13.33,325979,429907,103928,-,-
BAC65_M18,12,12p13.33,325979,429874,103895,-,-
BAC190_P12,12,12p13.33,335531,429907,94376,-,-
BAC118_H10,12,12p13.33,335531,421692,86161,-,-
BAC42_L11,12,12p13.33,335591,455503,119912,-,-
BAC227_K04,12,12p13.33,391389,465513,74124,-,-
BAC149_L04,12,12p13.33,429899,520148,90249,-,-
BAC143_N23,12,12p13.33,447766,559377,111611,-,-
BAC231_J23,12,12p13.33,455498,548935,93437,-,-
BAC155_L08,12,12p13.33,457823,579543,121720,-,-
BAC46_N14,12,12p13.33,461786,548931,87145,-,-
BAC237_A11,12,12p13.33,469618,584976,115358,-,-
BAC191_B18,12,12p13.33,471495,558896,87401,-,-
BAC141_N08,12,12p13.33,524327,643572,119245,-,-
BAC226_P03,12,12p13.33,575646,643515,67869,-,-
BAC193_F23,12,12p13.33,608929,712774,103845,-,-
BAC155_F02,12,12p13.33,619970,715211,95241,-,-
BAC131_C07,12,12p13.33,718860,808184,89324,-,-
BAC23_E11,12,12p13.33,750930,885840,134910,-,-
BAC172_D20,12,12p13.33,755385,842599,87214,-,-
BAC120_A19,12,12p13.33,755385,921580,166195,-,-
BAC252_M17,12,12p13.33,842594,1009582,166988,-,-
BAC83_A14,12,12p13.33,866781,964918,98137,-,-
BAC43_D11,12,12p13.33,870277,986866,116589,-,-
BAC167_M24,12,12p13.33,919080,1009477,90397,-,-
BAC26_B17,12,12p13.33,921579,1011409,89830,-,-
BAC60_C24,12,12p13.33,948351,1036223,87872,-,-
BAC141_P11,12,12p13.33,975349,1097730,122381,-,-
BAC91_A08,12,12p13.33,1093470,1209138,115668,-,-
BAC30_E23,12,12p13.33,1096012,1202056,106044,-,-
BAC240_O12,12,12p13.33,1247860,1323196,75336,-,-
BAC235_K11,12,12p13.33,1247863,1340067,92204,-,-
BAC109_M24,12,12p13.33,1267722,1287202,19480,-,-
BAC71_E20,12,12p13.33,1274381,1396008,121627,-,-
BAC197_H19,12,12p13.33,1301001,1376701,75700,-,-
BAC24_N12,12,12p13.33,1340066,1475782,135716,-,-
BAC102_J24,12,12p13.33,1348908,1463095,114187,-,-
BAC67_D20,12,12p13.33,1353823,1456137,102314,-,-
BAC90_K05,12,12p13.33,1367312,1456136,88824,-,-
BAC65_O03,12,12p13.33,1396876,1501767,104891,-,-
BAC101_B02,12,12p13.33,1396876,1475782,78906,-,-
BAC97_J05,12,12p13.33,1443337,1530840,87503,-,-
BAC194_N18,12,12p13.33,1497637,1582347,84710,-,-
BAC21_K14,12,12p13.33,1545874,1634437,88563,-,-
BAC84_G24,12,12p13.33,1568400,1666315,97915,-,-
BAC186_D17,12,12p13.33,1587799,1697834,110035,-,-
BAC11_O16,12,12p13.33,1595660,1689702,94042,-,-
BAC102_N01,12,12p13.33,1595691,1677167,81476,-,-
BAC28_H14,12,12p13.33,1626549,1728704,102155,-,-
BAC15_C12,12,12p13.33,1650898,1746696,95798,-,-
BAC141_L21,12,12p13.33,1695418,1768274,72856,-,-
BAC24_C04,12,12p13.33,1819897,1954312,134415,-,-
BAC60_J09,12,12p13.33,1862783,1956863,94080,-,-
BAC101_J21,12,12p13.33,1898576,1984389,85813,-,-
BAC58_A24,12,12p13.33,2000019,2131202,131183,-,-
BAC67_C19,12,12p13.33,2007377,2104057,96680,-,-
BAC151_J09,12,12p13.33,2010997,2104126,93129,-,-
BAC234_K15,12,12p13.33,2017216,2098188,80972,-,-
BAC241_P19,12,12p13.33,2020371,2104060,83689,-,-
BAC118_I02,12,12p13.33,2020393,2104061,83668,-,-
BAC130_N12,12,12p13.33,2044561,2132686,88125,-,-
BAC63_O17,12,12p13.33,2092361,2180043,87682,-,-
BAC73_O21,12,12p13.33,2099059,2224686,125627,-,-
BAC72_A10,12,12p13.33,2104117,2206695,102578,-,-
BAC134_E22,12,12p13.33,2120895,2224704,103809,-,-
BAC127_M10,12,12p13.33,2131196,2208620,77424,-,-
BAC181_N15,12,12p13.33,2162029,2268565,106536,-,-
BAC168_D20,12,12p13.33,2180460,2249032,68572,-,-
BAC128_F12,12,12p13.33,2232746,2312881,80135,-,-
BAC53_P18,12,12p13.33,2237613,2359677,122064,-,-
BAC247_K13,12,12p13.33,2322873,2400578,77705,-,-
BAC250_D24,12,12p13.33,2327484,2474816,147332,-,-
BAC113_L04,12,12p13.33,2328241,2411581,83340,-,-
BAC200_C19,12,12p13.33,2399576,2487772,88196,-,-
BAC143_J03,12,12p13.33,2400591,2497387,96796,-,-
BAC189_K14,12,12p13.33,2411575,2497389,85814,-,-
BAC104_K21,12,12p13.33,2469875,2581760,111885,-,-
BAC234_B07,12,12p13.33,2474811,2564061,89250,-,-
BAC217_G21,12,12p13.33,2474811,2581744,106933,-,-
BAC249_O22,12,12p13.33,2480665,2581744,101079,-,-
BAC200_K18,12,12p13.33,2508242,2588004,79762,-,-
BAC137_B08,12,12p13.33,2705496,2802850,97354,-,-
BAC198_C20,12,12p13.33,2710211,2802850,92639,-,-
BAC147_G19,12,12p13.33,2777474,2903075,125601,-,-
BAC107_O09,12,12p13.33,2777474,2879940,102466,-,-
BAC136_C16,12,12p13.33,2805885,2912955,107070,-,-
BAC65_J22,12,12p13.33,2858154,2982248,124094,-,-
BAC158_H23,12,12p13.33,2866179,2957062,90883,-,-
BAC217_H03,12,12p13.33,2867388,2957063,89675,-,-
BAC36_K16,12,12p13.33,2869746,2967169,97423,-,-
BAC197_O20,12,12p13.33,2869752,2956713,86961,-,-
BAC176_A02,12,12p13.33,2880323,2957063,76740,-,-
BAC132_L23,12,12p13.33,2880323,2988856,108533,-,-
BAC157_J17,12,12p13.33,2903424,3036529,133105,-,-
BAC144_F09,12,12p13.33-12p13.32,3032579,3112438,79859,-,-
BAC152_E18,12,12p13.33-12p13.32,3053047,3168798,115751,-,-
BAC243_B02,12,12p13.32,3160157,3261346,101189,-,-
BAC32_M16,12,12p13.32,3168791,3261369,92578,-,-
BAC239_F14,12,12p13.32,3186775,3305851,119076,-,-
BAC160_H16,12,12p13.32,3199975,3313104,113129,-,-
BAC26_P09,12,12p13.32,3212637,3293485,80848,-,-
BAC97_F21,12,12p13.32,3223485,3330817,107332,-,-
BAC224_C08,12,12p13.32,3261378,3362666,101288,-,-
BAC82_H07,12,12p13.32,3334584,3457251,122667,-,-
BAC12_N23,12,12p13.32,3356551,3440197,83646,-,-
BAC110_K06,12,12p13.32,3402075,3502798,100723,-,-
BAC22_G08,12,12p13.32,3402085,3581686,179601,-,-
BAC21_N18,12,12p13.32,3411285,3528489,117204,-,-
BAC183_N21,12,12p13.32,3411442,3482892,71450,-,-
BAC1_N18,12,12p13.32,3583377,3717817,134440,yes,-
BAC84_K06,12,12p13.32,3598751,3717821,119070,yes,-
BAC162_N21,12,12p13.32,3648054,3737337,89283,-,-
BAC220_H24,12,12p13.32,3648383,3737337,88954,-,-
BAC182_I03,12,12p13.32,3704014,3768573,64559,-,-
BAC192_L08,12,12p13.32,3717813,3798054,80241,-,-
BAC27_N11,12,12p13.32,3832048,3955093,123045,-,-
BAC170_L11,12,12p13.32,3862100,3943680,81580,-,-
BAC95_L01,12,12p13.32,3886200,4004723,118523,-,-
BAC52_F24,12,12p13.32,3891496,4019657,128161,-,-
BAC234_J07,12,12p13.32,3891989,4001343,109354,-,-
BAC101_B21,12,12p13.32,3910378,3999223,88845,-,-
BAC224_D09,12,12p13.32,3943753,4028895,85142,-,-
BAC23_F04,12,12p13.32,4008489,4087815,79326,-,-
BAC8_I10,12,12p13.32,4023476,4173602,150126,yes,-
BAC239_E11,12,12p13.32,4025412,4138486,113074,yes,-
BAC226_M13,12,12p13.32,4040597,4173602,133005,yes,-
BAC119_N11,12,12p13.32,4081445,4200255,118810,-,-
BAC136_J23,12,12p13.32,4087809,4193908,106099,-,-
BAC37_I02,12,12p13.32,4087809,4192771,104962,-,-
BAC13_N05,12,12p13.32,4185531,4287226,101695,-,-
BAC78_E11,12,12p13.32,4202069,4293906,91837,-,-
BAC45_E10,12,12p13.32,4271846,4416955,145109,yes,-
BAC36_D21,12,12p13.32,4279315,4365008,85693,yes,-
BAC29_O15,12,12p13.32,4279318,4365008,85690,yes,-
BAC184_M18,12,12p13.32,4306487,4383626,77139,yes,-
BAC40_I10,12,12p13.32,4321631,4416950,95319,-,-
BAC48_M14,12,12p13.32,4362921,4487750,124829,yes,-
BAC84_F16,12,12p13.32,4385376,4514769,129393,yes,-
BAC115_B18,12,12p13.32,4541774,4618416,76642,-,-
BAC129_N16,12,12p13.32,4684416,4794902,110486,-,-
BAC40_D12,12,12p13.32,4721714,4824885,103171,-,-
BAC126_I21,12,12p13.32,4723976,4809814,85838,-,-
BAC171_O15,12,12p13.32,4747337,4851191,103854,-,-
BAC230_N09,12,12p13.32,4802354,4893228,90874,-,-
BAC64_N20,12,12p13.32,4804955,4912757,107802,-,-
BAC13_A13,12,12p13.32,4807170,4904770,97600,-,-
BAC158_E18,12,12p13.32,4807889,4914917,107028,-,-
BAC54_I05,12,12p13.32,4914921,5041909,126988,yes,-
BAC188_O04,12,12p13.32,4928744,5007083,78339,yes,-
BAC190_O15,12,12p13.32,4942512,5047602,105090,yes,-
BAC60_G09,12,12p13.32,4975166,5062782,87616,-,-
BAC240_P15,12,12p13.32,4975876,5064628,88752,-,-
BAC146_N08,12,12p13.32,5012704,5108099,95395,-,-
BAC251_C04,12,12p13.32,5110772,5191338,80566,-,-
BAC162_M03,12,12p13.32,5131707,5223441,91734,-,-
BAC12_L01,12,12p13.32-12p13.31,5297183,5420401,123218,-,-
BAC127_P11,12,12p13.31,5312837,5403850,91013,-,-
BAC189_C07,12,12p13.31,5316577,5389582,73005,-,-
BAC199_K22,12,12p13.31,5520468,5599735,79267,-,-
BAC123_P19,12,12p13.31,5521377,5620650,99273,-,-
BAC64_L05,12,12p13.31,5527787,5611576,83789,-,-
BAC147_G16,12,12p13.31,5569554,5678774,109220,-,-
BAC90_L22,12,12p13.31,5580555,5683898,103343,-,-
BAC57_J15,12,12p13.31,5599727,5696282,96555,-,-
BAC226_I12,12,12p13.31,5611571,5706082,94511,-,-
BAC86_M19,12,12p13.31,5620991,5737347,116356,yes,-
BAC39_J18,12,12p13.31,5662304,5826872,164568,yes,-
BAC36_G12,12,12p13.31,5678341,5803156,124815,yes,-
BAC60_H03,12,12p13.31,5690817,5795147,104330,yes,-
BAC145_L05,12,12p13.31,5704598,5786877,82279,yes,-
BAC105_M19,12,12p13.31,5713641,5840809,127168,yes,-
BAC41_B19,12,12p13.31,5726062,5826869,100807,yes,-
BAC67_P10,12,12p13.31,5744308,5846611,102303,yes,-
BAC192_I18,12,12p13.31,5747295,5862929,115634,-,-
BAC54_F02,12,12p13.31,5865534,5968050,102516,-,-
BAC39_K13,12,12p13.31,5865542,5986908,121366,-,-
BAC51_L18,12,12p13.31,5944085,6063333,119248,-,-
BAC150_A24,12,12p13.31,5979121,6064025,84904,-,-
BAC193_A04,12,12p13.31,5982322,6120045,137723,-,-
BAC198_C03,12,12p13.31,6013878,6120045,106167,-,-
BAC132_M01,12,12p13.31,6026189,6119291,93102,-,-
BAC80_I09,12,12p13.31,6063347,6169799,106452,-,-
BAC187_O15,12,12p13.31,6066966,6145662,78696,-,-
BAC102_D03,12,12p13.31,6091741,6200110,108369,-,-
BAC218_G17,12,12p13.31,6119286,6207087,87801,-,-
BAC107_L03,12,12p13.31,6144897,6232160,87263,-,-
BAC188_D23,12,12p13.31,6175084,6283846,108762,-,-
BAC102_K15,12,12p13.31,6207082,6313689,106607,-,-
BAC73_I22,12,12p13.31,6209444,6342565,133121,-,-
BAC218_K18,12,12p13.31,6232178,6365032,132854,-,-
BAC39_G23,12,12p13.31,6267527,6373705,106178,-,-
BAC71_B04,12,12p13.31,6278255,6438858,160603,-,-
BAC193_J17,12,12p13.31,6301569,6395805,94236,-,-
BAC151_E10,12,12p13.31,6301569,6393513,91944,-,-
BAC147_L09,12,12p13.31,6338379,6480132,141753,-,-
BAC176_I02,12,12p13.31,6361064,6459825,98761,-,-
BAC230_K02,12,12p13.31,6370764,6459826,89062,-,-
BAC72_H11,12,12p13.31,6428925,6516111,87186,-,-
BAC97_M18,12,12p13.31,6440960,6464298,23338,-,-
BAC147_O20,12,12p13.31,6451742,6580557,128815,-,-
BAC117_G04,12,12p13.31,6464466,6580534,116068,-,-
BAC37_K23,12,12p13.31,6480124,6624696,144572,-,-
BAC123_K12,12,12p13.31,6496203,6624706,128503,-,-
BAC95_I23,12,12p13.31,6511396,6612069,100673,-,-
BAC181_H07,12,12p13.31,6516343,6612069,95726,-,-
BAC252_K23,12,12p13.31,6536842,6653009,116167,-,-
BAC109_N02,12,12p13.31,6555491,6671836,116345,-,-
BAC34_J07,12,12p13.31,6612064,6703575,91511,-,-
BAC101_I13,12,12p13.31,6703570,6772116,68546,-,-
BAC57_P07,12,12p13.31,6772162,6857028,84866,-,-
BAC63_A19,12,12p13.31,6864577,6953727,89150,-,-
BAC26_H10,12,12p13.31,6892188,6978804,86616,-,-
BAC38_L22,12,12p13.31,6892197,6985633,93436,-,-
BAC95_H22,12,12p13.31,6933963,7035247,101284,-,-
BAC143_P02,12,12p13.31,6948560,7035464,86904,-,-
BAC167_P10,12,12p13.31,6953789,7035629,81840,-,-
BAC169_E11,12,12p13.31,7145685,7266679,120994,-,-
BAC51_A12,12,12p13.31,7182219,7296861,114642,-,-
BAC68_I13,12,12p13.31,7205307,7342428,137121,-,-
BAC119_E20,12,12p13.31,7250823,7338623,87800,-,-
BAC130_E16,12,12p13.31,7252236,7351906,99670,-,-
BAC244_H03,12,12p13.31,7373492,7396454,22962,-,-
BAC75_P06,12,12p13.31,7610484,7714223,103739,-,-
BAC76_I11,12,12p13.31,7734062,7843466,109404,-,-
BAC120_M03,12,12p13.31,7734532,7828265,93733,-,-
BAC70_C16,12,12p13.31,7787856,7905448,117592,-,-
BAC76_K12,12,12p13.31,7845050,7934670,89620,-,-
BAC223_P09,12,12p13.31,7859979,7953262,93283,-,-
BAC54_B12,12,12p13.31,7868162,8027456,159294,-,-
BAC200_L10,12,12p13.31,7971134,8083777,112643,-,-
BAC106_O01,12,12p13.31,8007543,8135727,128184,-,-
BAC82_I15,12,12p13.31,8061490,8183967,122477,-,-
BAC165_D02,12,12p13.31,8114490,8244547,130057,-,-
BAC240_A18,12,12p13.31,8147330,8270016,122686,-,-
BAC182_H10,12,12p13.31,8147331,8240262,92931,-,-
BAC155_A18,12,12p13.31,8229750,8332171,102421,-,-
BAC169_J15,12,12p13.31,8233168,8325182,92014,-,-
BAC177_O11,12,12p13.31,8240257,8329644,89387,-,-
BAC193_O09,12,12p13.31,8321113,8424841,103728,-,-
BAC241_K18,12,12p13.31,8354624,8501697,147073,yes,-
BAC107_A11,12,12p13.31,8364504,8536351,171847,yes,-
BAC127_H16,12,12p13.31,8378805,8512125,133320,yes,-
BAC140_E10,12,12p13.31,8424835,8536326,111491,yes,-
BAC157_O10,12,12p13.31,8573329,8680902,107573,-,-
BAC118_P14,12,12p13.31,8578011,8680917,102906,-,-
BAC41_A22,12,12p13.31,8639421,8772441,133020,-,-
BAC30_E15,12,12p13.31,8654544,8757130,102586,-,-
BAC41_K20,12,12p13.31,8690510,8766632,76122,-,-
BAC237_M06,12,12p13.31,8740097,8832154,92057,-,-
BAC220_L15,12,12p13.31,8786464,8892906,106442,-,-
BAC218_K15,12,12p13.31,8807183,8880219,73036,-,-
BAC100_I11,12,12p13.31,8829721,8922825,93104,yes,-
BAC92_O14,12,12p13.31,8834146,8926918,92772,yes,-
BAC170_B23,12,12p13.31,8885182,9000191,115009,yes,-
BAC183_J14,12,12p13.31,8913362,8993989,80627,yes,-
BAC34_N16,12,12p13.31,8913378,9036245,122867,yes,-
BAC32_H06,12,12p13.31,8923010,9029671,106661,yes,-
BAC105_N07,12,12p13.31,8955815,9053883,98068,yes,-
BAC247_C03,12,12p13.31,8956859,9081026,124167,yes,-
BAC24_P24,12,12p13.31,8983032,9099911,116879,yes,-
BAC86_C09,12,12p13.31,9036587,9140859,104272,-,-
BAC137_H08,12,12p13.31,9065574,9170478,104904,-,-
BAC197_J22,12,12p13.31,9083048,9163354,80306,yes,-
BAC197_B06,12,12p13.31,9240797,9336432,95635,yes,-
BAC224_O07,12,12p13.31,9250468,9371184,120716,yes,-
BAC45_K02,12,12p13.31,9255048,9388546,133498,yes,-
BAC76_E20,12,12p13.31,9279583,9391577,111994,-,-
BAC178_D14,12,12p13.31,9438418,9552031,113613,-,-
BAC27_J01,12,12p13.31,9505283,9741810,236527,yes,-
BAC230_O14,12,12p13.31,9510458,9617330,106872,-,-
BAC55_M20,12,12p13.31,9532428,9617900,85472,-,-
BAC41_D23,12,12p13.31,9653995,9775028,121033,-,-
BAC82_N06,12,12p13.31,9784284,9921294,137010,yes,-
BAC153_H05,12,12p13.31,9887661,9987778,100117,-,-
BAC133_G05,12,12p13.31-12p13.2,9941537,10053720,112183,-,-
BAC152_P14,12,12p13.31-12p13.2,9944685,10029039,84354,-,-
BAC44_J04,12,12p13.2,10068578,10157200,88622,-,-
BAC237_N16,12,12p13.2,10072091,10185015,112924,-,-
BAC39_M20,12,12p13.2,10076568,10216842,140274,-,-
BAC150_D14,12,12p13.2,10076570,10158161,81591,-,-
BAC165_D08,12,12p13.2,10093634,10187435,93801,-,-
BAC36_O09,12,12p13.2,10119003,10213348,94345,-,-
BAC34_I11,12,12p13.2,10338283,10487628,149345,yes,-
BAC229_J18,12,12p13.2,10338712,10390676,51964,-,-
BAC238_B17,12,12p13.2,10372004,10456915,84911,yes,-
BAC102_C22,12,12p13.2,10372004,10456915,84911,yes,-
BAC199_L13,12,12p13.2,10378364,10451470,73106,-,-
BAC218_O17,12,12p13.2,10432128,10499557,67429,yes,-
BAC125_O05,12,12p13.2,10533492,10621290,87798,-,-
BAC233_C22,12,12p13.2,10574279,10649853,75574,-,-
BAC186_H20,12,12p13.2,10716168,10792578,76410,-,-
BAC182_J17,12,12p13.2,10732270,10836852,104582,-,-
BAC234_A13,12,12p13.2,10792615,10880537,87922,-,-
BAC115_I09,12,12p13.2,11011521,11115710,104189,yes,-
BAC202_K24,12,12p13.2,11090273,11115713,25440,yes,-
BAC180_J16,12,12p13.2,11115706,11214248,98542,yes,-
BAC191_M04,12,12p13.2,11308261,11384865,76604,-,-
BAC176_D15,12,12p13.2,11448123,11532912,84789,-,-
BAC18_N18,12,12p13.2,11464154,11606782,142628,-,-
BAC230_L13,12,12p13.2,11477630,11587563,109933,-,-
BAC224_G05,12,12p13.2,11494370,11584141,89771,-,-
BAC157_O02,12,12p13.2,11686000,11786980,100980,-,-
BAC169_O07,12,12p13.2,11691044,11788656,97612,-,-
BAC60_I23,12,12p13.2,11701743,11809262,107519,-,-
BAC85_D24,12,12p13.2,11719206,11733159,13953,-,-
BAC228_O23,12,12p13.2,11837514,11922307,84793,-,-
BAC107_G08,12,12p13.2,11840671,12024062,183391,-,-
BAC69_D06,12,12p13.2,11850709,11972558,121849,-,-
BAC45_A06,12,12p13.2,11885319,11974066,88747,-,-
BAC2_K20,12,12p13.2,11922302,12044292,121990,-,-
BAC10_E23,12,12p13.2,11923306,12078252,154946,-,-
BAC90_L05,12,12p13.2,11990855,12117528,126673,-,-
BAC113_C14,12,12p13.2,11995121,12124241,129120,-,-
BAC139_G09,12,12p13.2,11995121,12094994,99873,-,-
BAC181_L15,12,12p13.2,12028941,12130211,101270,-,-
BAC59_H04,12,12p13.2,12028941,12138308,109367,-,-
BAC61_F18,12,12p13.2,12130205,12223443,93238,-,-
BAC241_A16,12,12p13.2,12185647,12281220,95573,-,-
BAC53_I21,12,12p13.2,12192262,12312963,120701,-,-
BAC91_O11,12,12p13.2,12204114,12282722,78608,-,-
BAC84_E21,12,12p13.2,12259149,12364673,105524,-,-
BAC25_K04,12,12p13.2,12259150,12364673,105523,-,-
BAC8_E10,12,12p13.2,12282762,12371921,89159,-,-
BAC127_A12,12,12p13.2,12290002,12398728,108726,-,-
BAC2_I22,12,12p13.2,12314191,12481154,166963,-,-
BAC122_E02,12,12p13.2,12331643,12429433,97790,-,-
BAC169_G09,12,12p13.2-12p13.1,12500693,12631364,130671,-,-
BAC153_P17,12,12p13.2-12p13.1,12588104,12670671,82567,-,-
BAC69_F21,12,12p13.1,12631357,12763248,131891,-,-
BAC20_H09,12,12p13.1,12645156,12745501,100345,-,-
BAC26_E18,12,12p13.1,12646460,12800838,154378,-,-
BAC124_L19,12,12p13.1,12650979,12763248,112269,-,-
BAC118_C23,12,12p13.1,12745495,12833596,88101,-,-
BAC100_N17,12,12p13.1,12784201,12874093,89892,-,-
BAC67_G21,12,12p13.1,13020387,13117237,96850,-,-
BAC202_K13,12,12p13.1,13023382,13119008,95626,-,-
BAC173_E16,12,12p13.1,13046971,13124647,77676,-,-
BAC91_F05,12,12p13.1,13091992,13202881,110889,-,-
BAC213_O14,12,12p13.1,13109685,13215613,105928,-,-
BAC118_I11,12,12p13.1,13132474,13256799,124325,-,-
BAC167_P03,12,12p13.1,13152331,13254721,102390,-,-
BAC172_A01,12,12p13.1,13160899,13263484,102585,-,-
BAC233_A11,12,12p13.1,13178018,13283364,105346,-,-
BAC242_J07,12,12p13.1,13215621,13292489,76868,-,-
BAC168_L14,12,12p13.1,13290421,13360508,70087,-,-
BAC20_N10,12,12p13.1,13292483,13406437,113954,-,-
BAC60_O16,12,12p13.1,13323170,13434961,111791,-,-
BAC118_O19,12,12p13.1,13349116,13444254,95138,-,-
BAC116_O06,12,12p13.1,13360503,13431921,71418,-,-
BAC176_J07,12,12p13.1,13468117,13553695,85578,-,-
BAC97_F18,12,12p13.1,13800835,13926873,126038,-,-
BAC74_L08,12,12p13.1,13800835,13896648,95813,-,-
BAC86_G17,12,12p13.1,13800835,13926873,126038,-,-
BAC246_G04,12,12p13.1,13929895,14017490,87595,-,-
BAC82_M15,12,12p13.1,13976863,14064939,88076,-,-
BAC252_M05,12,12p13.1,14002461,14101254,98793,-,-
BAC181_P06,12,12p13.1,14016631,14101225,84594,-,-
BAC40_C11,12,12p13.1,14104488,14193235,88747,-,-
BAC61_H05,12,12p13.1,14127396,14304094,176698,-,-
BAC54_B20,12,12p13.1,14179903,14263810,83907,-,-
BAC163_P15,12,12p13.1,14267785,14350409,82624,-,-
BAC53_E11,12,12p13.1,14452856,14551995,99139,-,-
BAC96_F03,12,12p13.1,14472176,14573395,101219,-,-
BAC123_J10,12,12p13.1,14496263,14601930,105667,-,-
BAC185_O01,12,12p13.1,14562517,14655482,92965,-,-
BAC105_K09,12,12p13.1,14562547,14677192,114645,-,-
BAC230_N19,12,12p13.1-12p12.3,14791650,14881379,89729,-,-
BAC156_L17,12,12p12.3,14874357,15004112,129755,-,-
BAC64_A20,12,12p12.3,14929341,14995326,65985,-,-
BAC64_L15,12,12p12.3,14935833,15025038,89205,-,-
BAC237_P09,12,12p12.3,15224698,15325835,101137,-,-
BAC193_K18,12,12p12.3,15251165,15333984,82819,-,-
BAC63_M11,12,12p12.3,15291591,15408102,116511,-,-
BAC195_E22,12,12p12.3,15299105,15379814,80709,-,-
BAC147_N14,12,12p12.3,15372808,15504490,131682,-,-
BAC29_N16,12,12p12.3,15377184,15461747,84563,-,-
BAC148_M07,12,12p12.3,15450255,15528236,77981,-,-
BAC187_N20,12,12p12.3,15453900,15548371,94471,-,-
BAC244_J18,12,12p12.3,15635202,15705793,70591,-,-
BAC132_I20,12,12p12.3,15667156,15754643,87487,-,-
BAC124_F01,12,12p12.3,15667164,15790860,123696,-,-
BAC166_F04,12,12p12.3,15709858,15817270,107412,-,-
BAC102_H05,12,12p12.3,15786751,15865332,78581,-,-
BAC88_B12,12,12p12.3,15790585,15865332,74747,-,-
BAC75_H10,12,12p12.3,15877636,15986556,108920,-,-
BAC252_G01,12,12p12.3,15891647,15973291,81644,-,-
BAC144_I17,12,12p12.3,15958725,16062088,103363,-,-
BAC146_L01,12,12p12.3,15967242,16042320,75078,-,-
BAC85_B15,12,12p12.3,16042537,16143620,101083,-,-
BAC131_K06,12,12p12.3,16287013,16368296,81283,-,-
BAC140_E24,12,12p12.3,16317215,16406588,89373,-,-
BAC130_P03,12,12p12.3,16492271,16574312,82041,-,-
BAC141_A18,12,12p12.3,16541264,16622481,81217,-,-
BAC101_B19,12,12p12.3,16617810,16754631,136821,-,-
BAC97_E16,12,12p12.3,16951026,17067629,116603,-,-
BAC127_G15,12,12p12.3,17077889,17176283,98394,-,-
BAC46_N15,12,12p12.3,17213324,17312235,98911,-,-
BAC202_I08,12,12p12.3,17406622,17508885,102263,-,-
BAC136_I13,12,12p12.3,17475386,17577237,101851,-,-
BAC135_J24,12,12p12.3,17946612,18053441,106829,-,-
BAC188_L20,12,12p12.3,17950119,18046237,96118,-,-
BAC114_B13,12,12p12.3,18091604,18182480,90876,-,-
BAC67_M15,12,12p12.3,18099078,18222835,123757,-,-
BAC67_J03,12,12p12.3,18207037,18333988,126951,-,-
BAC249_I22,12,12p12.3,18360715,18486070,125355,-,-
BAC226_G23,12,12p12.3,18360718,18451172,90454,-,-
BAC149_J14,12,12p12.3,18399582,18513979,114397,-,-
BAC149_K20,12,12p12.3,18472997,18565787,92790,-,-
BAC37_G10,12,12p12.3,18520393,18645488,125095,-,-
BAC186_P13,12,12p12.3,18619375,18714858,95483,-,-
BAC247_M04,12,12p12.3,18733557,18829878,96321,-,-
BAC199_N16,12,12p12.3,18995411,19109310,113899,-,-
BAC124_J03,12,12p12.3,19025851,19124073,98222,-,-
BAC118_C19,12,12p12.3,19161092,19278440,117348,-,-
BAC60_A06,12,12p12.3,19380363,19467659,87296,-,-
BAC232_K14,12,12p12.3,19467650,19557940,90290,-,-
BAC148_M11,12,12p12.3,19470214,19537599,67385,-,-
BAC112_O04,12,12p12.3,19485431,19580321,94890,-,-
BAC80_E18,12,12p12.3,19521394,19619027,97633,-,-
BAC239_B16,12,12p12.3,19557241,19640429,83188,-,-
BAC124_A13,12,12p12.3,19577938,19697947,120009,-,-
BAC244_A02,12,12p12.3,19603048,19685459,82411,-,-
BAC88_B01,12,12p12.3,19671217,19784752,113535,-,-
BAC25_P13,12,12p12.3,19681946,19786618,104672,-,-
BAC88_D13,12,12p12.3,19803306,19891529,88223,-,-
BAC20_E19,12,12p12.3-12p12.2,19839597,19924317,84720,-,-
BAC12_B08,12,12p12.2,19911315,20018209,106894,-,-
BAC246_L13,12,12p12.2,19924311,20016994,92683,-,-
BAC223_F07,12,12p12.2,19924311,20020144,95833,-,-
BAC230_D11,12,12p12.2,20012002,20116312,104310,-,-
BAC91_O05,12,12p12.2,20078593,20185397,106804,-,-
BAC71_M01,12,12p12.2,20116357,20228988,112631,-,-
BAC167_M11,12,12p12.2,20136742,20226533,89791,-,-
BAC31_E16,12,12p12.2,20139190,20229216,90026,-,-
BAC150_J16,12,12p12.2,20149113,20229243,80130,-,-
BAC230_F16,12,12p12.2,20277328,20362333,85005,-,-
BAC74_P04,12,12p12.2,20340087,20470480,130393,-,-
BAC151_L05,12,12p12.2,20426854,20522252,95398,-,-
BAC103_K10,12,12p12.2,20470588,20582387,111799,-,-
BAC86_J14,12,12p12.2,20632473,20735250,102777,-,-
BAC185_M07,12,12p12.2,20790719,20874368,83649,-,-
BAC103_G01,12,12p12.2,20803477,20890911,87434,-,-
BAC33_E16,12,12p12.2,20838549,20936124,97575,-,-
BAC185_A03,12,12p12.2,20892092,20979885,87793,-,-
BAC17_B04,12,12p12.1,21263472,21405958,142486,-,-
BAC158_M04,12,12p12.1,21279381,21385089,105708,-,-
BAC57_E07,12,12p12.1,21317259,21402468,85209,-,-
BAC21_J04,12,12p12.1,21513807,21595719,81912,-,-
BAC153_L03,12,12p12.1,21691170,21778151,86981,-,-
BAC6_F15,12,12p12.1,21791073,21888253,97180,-,-
BAC217_A03,12,12p12.1,21981837,22103329,121492,-,-
BAC44_L04,12,12p12.1,22025715,22160702,134987,-,-
BAC25_F05,12,12p12.1,22045250,22191474,146224,-,-
BAC224_C16,12,12p12.1,22217518,22332742,115224,-,-
BAC192_E14,12,12p12.1,22328527,22430316,101789,-,-
BAC181_H12,12,12p12.1,22364419,22482697,118278,-,-
BAC51_B14,12,12p12.1,22517603,22671277,153674,-,-
BAC190_K17,12,12p12.1,22521054,22609761,88707,-,-
BAC12_K21,12,12p12.1,22530625,22623908,93283,-,-
BAC109_E19,12,12p12.1,22540393,22640103,99710,-,-
BAC71_M05,12,12p12.1,22544888,22652399,107511,-,-
BAC145_H01,12,12p12.1,22551797,22629531,77734,-,-
BAC72_C07,12,12p12.1,22575155,22652494,77339,-,-
BAC247_D15,12,12p12.1,22652502,22747872,95370,-,-
BAC158_O04,12,12p12.1,22725168,22813707,88539,-,-
BAC38_I16,12,12p12.1,22787992,22898938,110946,-,-
BAC165_K18,12,12p12.1,22788862,22869547,80685,-,-
BAC107_B02,12,12p12.1,22813732,22905547,91815,-,-
BAC236_I22,12,12p12.1,22894313,23027920,133607,-,-
BAC242_A17,12,12p12.1,22918197,22996202,78005,-,-
BAC168_P16,12,12p12.1,22959289,23048375,89086,-,-
BAC41_I06,12,12p12.1,22959313,23086117,126804,-,-
BAC148_C07,12,12p12.1,23037662,23122067,84405,-,-
BAC71_D12,12,12p12.1,23340615,23420723,80108,-,-
BAC175_C11,12,12p12.1,23345897,23439176,93279,-,-
BAC35_K01,12,12p12.1,23427953,23519880,91927,-,-
BAC122_G09,12,12p12.1,23516306,23661329,145023,-,-
BAC161_J05,12,12p12.1,23519969,23607085,87116,-,-
BAC127_D22,12,12p12.1,23573050,23684401,111351,-,-
BAC26_I24,12,12p12.1,23705873,23823244,117371,-,-
BAC176_A07,12,12p12.1,23814920,23907987,93067,-,-
BAC49_M10,12,12p12.1,23832567,23911204,78637,-,-
BAC154_C03,12,12p12.1,23933476,24032399,98923,-,-
BAC190_O01,12,12p12.1,23959224,24054412,95188,-,-
BAC208_F20,12,12p12.1,24292626,24381019,88393,-,-
BAC163_F20,12,12p12.1,24352622,24431754,79132,-,-
BAC38_B07,12,12p12.1,24388670,24497927,109257,-,-
BAC125_O15,12,12p12.1,24414262,24508371,94109,-,-
BAC95_M10,12,12p12.1,24540988,24629931,88943,-,-
BAC152_A22,12,12p12.1,24743963,24856520,112557,-,-
BAC69_O13,12,12p12.1,24809029,24917779,108750,-,-
BAC11_N08,12,12p12.1,24818399,24956827,138428,-,-
BAC123_L11,12,12p12.1,24891833,24987162,95329,-,-
BAC52_N21,12,12p12.1,24927138,25053665,126527,-,-
BAC86_E14,12,12p12.1,24963658,25058695,95037,-,-
BAC41_N04,12,12p12.1,25049382,25236636,187254,-,-
BAC143_N01,12,12p12.1,25091663,25210717,119054,-,-
BAC171_B10,12,12p12.1,25106744,25180225,73481,-,-
BAC33_O01,12,12p12.1,25205815,25314263,108448,-,-
BAC75_O04,12,12p12.1,25408099,25527973,119874,-,-
BAC127_N01,12,12p12.1,25429040,25552136,123096,-,-
BAC39_N10,12,12p12.1,25434889,25525532,90643,-,-
BAC162_L02,12,12p12.1,25445067,25539169,94102,-,-
BAC198_H24,12,12p12.1,25481435,25566267,84832,-,-
BAC142_I06,12,12p12.1,25495778,25607697,111919,-,-
BAC22_L01,12,12p12.1,25597207,25710006,112799,-,-
BAC118_M19,12,12p12.1,25666365,25783274,116909,-,-
BAC153_D05,12,12p12.1,25671033,25752468,81435,-,-
BAC221_F09,12,12p12.1,25736864,25824595,87731,-,-
BAC228_E13,12,12p12.1,25756678,25847547,90869,-,-
BAC125_A13,12,12p12.1,25756695,25840795,84100,-,-
BAC89_P13,12,12p12.1,25824908,25911388,86480,-,-
BAC22_H02,12,12p12.1,25895119,26015213,120094,-,-
BAC63_N23,12,12p12.1,25945199,26023371,78172,-,-
BAC53_D09,12,12p12.1,25973729,26075667,101938,-,-
BAC95_A14,12,12p12.1,26015371,26144098,128727,-,-
BAC152_J12,12,12p12.1,26146416,26277508,131092,-,-
BAC222_J09,12,12p12.1,26164682,26273543,108861,-,-
BAC121_J23,12,12p12.1-12p11.23,26191066,26316488,125422,-,-
BAC244_G14,12,12p12.1-12p11.23,26218240,26301721,83481,-,-
BAC2_N20,12,12p12.1-12p11.23,26231399,26322114,90715,-,-
BAC234_C01,12,12p12.1-12p11.23,26250309,26333552,83243,-,-
BAC50_P02,12,12p11.23,26322238,26436224,113986,-,-
BAC10_O01,12,12p11.23,26328962,26439616,110654,-,-
BAC50_I16,12,12p11.23,26332066,26352606,20540,-,-
BAC186_P18,12,12p11.23,26451706,26538539,86833,-,-
BAC92_P10,12,12p11.23,26466548,26558933,92385,-,-
BAC57_I14,12,12p11.23,26523922,26624665,100743,-,-
BAC121_P21,12,12p11.23,26689788,26798168,108380,-,-
BAC158_C04,12,12p11.23,26689809,26759730,69921,-,-
BAC250_L10,12,12p11.23,26800817,26883998,83181,-,-
BAC62_N12,12,12p11.23,26979730,27000123,20393,-,-
BAC66_P10,12,12p11.23,27017556,27096425,78869,-,-
BAC89_I12,12,12p11.23,27074518,27163292,88774,-,-
BAC149_A18,12,12p11.23,27170908,27263097,92189,-,-
BAC55_L02,12,12p11.23,27171095,27275700,104605,-,-
BAC227_F10,12,12p11.23,27183377,27290528,107151,-,-
BAC43_K17,12,12p11.23,27205997,27329744,123747,-,-
BAC238_N01,12,12p11.23,27215445,27290528,75083,-,-
BAC121_G15,12,12p11.23,27329778,27410521,80743,-,-
BAC39_I11,12,12p11.23,27344407,27423326,78919,-,-
BAC197_B02,12,12p11.23,27410569,27534217,123648,-,-
BAC124_O01,12,12p11.23,27429984,27517214,87230,-,-
BAC62_D22,12,12p11.23,27437256,27540483,103227,-,-
BAC88_M10,12,12p11.23,27483233,27590031,106798,-,-
BAC236_C02,12,12p11.23,27496308,27602457,106149,-,-
BAC189_G02,12,12p11.23,27499504,27584659,85155,-,-
BAC78_F24,12,12p11.23-12p11.22,27679860,27767972,88112,-,-
BAC151_B12,12,12p11.23-12p11.22,27679928,27790263,110335,-,-
BAC155_P13,12,12p11.23-12p11.22,27679928,27805858,125930,-,-
BAC146_C13,12,12p11.23-12p11.22,27679928,27762058,82130,-,-
BAC24_J19,12,12p11.22,27733134,27831406,98272,-,-
BAC28_J18,12,12p11.22,27762266,27911733,149467,-,-
BAC71_D05,12,12p11.22,27767971,27849685,81714,-,-
BAC90_L10,12,12p11.22,27821731,27929582,107851,-,-
BAC187_B15,12,12p11.22,27859360,27950445,91085,-,-
BAC247_C10,12,12p11.22,27906538,27986621,80083,-,-
BAC139_L03,12,12p11.22,28133046,28255685,122639,-,-
BAC29_J13,12,12p11.22,28261631,28371491,109860,-,-
BAC165_M07,12,12p11.22,28599209,28688144,88935,-,-
BAC161_B21,12,12p11.22,28807947,28900558,92611,-,-
BAC197_K17,12,12p11.22,28821680,28913109,91429,-,-
BAC73_A24,12,12p11.22,28900861,28990137,89276,-,-
BAC161_N21,12,12p11.22,29051860,29149332,97472,-,-
BAC226_F03,12,12p11.22,29392565,29484733,92168,-,-
BAC125_N02,12,12p11.22,29481093,29569314,88221,-,-
BAC64_M21,12,12p11.22,29626985,29716022,89037,-,-
BAC137_G09,12,12p11.22,29631004,29711269,80265,-,-
BAC75_B11,12,12p11.22,29647859,29757849,109990,-,-
BAC44_J07,12,12p11.22,29647875,29741523,93648,-,-
BAC233_A16,12,12p11.22,29673926,29741534,67608,-,-
BAC95_H11,12,12p11.22,29691798,29812836,121038,-,-
BAC151_F13,12,12p11.22,29728061,29807309,79248,-,-
BAC89_P09,12,12p11.22,29757846,29869033,111187,-,-
BAC235_D21,12,12p11.22,29781027,29864029,83002,-,-
BAC194_H05,12,12p11.22,29987772,30106665,118893,-,-
BAC155_L15,12,12p11.22,30013034,30176806,163772,-,-
BAC36_H04,12,12p11.22,30027767,30125950,98183,-,-
BAC252_F01,12,12p11.22,30049694,30150747,101053,-,-
BAC116_J16,12,12p11.22,30089752,30211681,121929,-,-
BAC84_M20,12,12p11.22,30232648,30343094,110446,-,-
BAC83_C01,12,12p11.22,30235830,30332741,96911,-,-
BAC72_D13,12,12p11.22,30301325,30401397,100072,-,-
BAC106_J22,12,12p11.22,30336130,30484960,148830,-,-
BAC83_B18,12,12p11.22,30405797,30487973,82176,-,-
BAC23_E23,12,12p11.22,30479073,30566733,87660,-,-
BAC231_H19,12,12p11.22-12p11.21,30547267,30636342,89075,-,-
BAC235_P16,12,12p11.21,30636362,30716229,79867,-,-
BAC24_K22,12,12p11.21,30696828,30818650,121822,-,-
BAC221_C22,12,12p11.21,30742148,30845410,103262,-,-
BAC46_N03,12,12p11.21,30742200,30826854,84654,-,-
BAC113_M08,12,12p11.21,30752396,30894744,142348,-,-
BAC105_C17,12,12p11.21,30801491,30894937,93446,-,-
BAC233_G08,12,12p11.21,30801491,30887375,85884,-,-
BAC161_J20,12,12p11.21,30848729,30935619,86890,-,-
BAC126_I02,12,12p11.21,30887370,30976080,88710,-,-
BAC33_L08,12,12p11.21,30888038,31031534,143496,-,-
BAC140_P24,12,12p11.21,30895023,30982930,87907,-,-
BAC194_H19,12,12p11.21,30897466,30976080,78614,-,-
BAC158_B09,12,12p11.21,30915145,31010117,94972,-,-
BAC42_L03,12,12p11.21,30981434,31093711,112277,-,-
BAC51_E06,12,12p11.21,30987856,31100160,112304,-,-
BAC143_H17,12,12p11.21,31017565,31099984,82419,-,-
BAC249_L05,12,12p11.21,31044452,31165604,121152,-,-
BAC35_O04,12,12p11.21,31100398,31197906,97508,-,-
BAC230_G01,12,12p11.21,31100688,31178801,78113,-,-
BAC32_B08,12,12p11.21,31178858,31289973,111115,-,-
BAC181_C05,12,12p11.21,31289189,31398711,109522,-,-
BAC167_G20,12,12p11.21,31289969,31390416,100447,-,-
BAC80_N02,12,12p11.21,31344481,31477917,133436,-,-
BAC149_A23,12,12p11.21,31390723,31510142,119419,-,-
BAC238_C09,12,12p11.21,31391101,31497846,106745,-,-
BAC143_C15,12,12p11.21,31398705,31489167,90462,-,-
BAC27_B05,12,12p11.21,31398721,31522521,123800,-,-
BAC158_I23,12,12p11.21,31401371,31510142,108771,-,-
BAC158_F23,12,12p11.21,31401371,31510125,108754,-,-
BAC206_M16,12,12p11.21,31434381,31509955,75574,-,-
BAC96_J02,12,12p11.21,31434381,31532687,98306,-,-
BAC76_B24,12,12p11.21,31436712,31560015,123303,-,-
BAC123_L17,12,12p11.21,31546914,31671400,124486,-,-
BAC57_G04,12,12p11.21,31561750,31691222,129472,-,-
BAC140_G22,12,12p11.21,31680830,31772818,91988,-,-
BAC229_B11,12,12p11.21,31706274,31787356,81082,-,-
BAC235_L01,12,12p11.21,31791071,31886910,95839,-,-
BAC156_E09,12,12p11.21,31799815,31886937,87122,-,-
BAC150_N17,12,12p11.21,31799815,31900461,100646,-,-
BAC66_F05,12,12p11.21,31849157,32002050,152893,-,-
BAC30_O13,12,12p11.21,31897184,31986306,89122,-,-
BAC181_P10,12,12p11.21,31900628,31998754,98126,-,-
BAC101_E20,12,12p11.21,31940180,32044452,104272,-,-
BAC231_F11,12,12p11.21,31943492,32044452,100960,-,-
BAC54_M14,12,12p11.21,31962083,32029977,67894,-,-
BAC167_H03,12,12p11.21,32010856,32108465,97609,-,-
BAC10_P04,12,12p11.21,32010856,32139687,128831,-,-
BAC97_L13,12,12p11.21,32014782,32139685,124903,-,-
BAC154_C24,12,12p11.21,32018672,32102598,83926,-,-
BAC151_M19,12,12p11.21,32044657,32182526,137869,-,-
BAC52_A21,12,12p11.21,32044698,32229763,185065,-,-
BAC118_B21,12,12p11.21,32188088,32286821,98733,-,-
BAC169_N24,12,12p11.21,32190489,32268576,78087,-,-
BAC146_J09,12,12p11.21,32236771,32315845,79074,-,-
BAC20_I03,12,12p11.21,32238468,32337163,98695,-,-
BAC150_K15,12,12p11.21,32384906,32461514,76608,-,-
BAC209_L05,12,12p11.21,32385093,32482653,97560,-,-
BAC127_C06,12,12p11.21,32397138,32482655,85517,-,-
BAC200_O03,12,12p11.21,32467812,32545976,78164,-,-
BAC150_G08,12,12p11.21,32522835,32609037,86202,-,-
BAC37_F03,12,12p11.21,32548850,32662712,113862,-,-
BAC246_K03,12,12p11.21,32552129,32632328,80199,-,-
BAC219_N03,12,12p11.21,32580040,32683980,103940,-,-
BAC233_H06,12,12p11.21,32626416,32747246,120830,-,-
BAC242_K10,12,12p11.21,32639701,32721379,81678,-,-
BAC180_L14,12,12p11.21,32639701,32716414,76713,-,-
BAC43_B08,12,12p11.21,32692122,32791187,99065,-,-
BAC64_K06,12,12p11.21,32715329,32794960,79631,-,-
BAC127_G22,12,12p11.21,32716406,32805307,88901,-,-
BAC102_G07,12,12p11.21,32752195,32864060,111865,-,-
BAC58_J11,12,12p11.21,32775135,32871214,96079,-,-
BAC39_O18,12,12p11.21,32781624,32870965,89341,-,-
BAC50_I18,12,12p11.21,32972383,33069912,97529,-,-
BAC118_O07,12,12p11.21-12p11.1,33169305,33261321,92016,-,-
BAC73_K18,12,12p11.1,33269959,33411296,141337,-,-
BAC152_K16,12,12p11.1,33379705,33457116,77411,-,-
BAC142_N01,12,12p11.1,33420446,33510718,90272,-,-
BAC24_D19,12,12p11.1,33424025,33566299,142274,-,-
BAC60_O12,12,12p11.1,33471824,33650529,178705,-,-
BAC39_H10,12,12p11.1,33520008,33632884,112876,-,-
BAC184_O17,12,12p11.1,33574312,33642053,67741,-,-
BAC50_H15,12,12p11.1,33817556,33903469,85913,-,-
BAC166_A23,12,12p11.1,33909583,33973809,64226,-,-
BAC31_C15,12,12p11.1,33921637,34002987,81350,-,-
BAC234_A16,12,12p11.1,34085963,34164829,78866,-,-
BAC65_A05,12,12p11.1,34246075,34354748,108673,-,-
BAC211_H20,12,12p11.1,34274891,34369378,94487,-,-
BAC155_B18,12,12p11.1,34288759,34392825,104066,-,-
BAC167_P13,12,12p11.1,34306833,34380506,73673,-,-
BAC131_N03,12,12q12,36673467,36775174,101707,-,-
BAC118_C16,12,12q12,36904302,36985405,81103,-,-
BAC166_F10,12,12q12,37225786,37293436,67650,-,-
BAC120_I16,12,12q12,37230782,37349563,118781,-,-
BAC136_L19,12,12q12,37326099,37410072,83973,-,-
BAC123_F22,12,12q12,37380326,37500475,120149,-,-
BAC103_D20,12,12q12,37459465,37555974,96509,-,-
BAC196_M14,12,12q12,37628041,37717269,89228,-,-
BAC152_F13,12,12q12,37762559,37838599,76040,-,-
BAC252_G03,12,12q12,37776143,37874707,98564,-,-
BAC84_G13,12,12q12,37776147,37857180,81033,-,-
BAC95_L22,12,12q12,37902819,37994579,91760,-,-
BAC21_B17,12,12q12,37902819,38031494,128675,-,-
BAC27_O03,12,12q12,38067517,38170858,103341,-,-
BAC56_N05,12,12q12,38170853,38251874,81021,-,-
BAC181_N07,12,12q12,38325390,38406510,81120,-,-
BAC117_C15,12,12q12,38325391,38468792,143401,-,-
BAC228_C03,12,12q12,38468781,38548844,80063,-,-
BAC195_M23,12,12q12,38494360,38586383,92023,-,-
BAC161_P10,12,12q12,38528267,38608800,80533,-,-
BAC69_D05,12,12q12,38843246,38937257,94011,-,-
BAC248_F13,12,12q12,38866588,38969989,103401,-,-
BAC168_I02,12,12q12,38871275,38952011,80736,-,-
BAC157_F06,12,12q12,38899480,38977805,78325,-,-
BAC58_G06,12,12q12,38937547,39039306,101759,-,-
BAC143_I21,12,12q12,39002330,39098609,96279,-,-
BAC76_H17,12,12q12,39011769,39110760,98991,-,-
BAC36_M18,12,12q12,39023964,39136015,112051,-,-
BAC157_H04,12,12q12,39111895,39189385,77490,-,-
BAC235_C23,12,12q12,39136010,39216404,80394,-,-
BAC240_N22,12,12q12,39261587,39334167,72580,-,-
BAC1_B14,12,12q12,39296650,39397797,101147,-,-
BAC230_M19,12,12q12,39309685,39395715,86030,-,-
BAC162_J17,12,12q12,39362903,39464694,101791,-,-
BAC142_G01,12,12q12,39368296,39464694,96398,-,-
BAC106_G21,12,12q12,39368296,39469283,100987,-,-
BAC199_G02,12,12q12,39582488,39679490,97002,-,-
BAC178_C19,12,12q12,39639437,39715077,75640,-,-
BAC69_F11,12,12q12,39647626,39756980,109354,-,-
BAC84_E24,12,12q12,39657378,39747266,89888,-,-
BAC191_N07,12,12q12,40153684,40236124,82440,-,-
BAC243_A02,12,12q12,40207760,40321750,113990,-,-
BAC103_A11,12,12q12,40253289,40364808,111519,-,-
BAC45_M01,12,12q12,40274127,40346189,72062,-,-
BAC113_M14,12,12q12,40274514,40450636,176122,-,-
BAC155_B24,12,12q12,40323018,40419808,96790,-,-
BAC231_K03,12,12q12,40366379,40456193,89814,-,-
BAC252_D07,12,12q12,40572257,40663766,91509,-,-
BAC86_L10,12,12q12,40603505,40739238,135733,-,-
BAC23_J10,12,12q12,40863416,40980734,117318,-,-
BAC89_M09,12,12q12,40868873,41014215,145342,-,-
BAC248_B21,12,12q12,40875580,40952988,77408,-,-
BAC192_D19,12,12q12,40881375,40980734,99359,-,-
BAC235_K13,12,12q12,41012295,41111677,99382,-,-
BAC51_A07,12,12q12,41057066,41159537,102471,-,-
BAC150_L15,12,12q12,41083664,41172701,89037,-,-
BAC92_D04,12,12q12,41146595,41254264,107669,-,-
BAC167_F03,12,12q12,41146596,41262775,116179,-,-
BAC230_C03,12,12q12,41172699,41252504,79805,-,-
BAC247_G12,12,12q12,41262771,41359587,96816,-,-
BAC189_G12,12,12q12,41296207,41385357,89150,-,-
BAC8_D06,12,12q12,41359578,41473349,113771,-,-
BAC28_F12,12,12q12,41449897,41572757,122860,-,-
BAC143_O23,12,12q12,41460345,41539968,79623,-,-
BAC65_E12,12,12q12,41482049,41572783,90734,-,-
BAC26_N19,12,12q12,41491003,41629350,138347,-,-
BAC132_F12,12,12q12,41644623,41732409,87786,-,-
BAC109_H16,12,12q12,41727806,41803440,75634,-,-
BAC167_B24,12,12q12,41728748,41805742,76994,-,-
BAC101_G13,12,12q12,41803434,41889889,86455,-,-
BAC187_L24,12,12q12,41803434,41907587,104153,-,-
BAC43_E19,12,12q12,41805760,41917055,111295,-,-
BAC228_N04,12,12q12,41962641,42053695,91054,-,-
BAC58_I02,12,12q12,42008367,42135265,126898,-,-
BAC24_O11,12,12q12,42017908,42098824,80916,-,-
BAC139_M06,12,12q12,42161296,42248227,86931,-,-
BAC83_L18,12,12q12,42363969,42498292,134323,-,-
BAC133_G13,12,12q12,42384377,42490904,106527,-,-
BAC10_A02,12,12q12,42451871,42663105,211234,-,-
BAC151_C15,12,12q12,42467735,42555928,88193,-,-
BAC139_M19,12,12q12,42843448,42926770,83322,-,-
BAC52_I10,12,12q12,42901475,42997007,95532,-,-
BAC42_M14,12,12q12,43070283,43176050,105767,-,-
BAC139_O09,12,12q12,43173459,43273237,99778,-,-
BAC81_A19,12,12q12,43329756,43422407,92651,-,-
BAC61_B08,12,12q12,43559911,43658510,98599,-,-
BAC100_N12,12,12q12,43560208,43658510,98302,-,-
BAC63_A01,12,12q12,43569442,43621551,52109,-,-
BAC199_I12,12,12q12,43704864,43778576,73712,-,-
BAC89_L11,12,12q12,43738599,43853814,115215,-,-
BAC188_D18,12,12q12,43738603,43759790,21187,-,-
BAC33_F17,12,12q12,43760297,43845812,85515,-,-
BAC152_M15,12,12q12,43768480,43884333,115853,-,-
BAC128_C07,12,12q12,43866948,43985201,118253,-,-
BAC142_O13,12,12q12,43932217,44015550,83333,-,-
BAC246_O04,12,12q12,44058614,44165748,107134,-,-
BAC13_O02,12,12q12,44062182,44161870,99688,-,-
BAC149_P06,12,12q12,44105587,44132275,26688,-,-
BAC136_M11,12,12q12,44165747,44255885,90138,-,-
BAC222_E10,12,12q12,44194379,44281573,87194,-,-
BAC249_J21,12,12q12,44220332,44314681,94349,-,-
BAC75_I03,12,12q12,44227630,44330907,103277,-,-
BAC117_N24,12,12q12,44229959,44263394,33435,-,-
BAC128_I20,12,12q12,44295875,44438335,142460,-,-
BAC178_E23,12,12q12,44331726,44438035,106309,-,-
BAC185_P06,12,12q12-12q13.11,44552256,44644656,92400,-,-
BAC92_I08,12,12q13.11,44816776,44978566,161790,-,-
BAC97_H20,12,12q13.11,44849498,44946744,97246,-,-
BAC24_B19,12,12q13.11,44864300,44943429,79129,-,-
BAC132_A11,12,12q13.11,44916351,45001263,84912,-,-
BAC171_P07,12,12q13.11,44927441,45028230,100789,-,-
BAC105_F14,12,12q13.11,45036823,45141267,104444,-,-
BAC180_A08,12,12q13.11,45039934,45141264,101330,-,-
BAC52_K20,12,12q13.11,45064204,45151295,87091,-,-
BAC236_L20,12,12q13.11,45099789,45207993,108204,-,-
BAC68_B07,12,12q13.11,45151293,45277713,126420,-,-
BAC162_D04,12,12q13.11,45381768,45457320,75552,-,-
BAC123_G08,12,12q13.11,45418388,45506831,88443,-,-
BAC25_G05,12,12q13.11,45627081,45740539,113458,-,-
BAC171_I23,12,12q13.11,45703378,45793500,90122,-,-
BAC140_D24,12,12q13.11,45822137,45899946,77809,-,-
BAC239_C19,12,12q13.11,45831555,45975737,144182,-,-
BAC12_M19,12,12q13.11,45859415,45942334,82919,-,-
BAC229_J08,12,12q13.11,45876487,45964171,87684,-,-
BAC248_E05,12,12q13.11,45899971,45975737,75766,-,-
BAC113_L13,12,12q13.11,45903704,46021927,118223,-,-
BAC227_M16,12,12q13.11,45942683,46060014,117331,-,-
BAC36_G03,12,12q13.11,46021123,46110608,89485,-,-
BAC110_C05,12,12q13.11,46036487,46177923,141436,-,-
BAC193_D01,12,12q13.11,46060414,46146207,85793,-,-
BAC69_B16,12,12q13.11,46177915,46291216,113301,-,-
BAC118_J01,12,12q13.11,46181406,46293294,111888,-,-
BAC33_C04,12,12q13.11,46184201,46278822,94621,-,-
BAC152_P23,12,12q13.11,46273615,46354665,81050,-,-
BAC167_E07,12,12q13.11,46370994,46450317,79323,-,-
BAC150_M18,12,12q13.11,46437768,46547942,110174,-,-
BAC226_A08,12,12q13.11,46490409,46633720,143311,-,-
BAC80_G06,12,12q13.11,46525617,46612427,86810,-,-
BAC159_B04,12,12q13.11,46525627,46633691,108064,-,-
BAC170_B22,12,12q13.11,46528031,46633720,105689,-,-
BAC232_H20,12,12q13.11,46567937,46654973,87036,-,-
BAC25_F15,12,12q13.11,46616298,46709160,92862,-,-
BAC54_H10,12,12q13.11,46633714,46743315,109601,-,-
BAC70_E09,12,12q13.11,46633853,46719115,85262,-,-
BAC84_C23,12,12q13.11,46655358,46743010,87652,-,-
BAC167_G19,12,12q13.11,46671157,46764229,93072,-,-
BAC175_F02,12,12q13.11,46719248,46819932,100684,-,-
BAC132_C07,12,12q13.11,46879942,47005002,125060,-,-
BAC88_M15,12,12q13.11,46879942,46992106,112164,-,-
BAC183_C07,12,12q13.11,46928984,47015669,86685,-,-
BAC72_H16,12,12q13.11,47077675,47164656,86981,-,-
BAC127_A23,12,12q13.11,47113803,47251031,137228,-,-
BAC51_O07,12,12q13.11,47147316,47232935,85619,-,-
BAC180_G15,12,12q13.11,47170141,47207889,37748,-,-
BAC194_E05,12,12q13.11,47249190,47335544,86354,-,-
BAC67_J14,12,12q13.11,47249192,47334685,85493,-,-
BAC117_C08,12,12q13.11-12q13.12,47305874,47441017,135143,-,-
BAC41_J09,12,12q13.11-12q13.12,47306575,47407061,100486,-,-
BAC111_A07,12,12q13.11-12q13.12,47306841,47412503,105662,-,-
BAC162_N02,12,12q13.11-12q13.12,47334693,47406671,71978,-,-
BAC248_O20,12,12q13.11-12q13.12,47335633,47432584,96951,-,-
BAC83_N07,12,12q13.11-12q13.12,47335633,47432589,96956,-,-
BAC76_M04,12,12q13.11-12q13.12,47337027,47425267,88240,-,-
BAC136_M17,12,12q13.11-12q13.12,47343615,47425267,81652,-,-
BAC124_I03,12,12q13.11-12q13.12,47366640,47454956,88316,-,-
BAC161_G12,12,12q13.12,47426001,47527086,101085,-,-
BAC100_J24,12,12q13.12,47453186,47609658,156472,-,-
BAC119_G18,12,12q13.12,47480869,47622294,141425,-,-
BAC217_J11,12,12q13.12,47491324,47615477,124153,-,-
BAC171_C04,12,12q13.12,47521552,47609663,88111,-,-
BAC36_H13,12,12q13.12,47534214,47622296,88082,-,-
BAC159_P05,12,12q13.12,47725712,47743000,17288,-,-
BAC20_A17,12,12q13.12,47865019,47956088,91069,-,-
BAC111_E13,12,12q13.12,47915349,48006404,91055,-,-
BAC238_G11,12,12q13.12,48043112,48128762,85650,-,-
BAC222_J08,12,12q13.12,48129019,48237300,108281,-,-
BAC127_C08,12,12q13.12,48135262,48286380,151118,-,-
BAC131_B09,12,12q13.12,48226547,48324099,97552,yes,-
BAC168_L19,12,12q13.12,48226547,48355720,129173,yes,-
BAC234_A05,12,12q13.12,48236232,48348921,112689,yes,-
BAC170_O04,12,12q13.12-12q13.13,48287766,48423755,135989,yes,-
BAC150_J23,12,12q13.12-12q13.13,48322014,48430087,108073,yes,-
BAC80_N08,12,12q13.13,48423799,48527388,103589,-,-
BAC97_F08,12,12q13.13,48423807,48527388,103581,-,-
BAC150_B01,12,12q13.13,48457615,48548110,90495,-,-
BAC41_B04,12,12q13.13,48457615,48544268,86653,-,-
BAC76_B01,12,12q13.13,48480829,48591905,111076,-,-
BAC188_I06,12,12q13.13,48486747,48566242,79495,-,-
BAC33_F16,12,12q13.13,48513027,48729394,216367,-,-
BAC214_E14,12,12q13.13,48582563,48670518,87955,-,-
BAC18_B24,12,12q13.13,48649643,48766529,116886,-,-
BAC108_F15,12,12q13.13,48712730,48824365,111635,-,-
BAC213_H13,12,12q13.13,48712941,48829436,116495,-,-
BAC27_M05,12,12q13.13,48712941,48817513,104572,-,-
BAC231_C05,12,12q13.13,48712941,48847321,134380,-,-
BAC127_O04,12,12q13.13,48713274,48817521,104247,-,-
BAC194_J01,12,12q13.13,48780135,48887257,107122,-,-
BAC29_L09,12,12q13.13,48780424,48881269,100845,-,-
BAC184_C03,12,12q13.13,48783835,48860667,76832,-,-
BAC78_H06,12,12q13.13,48791577,48961204,169627,-,-
BAC173_G04,12,12q13.13,48799252,48881276,82024,-,-
BAC28_D15,12,12q13.13,48831663,48941661,109998,-,-
BAC150_C21,12,12q13.13,48838528,48916518,77990,-,-
BAC97_N16,12,12q13.13,48860661,48956354,95693,-,-
BAC160_E12,12,12q13.13,48887250,48971768,84518,-,-
BAC117_E04,12,12q13.13,48941654,49037049,95395,-,-
BAC36_B19,12,12q13.13,48956348,49084339,127991,-,-
BAC51_K18,12,12q13.13,48962859,49082292,119433,-,-
BAC12_K02,12,12q13.13,48994856,49096506,101650,-,-
BAC142_P08,12,12q13.13,49014883,49096506,81623,-,-
BAC194_K21,12,12q13.13,49084337,49177630,93293,-,-
BAC146_C16,12,12q13.13,49084342,49183151,98809,-,-
BAC50_O09,12,12q13.13,49084366,49183151,98785,-,-
BAC75_J14,12,12q13.13,49096580,49208747,112167,-,-
BAC37_O10,12,12q13.13,49174862,49287733,112871,-,-
BAC39_L15,12,12q13.13,49249156,49374350,125194,-,-
BAC50_O11,12,12q13.13,49265361,49369469,104108,-,-
BAC70_D10,12,12q13.13,49282156,49376511,94355,-,-
BAC155_J07,12,12q13.13,49295113,49372114,77001,-,-
BAC157_F24,12,12q13.13,49405076,49494870,89794,-,-
BAC152_E04,12,12q13.13,49476952,49582250,105298,-,-
BAC102_K23,12,12q13.13,49526279,49618899,92620,-,-
BAC23_P18,12,12q13.13,49587160,49686670,99510,-,-
BAC241_P02,12,12q13.13,49664924,49794032,129108,-,-
BAC195_H19,12,12q13.13,49724888,49809037,84149,-,-
BAC97_P06,12,12q13.13,49729091,49826313,97222,-,-
BAC46_O19,12,12q13.13,49755811,49867070,111259,-,-
BAC151_A06,12,12q13.13,49770431,49881566,111135,-,-
BAC43_M06,12,12q13.13,49794060,49907110,113050,-,-
BAC171_H10,12,12q13.13,49826306,49924730,98424,-,-
BAC227_P16,12,12q13.13,49826306,49907174,80868,-,-
BAC36_E01,12,12q13.13,49910684,50023783,113099,-,-
BAC244_D11,12,12q13.13,49934744,50016020,81276,-,-
BAC191_J02,12,12q13.13,49966597,50029594,62997,-,-
BAC18_E10,12,12q13.13,49968180,50130836,162656,-,-
BAC57_O18,12,12q13.13,50016029,50178119,162090,-,-
BAC62_P14,12,12q13.13,50044788,50165872,121084,-,-
BAC95_D09,12,12q13.13,50178169,50277511,99342,-,-
BAC166_C19,12,12q13.13,50309909,50397650,87741,-,-
BAC46_E20,12,12q13.13,50364541,50461436,96895,-,-
BAC240_G09,12,12q13.13,50365126,50446979,81853,-,-
BAC123_H07,12,12q13.13,50428529,50567078,138549,-,-
BAC109_D21,12,12q13.13,50473626,50566813,93187,-,-
BAC39_I15,12,12q13.13,50524279,50639550,115271,-,-
BAC155_B16,12,12q13.13,50639588,50747638,108050,-,-
BAC236_D01,12,12q13.13,50774560,50890843,116283,-,-
BAC221_M15,12,12q13.13,50806147,50896393,90246,-,-
BAC159_I06,12,12q13.13,50806218,50900849,94631,-,-
BAC246_M23,12,12q13.13,50903912,51029778,125866,yes,-
BAC101_A16,12,12q13.13,50975661,51059090,83429,yes,-
BAC14_A13,12,12q13.13,50977225,51070255,93030,yes,-
BAC127_P09,12,12q13.13,50991951,51084828,92877,yes,-
BAC230_D23,12,12q13.13,51005409,51091494,86085,yes,-
BAC179_M18,12,12q13.13,51091753,51177030,85277,-,-
BAC35_N08,12,12q13.13,51146407,51230374,83967,-,-
BAC250_O07,12,12q13.13,51175613,51285381,109768,-,-
BAC65_G10,12,12q13.13,51215952,51320650,104698,-,-
BAC96_C03,12,12q13.13,51259055,51437356,178301,-,-
BAC32_F20,12,12q13.13,51297334,51415045,117711,-,-
BAC240_D24,12,12q13.13,51320981,51436068,115087,-,-
BAC192_I16,12,12q13.13,51334541,51420086,85545,-,-
BAC226_N22,12,12q13.13,51334563,51437356,102793,-,-
BAC88_F08,12,12q13.13,51391283,51482584,91301,-,-
BAC160_M01,12,12q13.13,51498544,51590344,91800,-,-
BAC50_D14,12,12q13.13,51498544,51599149,100605,-,-
BAC157_O19,12,12q13.13,51503211,51587042,83831,-,-
BAC31_A06,12,12q13.13,51626630,51735846,109216,-,-
BAC73_F11,12,12q13.13,51661357,51811966,150609,-,-
BAC183_B16,12,12q13.13,51756606,51853776,97170,-,-
BAC53_O23,12,12q13.13,51822917,51935193,112276,-,-
BAC234_A21,12,12q13.13,51867114,51966400,99286,-,-
BAC8_A17,12,12q13.13,51890545,52036093,145548,-,-
BAC8_C01,12,12q13.13,51935185,52036084,100899,-,-
BAC86_O17,12,12q13.13,51949135,52060287,111152,-,-
BAC101_H11,12,12q13.13,51968920,52059911,90991,-,-
BAC149_A19,12,12q13.13,52154494,52243236,88742,-,-
BAC242_F17,12,12q13.13,52159735,52254821,95086,-,-
BAC175_P14,12,12q13.13,52163524,52263257,99733,-,-
BAC182_C04,12,12q13.13,52163524,52243838,80314,-,-
BAC33_N02,12,12q13.13,52210293,52317478,107185,-,-
BAC220_D20,12,12q13.13,52295466,52425655,130189,-,-
BAC51_F12,12,12q13.13,52297956,52449199,151243,-,-
BAC143_O14,12,12q13.13,52315829,52405956,90127,-,-
BAC218_M02,12,12q13.13,52317920,52402819,84899,-,-
BAC189_F15,12,12q13.13,52345803,52436777,90974,-,-
BAC236_J22,12,12q13.13,52364585,52481294,116709,-,-
BAC209_C12,12,12q13.13,52425838,52509761,83923,-,-
BAC72_H09,12,12q13.13,52496019,52580496,84477,-,-
BAC69_G13,12,12q13.13,52580511,52671139,90628,-,-
BAC42_C17,12,12q13.13,52589400,52720256,130856,-,-
BAC222_J15,12,12q13.13,52589419,52671149,81730,-,-
BAC36_L13,12,12q13.13,52611538,52729062,117524,-,-
BAC214_D07,12,12q13.13,52688272,52778997,90725,-,-
BAC155_L02,12,12q13.13,52696505,52787639,91134,-,-
BAC243_O02,12,12q13.13,52701176,52825889,124713,-,-
BAC42_F24,12,12q13.13,52701176,52798598,97422,-,-
BAC21_I12,12,12q13.13,52701180,52815896,114716,-,-
BAC181_D03,12,12q13.13,52783712,52883638,99926,-,-
BAC249_B12,12,12q13.13,52821552,52896318,74766,-,-
BAC128_D03,12,12q13.13,52896329,53037240,140911,-,-
BAC219_J10,12,12q13.13,52906342,53021354,115012,-,-
BAC146_G23,12,12q13.13,52951710,53072016,120306,-,-
BAC5_N20,12,12q13.13,52965244,53099907,134663,-,-
BAC106_G13,12,12q13.13-12q13.2,53061437,53155858,94421,-,-
BAC33_D13,12,12q13.2,53146887,53256279,109392,-,-
BAC232_D12,12,12q13.2,53155943,53246300,90357,-,-
BAC160_B09,12,12q13.2,53169580,53259817,90237,-,-
BAC178_G08,12,12q13.2,53175080,53292140,117060,-,-
BAC41_I18,12,12q13.2,53220091,53326596,106505,-,-
BAC100_J18,12,12q13.2,53236028,53345994,109966,-,-
BAC141_E07,12,12q13.2,53236028,53326596,90568,-,-
BAC233_F22,12,12q13.2,53368057,53457989,89932,-,-
BAC148_J04,12,12q13.2,53545755,53653103,107348,-,-
BAC107_I18,12,12q13.2,53552400,53643398,90998,-,-
BAC52_B10,12,12q13.2,53675318,53774021,98703,-,-
BAC102_N03,12,12q13.2,53677272,53755844,78572,-,-
BAC152_B05,12,12q13.2,53716945,53823991,107046,-,-
BAC4_M05,12,12q13.2,53729319,53830962,101643,-,-
BAC169_N01,12,12q13.2,53744907,53837699,92792,-,-
BAC199_D15,12,12q13.2,54081830,54170386,88556,-,-
BAC115_I13,12,12q13.2,54222548,54381310,158762,-,-
BAC235_G10,12,12q13.2,54242287,54322618,80331,-,-
BAC121_N10,12,12q13.2,54291651,54379222,87571,-,-
BAC8_E03,12,12q13.2,54357017,54500958,143941,-,-
BAC217_C24,12,12q13.2,54379215,54517497,138282,-,-
BAC100_L24,12,12q13.2,54379215,54539970,160755,-,-
BAC50_C04,12,12q13.2,54381815,54473674,91859,-,-
BAC107_G06,12,12q13.2,54402925,54500958,98033,-,-
BAC247_N01,12,12q13.2,54438976,54531606,92630,-,-
BAC113_G17,12,12q13.2,54473816,54566346,92530,-,-
BAC8_K07,12,12q13.2,54500957,54607991,107034,-,-
BAC234_M05,12,12q13.2,54526205,54635932,109727,-,-
BAC208_A06,12,12q13.2,54566349,54656706,90357,-,-
BAC116_D06,12,12q13.2,54662462,54785677,123215,-,-
BAC66_F08,12,12q13.2,54665887,54753189,87302,-,-
BAC221_J05,12,12q13.2,54797210,54888514,91304,-,-
BAC67_F09,12,12q13.2,54872997,54997145,124148,-,-
BAC199_H20,12,12q13.2,54902464,54989944,87480,-,-
BAC237_M23,12,12q13.2,54981994,55049030,67036,-,-
BAC68_I14,12,12q13.2,54991643,55085129,93486,-,-
BAC39_P11,12,12q13.2,55008322,55178927,170605,yes,-
BAC107_K16,12,12q13.2,55085232,55182170,96938,yes,-
BAC193_G20,12,12q13.2-12q13.3,55178921,55264777,85856,yes,-
BAC41_M23,12,12q13.2-12q13.3,55178921,55263947,85026,-,-
BAC69_G15,12,12q13.2-12q13.3,55180633,55290701,110068,yes,-
BAC132_O04,12,12q13.2-12q13.3,55197792,55301056,103264,yes,-
BAC172_K15,12,12q13.3,55207147,55292531,85384,yes,-
BAC34_J20,12,12q13.3,55253595,55412643,159048,yes,-
BAC120_L20,12,12q13.3,55304226,55406941,102715,yes,-
BAC52_C03,12,12q13.3,55433846,55521174,87328,-,-
BAC82_A16,12,12q13.3,55433846,55520450,86604,-,-
BAC95_O13,12,12q13.3,55434197,55521174,86977,-,-
BAC144_P02,12,12q13.3,55488159,55607920,119761,-,-
BAC188_G08,12,12q13.3,55521294,55607920,86626,-,-
BAC101_G09,12,12q13.3,55673874,55804136,130262,yes,-
BAC196_D16,12,12q13.3,55679215,55821966,142751,yes,-
BAC122_G16,12,12q13.3,55736395,55821966,85571,-,-
BAC40_J13,12,12q13.3,55749739,55848800,99061,-,-
BAC165_N10,12,12q13.3,55751067,55850865,99798,-,-
BAC145_N01,12,12q13.3,55910679,55971317,60638,-,-
BAC181_K03,12,12q13.3,55934145,56023214,89069,-,-
BAC96_N18,12,12q13.3,55934145,56020948,86803,-,-
BAC33_K11,12,12q13.3,56047086,56128242,81156,-,-
BAC172_C01,12,12q13.3,56057696,56181765,124069,-,-
BAC73_E15,12,12q13.3,56060829,56154124,93295,-,-
BAC224_O13,12,12q14.1,56343071,56466396,123325,-,-
BAC72_N17,12,12q14.1,56354658,56490254,135596,-,-
BAC109_D18,12,12q14.1,56385602,56499127,113525,-,-
BAC239_G11,12,12q14.1,56448010,56555115,107105,-,-
BAC162_D20,12,12q14.1,56531918,56618798,86880,-,-
BAC192_P22,12,12q14.1,56579247,56662144,82897,-,-
BAC102_P18,12,12q14.1,56690884,56834158,143274,-,-
BAC65_B01,12,12q14.1,56822465,56922362,99897,-,-
BAC181_M19,12,12q14.1,56834229,56957618,123389,-,-
BAC64_F07,12,12q14.1,56850353,56943503,93150,-,-
BAC84_P21,12,12q14.1,56884507,57064358,179851,-,-
BAC39_I16,12,12q14.1,56924143,57071841,147698,-,-
BAC125_C09,12,12q14.1,57082189,57214348,132159,-,-
BAC24_E17,12,12q14.1,57522010,57629392,107382,-,-
BAC238_H05,12,12q14.1,57654162,57787523,133361,-,-
BAC20_C03,12,12q14.1,57715198,57804618,89420,-,-
BAC39_J01,12,12q14.1,57715551,57804614,89063,-,-
BAC126_B06,12,12q14.1,57797121,57894684,97563,-,-
BAC172_A22,12,12q14.1,57798178,57870990,72812,-,-
BAC218_L04,12,12q14.1,57970002,58054984,84982,-,-
BAC146_N19,12,12q14.1,58004279,58081065,76786,-,-
BAC115_B21,12,12q14.1,58112991,58241971,128980,-,-
BAC61_K24,12,12q14.1,58322554,58404381,81827,-,-
BAC189_J02,12,12q14.1,58495050,58573702,78652,-,-
BAC86_L23,12,12q14.1,58547593,58664720,117127,-,-
BAC75_F15,12,12q14.1,58644086,58788093,144007,-,-
BAC49_P14,12,12q14.1,58646029,58720830,74801,-,-
BAC118_B03,12,12q14.1,58700083,58790075,89992,-,-
BAC188_H14,12,12q14.1,58720827,58846206,125379,-,-
BAC88_K11,12,12q14.1,58788186,58938510,150324,-,-
BAC18_O04,12,12q14.1,58789933,58911252,121319,-,-
BAC151_B11,12,12q14.1,58828662,58911257,82595,-,-
BAC248_M17,12,12q14.1,58930479,59000656,70177,-,-
BAC235_J23,12,12q14.1,59072403,59165301,92898,-,-
BAC69_B06,12,12q14.1,59102762,59234316,131554,-,-
BAC252_D11,12,12q14.1,59135236,59250095,114859,-,-
BAC117_A09,12,12q14.1,59290848,59454978,164130,-,-
BAC186_G22,12,12q14.1,59669781,59750299,80518,-,-
BAC105_C12,12,12q14.1,59879643,60029156,149513,-,-
BAC125_O12,12,12q14.1,59948271,60032093,83822,-,-
BAC16_M19,12,12q14.1,59948278,60033363,85085,-,-
BAC77_L14,12,12q14.1,60037601,60129310,91709,-,-
BAC198_P14,12,12q14.1,60186028,60259074,73046,-,-
BAC19_A18,12,12q14.1,60228468,60334334,105866,-,-
BAC189_G05,12,12q14.1,60259066,60356879,97813,-,-
BAC62_D12,12,12q14.1,60334360,60435062,100702,-,-
BAC158_O11,12,12q14.1,60393125,60421909,28784,-,-
BAC195_F10,12,12q14.1,60472959,60560788,87829,-,-
BAC61_O11,12,12q14.1,60485248,60606538,121290,-,-
BAC74_I11,12,12q14.1,60517894,60617817,99923,-,-
BAC108_G22,12,12q14.1,60560788,60667221,106433,-,-
BAC140_H16,12,12q14.1,60640897,60723905,83008,-,-
BAC183_B14,12,12q14.1,60669736,60745237,75501,yes,-
BAC83_L03,12,12q14.1,60724214,60869695,145481,yes,-
BAC90_G13,12,12q14.1,60760580,60897224,136644,yes,-
BAC233_D11,12,12q14.1,60847361,60957754,110393,-,-
BAC124_M23,12,12q14.1,60912085,61011382,99297,-,-
BAC247_F09,12,12q14.1,60914005,61003594,89589,-,-
BAC46_D18,12,12q14.1,60916801,61003595,86794,-,-
BAC78_E14,12,12q14.1,61149410,61288202,138792,-,-
BAC36_G20,12,12q14.1,61181353,61269343,87990,-,-
BAC234_O21,12,12q14.1,61185128,61288202,103074,-,-
BAC29_P14,12,12q14.1,61226192,61342308,116116,-,-
BAC46_E23,12,12q14.1,61228691,61324990,96299,-,-
BAC194_A18,12,12q14.1-12q14.2,61379286,61462508,83222,-,-
BAC129_L04,12,12q14.1-12q14.2,61388096,61498549,110453,-,-
BAC133_A12,12,12q14.2,61544990,61635830,90840,-,-
BAC178_M16,12,12q14.2,61583291,61656014,72723,-,-
BAC134_N01,12,12q14.2,61583291,61675404,92113,-,-
BAC34_K07,12,12q14.2,61707789,61790264,82475,-,-
BAC176_N18,12,12q14.2,61750169,61821310,71141,-,-
BAC65_C07,12,12q14.2,61781156,61869796,88640,-,-
BAC107_K03,12,12q14.2,61802359,61892994,90635,-,-
BAC202_I05,12,12q14.2,61821560,61899127,77567,-,-
BAC104_A20,12,12q14.2,61827590,61909810,82220,-,-
BAC59_D09,12,12q14.2,61872615,61961056,88441,-,-
BAC134_F24,12,12q14.2,61872616,61977610,104994,-,-
BAC28_H13,12,12q14.2,62114072,62239637,125565,-,-
BAC45_F03,12,12q14.2,62407455,62495931,88476,-,-
BAC170_N18,12,12q14.2,62413745,62482610,68865,-,-
BAC8_H17,12,12q14.2,62717149,62853332,136183,-,-
BAC76_C19,12,12q14.2,62793484,62875505,82021,-,-
BAC60_A22,12,12q14.2,62898080,63009239,111159,-,-
BAC33_C14,12,12q14.2,62979313,63076041,96728,-,-
BAC25_C23,12,12q14.2,63035839,63208920,173081,-,-
BAC35_J07,12,12q14.2,63171702,63343517,171815,-,-
BAC181_N11,12,12q14.2,63250205,63343537,93332,-,-
BAC46_N17,12,12q14.2,63267758,63349934,82176,-,-
BAC234_A06,12,12q14.2-12q14.3,63396161,63482079,85918,-,-
BAC33_P06,12,12q14.3,63424839,63516208,91369,-,-
BAC198_O15,12,12q14.3,63627635,63703823,76188,-,-
BAC134_E19,12,12q14.3,63637187,63749926,112739,-,-
BAC176_D07,12,12q14.3,63709247,63787158,77911,-,-
BAC68_I24,12,12q14.3,63715294,63819302,104008,-,-
BAC69_A03,12,12q14.3,63715322,63861645,146323,-,-
BAC247_B07,12,12q14.3,63750393,63861635,111242,-,-
BAC101_H08,12,12q14.3,63876206,63990231,114025,-,-
BAC53_A23,12,12q14.3,63888207,63970154,81947,-,-
BAC64_F18,12,12q14.3,63896317,63979027,82710,-,-
BAC39_H02,12,12q14.3,63980692,64123237,142545,-,-
BAC56_I06,12,12q14.3,63985134,64103528,118394,-,-
BAC246_G05,12,12q14.3,64133194,64221989,88795,-,-
BAC133_P12,12,12q14.3,64133333,64240639,107306,-,-
BAC46_N12,12,12q14.3,64136494,64236110,99616,-,-
BAC27_I23,12,12q14.3,64209843,64318405,108562,-,-
BAC232_N21,12,12q14.3,64240453,64311792,71339,-,-
BAC46_N05,12,12q14.3,64264983,64399299,134316,-,-
BAC126_F24,12,12q14.3,64320650,64408008,87358,-,-
BAC180_D18,12,12q14.3,64327380,64417309,89929,-,-
BAC175_D16,12,12q14.3,64371166,64452568,81402,-,-
BAC54_N20,12,12q14.3,64372721,64477661,104940,-,-
BAC239_P21,12,12q14.3,64375998,64488274,112276,-,-
BAC5_L02,12,12q14.3,64375998,64479315,103317,-,-
BAC234_J20,12,12q14.3,64404175,64479219,75044,-,-
BAC10_M07,12,12q14.3,64499036,64596568,97532,-,-
BAC101_A22,12,12q14.3,64526339,64608573,82234,-,-
BAC141_K16,12,12q14.3,64680129,64768575,88446,-,-
BAC56_F16,12,12q14.3,64784303,64896695,112392,-,-
BAC11_O02,12,12q14.3,64805872,64908456,102584,-,-
BAC144_C12,12,12q14.3,64943925,65063006,119081,-,-
BAC21_E01,12,12q14.3,65143054,65274114,131060,-,-
BAC149_L18,12,12q14.3,65205366,65291067,85701,-,-
BAC204_K16,12,12q14.3,65306235,65402091,95856,-,-
BAC186_L17,12,12q14.3,65440987,65509529,68542,-,-
BAC52_E07,12,12q14.3,65452548,65548604,96056,-,-
BAC144_A11,12,12q14.3,65499018,65654882,155864,-,-
BAC28_B17,12,12q14.3,65517019,65622921,105902,-,-
BAC133_C16,12,12q14.3,65531264,65610756,79492,-,-
BAC36_K11,12,12q14.3,65552265,65652573,100308,-,-
BAC30_P03,12,12q14.3,65564967,65658766,93799,-,-
BAC237_G03,12,12q14.3,65687043,65820401,133358,-,-
BAC131_K23,12,12q14.3,65695354,65782466,87112,-,-
BAC91_N21,12,12q14.3,65706406,65789964,83558,-,-
BAC26_M07,12,12q14.3,65713547,65842730,129183,-,-
BAC97_I12,12,12q14.3,65824364,65941370,117006,-,-
BAC167_O06,12,12q14.3,65830377,65941245,110868,-,-
BAC34_M05,12,12q14.3,65843617,65957465,113848,-,-
BAC162_D15,12,12q14.3,65915366,65998809,83443,-,-
BAC222_O04,12,12q14.3-12q15,65951586,66034016,82430,-,-
BAC190_I05,12,12q15,66026226,66080636,54410,-,-
BAC217_B05,12,12q15,66077994,66181858,103864,-,-
BAC71_E04,12,12q15,66161264,66280285,119021,-,-
BAC56_F17,12,12q15,66207233,66313776,106543,-,-
BAC251_C10,12,12q15,66207975,66318606,110631,-,-
BAC43_B16,12,12q15,66268633,66402229,133596,-,-
BAC217_L01,12,12q15,66290866,66378510,87644,-,-
BAC69_O23,12,12q15,66398686,66470509,71823,-,-
BAC234_B20,12,12q15,66405453,66499166,93713,-,-
BAC26_C07,12,12q15,66408678,66499166,90488,-,-
BAC190_N18,12,12q15,66678100,66758671,80571,-,-
BAC29_D12,12,12q15,66756954,66861259,104305,-,-
BAC26_K10,12,12q15,66758665,66880811,122146,-,-
BAC176_A14,12,12q15,66773481,66859810,86329,-,-
BAC183_E10,12,12q15,66880836,66972227,91391,-,-
BAC46_K06,12,12q15,67010045,67108510,98465,-,-
BAC54_D20,12,12q15,67057047,67149451,92404,-,-
BAC149_N14,12,12q15,67061963,67158516,96553,-,-
BAC43_O14,12,12q15,67131101,67234974,103873,-,-
BAC187_F15,12,12q15,67159662,67248780,89118,-,-
BAC17_O11,12,12q15,67168424,67263716,95292,-,-
BAC230_J13,12,12q15,67211424,67305967,94543,-,-
BAC132_M16,12,12q15,67297402,67399306,101904,-,-
BAC234_L21,12,12q15,67299406,67386291,86885,-,-
BAC81_O04,12,12q15,67301542,67392999,91457,-,-
BAC240_B11,12,12q15,67301544,67407077,105533,-,-
BAC65_E02,12,12q15,67329445,67467126,137681,-,-
BAC157_A07,12,12q15,67478806,67552736,73930,-,-
BAC232_J22,12,12q15,67483861,67571056,87195,-,-
BAC67_A24,12,12q15,67659618,67739569,79951,-,-
BAC147_A03,12,12q15,67739588,67858644,119056,-,-
BAC139_C04,12,12q15,67749024,67859327,110303,-,-
BAC115_N12,12,12q15,67749024,67850569,101545,-,-
BAC157_F08,12,12q15,67769938,67858643,88705,-,-
BAC40_O16,12,12q15,67798238,67894774,96536,-,-
BAC29_K19,12,12q15,67886099,68012395,126296,-,-
BAC161_A13,12,12q15,68012405,68074384,61979,-,-
BAC168_J22,12,12q15,68037292,68128124,90832,-,-
BAC170_D17,12,12q15,68087337,68175973,88636,-,-
BAC35_G16,12,12q15,68104296,68193198,88902,-,-
BAC76_F24,12,12q15,68155821,68267808,111987,-,-
BAC42_G13,12,12q15,68178629,68271956,93327,-,-
BAC78_L01,12,12q15,68178629,68280846,102217,-,-
BAC157_J11,12,12q15,68271954,68352773,80819,-,-
BAC8_B02,12,12q15,68407416,68521567,114151,-,-
BAC219_D16,12,12q15,68470041,68599963,129922,-,-
BAC150_J20,12,12q15,68553405,68628113,74708,-,-
BAC119_O16,12,12q15,68553405,68629590,76185,-,-
BAC157_P03,12,12q15,68580473,68656292,75819,-,-
BAC80_L14,12,12q15,68682619,68774296,91677,-,-
BAC152_N24,12,12q15,68847256,68913277,66021,-,-
BAC246_E22,12,12q15,69008145,69096209,88064,-,-
BAC154_D12,12,12q15,69015092,69103329,88237,-,-
BAC52_L04,12,12q15,69103321,69188197,84876,-,-
BAC136_I17,12,12q15,69114207,69205674,91467,-,-
BAC50_O12,12,12q15,69292619,69455769,163150,-,-
BAC96_A07,12,12q15,69316520,69339446,22926,-,-
BAC116_A22,12,12q15,69338963,69431564,92601,-,-
BAC236_C03,12,12q15,69437054,69514275,77221,-,-
BAC110_J13,12,12q15,69514340,69673947,159607,-,-
BAC182_B20,12,12q15,69598168,69676494,78326,-,-
BAC228_P13,12,12q15,69719682,69791986,72304,-,-
BAC195_B05,12,12q15-12q21.1,69791147,69898583,107436,-,-
BAC140_K15,12,12q21.1,69845603,69920530,74927,-,-
BAC5_N02,12,12q21.1,69856940,69937783,80843,-,-
BAC158_J07,12,12q21.1,69920838,70005527,84689,-,-
BAC61_N06,12,12q21.1,69978557,70074623,96066,-,-
BAC176_E17,12,12q21.1,70047001,70129484,82483,-,-
BAC55_F15,12,12q21.1,70218698,70302090,83392,-,-
BAC14_B17,12,12q21.1,70218698,70356241,137543,-,-
BAC97_B21,12,12q21.1,70221467,70314873,93406,-,-
BAC127_N05,12,12q21.1,70229380,70311505,82125,-,-
BAC156_K22,12,12q21.1,70280125,70388031,107906,-,-
BAC223_M11,12,12q21.1,70307857,70396025,88168,-,-
BAC105_I11,12,12q21.1,70320056,70429990,109934,-,-
BAC65_M12,12,12q21.1,70388216,70468012,79796,-,-
BAC56_P07,12,12q21.1,70398537,70556543,158006,-,-
BAC156_I12,12,12q21.1,70408376,70510406,102030,-,-
BAC48_I13,12,12q21.1,70564612,70676035,111423,-,-
BAC191_C08,12,12q21.1,70580459,70674448,93989,-,-
BAC27_K19,12,12q21.1,70594326,70712372,118046,-,-
BAC178_N22,12,12q21.1,70610411,70716249,105838,yes,-
BAC201_N20,12,12q21.1,70610411,70732018,121607,yes,-
BAC123_N24,12,12q21.1,70624028,70661760,37732,-,-
BAC246_P22,12,12q21.1,70712366,70817878,105512,-,-
BAC231_H01,12,12q21.1,70799833,70914161,114328,-,-
BAC182_E14,12,12q21.1,70910873,71001032,90159,-,-
BAC66_F19,12,12q21.1,71082432,71151870,69438,-,-
BAC120_I13,12,12q21.1,71247193,71355601,108408,-,-
BAC200_E16,12,12q21.1,71355864,71435743,79879,-,-
BAC188_F11,12,12q21.1,71527712,71605439,77727,yes,-
BAC179_D18,12,12q21.1,71595513,71676436,80923,-,-
BAC139_G22,12,12q21.1,71645661,71749617,103956,-,-
BAC83_E05,12,12q21.1,71972208,72051721,79513,-,-
BAC100_O01,12,12q21.1,72062391,72163882,101491,-,-
BAC221_M17,12,12q21.1,72182874,72267111,84237,-,-
BAC116_K01,12,12q21.1,72215159,72297652,82493,-,-
BAC30_C09,12,12q21.1,72215174,72325966,110792,-,-
BAC232_G15,12,12q21.1,72236880,72318185,81305,-,-
BAC10_B06,12,12q21.1,72267122,72355217,88095,-,-
BAC237_L11,12,12q21.1,72309897,72392282,82385,-,-
BAC41_O13,12,12q21.1,72407591,72506020,98429,-,-
BAC70_P10,12,12q21.1,72508289,72625503,117214,-,-
BAC217_N03,12,12q21.1,72592165,72722947,130782,-,-
BAC46_K13,12,12q21.1,72605549,72704371,98822,-,-
BAC117_N03,12,12q21.1,72607989,72624317,16328,-,-
BAC118_G05,12,12q21.1,72744839,72831388,86549,-,-
BAC75_G16,12,12q21.1,72774493,72856278,81785,-,-
BAC166_D22,12,12q21.1,72786888,72873161,86273,-,-
BAC141_D12,12,12q21.1,72930057,73047731,117674,-,-
BAC185_K05,12,12q21.1,72943078,73042789,99711,-,-
BAC37_D21,12,12q21.1,73434572,73547743,113171,-,-
BAC124_G20,12,12q21.1,73456741,73540163,83422,-,-
BAC109_A21,12,12q21.1,73481947,73587903,105956,-,-
BAC64_L06,12,12q21.1,73547820,73653253,105433,-,-
BAC190_H03,12,12q21.1,73603174,73678312,75138,-,-
BAC39_O14,12,12q21.1,73748137,73850966,102829,-,-
BAC84_H21,12,12q21.1,73762588,73837275,74687,-,-
BAC140_E11,12,12q21.1,73870056,73980602,110546,-,-
BAC133_C18,12,12q21.1,73927677,74006032,78355,-,-
BAC237_O18,12,12q21.1-12q21.2,74028400,74109484,81084,-,-
BAC185_C05,12,12q21.2,74118358,74207864,89506,-,-
BAC61_M18,12,12q21.2,74143050,74291274,148224,-,-
BAC42_H03,12,12q21.2,74327722,74478861,151139,-,-
BAC223_P08,12,12q21.2,74393571,74478818,85247,-,-
BAC234_I19,12,12q21.2,74505641,74598813,93172,-,-
BAC41_K19,12,12q21.2,74604328,74744441,140113,-,-
BAC106_H13,12,12q21.2,74611385,74763510,152125,-,-
BAC198_O22,12,12q21.2,74710897,74786771,75874,-,-
BAC62_L18,12,12q21.2,75084239,75197840,113601,-,-
BAC63_H04,12,12q21.2,75100209,75197840,97631,-,-
BAC133_I05,12,12q21.2,75114156,75197840,83684,-,-
BAC81_C12,12,12q21.2,75167369,75246537,79168,-,-
BAC198_H05,12,12q21.2,75197842,75294743,96901,-,-
BAC145_J17,12,12q21.2,75436633,75525046,88413,-,-
BAC100_K10,12,12q21.2,75478234,75566176,87942,-,-
BAC42_L12,12,12q21.2,75478234,75614263,136029,-,-
BAC193_A02,12,12q21.2,75552266,75623705,71439,-,-
BAC44_F10,12,12q21.2,75665041,75759385,94344,-,-
BAC96_E23,12,12q21.2,75674366,75776987,102621,-,-
BAC81_P15,12,12q21.2,75764851,75911347,146496,-,-
BAC115_O10,12,12q21.2,75882767,75979063,96296,-,-
BAC64_L16,12,12q21.2,76083123,76189328,106205,-,-
BAC175_D01,12,12q21.2,76155481,76232510,77029,-,-
BAC161_K11,12,12q21.2,76177340,76265596,88256,-,-
BAC153_P05,12,12q21.2,76234488,76329295,94807,-,-
BAC44_I18,12,12q21.2,76311981,76401040,89059,-,-
BAC102_L21,12,12q21.2,76436810,76536857,100047,-,-
BAC45_J14,12,12q21.2,76440650,76559385,118735,-,-
BAC39_C21,12,12q21.2,76784700,76872887,88187,-,-
BAC134_F18,12,12q21.2,76795866,76948541,152675,-,-
BAC143_J07,12,12q21.2,76888159,77003986,115827,-,-
BAC78_M02,12,12q21.2,76993820,77098025,104205,-,-
BAC211_A09,12,12q21.2,77398576,77490484,91908,-,-
BAC1_L04,12,12q21.2,77463181,77573512,110331,-,-
BAC171_O10,12,12q21.2,77495017,77605106,110089,-,-
BAC109_C20,12,12q21.2,77505758,77598176,92418,-,-
BAC160_M05,12,12q21.2,77606033,77700508,94475,-,-
BAC8_G05,12,12q21.2,77762566,77854926,92360,-,-
BAC175_L03,12,12q21.2,78116701,78215242,98541,-,-
BAC54_D12,12,12q21.2,78258691,78373159,114468,-,-
BAC80_G16,12,12q21.2,78361874,78467576,105702,-,-
BAC120_K21,12,12q21.2,78373192,78539915,166723,-,-
BAC92_I10,12,12q21.2,78373193,78489775,116582,-,-
BAC62_J06,12,12q21.2,78451220,78536852,85632,-,-
BAC57_H10,12,12q21.2,78467570,78483678,16108,-,-
BAC240_G01,12,12q21.2,78485456,78573651,88195,-,-
BAC231_E17,12,12q21.2,78497138,78585251,88113,-,-
BAC146_P22,12,12q21.2,78593818,78695184,101366,-,-
BAC58_F23,12,12q21.31,78700569,78790068,89499,-,-
BAC2_N09,12,12q21.31,78710780,78819073,108293,-,-
BAC81_I20,12,12q21.31,78783018,78906050,123032,-,-
BAC226_D15,12,12q21.31,78790063,78864735,74672,-,-
BAC75_I23,12,12q21.31,78856867,78938260,81393,-,-
BAC84_G08,12,12q21.31,78944351,79122775,178424,-,-
BAC71_A08,12,12q21.31,79043318,79127175,83857,-,-
BAC165_O03,12,12q21.31,79076191,79164448,88257,-,-
BAC220_J22,12,12q21.31,79140569,79218784,78215,-,-
BAC52_K14,12,12q21.31,79344960,79499700,154740,-,-
BAC38_C15,12,12q21.31,79703360,79795778,92418,-,-
BAC128_D12,12,12q21.31,79719825,79829178,109353,-,-
BAC140_P07,12,12q21.31,79822874,79934713,111839,-,-
BAC243_F22,12,12q21.31,79948977,80042606,93629,-,-
BAC63_M01,12,12q21.31,79954318,80043806,89488,-,-
BAC60_G01,12,12q21.31,80014545,80108023,93478,-,-
BAC52_F19,12,12q21.31,80079869,80183201,103332,-,-
BAC179_C22,12,12q21.31,80227796,80312718,84922,-,-
BAC11_L03,12,12q21.31,80397593,80555661,158068,-,-
BAC222_B11,12,12q21.31,80691481,80781114,89633,-,-
BAC176_K07,12,12q21.31,80709730,80811028,101298,-,-
BAC42_I01,12,12q21.31,80768891,80861235,92344,-,-
BAC42_I14,12,12q21.31,80777276,80864156,86880,-,-
BAC4_O24,12,12q21.31,80886719,80973313,86594,-,-
BAC54_F20,12,12q21.31,81196304,81316025,119721,-,-
BAC200_N10,12,12q21.31,81415050,81502938,87888,-,-
BAC244_F17,12,12q21.31,81505027,81599495,94468,-,-
BAC97_D03,12,12q21.31,81656076,81761521,105445,-,-
BAC53_M24,12,12q21.31,81717798,81813793,95995,-,-
BAC7_M10,12,12q21.31,81740288,81844791,104503,-,-
BAC100_I09,12,12q21.31,81751219,81847869,96650,-,-
BAC247_D02,12,12q21.31,81775144,81861128,85984,-,-
BAC95_O20,12,12q21.31,81861121,81959835,98714,-,-
BAC173_P13,12,12q21.31,82742895,82846947,104052,-,-
BAC68_P22,12,12q21.31,82815089,82934956,119867,-,-
BAC51_M09,12,12q21.31,82995547,83092442,96895,-,-
BAC139_A01,12,12q21.31,83025338,83127387,102049,-,-
BAC200_C18,12,12q21.31,83201201,83294257,93056,-,-
BAC146_M11,12,12q21.31,83319123,83440398,121275,-,-
BAC64_D20,12,12q21.31,83457441,83579250,121809,-,-
BAC223_A05,12,12q21.31,83543504,83620474,76970,-,-
BAC150_D21,12,12q21.31,83543506,83618694,75188,-,-
BAC92_F04,12,12q21.31,83569795,83660806,91011,-,-
BAC97_E20,12,12q21.31,83630281,83714497,84216,-,-
BAC59_E18,12,12q21.31,83630281,83720063,89782,-,-
BAC59_C14,12,12q21.31,83698266,83783057,84791,-,-
BAC125_K24,12,12q21.31,84098341,84176474,78133,-,-
BAC226_N05,12,12q21.31,84361895,84458277,96382,-,-
BAC129_L24,12,12q21.31,84372873,84452337,79464,-,-
BAC8_M10,12,12q21.31,84541738,84650364,108626,-,-
BAC79_G21,12,12q21.31,84621210,84704338,83128,-,-
BAC15_K04,12,12q21.31,84623148,84732048,108900,-,-
BAC140_L20,12,12q21.31,84885339,84958010,72671,-,-
BAC125_G05,12,12q21.31-12q21.32,85030388,85116777,86389,-,-
BAC76_N15,12,12q21.32,85345486,85434320,88834,-,-
BAC46_C08,12,12q21.32,85575153,85695116,119963,-,-
BAC56_L15,12,12q21.32,85695161,85836551,141390,-,-
BAC44_B16,12,12q21.32,85710527,85804341,93814,-,-
BAC162_I22,12,12q21.32,85949374,86043783,94409,-,-
BAC76_A06,12,12q21.32,85994997,86090672,95675,-,-
BAC39_G06,12,12q21.32,86089801,86267381,177580,-,-
BAC69_L16,12,12q21.32,86287879,86379185,91306,-,-
BAC122_C02,12,12q21.32,86313283,86406458,93175,-,-
BAC49_O23,12,12q21.32,86429365,86530442,101077,-,-
BAC34_J23,12,12q21.32,86446373,86545520,99147,-,-
BAC144_K11,12,12q21.32,86754102,86851280,97178,-,-
BAC189_C14,12,12q21.32,87052075,87129845,77770,-,-
BAC234_E19,12,12q21.32,87417248,87486130,68882,-,-
BAC229_J05,12,12q21.32-12q21.33,87481148,87585649,104501,-,-
BAC140_H07,12,12q21.33,87722674,87824653,101979,-,-
BAC144_I04,12,12q21.33,87747622,87824653,77031,-,-
BAC127_B05,12,12q21.33,87763869,87861203,97334,-,-
BAC236_N03,12,12q21.33,87972240,88066128,93888,-,-
BAC118_H23,12,12q21.33,88017995,88120088,102093,-,-
BAC120_F22,12,12q21.33,88050785,88143653,92868,-,-
BAC38_O11,12,12q21.33,88175722,88265408,89686,-,-
BAC186_E04,12,12q21.33,88187510,88301853,114343,-,-
BAC39_F23,12,12q21.33,88222718,88346436,123718,-,-
BAC58_E07,12,12q21.33,88224816,88380457,155641,-,-
BAC182_E06,12,12q21.33,88227469,88301884,74415,-,-
BAC53_B02,12,12q21.33,88248529,88392119,143590,-,-
BAC137_B17,12,12q21.33,88302063,88377518,75455,-,-
BAC15_M01,12,12q21.33,88404251,88509493,105242,-,-
BAC88_N15,12,12q21.33,88620910,88704951,84041,-,-
BAC76_L24,12,12q21.33,88620910,88746831,125921,-,-
BAC184_O18,12,12q21.33,88632523,88704951,72428,-,-
BAC158_M22,12,12q21.33,88746833,88855107,108274,-,-
BAC106_F02,12,12q21.33,88782021,88899919,117898,-,-
BAC64_N10,12,12q21.33,89239504,89307252,67748,-,-
BAC88_L07,12,12q21.33,89392884,89501398,108514,-,-
BAC155_J04,12,12q21.33,89504107,89590402,86295,-,-
BAC33_J07,12,12q21.33,89700584,89827390,126806,-,-
BAC36_C05,12,12q21.33,89703203,89787803,84600,-,-
BAC172_M13,12,12q21.33,89728367,89827326,98959,-,-
BAC118_O15,12,12q21.33,89979701,90102677,122976,-,-
BAC247_H01,12,12q21.33,89988540,90102356,113816,-,-
BAC240_M21,12,12q21.33,89988896,90069610,80714,-,-
BAC151_I04,12,12q21.33,90236488,90334526,98038,-,-
BAC215_A17,12,12q21.33,90298647,90380998,82351,-,-
BAC76_J12,12,12q21.33,90400673,90491601,90928,-,-
BAC249_J15,12,12q21.33,90733222,90809461,76239,-,-
BAC18_A06,12,12q21.33,90770961,90966680,195719,-,-
BAC161_N12,12,12q21.33,90834164,90933173,99009,-,-
BAC236_J09,12,12q21.33,90964385,91049905,85520,-,-
BAC191_N10,12,12q21.33,90965391,91048409,83018,-,-
BAC163_H09,12,12q21.33-12q22,91108394,91200356,91962,-,-
BAC84_C20,12,12q21.33-12q22,91186293,91277912,91619,-,-
BAC51_G13,12,12q21.33-12q22,91198600,91313505,114905,-,-
BAC46_P11,12,12q22,91370000,91474974,104974,-,-
BAC151_M05,12,12q22,91422382,91502192,79810,-,-
BAC203_L13,12,12q22,91475608,91556275,80667,-,-
BAC235_K08,12,12q22,91508540,91627245,118705,-,-
BAC227_O16,12,12q22,91584124,91701764,117640,-,-
BAC32_D07,12,12q22,91584135,91688588,104453,-,-
BAC5_H04,12,12q22,91724166,91861897,137731,-,-
BAC109_H02,12,12q22,91796686,91905058,108372,-,-
BAC139_C10,12,12q22,91827633,91905101,77468,-,-
BAC41_O14,12,12q22,91827633,91936814,109181,-,-
BAC249_L21,12,12q22,91905118,92055442,150324,-,-
BAC105_P03,12,12q22,91916416,92075419,159003,-,-
BAC59_J07,12,12q22,91936832,92020820,83988,-,-
BAC234_I16,12,12q22,92053777,92154340,100563,-,-
BAC130_N13,12,12q22,92061587,92138873,77286,-,-
BAC124_G09,12,12q22,92150004,92237044,87040,-,-
BAC125_N08,12,12q22,92197152,92270373,73221,-,-
BAC249_P07,12,12q22,92214464,92299753,85289,-,-
BAC198_P10,12,12q22,92216065,92337297,121232,-,-
BAC31_H10,12,12q22,92216916,92314964,98048,-,-
BAC143_J13,12,12q22,92299745,92393592,93847,-,-
BAC240_D02,12,12q22,92301039,92399439,98400,-,-
BAC185_L07,12,12q22,92327609,92435225,107616,-,-
BAC226_N01,12,12q22,92426398,92522048,95650,-,-
BAC50_F13,12,12q22,92502423,92601249,98826,-,-
BAC200_D14,12,12q22,92585720,92663063,77343,-,-
BAC106_B21,12,12q22,92601243,92743475,142232,-,-
BAC20_B18,12,12q22,92612321,92704258,91937,-,-
BAC83_G05,12,12q22,92625517,92746083,120566,-,-
BAC211_G05,12,12q22,92628271,92713621,85350,-,-
BAC60_L20,12,12q22,92640357,92774851,134494,-,-
BAC218_G13,12,12q22,92663057,92757514,94457,-,-
BAC135_L03,12,12q22,92663061,92746083,83022,-,-
BAC55_O04,12,12q22,92784156,92937137,152981,-,-
BAC155_C22,12,12q22,92864339,92939506,75167,-,-
BAC163_J04,12,12q22,92896520,92983541,87021,-,-
BAC116_N17,12,12q22,92922579,93069622,147043,-,-
BAC36_A21,12,12q22,93030015,93135809,105794,-,-
BAC182_K18,12,12q22,93090065,93222306,132241,-,-
BAC51_L22,12,12q22,93097897,93213761,115864,-,-
BAC63_M10,12,12q22,93135809,93244786,108977,-,-
BAC228_E09,12,12q22,93138699,93221600,82901,-,-
BAC191_L03,12,12q22,93297309,93429510,132201,-,-
BAC148_M09,12,12q22,93323626,93414422,90796,-,-
BAC35_C16,12,12q22,93432597,93536024,103427,-,-
BAC236_A08,12,12q22,93464502,93577127,112625,-,-
BAC69_P13,12,12q22,93482855,93583616,100761,-,-
BAC144_H20,12,12q22,93483788,93583616,99828,-,-
BAC224_J15,12,12q22,93608228,93687879,79651,-,-
BAC248_B13,12,12q22,93648462,93744489,96027,-,-
BAC122_C21,12,12q22,93648538,93742050,93512,-,-
BAC63_F15,12,12q22,93705982,93815068,109086,-,-
BAC106_M19,12,12q22,93737219,93849173,111954,-,-
BAC237_M10,12,12q22,93760291,93891530,131239,-,-
BAC29_D10,12,12q22,93774948,93851847,76899,-,-
BAC248_N12,12,12q22,93848658,93946829,98171,-,-
BAC96_F17,12,12q22,93861550,93957484,95934,-,-
BAC184_I09,12,12q22,93904886,93991973,87087,-,-
BAC248_L22,12,12q22,93933467,94055345,121878,-,-
BAC70_J14,12,12q22,93980984,94090941,109957,-,-
BAC188_A08,12,12q22,94009700,94126559,116859,-,-
BAC141_G11,12,12q22,94059498,94125740,66242,-,-
BAC100_P24,12,12q22,94095341,94183490,88149,-,-
BAC45_L18,12,12q22,94095355,94200593,105238,-,-
BAC102_B18,12,12q22,94126563,94215115,88552,-,-
BAC137_O08,12,12q22,94227393,94325275,97882,-,-
BAC125_K22,12,12q22,94257758,94360508,102750,-,-
BAC59_F05,12,12q22,94259104,94385168,126064,-,-
BAC38_F07,12,12q22,94260148,94391000,130852,-,-
BAC67_B18,12,12q22,94260236,94378804,118568,-,-
BAC101_K07,12,12q22,94330960,94454864,123904,-,-
BAC156_L19,12,12q22,94510280,94578434,68154,-,-
BAC2_O15,12,12q22,94594746,94686964,92218,-,-
BAC105_B17,12,12q22,94613178,94712790,99612,-,-
BAC16_N10,12,12q22,94713273,94788591,75318,-,-
BAC162_A22,12,12q22-12q23.1,94732204,94859140,126936,-,-
BAC17_F22,12,12q22-12q23.1,94753452,94884820,131368,-,-
BAC50_M13,12,12q22-12q23.1,94788630,94938741,150111,-,-
BAC83_F03,12,12q23.1,94826632,94924879,98247,-,-
BAC143_E02,12,12q23.1,94831744,94896532,64788,-,-
BAC120_L12,12,12q23.1,94855001,94985739,130738,-,-
BAC13_H06,12,12q23.1,94861952,94937168,75216,-,-
BAC232_B11,12,12q23.1,94950404,95035745,85341,-,-
BAC60_K23,12,12q23.1,94965538,95039749,74211,-,-
BAC163_G22,12,12q23.1,94965547,95064336,98789,-,-
BAC36_H05,12,12q23.1,94975031,95064029,88998,-,-
BAC210_L02,12,12q23.1,95035760,95118365,82605,-,-
BAC188_B05,12,12q23.1,95035760,95121788,86028,-,-
BAC101_J17,12,12q23.1,95039755,95160219,120464,-,-
BAC46_G20,12,12q23.1,95049627,95186464,136837,-,-
BAC84_F14,12,12q23.1,95057839,95199738,141899,-,-
BAC86_O23,12,12q23.1,95118895,95221258,102363,-,-
BAC109_I20,12,12q23.1,95160213,95253280,93067,-,-
BAC121_K17,12,12q23.1,95220884,95335044,114160,-,-
BAC54_L18,12,12q23.1,95262207,95372473,110266,-,-
BAC15_E11,12,12q23.1,95262207,95356322,94115,-,-
BAC244_G07,12,12q23.1,95274506,95388721,114215,-,-
BAC24_K21,12,12q23.1,95553260,95641399,88139,-,-
BAC1_E09,12,12q23.1,95557627,95641399,83772,-,-
BAC217_G17,12,12q23.1,95648737,95736589,87852,-,-
BAC113_K04,12,12q23.1,95692010,95788250,96240,-,-
BAC236_G03,12,12q23.1,95717128,95843686,126558,-,-
BAC127_D09,12,12q23.1,95770525,95854729,84204,-,-
BAC133_I02,12,12q23.1,95871139,95946962,75823,-,-
BAC56_M11,12,12q23.1,95973189,95986605,13416,-,-
BAC76_G14,12,12q23.1,96039683,96140498,100815,-,-
BAC61_I17,12,12q23.1,96078081,96187472,109391,-,-
BAC158_F12,12,12q23.1,96103449,96191036,87587,-,-
BAC123_N01,12,12q23.1,96190248,96280194,89946,-,-
BAC72_D03,12,12q23.1,96277389,96389340,111951,-,-
BAC57_L01,12,12q23.1,96300615,96398487,97872,-,-
BAC41_A02,12,12q23.1,96300616,96398483,97867,-,-
BAC180_C06,12,12q23.1,96519080,96600006,80926,-,-
BAC55_I09,12,12q23.1,96713696,96819060,105364,-,-
BAC39_C04,12,12q23.1,96720544,96873332,152788,-,-
BAC140_P11,12,12q23.1,96749135,96840664,91529,-,-
BAC141_M05,12,12q23.1,96877594,97001386,123792,-,-
BAC230_E17,12,12q23.1,96932406,97023197,90791,-,-
BAC247_I05,12,12q23.1,96954471,97034426,79955,-,-
BAC54_J18,12,12q23.1,97123669,97205767,82098,-,-
BAC77_C20,12,12q23.1,97173675,97261748,88073,-,-
BAC150_B02,12,12q23.1,97182709,97253582,70873,-,-
BAC40_N13,12,12q23.1,97213461,97343409,129948,-,-
BAC166_C03,12,12q23.1,97303578,97388983,85405,-,-
BAC29_L11,12,12q23.1,97343685,97431391,87706,-,-
BAC155_H16,12,12q23.1,97506388,97638815,132427,-,-
BAC100_G20,12,12q23.1,97531798,97665000,133202,-,-
BAC1_M18,12,12q23.1,97645034,97748356,103322,-,-
BAC141_J14,12,12q23.1,97742666,97841229,98563,-,-
BAC38_K07,12,12q23.1,97753679,97872542,118863,-,-
BAC92_N22,12,12q23.1,97864977,97977534,112557,-,-
BAC81_H05,12,12q23.1,98046836,98115786,68950,-,-
BAC183_B13,12,12q23.1,98136053,98238408,102355,-,-
BAC175_K21,12,12q23.1,98469915,98553920,84005,-,-
BAC78_H19,12,12q23.1,98513253,98621969,108716,-,-
BAC39_O11,12,12q23.1,98553915,98632871,78956,-,-
BAC102_O03,12,12q23.1,98661796,98752134,90338,-,-
BAC195_M02,12,12q23.1,98775888,98878167,102279,-,-
BAC59_J12,12,12q23.1,98816361,98932381,116020,-,-
BAC110_C01,12,12q23.1,98928296,99054119,125823,-,-
BAC84_J04,12,12q23.1,98961557,99039263,77706,-,-
BAC78_O21,12,12q23.1,98974433,99086464,112031,-,-
BAC184_P04,12,12q23.1,99045182,99163848,118666,-,-
BAC195_B14,12,12q23.1,99246845,99367812,120967,-,-
BAC136_A06,12,12q23.1,99278962,99346686,67724,-,-
BAC179_H13,12,12q23.1,99278962,99408376,129414,-,-
BAC188_A06,12,12q23.1,99297677,99398638,100961,-,-
BAC36_J18,12,12q23.1,99327576,99432699,105123,-,-
BAC89_E06,12,12q23.1,99332456,99466561,134105,-,-
BAC133_L22,12,12q23.1,99402787,99504649,101862,-,-
BAC179_L09,12,12q23.1,99419867,99507159,87292,-,-
BAC78_D16,12,12q23.1,99454097,99567715,113618,-,-
BAC120_F08,12,12q23.1,99507260,99632562,125302,-,-
BAC61_D18,12,12q23.1,99564797,99661125,96328,-,-
BAC10_P02,12,12q23.1,99593896,99705735,111839,-,-
BAC33_N20,12,12q23.1,99605893,99710134,104241,-,-
BAC134_K03,12,12q23.1,99605894,99671055,65161,-,-
BAC167_M09,12,12q23.1,99730769,99839281,108512,-,-
BAC186_D13,12,12q23.1,99738449,99820896,82447,-,-
BAC63_K08,12,12q23.1,99855568,99938438,82870,-,-
BAC158_K05,12,12q23.1,99870184,99992550,122366,-,-
BAC252_O04,12,12q23.1,99871208,99968203,96995,-,-
BAC120_C17,12,12q23.1,99888647,99980657,92010,-,-
BAC20_D22,12,12q23.2,100010313,100234794,224481,-,-
BAC95_O15,12,12q23.2,100033451,100161195,127744,-,-
BAC129_K16,12,12q23.2,100051369,100122271,70902,-,-
BAC168_E21,12,12q23.2,100171499,100274490,102991,-,-
BAC10_M04,12,12q23.2,100191210,100315289,124079,-,-
BAC103_K24,12,12q23.2,100206008,100325139,119131,-,-
BAC228_J11,12,12q23.2,100226659,100313041,86382,-,-
BAC27_K15,12,12q23.2,100240690,100372109,131419,-,-
BAC52_G03,12,12q23.2,100253455,100263712,10257,-,-
BAC100_N21,12,12q23.2,100313738,100461477,147739,-,-
BAC37_M22,12,12q23.2,100313784,100399051,85267,-,-
BAC167_C20,12,12q23.2,100372282,100458161,85879,-,-
BAC33_A11,12,12q23.2,100539556,100638360,98804,-,-
BAC89_C15,12,12q23.2,100638357,100759870,121513,-,-
BAC163_P21,12,12q23.2,100718775,100809343,90568,-,-
BAC36_I03,12,12q23.2,100760324,100881270,120946,-,-
BAC177_F05,12,12q23.2,100781601,100881272,99671,-,-
BAC169_N10,12,12q23.2,100952725,101034559,81834,-,-
BAC204_H06,12,12q23.2,101147156,101228033,80877,-,-
BAC136_L01,12,12q23.2,101228040,101315395,87355,-,-
BAC123_K17,12,12q23.2,101270348,101364004,93656,-,-
BAC237_N01,12,12q23.2,101285969,101372219,86250,-,-
BAC178_M15,12,12q23.2,101295480,101408773,113293,-,-
BAC88_D06,12,12q23.2,101336924,101474542,137618,-,-
BAC51_K11,12,12q23.2,101355408,101488407,132999,-,-
BAC143_A18,12,12q23.2,101412067,101488907,76840,-,-
BAC156_G18,12,12q23.2,101507720,101612808,105088,-,-
BAC17_N20,12,12q23.2,101519481,101613492,94011,-,-
BAC114_F15,12,12q23.2,101602145,101685491,83346,-,-
BAC181_D05,12,12q23.2,101660565,101751162,90597,-,-
BAC189_J10,12,12q23.2,101765780,101849244,83464,-,-
BAC143_K20,12,12q23.2,101775208,101879115,103907,-,-
BAC126_E14,12,12q23.2,101786114,101881279,95165,-,-
BAC218_F23,12,12q23.2,101857758,102017918,160160,-,-
BAC108_D16,12,12q23.2,101859902,101961761,101859,-,-
BAC67_D04,12,12q23.2,101883906,101988061,104155,-,-
BAC116_N24,12,12q23.2,102037786,102178341,140555,-,-
BAC82_K15,12,12q23.2-12q23.3,102296927,102402200,105273,-,-
BAC45_G08,12,12q23.2-12q23.3,102386653,102498952,112299,-,-
BAC143_I01,12,12q23.2-12q23.3,102389591,102475768,86177,-,-
BAC229_O11,12,12q23.3,102406586,102505526,98940,-,-
BAC196_C09,12,12q23.3,102484361,102585695,101334,-,-
BAC22_D14,12,12q23.3,102489692,102624679,134987,-,-
BAC180_O15,12,12q23.3,102700487,102798169,97682,-,-
BAC109_K13,12,12q23.3,102833403,102951449,118046,-,-
BAC69_O20,12,12q23.3,102860447,102960680,100233,yes,-
BAC219_M23,12,12q23.3,102960137,103046544,86407,-,-
BAC137_D12,12,12q23.3,102989514,103011501,21987,-,-
BAC178_B21,12,12q23.3,103044180,103131838,87658,-,-
BAC10_O17,12,12q23.3,103063448,103153705,90257,-,-
BAC118_M17,12,12q23.3,103202377,103326752,124375,-,-
BAC151_N03,12,12q23.3,103217030,103291993,74963,-,-
BAC155_N22,12,12q23.3,103287233,103435301,148068,-,-
BAC33_N08,12,12q23.3,103348612,103435225,86613,-,-
BAC252_N05,12,12q23.3,103353540,103461015,107475,-,-
BAC200_E02,12,12q23.3,103367128,103499181,132053,-,-
BAC151_K23,12,12q23.3,103384564,103478597,94033,-,-
BAC160_I19,12,12q23.3,103432453,103473040,40587,-,-
BAC130_G17,12,12q23.3,103497072,103587960,90888,-,-
BAC230_D13,12,12q23.3,103499186,103584205,85019,-,-
BAC38_G05,12,12q23.3,103508182,103547710,39528,-,-
BAC140_P13,12,12q23.3,103600327,103676542,76215,-,-
BAC237_H20,12,12q23.3,103612972,103722623,109651,-,-
BAC13_C22,12,12q23.3,103626459,103774421,147962,-,-
BAC247_M08,12,12q23.3,103646001,103713182,67181,-,-
BAC132_L03,12,12q23.3,103663736,103751486,87750,-,-
BAC238_E12,12,12q23.3,103680115,103769275,89160,-,-
BAC15_E08,12,12q23.3,103801099,103900961,99862,-,-
BAC39_O07,12,12q23.3,103805982,103900961,94979,-,-
BAC204_J04,12,12q23.3,103834129,103930755,96626,-,-
BAC241_P17,12,12q23.3,103962257,104058681,96424,-,-
BAC233_G14,12,12q23.3,104074342,104172173,97831,-,-
BAC231_I19,12,12q23.3,104130741,104223459,92718,-,-
BAC188_D21,12,12q23.3,104188239,104276658,88419,-,-
BAC175_M23,12,12q23.3,104188859,104271590,82731,-,-
BAC132_C17,12,12q23.3,104188859,104310077,121218,-,-
BAC31_H09,12,12q23.3,104260569,104358988,98419,-,-
BAC232_G10,12,12q23.3,104279605,104423812,144207,-,-
BAC157_B05,12,12q23.3,104298595,104398576,99981,-,-
BAC53_G04,12,12q23.3,104306795,104399623,92828,-,-
BAC213_M21,12,12q23.3,104306814,104411629,104815,-,-
BAC43_A01,12,12q23.3,104310142,104321010,10868,-,-
BAC180_M18,12,12q23.3,104420458,104532623,112165,-,-
BAC226_B04,12,12q23.3,104423880,104540399,116519,-,-
BAC80_A04,12,12q23.3,104460086,104559943,99857,-,-
BAC37_I09,12,12q23.3,104618244,104722137,103893,-,-
BAC82_B11,12,12q23.3,104794733,104969713,174980,-,-
BAC130_I16,12,12q23.3,104940988,105047664,106676,-,-
BAC1_K20,12,12q23.3,105009968,105146146,136178,-,-
BAC197_C23,12,12q23.3,105048460,105175957,127497,-,-
BAC176_H21,12,12q23.3,105075676,105154828,79152,-,-
BAC106_H22,12,12q23.3,105146182,105233140,86958,-,-
BAC161_C02,12,12q23.3,105175967,105265435,89468,-,-
BAC165_J24,12,12q23.3,105191224,105270028,78804,-,-
BAC137_N12,12,12q23.3,105234672,105319514,84842,-,-
BAC238_P15,12,12q23.3,105278606,105413633,135027,-,-
BAC125_N24,12,12q23.3,105338910,105466195,127285,-,-
BAC128_D09,12,12q23.3,105369678,105468078,98400,-,-
BAC181_N04,12,12q23.3,105508265,105606413,98148,-,-
BAC67_J08,12,12q23.3,105521508,105614135,92627,-,-
BAC78_B08,12,12q23.3,105540004,105655686,115682,-,-
BAC229_P02,12,12q23.3,105540042,105628988,88946,-,-
BAC25_G06,12,12q23.3,105813717,105906544,92827,-,-
BAC189_A13,12,12q23.3,105820553,105906544,85991,-,-
BAC90_H07,12,12q23.3,105838782,105928937,90155,-,-
BAC22_C06,12,12q23.3,105853493,105949258,95765,-,-
BAC12_E09,12,12q23.3,105887258,106007173,119915,-,-
BAC219_D19,12,12q23.3,105906538,105990192,83654,-,-
BAC170_N19,12,12q23.3,105912992,106001325,88333,-,-
BAC125_J22,12,12q23.3,106023319,106106645,83326,-,-
BAC126_I23,12,12q23.3,106023319,106106562,83243,-,-
BAC27_L22,12,12q23.3,106052594,106157827,105233,-,-
BAC39_P15,12,12q23.3,106065082,106253933,188851,-,-
BAC117_H19,12,12q23.3,106089531,106202639,113108,-,-
BAC117_H07,12,12q23.3,106166980,106253938,86958,-,-
BAC144_A21,12,12q23.3,106222722,106328693,105971,-,-
BAC105_O01,12,12q23.3,106227497,106350773,123276,-,-
BAC43_I11,12,12q23.3,106260197,106288212,28015,-,-
BAC151_K24,12,12q23.3,106260635,106340837,80202,-,-
BAC23_H02,12,12q23.3,106328685,106410932,82247,-,-
BAC26_I14,12,12q23.3,106338693,106444982,106289,-,-
BAC66_E16,12,12q23.3,106352045,106510922,158877,-,-
BAC186_O22,12,12q23.3,106368287,106442629,74342,-,-
BAC88_A03,12,12q23.3,106374278,106481313,107035,-,-
BAC205_F12,12,12q23.3,106444995,106512522,67527,-,-
BAC34_J13,12,12q23.3,106475470,106650215,174745,-,-
BAC250_I18,12,12q23.3,106495840,106598552,102712,-,-
BAC8_G06,12,12q23.3,106511002,106675449,164447,-,-
BAC33_A23,12,12q23.3,106576179,106665539,89360,-,-
BAC181_G10,12,12q23.3,106641453,106741604,100151,-,-
BAC182_M18,12,12q23.3,106796719,106872513,75794,-,-
BAC234_N07,12,12q23.3,106868136,106971317,103181,-,-
BAC230_M08,12,12q23.3,106908873,106979570,70697,-,-
BAC64_N12,12,12q23.3,106911892,106996151,84259,-,-
BAC244_H18,12,12q23.3,106913251,106993339,80088,-,-
BAC157_F23,12,12q23.3,106953666,106982487,28821,-,-
BAC193_B12,12,12q23.3,107005242,107116850,111608,-,-
BAC119_D12,12,12q23.3,107019192,107155391,136199,-,-
BAC80_G01,12,12q23.3,107039868,107128714,88846,-,-
BAC213_P11,12,12q23.3,107052302,107117675,65373,-,-
BAC232_M19,12,12q23.3,107189079,107254131,65052,-,-
BAC234_D20,12,12q23.3,107194130,107274788,80658,-,-
BAC17_H18,12,12q23.3,107211598,107335649,124051,-,-
BAC22_D06,12,12q23.3,107260936,107385098,124162,-,-
BAC224_A05,12,12q23.3,107276301,107349517,73216,-,-
BAC126_O21,12,12q23.3,107339874,107440325,100451,-,-
BAC31_N12,12,12q23.3,107348198,107466991,118793,-,-
BAC26_B05,12,12q24.11,107506884,107601756,94872,-,-
BAC197_F10,12,12q24.11,107512096,107590094,77998,-,-
BAC176_N07,12,12q24.11,107512836,107590265,77429,-,-
BAC57_O09,12,12q24.11,107590322,107831429,241107,-,-
BAC252_K16,12,12q24.11,107619295,107799067,179772,-,-
BAC100_L12,12,12q24.11,107627655,107643630,15975,-,-
BAC73_M21,12,12q24.11,107658310,107743778,85468,-,-
BAC235_L04,12,12q24.11,107936222,108014324,78102,-,-
BAC136_F17,12,12q24.11,107958510,108032273,73763,-,-
BAC102_O15,12,12q24.11,107962457,108103999,141542,-,-
BAC101_N13,12,12q24.11,107964854,108104257,139403,-,-
BAC67_P04,12,12q24.11,108104321,108201347,97026,-,-
BAC243_D04,12,12q24.11,108115969,108201120,85151,-,-
BAC75_B23,12,12q24.11,108136742,108228402,91660,-,-
BAC8_H10,12,12q24.11,108154806,108254368,99562,-,-
BAC220_L21,12,12q24.11,108158886,108278380,119494,-,-
BAC148_N08,12,12q24.11,108183547,108271013,87466,-,-
BAC177_M13,12,12q24.11,108253682,108348090,94408,-,-
BAC234_J23,12,12q24.11,108254362,108344401,90039,-,-
BAC139_K13,12,12q24.11,108265294,108348090,82796,-,-
BAC89_B11,12,12q24.11,108436087,108572252,136165,-,-
BAC103_K08,12,12q24.11,108444039,108529054,85015,-,-
BAC218_B08,12,12q24.11,108449740,108544880,95140,-,-
BAC77_J06,12,12q24.11,108460471,108544857,84386,-,-
BAC63_P13,12,12q24.11,108460488,108578529,118041,-,-
BAC187_G01,12,12q24.11,108472323,108579477,107154,-,-
BAC116_L10,12,12q24.11,108477020,108578543,101523,-,-
BAC247_D04,12,12q24.11,108498325,108571667,73342,-,-
BAC41_G05,12,12q24.11,108578771,108698774,120003,-,-
BAC76_P17,12,12q24.11,108579471,108697600,118129,-,-
BAC121_A07,12,12q24.11,108697597,108780736,83139,-,-
BAC168_A20,12,12q24.11,108697597,108780719,83122,-,-
BAC217_P07,12,12q24.11,108697597,108780736,83139,-,-
BAC151_J11,12,12q24.11,108734223,108808762,74539,-,-
BAC158_D18,12,12q24.11,108740733,108822643,81910,-,-
BAC52_E06,12,12q24.11,108780758,108855440,74682,-,-
BAC119_A14,12,12q24.11,108883770,108969379,85609,-,-
BAC218_H02,12,12q24.11,108886386,108989249,102863,-,-
BAC104_E04,12,12q24.11,108905373,109058922,153549,-,-
BAC34_F07,12,12q24.11,108966235,109134144,167909,-,-
BAC192_I20,12,12q24.11,109007719,109102265,94546,-,-
BAC149_A21,12,12q24.11,109108902,109211391,102489,-,-
BAC194_J22,12,12q24.11,109209790,109324101,114311,-,-
BAC148_N18,12,12q24.11,109222851,109303246,80395,-,-
BAC198_C19,12,12q24.11,109224286,109324101,99815,-,-
BAC100_D06,12,12q24.11,109262156,109390654,128498,-,-
BAC21_M24,12,12q24.11,109390648,109494628,103980,-,-
BAC101_I24,12,12q24.11,109391712,109498452,106740,-,-
BAC161_P11,12,12q24.11,109405586,109508019,102433,-,-
BAC206_I23,12,12q24.11,109414070,109492880,78810,-,-
BAC33_K15,12,12q24.11,109493327,109579041,85714,-,-
BAC193_M13,12,12q24.11,109498601,109584891,86290,-,-
BAC130_H07,12,12q24.11,109508166,109627141,118975,-,-
BAC146_A21,12,12q24.11,109512637,109595910,83273,-,-
BAC1_E21,12,12q24.11,109517502,109638355,120853,-,-
BAC139_C07,12,12q24.11,109524339,109630488,106149,-,-
BAC91_I19,12,12q24.11,109607896,109723786,115890,-,-
BAC197_A06,12,12q24.11,109607896,109712297,104401,-,-
BAC41_C16,12,12q24.11,109627139,109742665,115526,-,-
BAC248_D21,12,12q24.11,109707575,109763947,56372,-,-
BAC213_K12,12,12q24.11,109909851,110004463,94612,-,-
BAC26_P19,12,12q24.11,109909851,109998287,88436,-,-
BAC236_I23,12,12q24.11,110016335,110136048,119713,-,-
BAC218_G08,12,12q24.11,110040113,110132768,92655,-,-
BAC59_C10,12,12q24.11-12q24.12,110071395,110271210,199815,-,-
BAC118_B02,12,12q24.11-12q24.12,110144806,110263789,118983,-,-
BAC92_G12,12,12q24.11-12q24.12,110152759,110283404,130645,-,-
BAC144_M13,12,12q24.11-12q24.12,110188972,110291858,102886,-,-
BAC119_E12,12,12q24.12,110263841,110386421,122580,-,-
BAC228_F09,12,12q24.12,110271200,110364119,92919,-,-
BAC182_D16,12,12q24.12,110291851,110399771,107920,-,-
BAC237_H12,12,12q24.12,110291852,110386425,94573,-,-
BAC54_A03,12,12q24.12,110295502,110386434,90932,-,-
BAC217_F20,12,12q24.12,110372608,110486398,113790,-,-
BAC176_A04,12,12q24.12,110386558,110463931,77373,-,-
BAC72_J08,12,12q24.12,110386558,110497217,110659,-,-
BAC172_B21,12,12q24.12,110386558,110493362,106804,-,-
BAC244_C06,12,12q24.12,110402231,110494588,92357,-,-
BAC91_J18,12,12q24.12,110402235,110486398,84163,-,-
BAC55_E11,12,12q24.12,110479250,110644556,165306,-,-
BAC252_F06,12,12q24.12,110486391,110603557,117166,-,-
BAC84_G16,12,12q24.12,110697673,110783910,86237,-,-
BAC238_G15,12,12q24.12-12q24.13,110722643,110850233,127590,-,-
BAC178_H17,12,12q24.12-12q24.13,110726612,110854803,128191,-,-
BAC252_I08,12,12q24.12-12q24.13,110753719,110854781,101062,-,-
BAC95_J18,12,12q24.12-12q24.13,110792920,110936914,143994,-,-
BAC63_J22,12,12q24.13,110894313,111029942,135629,-,-
BAC130_B14,12,12q24.13,110899339,110976807,77468,-,-
BAC36_K17,12,12q24.13,110965103,111074897,109794,-,-
BAC73_C01,12,12q24.13,110977338,111084649,107311,-,-
BAC51_A18,12,12q24.13,110977338,111048531,71193,-,-
BAC101_B11,12,12q24.13,110994388,111087860,93472,-,-
BAC125_J02,12,12q24.13,111048536,111137786,89250,-,-
BAC188_A22,12,12q24.13,111087911,111197524,109613,-,-
BAC58_H10,12,12q24.13,111158400,111265563,107163,-,-
BAC81_G02,12,12q24.13,111179993,111317656,137663,-,-
BAC223_J21,12,12q24.13,111265557,111358435,92878,-,-
BAC48_E09,12,12q24.13,111273506,111376849,103343,-,-
BAC247_K12,12,12q24.13,111274311,111376893,102582,-,-
BAC77_I20,12,12q24.13,111274313,111382687,108374,-,-
BAC95_L17,12,12q24.13,111358485,111467305,108820,-,-
BAC14_O03,12,12q24.13,111358485,111450097,91612,-,-
BAC23_A24,12,12q24.13,111378898,111527561,148663,-,-
BAC252_H21,12,12q24.13,111433830,111537398,103568,-,-
BAC158_P06,12,12q24.13,111456853,111542177,85324,-,-
BAC46_N13,12,12q24.13,111456879,111546953,90074,-,-
BAC141_M03,12,12q24.13,111489864,111587618,97754,-,-
BAC21_I20,12,12q24.13,111616051,111717094,101043,-,-
BAC75_K07,12,12q24.13,111616060,111704669,88609,-,-
BAC247_H14,12,12q24.13,111629090,111715183,86093,-,-
BAC19_C19,12,12q24.13,111632181,111773406,141225,-,-
BAC100_L03,12,12q24.13,111718195,111795924,77729,-,-
BAC243_A09,12,12q24.13,111886995,112014987,127992,-,-
BAC80_N13,12,12q24.13,111916210,112014987,98777,-,-
BAC157_N10,12,12q24.13,111985302,112072428,87126,-,-
BAC137_C10,12,12q24.13,112014997,112123626,108629,-,-
BAC131_P07,12,12q24.13,112123619,112255392,131773,-,-
BAC17_N06,12,12q24.13,112123619,112213470,89851,-,-
BAC76_E09,12,12q24.13,112176309,112254216,77907,-,-
BAC155_D23,12,12q24.13,112193843,112276830,82987,-,-
BAC60_N20,12,12q24.13,112213653,112307934,94281,-,-
BAC239_A09,12,12q24.13,112276928,112393404,116476,-,-
BAC65_H19,12,12q24.13,112299635,112393397,93762,-,-
BAC55_A06,12,12q24.13,112307900,112393191,85291,-,-
BAC88_F05,12,12q24.13,112340710,112488864,148154,-,-
BAC79_F08,12,12q24.13,112375436,112479640,104204,-,-
BAC243_I01,12,12q24.13,112405409,112564240,158831,-,-
BAC92_I20,12,12q24.13,112466822,112576356,109534,-,-
BAC103_O21,12,12q24.13,112479636,112576356,96720,-,-
BAC28_J11,12,12q24.13,112488887,112524171,35284,-,-
BAC252_J08,12,12q24.13,112547918,112645185,97267,-,-
BAC131_L15,12,12q24.13,112558034,112657652,99618,-,-
BAC27_G15,12,12q24.13,112593315,112716305,122990,-,-
BAC165_D20,12,12q24.13,112593316,112696466,103150,-,-
BAC55_B09,12,12q24.13,112593320,112701044,107724,-,-
BAC244_M03,12,12q24.13,112647373,112740401,93028,-,-
BAC60_N11,12,12q24.13,112665463,112748340,82877,-,-
BAC249_F03,12,12q24.13-12q24.21,112740723,112878401,137678,-,-
BAC24_I14,12,12q24.13-12q24.21,112776295,112889414,113119,-,-
BAC35_K02,12,12q24.13-12q24.21,112776323,112914219,137896,-,-
BAC154_M09,12,12q24.21,112858974,112942125,83151,-,-
BAC196_A05,12,12q24.21,112889408,112996919,107511,-,-
BAC217_O21,12,12q24.21,112914796,113036994,122198,-,-
BAC140_C13,12,12q24.21,112942128,113054369,112241,-,-
BAC4_F12,12,12q24.21,112960759,113053466,92707,-,-
BAC179_H19,12,12q24.21,113005511,113092179,86668,-,-
BAC27_I07,12,12q24.21,113033072,113153127,120055,-,-
BAC154_E02,12,12q24.21,113057247,113153442,96195,-,-
BAC148_A05,12,12q24.21,113096233,113210308,114075,-,-
BAC40_D23,12,12q24.21,113099263,113210308,111045,-,-
BAC35_M13,12,12q24.21,113100951,113194971,94020,-,-
BAC226_J08,12,12q24.21,113100951,113183709,82758,-,-
BAC199_J11,12,12q24.21,113189184,113301730,112546,-,-
BAC162_I19,12,12q24.21,113210302,113296536,86234,-,-
BAC237_B07,12,12q24.21,113213267,113306461,93194,-,-
BAC70_J18,12,12q24.21,113214307,113300567,86260,-,-
BAC29_A01,12,12q24.21,113278149,113387592,109443,-,-
BAC19_I19,12,12q24.21,113300594,113405170,104576,-,-
BAC76_P02,12,12q24.21,113314551,113413545,98994,-,-
BAC27_M07,12,12q24.21,113346512,113505695,159183,-,-
BAC248_D05,12,12q24.21,113387587,113476483,88896,-,-
BAC49_G13,12,12q24.21,113413581,113535707,122126,-,-
BAC95_B13,12,12q24.21,113446566,113528462,81896,-,-
BAC184_E02,12,12q24.21,113559565,113647957,88392,-,-
BAC161_G24,12,12q24.21,113660490,113762760,102270,-,-
BAC188_H01,12,12q24.21,113680930,113759029,78099,-,-
BAC231_N01,12,12q24.21,113685269,113815003,129734,-,-
BAC67_I03,12,12q24.21,113737672,113759029,21357,-,-
BAC234_E06,12,12q24.21,113815014,113930493,115479,-,-
BAC188_I12,12,12q24.21,113819098,113930493,111395,-,-
BAC167_M15,12,12q24.21,113820936,113904246,83310,-,-
BAC122_L17,12,12q24.21,113930487,114034421,103934,-,-
BAC141_B23,12,12q24.21,113930488,114038034,107546,-,-
BAC53_O11,12,12q24.21,113939862,114028668,88806,-,-
BAC192_H10,12,12q24.21,113942772,114038034,95262,-,-
BAC200_D19,12,12q24.21,114134442,114234504,100062,-,-
BAC210_L21,12,12q24.21,114151590,114236195,84605,-,-
BAC160_E06,12,12q24.21,114230460,114325091,94631,-,-
BAC64_N11,12,12q24.21,114242656,114353525,110869,-,-
BAC192_I05,12,12q24.21,114249196,114325797,76601,-,-
BAC144_L10,12,12q24.21,114387426,114465041,77615,-,-
BAC218_C16,12,12q24.21,114387435,114467056,79621,-,-
BAC188_H23,12,12q24.21,114391476,114473042,81566,-,-
BAC146_O21,12,12q24.21,114467128,114587113,119985,-,-
BAC166_H24,12,12q24.21,114476819,114562643,85824,-,-
BAC65_K11,12,12q24.21,114509915,114600506,90591,-,-
BAC57_B22,12,12q24.21,114509925,114642112,132187,-,-
BAC51_A11,12,12q24.21,114572423,114669734,97311,-,-
BAC218_I08,12,12q24.21,114621856,114743555,121699,-,-
BAC11_H10,12,12q24.21,114642110,114750706,108596,-,-
BAC75_M14,12,12q24.21,114691055,114869181,178126,-,-
BAC43_D12,12,12q24.21,114695265,114801789,106524,-,-
BAC182_L17,12,12q24.21,114695526,114813842,118316,-,-
BAC246_G12,12,12q24.21,114713317,114786925,73608,-,-
BAC82_A13,12,12q24.21,114732636,114841824,109188,-,-
BAC218_P11,12,12q24.21,114744964,114867634,122670,-,-
BAC134_M17,12,12q24.21,114892621,114996460,103839,-,-
BAC82_K04,12,12q24.21,114962386,115052707,90321,-,-
BAC59_N23,12,12q24.21,115012361,115108862,96501,-,-
BAC32_M20,12,12q24.21,115176560,115265608,89048,-,-
BAC228_J10,12,12q24.21-12q24.22,115274131,115369682,95551,-,-
BAC198_M06,12,12q24.22,115314458,115411805,97347,-,-
BAC20_J15,12,12q24.22,115386872,115506327,119455,-,-
BAC248_I05,12,12q24.22,115488388,115590185,101797,-,-
BAC108_N16,12,12q24.22,115506515,115611706,105191,-,-
BAC234_L12,12,12q24.22,115507654,115595647,87993,-,-
BAC151_K12,12,12q24.22,115507654,115596582,88928,-,-
BAC148_G18,12,12q24.22,115507717,115596582,88865,-,-
BAC103_B22,12,12q24.22,115544210,115653178,108968,-,-
BAC97_P21,12,12q24.22,115596921,115722294,125373,-,-
BAC244_C20,12,12q24.22,115618459,115722294,103835,-,-
BAC152_J06,12,12q24.22,115688138,115779294,91156,-,-
BAC96_B11,12,12q24.22,115722311,115806439,84128,-,-
BAC67_M16,12,12q24.22,115778467,115865983,87516,-,-
BAC168_A15,12,12q24.22,115786677,115854129,67452,-,-
BAC249_F22,12,12q24.22,115914701,116011458,96757,-,-
BAC30_O03,12,12q24.22,115932135,116027408,95273,-,-
BAC78_B11,12,12q24.22,115936043,116027408,91365,-,-
BAC90_O11,12,12q24.22,115937738,116038510,100772,-,-
BAC221_J15,12,12q24.22,115939619,116027394,87775,-,-
BAC59_C07,12,12q24.22,115961139,116063014,101875,-,-
BAC29_C08,12,12q24.22,115967737,116087595,119858,-,-
BAC97_L15,12,12q24.22,116015247,116117736,102489,-,-
BAC105_B04,12,12q24.22,116063040,116152560,89520,-,-
BAC127_D05,12,12q24.22,116144822,116238027,93205,-,-
BAC219_E22,12,12q24.22,116238024,116326123,88099,-,-
BAC57_L22,12,12q24.22,116262365,116416569,154204,-,-
BAC75_D15,12,12q24.22,116280922,116419925,139003,-,-
BAC234_B03,12,12q24.22,116312091,116395686,83595,-,-
BAC248_F15,12,12q24.22,116353211,116434487,81276,-,-
BAC192_G22,12,12q24.22,116388433,116490541,102108,-,-
BAC227_F22,12,12q24.22,116409952,116494334,84382,-,-
BAC167_P21,12,12q24.22,116463603,116539063,75460,-,-
BAC233_N05,12,12q24.22,116494916,116583616,88700,-,-
BAC46_A12,12,12q24.22-12q24.23,116609478,116713583,104105,-,-
BAC8_N02,12,12q24.22-12q24.23,116630036,116730310,100274,-,-
BAC213_A05,12,12q24.22-12q24.23,116668154,116745305,77151,-,-
BAC84_O20,12,12q24.23,116749665,116867996,118331,-,-
BAC52_H16,12,12q24.23,116749673,116840540,90867,-,-
BAC144_M19,12,12q24.23,116767029,116857947,90918,-,-
BAC33_F09,12,12q24.23,116794769,116938559,143790,-,-
BAC191_L17,12,12q24.23,116876536,116988793,112257,-,-
BAC53_K20,12,12q24.23,116894713,117001337,106624,-,-
BAC102_L19,12,12q24.23,116912040,117006782,94742,-,-
BAC109_H23,12,12q24.23,116918437,117006314,87877,-,-
BAC198_A05,12,12q24.23,117001411,117105102,103691,-,-
BAC125_B20,12,12q24.23,117003799,117082846,79047,-,-
BAC60_L22,12,12q24.23,117007233,117105339,98106,-,-
BAC51_E14,12,12q24.23,117043306,117219214,175908,-,-
BAC60_P22,12,12q24.23,117083580,117232638,149058,-,-
BAC152_O04,12,12q24.23,117142304,117222117,79813,-,-
BAC30_C10,12,12q24.23,117142386,117219214,76828,-,-
BAC210_M07,12,12q24.23,117142501,117222113,79612,-,-
BAC29_H03,12,12q24.23,117154796,117273775,118979,-,-
BAC48_O06,12,12q24.23,117219246,117332596,113350,-,-
BAC65_J17,12,12q24.23,117220530,117344555,124025,-,-
BAC181_M24,12,12q24.23,117251809,117335408,83599,-,-
BAC78_A02,12,12q24.23,117251809,117335033,83224,-,-
BAC169_A08,12,12q24.23,117318852,117410139,91287,-,-
BAC103_N08,12,12q24.23,117368923,117452245,83322,-,-
BAC35_N05,12,12q24.23,117450442,117569763,119321,-,-
BAC168_D02,12,12q24.23,117465759,117541504,75745,-,-
BAC62_K19,12,12q24.23,117511881,117603084,91203,-,-
BAC168_K12,12,12q24.23,117524457,117668721,144264,-,-
BAC154_G22,12,12q24.23,117585612,117699730,114118,-,-
BAC48_P07,12,12q24.23,117589273,117679092,89819,-,-
BAC126_K04,12,12q24.23,117603079,117702872,99793,-,-
BAC192_H13,12,12q24.23,117603082,117679112,76030,-,-
BAC96_A15,12,12q24.23,117683772,117788555,104783,-,-
BAC248_N16,12,12q24.23,117702866,117798227,95361,-,-
BAC107_I13,12,12q24.23,117708473,117798231,89758,-,-
BAC241_A10,12,12q24.23,117827517,117923520,96003,-,-
BAC59_P04,12,12q24.23,117852428,117978639,126211,-,-
BAC182_I04,12,12q24.23,117869359,117966750,97391,-,-
BAC30_P14,12,12q24.23,117934604,118015601,80997,-,-
BAC33_P17,12,12q24.23,117978634,118104411,125777,-,-
BAC53_I15,12,12q24.23,117986855,118098728,111873,-,-
BAC115_K01,12,12q24.23,117987003,118113626,126623,-,-
BAC155_J19,12,12q24.23,118029367,118185518,156151,-,-
BAC178_M02,12,12q24.23,118070521,118148616,78095,-,-
BAC177_C08,12,12q24.23,118070521,118184850,114329,-,-
BAC61_N18,12,12q24.23,118070521,118192115,121594,-,-
BAC145_P08,12,12q24.23,118070521,118173131,102610,-,-
BAC54_A05,12,12q24.23,118098755,118196132,97377,-,-
BAC188_M03,12,12q24.23,118181050,118266598,85548,-,-
BAC36_A06,12,12q24.23,118184894,118265514,80620,-,-
BAC139_O20,12,12q24.23,118196127,118295669,99542,-,-
BAC107_K14,12,12q24.23,118197591,118304797,107206,-,-
BAC131_E11,12,12q24.23,118482322,118624296,141974,-,-
BAC160_H05,12,12q24.23,118584836,118669174,84338,-,-
BAC176_B01,12,12q24.23,118608146,118721932,113786,-,-
BAC38_P10,12,12q24.23,118624433,118720203,95770,-,-
BAC144_O22,12,12q24.23,118669168,118763320,94152,-,-
BAC151_O24,12,12q24.23,118696063,118779054,82991,-,-
BAC240_B13,12,12q24.23,118723774,118802577,78803,-,-
BAC109_O19,12,12q24.23,118745274,118848471,103197,-,-
BAC248_P20,12,12q24.23,118752003,118833559,81556,-,-
BAC65_N17,12,12q24.23,118756675,118906247,149572,-,-
BAC63_E22,12,12q24.23,118779065,118893639,114574,-,-
BAC53_P13,12,12q24.23,118790273,118876731,86458,-,-
BAC134_I03,12,12q24.23,118838341,118938955,100614,-,-
BAC229_B16,12,12q24.23,118848533,118938938,90405,-,-
BAC140_D18,12,12q24.23,118907035,119030746,123711,-,-
BAC15_E07,12,12q24.23-12q24.31,118976619,119107566,130947,-,-
BAC223_I04,12,12q24.23,118980376,119063569,83193,-,-
BAC158_P18,12,12q24.23-12q24.31,119001541,119107563,106022,-,-
BAC250_B22,12,12q24.23,119001926,119096685,94759,-,-
BAC229_H09,12,12q24.23-12q24.31,119016960,119115941,98981,-,-
BAC181_M03,12,12q24.31,119106193,119209066,102873,-,-
BAC148_K21,12,12q24.31,119131005,119222477,91472,-,-
BAC149_J11,12,12q24.31,119140246,119242564,102318,-,-
BAC181_M22,12,12q24.31,119140250,119222477,82227,-,-
BAC22_K12,12,12q24.31,119140344,119242564,102220,-,-
BAC172_A10,12,12q24.31,119147315,119256005,108690,-,-
BAC144_H18,12,12q24.31,119259959,119346594,86635,-,-
BAC135_F11,12,12q24.31,119264522,119383647,119125,-,-
BAC124_O08,12,12q24.31,119304011,119383647,79636,-,-
BAC121_F11,12,12q24.31,119461467,119543152,81685,-,-
BAC185_A16,12,12q24.31,119500789,119631246,130457,-,-
BAC223_B18,12,12q24.31,119503618,119617510,113892,-,-
BAC214_N21,12,12q24.31,119509258,119617088,107830,-,-
BAC160_N11,12,12q24.31,119509266,119617510,108244,-,-
BAC92_G17,12,12q24.31,119523377,119622864,99487,-,-
BAC205_I17,12,12q24.31,119523377,119611298,87921,-,-
BAC24_J05,12,12q24.31,119523377,119611390,88013,-,-
BAC34_N17,12,12q24.31,119523377,119622864,99487,-,-
BAC217_H15,12,12q24.31,119523377,119617510,94133,-,-
BAC187_O16,12,12q24.31,119611535,119695880,84345,-,-
BAC139_I06,12,12q24.31,119611785,119683340,71555,-,-
BAC178_O06,12,12q24.31,119642926,119734976,92050,-,-
BAC178_L06,12,12q24.31,119642926,119734976,92050,-,-
BAC83_E14,12,12q24.31,119642946,119734989,92043,-,-
BAC150_C23,12,12q24.31,119695873,119816510,120637,-,-
BAC169_J21,12,12q24.31,119695876,119828153,132277,-,-
BAC30_L04,12,12q24.31,119751461,119845865,94404,-,-
BAC178_F18,12,12q24.31,119757712,119902786,145074,-,-
BAC196_M05,12,12q24.31,119854386,119964024,109638,-,-
BAC222_O11,12,12q24.31,119903095,119976514,73419,-,-
BAC127_L19,12,12q24.31,119964313,120088620,124307,-,-
BAC157_H21,12,12q24.31,119974936,120069431,94495,-,-
BAC102_E18,12,12q24.31,119976508,120152831,176323,-,-
BAC235_C02,12,12q24.31,119983999,120068935,84936,-,-
BAC51_K02,12,12q24.31,120025155,120126329,101174,-,-
BAC218_F13,12,12q24.31,120025155,120113087,87932,-,-
BAC22_P18,12,12q24.31,120036979,120152165,115186,-,-
BAC176_J09,12,12q24.31,120036979,120133119,96140,-,-
BAC218_H15,12,12q24.31,120069529,120175454,105925,-,-
BAC229_K10,12,12q24.31,120151566,120240748,89182,-,-
BAC6_D05,12,12q24.31,120152180,120251796,99616,-,-
BAC5_I06,12,12q24.31,120152825,120256144,103319,-,-
BAC22_O02,12,12q24.31,120177582,120251796,74214,-,-
BAC41_C21,12,12q24.31,120177582,120276777,99195,-,-
BAC217_M01,12,12q24.31,120177928,120297673,119745,-,-
BAC241_F08,12,12q24.31,120184773,120268182,83409,-,-
BAC27_K10,12,12q24.31,120291903,120417693,125790,-,-
BAC76_P24,12,12q24.31,120346536,120464506,117970,-,-
BAC217_P11,12,12q24.31,120549288,120681411,132123,-,-
BAC239_H08,12,12q24.31,120549288,120638068,88780,-,-
BAC153_C03,12,12q24.31,120549288,120645771,96483,-,-
BAC44_F09,12,12q24.31,120549288,120645695,96407,-,-
BAC11_F06,12,12q24.31,120549288,120678891,129603,-,-
BAC244_J03,12,12q24.31,120549308,120645771,96463,-,-
BAC143_F18,12,12q24.31,120560804,120637233,76429,-,-
BAC81_O14,12,12q24.31,120560804,120645771,84967,-,-
BAC143_O22,12,12q24.31,120645764,120753526,107762,-,-
BAC196_H23,12,12q24.31,120718163,120832254,114091,-,-
BAC33_H02,12,12q24.31,120718168,120804689,86521,-,-
BAC28_P19,12,12q24.31,120720771,120844812,124041,-,-
BAC57_A22,12,12q24.31,120743352,120890986,147634,-,-
BAC69_H07,12,12q24.31,120781379,120881352,99973,-,-
BAC154_P09,12,12q24.31,120788885,120867939,79054,-,-
BAC22_D24,12,12q24.31,120793250,120913443,120193,-,-
BAC162_L24,12,12q24.31,120793362,120873885,80523,-,-
BAC182_A24,12,12q24.31,120793670,120869214,75544,-,-
BAC127_E04,12,12q24.31,120869227,120959302,90075,-,-
BAC107_C02,12,12q24.31,120873877,120959605,85728,-,-
BAC147_A23,12,12q24.31,120890980,120959302,68322,-,-
BAC41_O04,12,12q24.31,120913658,120995103,81445,-,-
BAC160_J09,12,12q24.31,121231066,121318011,86945,-,-
BAC26_M06,12,12q24.31,121231066,121371072,140006,-,-
BAC247_O02,12,12q24.31,121231068,121363887,132819,-,-
BAC163_E10,12,12q24.31,121244725,121318033,73308,-,-
BAC176_K11,12,12q24.31,121244725,121322969,78244,-,-
BAC218_A02,12,12q24.31,121246251,121374311,128060,-,-
BAC169_A05,12,12q24.31,121246603,121356552,109949,-,-
BAC46_O15,12,12q24.31,121322979,121417684,94705,-,-
BAC140_J21,12,12q24.31,121385184,121502892,117708,-,-
BAC139_I01,12,12q24.31,121395842,121485460,89618,-,-
BAC199_F01,12,12q24.31,121417681,121502892,85211,-,-
BAC88_E01,12,12q24.31,121431172,121592705,161533,-,-
BAC169_M04,12,12q24.31,121489825,121579968,90143,-,-
BAC46_E13,12,12q24.31,121524123,121671232,147109,-,-
BAC132_B04,12,12q24.31,121573216,121677478,104262,-,-
BAC149_E04,12,12q24.31,121638688,121731354,92666,-,-
BAC227_G20,12,12q24.31,121671234,121752171,80937,-,-
BAC65_B22,12,12q24.31,121671234,121811288,140054,-,-
BAC40_I18,12,12q24.31,121730022,121877496,147474,-,-
BAC141_M18,12,12q24.31,121752165,121831855,79690,-,-
BAC12_O09,12,12q24.31,121831184,121914909,83725,-,-
BAC234_I08,12,12q24.31,121831850,121920539,88689,-,-
BAC78_C16,12,12q24.31,121832911,121932689,99778,-,-
BAC126_K22,12,12q24.31,121901782,122026818,125036,-,-
BAC95_M02,12,12q24.31,121901799,122061391,159592,-,-
BAC23_C17,12,12q24.31,121914904,122026670,111766,-,-
BAC230_H17,12,12q24.31,121931544,122026811,95267,-,-
BAC53_E15,12,12q24.31,121962079,122110049,147970,-,-
BAC80_N06,12,12q24.31,122039954,122145759,105805,-,-
BAC218_F16,12,12q24.31,122049020,122134432,85412,-,-
BAC88_L17,12,12q24.31,122049049,122181339,132290,-,-
BAC214_P11,12,12q24.31,122061383,122153043,91660,-,-
BAC10_A12,12,12q24.31,122069860,122215930,146070,-,-
BAC82_H13,12,12q24.31,122094407,122222778,128371,-,-
BAC33_N13,12,12q24.31,122094407,122222765,128358,-,-
BAC190_P18,12,12q24.31,122095798,122177357,81559,-,-
BAC188_C06,12,12q24.31,122125182,122222766,97584,-,-
BAC39_F07,12,12q24.31,122218553,122300481,81928,-,-
BAC57_P08,12,12q24.31,122219186,122390202,171016,-,-
BAC56_J06,12,12q24.31,122254009,122340341,86332,-,-
BAC112_K04,12,12q24.31,122282399,122378042,95643,-,-
BAC64_O02,12,12q24.31,122329067,122434828,105761,-,-
BAC152_D18,12,12q24.31,122353818,122434828,81010,-,-
BAC206_D16,12,12q24.31,122376201,122474499,98298,yes,-
BAC1_O07,12,12q24.31,122400605,122508709,108104,yes,-
BAC70_C06,12,12q24.31,122669292,122764029,94737,-,-
BAC169_B09,12,12q24.31,122676772,122746807,70035,-,-
BAC135_G06,12,12q24.31,122711669,122800812,89143,-,-
BAC86_J02,12,12q24.31,122711669,122802243,90574,-,-
BAC150_K21,12,12q24.31,122764032,122874235,110203,-,-
BAC36_B24,12,12q24.31,122822485,122960965,138480,-,-
BAC21_G15,12,12q24.31,122833526,122951111,117585,-,-
BAC30_C13,12,12q24.31,122834046,122953412,119366,-,-
BAC182_J14,12,12q24.31,122850919,122954056,103137,-,-
BAC117_M04,12,12q24.31,122874229,122983444,109215,-,-
BAC67_M03,12,12q24.31,122905253,122989471,84218,-,-
BAC173_H09,12,12q24.31,122954195,123030576,76381,-,-
BAC65_I21,12,12q24.31,122960995,123070617,109622,-,-
BAC62_H04,12,12q24.31,122983464,123052735,69271,-,-
BAC83_L11,12,12q24.31,123052767,123223442,170675,-,-
BAC76_F08,12,12q24.31,123070629,123161312,90683,-,-
BAC234_B16,12,12q24.31,123140278,123217697,77419,-,-
BAC68_P19,12,12q24.31,123157032,123298282,141250,-,-
BAC79_G22,12,12q24.31,123199692,123325577,125885,-,-
BAC39_I21,12,12q24.31,123224795,123314910,90115,-,-
BAC238_A11,12,12q24.31,123234375,123339746,105371,-,-
BAC83_O04,12,12q24.31,123298278,123444343,146065,-,-
BAC100_H01,12,12q24.31,123331951,123464756,132805,-,-
BAC142_E09,12,12q24.31,123383067,123463996,80929,-,-
BAC113_K02,12,12q24.31,123526000,123614844,88844,yes,-
BAC60_E12,12,12q24.31,123601112,123732880,131768,yes,-
BAC247_M11,12,12q24.31,123686611,123783240,96629,-,-
BAC211_K21,12,12q24.31,123775041,123903614,128573,-,-
BAC156_I03,12,12q24.31,123775041,123877482,102441,-,-
BAC77_A22,12,12q24.31,123849555,123966510,116955,-,-
BAC65_C20,12,12q24.31,123939209,124065014,125805,-,-
BAC168_P19,12,12q24.31,123987424,124079755,92331,-,-
BAC193_D21,12,12q24.31,123987426,124079744,92318,-,-
BAC200_D05,12,12q24.31,124026621,124106610,79989,-,-
BAC7_O24,12,12q24.31,124073900,124200250,126350,-,-
BAC169_K08,12,12q24.31,124107130,124198531,91401,-,-
BAC101_J09,12,12q24.31,124122922,124252284,129362,-,-
BAC197_D08,12,12q24.31,124158878,124303764,144886,-,-
BAC185_A06,12,12q24.31,124158878,124235864,76986,-,-
BAC158_P17,12,12q24.31,124235860,124328753,92893,-,-
BAC5_P06,12,12q24.31,124270913,124384222,113309,-,-
BAC192_A17,12,12q24.31,124290946,124384171,93225,-,-
BAC127_O12,12,12q24.31,124332802,124439512,106710,-,-
BAC186_A15,12,12q24.31,124382813,124475334,92521,-,-
BAC56_G04,12,12q24.31-12q24.32,124430121,124569469,139348,-,-
BAC141_F02,12,12q24.31-12q24.32,124438227,124548292,110065,-,-
BAC166_M03,12,12q24.31-12q24.32,124438230,124528977,90747,-,-
BAC240_K23,12,12q24.31-12q24.32,124439639,124531402,91763,-,-
BAC23_N09,12,12q24.32,124528971,124630425,101454,-,-
BAC132_P18,12,12q24.32,124556426,124656139,99713,-,-
BAC167_N05,12,12q24.32,124571388,124676974,105586,-,-
BAC41_N17,12,12q24.32,124586840,124704587,117747,-,-
BAC73_M19,12,12q24.32,124707199,124796906,89707,-,-
BAC188_O20,12,12q24.32,124775289,124883063,107774,-,-
BAC123_O02,12,12q24.32,124863685,124988012,124327,-,-
BAC198_D05,12,12q24.32,125112270,125206692,94422,-,-
BAC217_I02,12,12q24.32,125117902,125207630,89728,-,-
BAC34_F11,12,12q24.32,125127960,125225323,97363,-,-
BAC190_B06,12,12q24.32,125138440,125235255,96815,-,-
BAC155_O12,12,12q24.32,125145764,125254469,108705,-,-
BAC39_A10,12,12q24.32,125150610,125239920,89310,-,-
BAC162_J20,12,12q24.32,125207667,125299606,91939,-,-
BAC214_D21,12,12q24.32,125243479,125299605,56126,-,-
BAC234_B05,12,12q24.32,125519647,125589716,70069,-,-
BAC247_P06,12,12q24.32,125707102,125803499,96397,-,-
BAC188_L09,12,12q24.32,125804454,125881502,77048,-,-
BAC135_I17,12,12q24.32,125816014,125914897,98883,-,-
BAC46_J16,12,12q24.32,125817029,125914069,97040,-,-
BAC91_I09,12,12q24.32,125837300,126001974,164674,-,-
BAC115_P09,12,12q24.32,125904738,126037806,133068,-,-
BAC252_C22,12,12q24.32,125961371,126069316,107945,-,-
BAC109_L11,12,12q24.32,125961374,126101561,140187,-,-
BAC37_O16,12,12q24.32,125961376,126069340,107964,-,-
BAC126_P07,12,12q24.32,125996418,126081625,85207,-,-
BAC119_D20,12,12q24.32,125996418,126092149,95731,-,-
BAC6_K08,12,12q24.32,126022844,126113239,90395,-,-
BAC169_E05,12,12q24.32,126044481,126151896,107415,-,-
BAC22_B06,12,12q24.32,126060040,126151896,91856,-,-
BAC120_B15,12,12q24.32,126133848,126233779,99931,-,-
BAC237_D10,12,12q24.32,126135285,126204955,69670,-,-
BAC232_F15,12,12q24.32,126187273,126275203,87930,-,-
BAC110_J03,12,12q24.32,126260591,126364473,103882,-,-
BAC82_B22,12,12q24.32,126350571,126484165,133594,-,-
BAC73_L03,12,12q24.32,126364916,126474639,109723,-,-
BAC231_M03,12,12q24.32,126393153,126472206,79053,-,-
BAC187_A14,12,12q24.32,126508680,126613846,105166,-,-
BAC25_H01,12,12q24.32,126560493,126676234,115741,-,-
BAC185_E05,12,12q24.32,126577950,126669041,91091,-,-
BAC249_D01,12,12q24.32,126611491,126729752,118261,-,-
BAC159_O07,12,12q24.32,126687436,126768218,80782,-,-
BAC76_O02,12,12q24.32,126717909,126798483,80574,-,-
BAC15_M13,12,12q24.32,126730831,126820163,89332,-,-
BAC129_J10,12,12q24.32,126754094,126849051,94957,-,-
BAC155_H17,12,12q24.32,126788521,126877987,89466,-,-
BAC71_K16,12,12q24.32,126855188,126970939,115751,-,-
BAC161_E07,12,12q24.32,126884906,126968910,84004,-,-
BAC84_N24,12,12q24.32,126970932,127049748,78816,-,-
BAC161_K12,12,12q24.32,126978158,127047982,69824,-,-
BAC119_H21,12,12q24.32,126978160,127072043,93883,-,-
BAC8_I17,12,12q24.32,126978171,127072043,93872,-,-
BAC80_N05,12,12q24.32,126992099,127090308,98209,-,-
BAC82_P11,12,12q24.32,126992168,127095045,102877,-,-
BAC60_B04,12,12q24.32,127047979,127140481,92502,-,-
BAC80_H02,12,12q24.32,127072208,127220768,148560,-,-
BAC101_G12,12,12q24.32,127192495,127278153,85658,-,-
BAC149_K18,12,12q24.32,127276815,127412162,135347,-,-
BAC126_P22,12,12q24.32,127281020,127363558,82538,-,-
BAC126_I05,12,12q24.32,127281028,127363558,82530,-,-
BAC72_K04,12,12q24.32,127301886,127431820,129934,-,-
BAC35_N04,12,12q24.32,127312740,127412143,99403,-,-
BAC161_O02,12,12q24.32,127326315,127426513,100198,-,-
BAC244_F05,12,12q24.32,127363552,127431859,68307,-,-
BAC242_P13,12,12q24.32,127378666,127482381,103715,-,-
BAC25_L16,12,12q24.32,127544721,127651547,106826,-,-
BAC88_H11,12,12q24.32,127568325,127658420,90095,-,-
BAC238_M21,12,12q24.32,127575483,127659111,83628,-,-
BAC234_K18,12,12q24.32,127603849,127675041,71192,-,-
BAC80_O15,12,12q24.32,127650086,127736082,85996,-,-
BAC170_H16,12,12q24.32,127651541,127742958,91417,-,-
BAC169_A22,12,12q24.32,127651541,127744898,93357,-,-
BAC217_P04,12,12q24.32,127657330,127736079,78749,-,-
BAC144_E08,12,12q24.32,127657330,127742958,85628,-,-
BAC6_L19,12,12q24.32,127658418,127742958,84540,-,-
BAC34_J24,12,12q24.32,127659105,127795641,136536,-,-
BAC12_P15,12,12q24.32,127659149,127783707,124558,-,-
BAC149_L17,12,12q24.32,127730397,127804210,73813,-,-
BAC191_A08,12,12q24.32,127742952,127839929,96977,-,-
BAC180_P22,12,12q24.32,127820496,127910370,89874,-,-
BAC242_J14,12,12q24.32,127833759,127914752,80993,-,-
BAC196_C03,12,12q24.32,127857421,127966289,108868,-,-
BAC22_N22,12,12q24.32,127862363,127966289,103926,-,-
BAC8_E09,12,12q24.32,127875602,127994775,119173,-,-
BAC58_L17,12,12q24.32,128010276,128148370,138094,-,-
BAC53_O19,12,12q24.32,128010293,128151596,141303,-,-
BAC97_B07,12,12q24.32,128100440,128198308,97868,-,-
BAC69_A09,12,12q24.32,128210553,128292982,82429,-,-
BAC127_B08,12,12q24.32,128226799,128322890,96091,-,-
BAC68_I10,12,12q24.32,128322884,128414982,92098,-,-
BAC120_G23,12,12q24.32,128362632,128448805,86173,-,-
BAC22_K02,12,12q24.32,128426454,128571853,145399,-,-
BAC126_G21,12,12q24.32,128450854,128535560,84706,-,-
BAC246_A22,12,12q24.32,128559949,128661999,102050,-,-
BAC200_G06,12,12q24.32,128564354,128662940,98586,-,-
BAC38_D18,12,12q24.32,128564354,128662940,98586,-,-
BAC221_J10,12,12q24.32,128572898,128655280,82382,-,-
BAC128_G07,12,12q24.32-12q24.33,128652044,128763164,111120,-,-
BAC31_L05,12,12q24.32-12q24.33,128655277,128738088,82811,-,-
BAC146_H05,12,12q24.32-12q24.33,128663142,128738088,74946,-,-
BAC191_O21,12,12q24.33,128744357,128877284,132927,-,-
BAC66_G22,12,12q24.33,128814642,128913262,98620,-,-
BAC45_L08,12,12q24.33,128834953,128994969,160016,-,-
BAC117_N11,12,12q24.33,128838826,128990465,151639,-,-
BAC55_E10,12,12q24.33,128882962,128959742,76780,-,-
BAC35_M20,12,12q24.33,128883136,128999152,116016,-,-
BAC218_G04,12,12q24.33,128886455,128990436,103981,-,-
BAC167_B23,12,12q24.33,128886455,128989434,102979,-,-
BAC227_G03,12,12q24.33,128888177,128980160,91983,-,-
BAC198_B07,12,12q24.33,128904017,129014475,110458,-,-
BAC140_P19,12,12q24.33,129015735,129104088,88353,-,-
BAC52_F08,12,12q24.33,129038253,129260004,221751,-,-
BAC183_D15,12,12q24.33,129039413,129132011,92598,-,-
BAC83_N12,12,12q24.33,129046753,129136648,89895,-,-
BAC83_L23,12,12q24.33,129068125,129156567,88442,-,-
BAC246_P16,12,12q24.33,129157564,129273337,115773,-,-
BAC243_O24,12,12q24.33,129284837,129384468,99631,-,-
BAC2_B22,12,12q24.33,129306627,129424846,118219,-,-
BAC102_C13,12,12q24.33,129311677,129411294,99617,-,-
BAC233_E02,12,12q24.33,129428604,129558122,129518,-,-
BAC14_O15,12,12q24.33,129448880,129571741,122861,-,-
BAC221_F11,12,12q24.33,129450755,129537997,87242,-,-
BAC16_G08,12,12q24.33,129450794,129558122,107328,-,-
BAC127_L09,12,12q24.33,129461302,129598366,137064,-,-
BAC27_I09,12,12q24.33,129470089,129607787,137698,-,-
BAC155_L03,12,12q24.33,129511958,129607812,95854,-,-
BAC193_E20,12,12q24.33,129544562,129626124,81562,-,-
BAC170_I06,12,12q24.33,129567313,129640898,73585,-,-
BAC104_H01,12,12q24.33,129571968,129660213,88245,-,-
BAC165_N09,12,12q24.33,129574762,129660215,85453,-,-
BAC175_P09,12,12q24.33,129641568,129770298,128730,-,-
BAC161_O03,12,12q24.33,129641585,129738836,97251,-,-
BAC217_B12,12,12q24.33,129642742,129756490,113748,-,-
BAC217_L12,12,12q24.33,129660206,129763320,103114,-,-
BAC103_N02,12,12q24.33,129700933,129777603,76670,-,-
BAC35_J13,12,12q24.33,129700934,129805538,104604,-,-
BAC136_E22,12,12q24.33,129770293,129849941,79648,-,-
BAC8_D05,12,12q24.33,129811916,129921487,109571,-,-
BAC123_F23,12,12q24.33,129843455,129977735,134280,-,-
BAC36_L12,12,12q24.33,129921495,130012392,90897,-,-
BAC238_F05,12,12q24.33,129951240,130032960,81720,-,-
BAC114_L11,12,12q24.33,130018179,130197381,179202,-,-
BAC27_E08,12,12q24.33,130071553,130182033,110480,-,-
BAC14_G09,12,12q24.33,130086523,130173853,87330,-,-
BAC58_D04,12,12q24.33,130182030,130272774,90744,-,-
BAC85_B20,12,12q24.33,130259490,130353119,93629,-,-
BAC117_E18,12,12q24.33,130287040,130416800,129760,-,-
BAC229_B01,12,12q24.33,130392733,130476344,83611,-,-
BAC48_B15,12,12q24.33,130512646,130621511,108865,-,-
BAC184_I06,12,12q24.33,130550917,130650899,99982,-,-
BAC103_O01,12,12q24.33,130673022,130814975,141953,-,-
BAC237_K08,12,12q24.33,130680384,130780296,99912,-,-
BAC197_O19,12,12q24.33,130772111,130869773,97662,-,-
BAC228_N19,12,12q24.33,130780292,130862057,81765,-,-
BAC224_M23,12,12q24.33,130832360,130940245,107885,-,-
BAC106_E08,12,12q24.33,130832364,130914286,81922,-,-
BAC10_B01,12,12q24.33,130859334,130978565,119231,-,-
BAC248_F19,12,12q24.33,130862109,130978593,116484,-,-
BAC65_D22,12,12q24.33,130923179,131116493,193314,-,-
BAC44_J14,12,12q24.33,130924452,131080433,155981,-,-
BAC19_F03,12,12q24.33,130926043,131008704,82661,-,-
BAC73_E02,12,12q24.33,130940264,131063428,123164,-,-
BAC217_P24,12,12q24.33,130978589,131107913,129324,-,-
BAC190_P10,12,12q24.33,130978874,131061513,82639,-,-
BAC63_L21,12,12q24.33,131037601,131129228,91627,-,-
BAC177_L02,12,12q24.33,131063421,131151155,87734,-,-
BAC42_A11,12,12q24.33,131129374,131222479,93105,-,-
BAC142_F08,12,12q24.33,131383156,131467148,83992,-,-
BAC103_C07,12,12q24.33,131415051,131533626,118575,-,-
BAC177_G05,12,12q24.33,131449633,131529703,80070,-,-
BAC40_K02,12,12q24.33,131529697,131689940,160243,-,-
BAC134_F21,12,12q24.33,131594559,131745340,150781,-,-
BAC137_J12,12,12q24.33,131641671,131732254,90583,-,-
BAC83_L05,12,12q24.33,131695462,131829293,133831,-,-
BAC130_F21,12,12q24.33,131719840,131806080,86240,-,-
BAC89_P03,12,12q24.33,131821311,131985107,163796,-,-
BAC242_J04,12,12q24.33,131834899,131960875,125976,-,-
BAC195_G22,12,12q24.33,131855308,131960875,105567,-,-
BAC144_B20,12,12q24.33,131855308,131960875,105567,-,-
BAC135_A03,12,12q24.33,131884969,131960872,75903,-,-
BAC167_J13,12,12q24.33,131886344,131962832,76488,-,-
BAC28_D20,12,12q24.33,131917813,132012384,94571,-,-
BAC72_D06,12,12q24.33,132085370,132216267,130897,-,-
BAC71_L17,12,12q24.33,132163024,132277491,114467,-,-
BAC229_F10,12,12q24.33,132181908,132275340,93432,-,-
BAC54_D08,13,13q11,17940868,18028531,87663,-,-
BAC32_C22,13,13q11,17941054,18048389,107335,-,-
BAC14_B09,13,13q11,17941538,18048993,107455,-,-
BAC17_H11,13,13q11,18041699,18122669,80970,-,-
BAC37_G14,13,13q11,18067009,18171951,104942,-,-
BAC218_K05,13,13q11,18084467,18103784,19317,-,-
BAC219_D11,13,13q11,18103779,18220642,116863,-,-
BAC50_D23,13,13q11,18151265,18276607,125342,-,-
BAC151_M15,13,13q11,18231212,18334963,103751,-,-
BAC59_F04,13,13q11-13q12.11,18246633,18430963,184330,-,-
BAC136_K20,13,13q11-13q12.11,18324819,18420143,95324,-,-
BAC132_G09,13,13q12.11,18416729,18518398,101669,-,-
BAC165_G05,13,13q12.11,18442503,18556905,114402,-,-
BAC151_H19,13,13q12.11,18478124,18556905,78781,-,-
BAC193_F01,13,13q12.11,18506278,18602186,95908,-,-
BAC157_G05,13,13q12.11,18556904,18643011,86107,-,-
BAC156_K11,13,13q12.11,18842438,18911560,69122,-,-
BAC120_N13,13,13q12.11,18853906,18985321,131415,-,-
BAC37_E21,13,13q12.11,18894608,19052065,157457,-,-
BAC217_B10,13,13q12.11,18945229,19043862,98633,-,-
BAC50_N23,13,13q12.11,19026710,19146944,120234,-,-
BAC26_H07,13,13q12.11,19047637,19171034,123397,-,-
BAC167_A11,13,13q12.11,19068131,19148189,80058,-,-
BAC26_O07,13,13q12.11,19068131,19209835,141704,-,-
BAC208_G22,13,13q12.11,19147405,19256148,108743,-,-
BAC126_O23,13,13q12.11,19178551,19265616,87065,-,-
BAC43_N11,13,13q12.11,19222015,19312235,90220,-,-
BAC243_F15,13,13q12.11,19239706,19321024,81318,-,-
BAC140_E19,13,13q12.11,19239706,19321024,81318,-,-
BAC60_G19,13,13q12.11,19239706,19331479,91773,-,-
BAC203_J09,13,13q12.11,19328415,19406559,78144,-,-
BAC153_N02,13,13q12.11,19331561,19409513,77952,-,-
BAC199_P10,13,13q12.11,19337494,19423147,85653,-,-
BAC145_B14,13,13q12.11,19337494,19417807,80313,-,-
BAC82_A24,13,13q12.11,19337494,19423053,85559,-,-
BAC230_D08,13,13q12.11,19439319,19528262,88943,-,-
BAC104_B04,13,13q12.11,19439319,19567539,128220,-,-
BAC127_F04,13,13q12.11,19445895,19528264,82369,-,-
BAC118_B22,13,13q12.11,19528255,19613541,85286,-,-
BAC199_L02,13,13q12.11,19533078,19657662,124584,-,-
BAC171_K21,13,13q12.11,19567543,19652715,85172,-,-
BAC144_E12,13,13q12.11,19612948,19693306,80358,-,-
BAC26_N06,13,13q12.11,19630029,19711501,81472,-,-
BAC78_N09,13,13q12.11,19657655,19753169,95514,-,-
BAC8_G08,13,13q12.11,19666174,19756379,90205,-,-
BAC206_K13,13,13q12.11,19693429,19779149,85720,-,-
BAC124_E19,13,13q12.11,19715368,19840783,125415,-,-
BAC219_F17,13,13q12.11,19756371,19840761,84390,-,-
BAC140_B17,13,13q12.11,19756373,19839691,83318,-,-
BAC220_N20,13,13q12.11,19756432,19839691,83259,-,-
BAC62_L02,13,13q12.11,19892204,20045932,153728,-,-
BAC82_P14,13,13q12.11,19905008,20040152,135144,-,-
BAC46_E12,13,13q12.11,19951412,20039994,88582,-,-
BAC190_L08,13,13q12.11,19972993,20073504,100511,-,-
BAC237_G13,13,13q12.11,20020166,20116637,96471,-,-
BAC180_I05,13,13q12.11,20113864,20203034,89170,-,-
BAC233_D18,13,13q12.11,20113865,20203043,89178,-,-
BAC70_N06,13,13q12.11,20123020,20258400,135380,-,-
BAC163_J19,13,13q12.11,20210115,20289067,78952,-,-
BAC170_E18,13,13q12.11,20332212,20407380,75168,-,-
BAC167_K14,13,13q12.11,20345256,20445559,100303,-,-
BAC215_G13,13,13q12.11,20345259,20429845,84586,-,-
BAC128_L05,13,13q12.11,20503355,20578591,75236,-,-
BAC122_I16,13,13q12.11,20578958,20654940,75982,yes,-
BAC96_L06,13,13q12.11,20579934,20690566,110632,yes,-
BAC50_P17,13,13q12.11,20588432,20698452,110020,yes,-
BAC34_P21,13,13q12.11,20588432,20698120,109688,yes,-
BAC32_A16,13,13q12.11,20592328,20745842,153514,yes,-
BAC151_E11,13,13q12.11,20616864,20745842,128978,yes,-
BAC8_O04,13,13q12.11,20622425,20754982,132557,yes,-
BAC75_H23,13,13q12.11,20690561,20780443,89882,-,-
BAC220_H11,13,13q12.11,20698119,20809446,111327,-,-
BAC22_A05,13,13q12.11,20698127,20809469,111342,-,-
BAC54_E14,13,13q12.11,20698469,20780446,81977,-,-
BAC19_H24,13,13q12.11,20708876,20809461,100585,-,-
BAC25_H15,13,13q12.11,20718115,20856941,138826,-,-
BAC122_M02,13,13q12.11,20734948,20926429,191481,-,-
BAC120_H24,13,13q12.11,20809628,20945885,136257,-,-
BAC39_C03,13,13q12.11,20908933,20999604,90671,-,-
BAC64_H19,13,13q12.11,20926569,21021377,94808,-,-
BAC153_L01,13,13q12.11,20945880,21054076,108196,-,-
BAC191_G21,13,13q12.11,20975721,21073722,98001,-,-
BAC5_M05,13,13q12.11,20999603,21101888,102285,-,-
BAC166_C21,13,13q12.11,21039537,21118075,78538,-,-
BAC244_K04,13,13q12.11,21111711,21201612,89901,-,-
BAC177_C17,13,13q12.11,21111713,21193050,81337,-,-
BAC133_F10,13,13q12.11,21136988,21205279,68291,-,-
BAC112_L05,13,13q12.11,21148079,21227926,79847,-,-
BAC69_D09,13,13q12.11,21148079,21251761,103682,-,-
BAC150_J21,13,13q12.11,21205301,21295209,89908,-,-
BAC148_P03,13,13q12.11,21206123,21290216,84093,-,-
BAC228_N22,13,13q12.11,21351620,21429977,78357,-,-
BAC36_B05,13,13q12.11,21358148,21478147,119999,-,-
BAC141_B06,13,13q12.11,21374130,21478148,104018,-,-
BAC34_J18,13,13q12.11,21523140,21629700,106560,-,-
BAC134_K17,13,13q12.11,21523140,21629728,106588,-,-
BAC244_D21,13,13q12.11,21561827,21666442,104615,-,-
BAC48_D04,13,13q12.11,21562332,21681746,119414,-,-
BAC77_M02,13,13q12.11,21601858,21704121,102263,-,-
BAC25_H19,13,13q12.11,21799132,21895049,95917,-,-
BAC37_B10,13,13q12.11,21813704,21905758,92054,-,-
BAC161_A12,13,13q12.11,21976414,22055374,78960,-,-
BAC59_G16,13,13q12.11,22000658,22097301,96643,-,-
BAC119_C14,13,13q12.11,22016687,22141897,125210,-,-
BAC195_I11,13,13q12.11,22086023,22180595,94572,-,-
BAC101_D15,13,13q12.11-13q12.12,22180671,22296291,115620,-,-
BAC251_A15,13,13q12.12,22226247,22246626,20379,-,-
BAC61_L16,13,13q12.12,22343689,22416193,72504,-,-
BAC63_I16,13,13q12.12,22383190,22481030,97840,-,-
BAC23_L05,13,13q12.12,22636852,22790259,153407,-,-
BAC78_D05,13,13q12.12,22654250,22739718,85468,-,-
BAC57_A09,13,13q12.12,22654272,22743674,89402,-,-
BAC106_J10,13,13q12.12,22654281,22817435,163154,-,-
BAC29_F13,13,13q12.12,22739723,22810773,71050,-,-
BAC63_D08,13,13q12.12,22743665,22827127,83462,-,-
BAC120_E04,13,13q12.12,22817783,22923684,105901,-,-
BAC48_B17,13,13q12.12,22822281,22936396,114115,-,-
BAC50_G23,13,13q12.12,22882980,22997591,114611,-,-
BAC150_I14,13,13q12.12,22894816,23000713,105897,-,-
BAC152_I14,13,13q12.12,22895592,22991542,95950,-,-
BAC90_I06,13,13q12.12,22896927,22991549,94622,-,-
BAC238_D05,13,13q12.12,22998983,23052875,53892,-,-
BAC170_K02,13,13q12.12,23000732,23123200,122468,-,-
BAC23_M12,13,13q12.12,23079263,23217089,137826,-,-
BAC244_N04,13,13q12.12,23083293,23164804,81511,-,-
BAC97_P05,13,13q12.12,23135045,23252067,117022,-,-
BAC166_C06,13,13q12.12,23210768,23301073,90305,-,-
BAC14_M18,13,13q12.12,23212837,23353871,141034,-,-
BAC49_N17,13,13q12.12,23293405,23417375,123970,-,-
BAC243_O06,13,13q12.12,23320255,23410566,90311,-,-
BAC59_G07,13,13q12.12,23354227,23450409,96182,-,-
BAC46_I19,13,13q12.12,23360766,23503219,142453,-,-
BAC39_H11,13,13q12.12,23482146,23589226,107080,-,-
BAC177_G13,13,13q12.12,23504137,23586314,82177,-,-
BAC171_B19,13,13q12.12,23541649,23617016,75367,-,-
BAC200_I11,13,13q12.12,23668292,23771598,103306,-,-
BAC70_I18,13,13q12.12,23701202,23801739,100537,-,-
BAC158_C19,13,13q12.12,23711246,23837971,126725,-,-
BAC35_O03,13,13q12.12,23763699,23867662,103963,-,-
BAC59_G21,13,13q12.12,23771619,23914753,143134,-,-
BAC240_G24,13,13q12.12,23815887,23892145,76258,-,-
BAC247_L02,13,13q12.12,23867700,23963081,95381,-,-
BAC27_G18,13,13q12.12,23878109,23998990,120881,-,-
BAC169_H21,13,13q12.12,23910931,23999678,88747,-,-
BAC27_M22,13,13q12.12,23920605,24000026,79421,-,-
BAC155_H05,13,13q12.12,23963277,24038021,74744,-,-
BAC118_N07,13,13q12.12,23992871,24121133,128262,-,-
BAC218_G21,13,13q12.12,23996122,24077141,81019,-,-
BAC125_B03,13,13q12.12,23996799,24107345,110546,-,-
BAC54_O05,13,13q12.12,23996800,24140834,144034,-,-
BAC244_O13,13,13q12.12,24059302,24136522,77220,-,-
BAC120_H15,13,13q12.12,24135960,24254487,118527,-,-
BAC137_M24,13,13q12.12,24171806,24254487,82681,-,-
BAC219_D09,13,13q12.12,24215466,24308414,92948,-,-
BAC26_I21,13,13q12.12,24216767,24394507,177740,-,-
BAC107_C11,13,13q12.12,24224539,24318838,94299,-,-
BAC250_C16,13,13q12.12,24235130,24308414,73284,-,-
BAC53_H06,13,13q12.12-13q12.13,24319006,24470212,151206,-,-
BAC127_D13,13,13q12.12-13q12.13,24321607,24422599,100992,-,-
BAC169_K15,13,13q12.13,24425664,24561262,135598,-,-
BAC252_K08,13,13q12.13,24448587,24572502,123915,-,-
BAC128_J03,13,13q12.13,24457425,24556587,99162,-,-
BAC155_F03,13,13q12.13,24472132,24561262,89130,-,-
BAC246_N04,13,13q12.13,24496708,24561262,64554,-,-
BAC244_M13,13,13q12.13,24539789,24625478,85689,-,-
BAC243_E07,13,13q12.13,24572532,24673323,100791,-,-
BAC180_L03,13,13q12.13,24669177,24791429,122252,-,-
BAC235_M03,13,13q12.13,24679779,24741379,61600,-,-
BAC96_A19,13,13q12.13,24679797,24777268,97471,-,-
BAC56_E16,13,13q12.13,24752299,24898523,146224,-,-
BAC220_A10,13,13q12.13,24881718,25007172,125454,-,-
BAC83_P22,13,13q12.13,24882948,24966127,83179,-,-
BAC104_C22,13,13q12.13,24908274,25046738,138464,-,-
BAC214_M07,13,13q12.13,25041768,25115575,73807,-,-
BAC28_H21,13,13q12.13,25143222,25245331,102109,-,-
BAC72_J10,13,13q12.13,25159643,25254542,94899,-,-
BAC8_I07,13,13q12.13,25184824,25280271,95447,-,-
BAC188_G22,13,13q12.13,25206231,25295971,89740,-,-
BAC118_N01,13,13q12.13,25223605,25337974,114369,-,-
BAC96_L11,13,13q12.13,25267723,25349287,81564,-,-
BAC235_C22,13,13q12.13,25313149,25431727,118578,-,-
BAC61_E07,13,13q12.13,25313149,25453821,140672,-,-
BAC169_E09,13,13q12.13,25414578,25513244,98666,-,-
BAC206_O02,13,13q12.13,25421183,25540459,119276,-,-
BAC21_K16,13,13q12.13,25423319,25514520,91201,-,-
BAC53_O09,13,13q12.13,25482970,25585772,102802,-,-
BAC167_O02,13,13q12.13,25506182,25585803,79621,-,-
BAC39_J15,13,13q12.13,25536228,25666038,129810,-,-
BAC237_G18,13,13q12.13,25609303,25708955,99652,-,-
BAC27_H16,13,13q12.13,25624822,25738224,113402,-,-
BAC237_E10,13,13q12.13,25666036,25750720,84684,-,-
BAC230_H16,13,13q12.13,25680606,25807131,126525,-,-
BAC145_H18,13,13q12.13,25681531,25768521,86990,-,-
BAC176_P22,13,13q12.13,25738279,25835638,97359,-,-
BAC172_B09,13,13q12.13,25750717,25854183,103466,-,-
BAC82_L01,13,13q12.13,25750717,25862647,111930,-,-
BAC42_P16,13,13q12.13,25760885,25850492,89607,-,-
BAC218_C07,13,13q12.13,25824535,25890449,65914,-,-
BAC102_O19,13,13q12.13,25904044,26022452,118408,-,-
BAC161_E17,13,13q12.13,25959836,26051732,91896,-,-
BAC238_D09,13,13q12.13,25970084,26064163,94079,-,-
BAC91_O18,13,13q12.13,25994384,26101083,106699,-,-
BAC84_M01,13,13q12.13,26058766,26165009,106243,-,-
BAC27_O22,13,13q12.13,26093865,26199141,105276,-,-
BAC61_P16,13,13q12.13,26104678,26201486,96808,-,-
BAC43_F02,13,13q12.13,26104678,26199129,94451,-,-
BAC175_I11,13,13q12.13,26107424,26199141,91717,-,-
BAC74_K07,13,13q12.13,26159001,26243900,84899,-,-
BAC103_I09,13,13q12.13,26181748,26302053,120305,-,-
BAC22_O04,13,13q12.13,26243898,26338825,94927,-,-
BAC190_J07,13,13q12.13,26302122,26385408,83286,-,-
BAC8_L08,13,13q12.13,26347989,26422110,74121,-,-
BAC28_P08,13,13q12.13,26532017,26605150,73133,-,-
BAC162_P19,13,13q12.13,26548646,26667878,119232,-,-
BAC61_A17,13,13q12.13,26587257,26689096,101839,-,-
BAC224_N08,13,13q12.13,26598105,26696616,98511,-,-
BAC140_P10,13,13q12.13,26599417,26682409,82992,-,-
BAC226_K18,13,13q12.13-13q12.2,26662209,26780302,118093,-,-
BAC99_A01,13,13q12.13-13q12.2,26676670,26814856,138186,-,-
BAC109_G01,13,13q12.13-13q12.2,26682473,26764701,82228,-,-
BAC50_C07,13,13q12.13-13q12.2,26692551,26836904,144353,-,-
BAC140_D10,13,13q12.2,26770355,26890348,119993,-,-
BAC151_A12,13,13q12.2,26771248,26861759,90511,-,-
BAC222_B04,13,13q12.2,26908013,27004976,96963,-,-
BAC153_N11,13,13q12.2,27056851,27148863,92012,-,-
BAC198_E23,13,13q12.2,27104058,27181607,77549,-,-
BAC54_K19,13,13q12.2,27108211,27224361,116150,-,-
BAC31_K15,13,13q12.2,27126490,27244307,117817,-,-
BAC52_O11,13,13q12.2,27128477,27221056,92579,-,-
BAC155_O11,13,13q12.2,27132999,27222226,89227,-,-
BAC242_E14,13,13q12.2,27132999,27221056,88057,-,-
BAC39_C02,13,13q12.2,27133216,27239097,105881,-,-
BAC61_D20,13,13q12.2,27133218,27244312,111094,-,-
BAC195_B16,13,13q12.2,27244304,27343105,98801,-,-
BAC199_F02,13,13q12.2,27301234,27426431,125197,-,-
BAC188_B23,13,13q12.2,27341774,27434836,93062,-,-
BAC125_D16,13,13q12.2,27357055,27448358,91303,-,-
BAC60_F07,13,13q12.2,27357055,27443938,86883,-,-
BAC12_K06,13,13q12.2,27382673,27481077,98404,-,-
BAC175_H12,13,13q12.2,27412424,27513871,101447,-,-
BAC55_N17,13,13q12.2,27412424,27546068,133644,-,-
BAC103_M08,13,13q12.2,27412424,27511297,98873,-,-
BAC96_H15,13,13q12.2,27602365,27682447,80082,-,-
BAC126_M22,13,13q12.2,27609384,27712068,102684,-,-
BAC158_N18,13,13q12.2,27609692,27711501,101809,-,-
BAC234_A04,13,13q12.2-13q12.3,27736698,27820033,83335,-,-
BAC2_C04,13,13q12.3,27952764,28042307,89543,-,-
BAC247_B01,13,13q12.3,28001706,28112837,111131,-,-
BAC84_M10,13,13q12.3,28003166,28092939,89773,-,-
BAC142_B19,13,13q12.3,28003428,28074994,71566,-,-
BAC158_L14,13,13q12.3,28015101,28111396,96295,-,-
BAC27_D24,13,13q12.3,28015103,28128000,112897,-,-
BAC203_O01,13,13q12.3,28015108,28090368,75260,-,-
BAC102_M08,13,13q12.3,28026929,28128000,101071,-,-
BAC61_N12,13,13q12.3,28063066,28164998,101932,-,-
BAC90_C14,13,13q12.3,28128455,28248396,119941,-,-
BAC182_C01,13,13q12.3,28167056,28267937,100881,-,-
BAC246_I04,13,13q12.3,28200905,28289661,88756,-,-
BAC89_M18,13,13q12.3,28200905,28289664,88759,-,-
BAC220_N06,13,13q12.3,28236164,28342696,106532,-,-
BAC79_B22,13,13q12.3,28237334,28267934,30600,-,-
BAC210_C04,13,13q12.3,28237883,28322544,84661,-,-
BAC160_O18,13,13q12.3,28241148,28323205,82057,-,-
BAC84_D20,13,13q12.3,28267933,28435032,167099,-,-
BAC91_L16,13,13q12.3,28322547,28435010,112463,-,-
BAC1_C08,13,13q12.3,28326154,28423046,96892,-,-
BAC241_M09,13,13q12.3,28341949,28435032,93083,-,-
BAC16_M20,13,13q12.3,28342895,28435032,92137,-,-
BAC154_J03,13,13q12.3,28435023,28504902,69879,-,-
BAC150_F09,13,13q12.3,28435023,28575078,140055,-,-
BAC194_O23,13,13q12.3,28435023,28542073,107050,-,-
BAC44_J10,13,13q12.3,28435028,28554780,119752,-,-
BAC203_P02,13,13q12.3,28451364,28511664,60300,-,-
BAC53_J14,13,13q12.3,28571914,28734547,162633,-,-
BAC123_B07,13,13q12.3,28575071,28660865,85794,-,-
BAC101_O18,13,13q12.3,28586215,28666405,80190,-,-
BAC236_D03,13,13q12.3,28594317,28683106,88789,-,-
BAC25_K08,13,13q12.3,28594317,28683101,88784,-,-
BAC103_M05,13,13q12.3,28733972,28845738,111766,-,-
BAC229_C14,13,13q12.3,28818329,28915351,97022,-,-
BAC49_K15,13,13q12.3,28820305,28916269,95964,-,-
BAC82_E20,13,13q12.3,28823437,28908293,84856,-,-
BAC195_G06,13,13q12.3,28832839,28926995,94156,-,-
BAC195_H06,13,13q12.3,28832839,28926982,94143,-,-
BAC217_F17,13,13q12.3,28845793,28915539,69746,-,-
BAC176_G24,13,13q12.3,28911957,28991850,79893,-,-
BAC103_E02,13,13q12.3,28915534,29028929,113395,-,-
BAC65_I20,13,13q12.3,28926989,29104807,177818,-,-
BAC46_L13,13,13q12.3,28927027,29039387,112360,-,-
BAC248_M16,13,13q12.3,28933995,29025687,91692,-,-
BAC33_M03,13,13q12.3,29255532,29414755,159223,-,-
BAC113_I03,13,13q12.3,29255532,29411416,155884,-,-
BAC65_B11,13,13q12.3,29307323,29395118,87795,-,-
BAC45_O14,13,13q12.3,29310179,29404583,94404,-,-
BAC90_A06,13,13q12.3,29310183,29395118,84935,-,-
BAC100_P07,13,13q12.3,29325102,29411426,86324,-,-
BAC234_A19,13,13q12.3,29332636,29431359,98723,-,-
BAC104_C13,13,13q12.3,29395383,29467969,72586,-,-
BAC96_M15,13,13q12.3,29404585,29527277,122692,-,-
BAC147_H07,13,13q12.3,29404588,29490039,85451,-,-
BAC64_L12,13,13q12.3,29414801,29565178,150377,-,-
BAC177_G09,13,13q12.3,29431354,29518268,86914,-,-
BAC56_G13,13,13q12.3,29447961,29533250,85289,-,-
BAC88_P22,13,13q12.3,29526429,29619141,92712,-,-
BAC154_G09,13,13q12.3,29527056,29614694,87638,-,-
BAC217_K04,13,13q12.3,29527271,29621149,93878,-,-
BAC26_F05,13,13q12.3,29527271,29641446,114175,-,-
BAC179_G15,13,13q12.3,29527271,29618136,90865,-,-
BAC65_M02,13,13q12.3,29569600,29689598,119998,-,-
BAC65_O12,13,13q12.3,29704547,29826281,121734,-,-
BAC177_H14,13,13q12.3,29717330,29806781,89451,-,-
BAC104_P23,13,13q12.3,29885498,30012292,126794,-,-
BAC103_G06,13,13q12.3,29905498,30005191,99693,-,-
BAC218_H14,13,13q12.3,29909435,30012292,102857,-,-
BAC233_D23,13,13q12.3,29948756,30045664,96908,-,-
BAC91_D10,13,13q12.3,30027936,30116944,89008,-,-
BAC80_B21,13,13q12.3,30037343,30092592,55249,-,-
BAC37_M08,13,13q12.3,30177177,30250664,73487,-,-
BAC154_I20,13,13q12.3,30402341,30484161,81820,-,-
BAC223_K20,13,13q12.3,30416538,30510546,94008,-,-
BAC160_E05,13,13q12.3,30462858,30544534,81676,-,-
BAC184_E13,13,13q12.3,30501684,30595546,93862,-,-
BAC115_L04,13,13q12.3,30501716,30587682,85966,-,-
BAC167_A24,13,13q12.3,30501796,30586275,84479,-,-
BAC163_F01,13,13q12.3,30534492,30645395,110903,-,-
BAC84_B08,13,13q12.3,30548805,30654707,105902,-,-
BAC11_K04,13,13q12.3,30563392,30701086,137694,-,-
BAC186_L05,13,13q12.3,30579109,30683532,104423,-,-
BAC42_M04,13,13q12.3,30598094,30707497,109403,-,-
BAC41_E19,13,13q12.3,30613651,30710547,96896,-,-
BAC40_F07,13,13q12.3,30676539,30788086,111547,-,-
BAC91_G04,13,13q12.3,30717359,30841271,123912,-,-
BAC235_J07,13,13q12.3,30844488,30924347,79859,-,-
BAC89_I10,13,13q12.3,30850489,30953344,102855,-,-
BAC218_N14,13,13q12.3,30963457,31046433,82976,-,-
BAC175_P07,13,13q12.3,30964953,31070470,105517,-,-
BAC18_H11,13,13q12.3,30990355,31095265,104910,-,-
BAC70_I14,13,13q13.1,31114519,31227026,112507,-,-
BAC231_H09,13,13q13.1,31139668,31254421,114753,-,-
BAC141_N18,13,13q13.1,31172182,31273806,101624,-,-
BAC143_F23,13,13q13.1,31180931,31273855,92924,-,-
BAC248_L19,13,13q13.1,31182372,31257591,75219,-,-
BAC82_J17,13,13q13.1,31273850,31367308,93458,-,-
BAC25_K21,13,13q13.1,31370972,31480457,109485,-,-
BAC40_L10,13,13q13.1,31385226,31498339,113113,-,-
BAC50_I04,13,13q13.1,31425251,31499169,73918,-,-
BAC42_G18,13,13q13.1,31483361,31584374,101013,-,-
BAC157_M18,13,13q13.1,31598553,31708057,109504,-,-
BAC67_K07,13,13q13.1,31598553,31766403,167850,-,-
BAC157_J18,13,13q13.1,31598553,31708087,109534,-,-
BAC182_D19,13,13q13.1,31617249,31731989,114740,-,-
BAC114_L03,13,13q13.1,31726956,31842228,115272,-,-
BAC250_O09,13,13q13.1,31801267,31898656,97389,-,-
BAC244_L12,13,13q13.1,31911374,31996411,85037,-,-
BAC129_D02,13,13q13.1,31943349,32021852,78503,-,-
BAC90_L24,13,13q13.1,31978762,32061397,82635,-,-
BAC238_N07,13,13q13.1,31988870,32061397,72527,-,-
BAC198_O02,13,13q13.1,31994441,32081663,87222,-,-
BAC59_P07,13,13q13.1,32216576,32398726,182150,-,-
BAC160_C09,13,13q13.1,32249581,32332926,83345,-,-
BAC54_O17,13,13q13.1,32296629,32425514,128885,-,-
BAC175_N14,13,13q13.1,32374413,32486503,112090,-,-
BAC150_D12,13,13q13.1,32374415,32465508,91093,-,-
BAC235_B14,13,13q13.1,32385683,32479980,94297,-,-
BAC65_E23,13,13q13.1,32391785,32479978,88193,-,-
BAC5_P22,13,13q13.1,32471103,32647918,176815,-,-
BAC226_J03,13,13q13.1,32480241,32599439,119198,-,-
BAC67_P22,13,13q13.1,32480257,32572091,91834,-,-
BAC59_D20,13,13q13.1,32505450,32635666,130216,-,-
BAC197_B16,13,13q13.1,32508587,32606536,97949,-,-
BAC36_J04,13,13q13.1,32519002,32599145,80143,-,-
BAC237_D04,13,13q13.1,32541528,32635668,94140,-,-
BAC197_H09,13,13q13.1,32579222,32658750,79528,-,-
BAC42_P04,13,13q13.1,32579234,32663309,84075,-,-
BAC113_E03,13,13q13.1,32586981,32685941,98960,-,-
BAC57_P01,13,13q13.1,32606529,32701744,95215,-,-
BAC170_D07,13,13q13.1,32636004,32718229,82225,-,-
BAC134_P21,13,13q13.1,32665895,32763578,97683,-,-
BAC42_C01,13,13q13.1,32680532,32805128,124596,-,-
BAC39_G02,13,13q13.1-13q13.2,32819564,32913864,94300,-,-
BAC226_K19,13,13q13.2,33058885,33160826,101941,-,-
BAC186_J02,13,13q13.2,33059736,33150759,91023,-,-
BAC120_G21,13,13q13.2,33085770,33224973,139203,-,-
BAC223_D09,13,13q13.2,33118189,33209088,90899,-,-
BAC88_N10,13,13q13.2,33118189,33218350,100161,-,-
BAC101_G14,13,13q13.2,33128545,33264267,135722,-,-
BAC235_M13,13,13q13.2,33137867,33231965,94098,-,-
BAC159_F06,13,13q13.2,33361345,33436554,75209,-,-
BAC29_D09,13,13q13.2,33450334,33550059,99725,-,-
BAC117_P14,13,13q13.2,33473090,33621057,147967,-,-
BAC53_C11,13,13q13.2,33494041,33586455,92414,-,-
BAC173_K13,13,13q13.2,33494044,33575353,81309,-,-
BAC188_J16,13,13q13.2,33502627,33584791,82164,-,-
BAC235_G16,13,13q13.2,33537087,33652630,115543,-,-
BAC244_H01,13,13q13.2,33584782,33665623,80841,-,-
BAC97_L14,13,13q13.2,33798450,33918501,120051,-,-
BAC49_M13,13,13q13.2,33862941,33962710,99769,-,-
BAC248_D23,13,13q13.2,33866933,33950561,83628,-,-
BAC151_G17,13,13q13.2,33867265,33962789,95524,-,-
BAC67_M04,13,13q13.2,33961772,34061089,99317,-,-
BAC65_F09,13,13q13.2,34043116,34139027,95911,-,-
BAC206_A24,13,13q13.2,34172258,34274138,101880,-,-
BAC66_A22,13,13q13.2,34225266,34312738,87472,-,-
BAC86_K12,13,13q13.2,34300550,34418496,117946,-,-
BAC73_B14,13,13q13.2,34320892,34400436,79544,-,-
BAC119_B10,13,13q13.2,34429413,34544112,114699,-,-
BAC85_B17,13,13q13.2,34521330,34601665,80335,-,-
BAC14_K08,13,13q13.3,34875358,35017111,141753,-,-
BAC248_J17,13,13q13.3,35015164,35111670,96506,-,-
BAC113_M07,13,13q13.3,35139940,35214896,74956,-,-
BAC71_N08,13,13q13.3,35172248,35275301,103053,-,-
BAC196_K04,13,13q13.3,35216702,35299359,82657,-,-
BAC2_A23,13,13q13.3,35306866,35426816,119950,-,-
BAC151_H21,13,13q13.3,35324548,35422906,98358,-,-
BAC233_I07,13,13q13.3,35517586,35587311,69725,-,-
BAC126_K19,13,13q13.3,35648435,35779771,131336,-,-
BAC147_I20,13,13q13.3,35753635,35848398,94763,-,-
BAC193_N05,13,13q13.3,35757287,35848398,91111,-,-
BAC38_G22,13,13q13.3,35766619,35851478,84859,-,-
BAC218_J23,13,13q13.3,35777925,35873151,95226,-,-
BAC103_A06,13,13q13.3,36039311,36143423,104112,-,-
BAC65_K01,13,13q13.3,36130095,36179271,49176,-,-
BAC121_D20,13,13q13.3,36143415,36242747,99332,-,-
BAC224_M01,13,13q13.3,36153721,36230419,76698,-,-
BAC234_I10,13,13q13.3,36179316,36283057,103741,-,-
BAC145_N13,13,13q13.3,36245887,36338878,92991,-,-
BAC191_N22,13,13q13.3,36296260,36398742,102482,-,-
BAC168_C24,13,13q13.3,36307519,36398429,90910,-,-
BAC56_G05,13,13q13.3,36321436,36420643,99207,-,-
BAC40_N21,13,13q13.3,36330069,36514156,184087,-,-
BAC96_C22,13,13q13.3,36335916,36424827,88911,-,-
BAC143_G05,13,13q13.3,36338873,36420643,81770,-,-
BAC104_C24,13,13q13.3,36511054,36608152,97098,-,-
BAC114_N07,13,13q13.3,36520737,36608169,87432,-,-
BAC42_H13,13,13q13.3,36523617,36654722,131105,-,-
BAC218_H12,13,13q13.3,36544178,36608188,64010,-,-
BAC197_M22,13,13q13.3,36661142,36747053,85911,-,-
BAC219_B01,13,13q13.3,36684071,36803630,119559,-,-
BAC224_N21,13,13q13.3,36739048,36814374,75326,-,-
BAC55_B06,13,13q13.3,36774840,36875940,101100,-,-
BAC18_M02,13,13q13.3,36796628,36910672,114044,-,-
BAC134_P10,13,13q13.3,36854593,36960579,105986,-,-
BAC45_M08,13,13q13.3,37237533,37392221,154688,-,-
BAC172_A04,13,13q13.3,37341552,37435099,93547,-,-
BAC133_I14,13,13q13.3,37357816,37435133,77317,-,-
BAC113_K03,13,13q13.3,37358021,37445796,87775,-,-
BAC6_P03,13,13q13.3,37571019,37650824,79805,-,-
BAC139_A23,13,13q13.3,37854061,37920780,66719,-,-
BAC142_M12,13,13q13.3,37894589,37972216,77627,-,-
BAC129_L18,13,13q13.3,38209426,38298384,88958,-,-
BAC161_I03,13,13q13.3,38299714,38411844,112130,-,-
BAC40_J21,13,13q13.3,38299714,38386446,86732,-,-
BAC186_M11,13,13q13.3,38441358,38525751,84393,-,-
BAC24_F09,13,13q13.3,38447512,38547508,99996,-,-
BAC21_L12,13,13q13.3,38479416,38605121,125705,-,-
BAC166_A21,13,13q13.3,38516828,38588027,71199,-,-
BAC58_B03,13,13q13.3,38682008,38792457,110449,-,-
BAC80_A02,13,13q13.3,38908187,39024893,116706,-,-
BAC200_K12,13,13q13.3,38910873,39009776,98903,-,-
BAC202_I04,13,13q13.3,38947199,39042163,94964,-,-
BAC178_I06,13,13q13.3,38962846,39044302,81456,-,-
BAC88_K22,13,13q13.3,38973951,39063693,89742,-,-
BAC170_K04,13,13q13.3,39009796,39107246,97450,-,-
BAC41_N14,13,13q13.3,39018220,39139402,121182,-,-
BAC151_L07,13,13q13.3,39051949,39140148,88199,-,-
BAC252_J23,13,13q13.3,39052004,39137280,85276,-,-
BAC144_J10,13,13q13.3,39112856,39199089,86233,-,-
BAC189_P13,13,13q13.3,39156067,39235616,79549,-,-
BAC12_C05,13,13q13.3,39272965,39433248,160283,-,-
BAC238_C21,13,13q13.3,39287642,39378353,90711,-,-
BAC196_I17,13,13q13.3,39388636,39473508,84872,-,-
BAC192_M08,13,13q13.3-13q14.11,39457967,39568324,110357,-,-
BAC248_O14,13,13q14.11,39526228,39653411,127183,-,-
BAC83_B08,13,13q14.11,39616737,39718554,101817,-,-
BAC238_E08,13,13q14.11,39733612,39814082,80470,-,-
BAC74_H16,13,13q14.11,39811887,39911341,99454,-,-
BAC123_M03,13,13q14.11,39838485,39942221,103736,-,-
BAC67_M06,13,13q14.11,39871202,39981417,110215,-,-
BAC184_A21,13,13q14.11,39925708,40042446,116738,-,-
BAC232_L06,13,13q14.11,39938537,40037394,98857,-,-
BAC140_M04,13,13q14.11,40031706,40107491,75785,-,-
BAC224_O21,13,13q14.11,40157660,40232684,75024,-,-
BAC161_N04,13,13q14.11,40157663,40237423,79760,-,-
BAC78_E18,13,13q14.11,40245235,40349203,103968,-,-
BAC130_O11,13,13q14.11,40269979,40369046,99067,-,-
BAC19_M01,13,13q14.11,40397059,40519020,121961,-,-
BAC186_C04,13,13q14.11,40417473,40492121,74648,-,-
BAC44_P09,13,13q14.11,40420593,40475284,54691,-,-
BAC29_O05,13,13q14.11,40422715,40519142,96427,-,-
BAC179_I09,13,13q14.11,40481950,40568592,86642,-,-
BAC86_P02,13,13q14.11,40492113,40599811,107698,-,-
BAC64_F04,13,13q14.11,40502235,40629496,127261,-,-
BAC116_K10,13,13q14.11,40519217,40665836,146619,-,-
BAC72_O10,13,13q14.11,40526414,40608965,82551,-,-
BAC46_H03,13,13q14.11,40536510,40648701,112191,-,-
BAC192_B03,13,13q14.11,40570181,40658688,88507,-,-
BAC100_B01,13,13q14.11,40624079,40722483,98404,-,-
BAC243_G18,13,13q14.11,40657180,40743190,86010,yes,-
BAC70_E20,13,13q14.11,40669446,40773522,104076,-,-
BAC28_D10,13,13q14.11,40671721,40790761,119040,yes,-
BAC90_F03,13,13q14.11,40749719,40832761,83042,-,-
BAC89_J14,13,13q14.11,40787426,40941400,153974,-,-
BAC144_N07,13,13q14.11,40866970,40941400,74430,-,-
BAC27_J20,13,13q14.11,40890924,41014000,123076,-,-
BAC175_L07,13,13q14.11,40977655,41051609,73954,-,-
BAC150_B24,13,13q14.11,40979068,41088984,109916,-,-
BAC220_D06,13,13q14.11,41048467,41122721,74254,-,-
BAC125_P04,13,13q14.11,41073345,41146890,73545,-,-
BAC61_M17,13,13q14.11,41088976,41178796,89820,-,-
BAC136_F23,13,13q14.11,41233635,41324677,91042,-,-
BAC108_F11,13,13q14.11,41238819,41335411,96592,-,-
BAC39_M22,13,13q14.11,41256333,41362103,105770,-,-
BAC148_N11,13,13q14.11,41399051,41475947,76896,-,-
BAC19_I22,13,13q14.11,41454217,41601360,147143,-,-
BAC197_F08,13,13q14.11,41498286,41601361,103075,-,-
BAC188_K24,13,13q14.11,41503115,41597568,94453,-,-
BAC160_G08,13,13q14.11,41601355,41672353,70998,-,-
BAC151_C09,13,13q14.11,41601365,41693716,92351,-,-
BAC117_J13,13,13q14.11,41612379,41693748,81369,-,-
BAC186_C20,13,13q14.11,41743536,41825249,81713,-,-
BAC131_L13,13,13q14.11,41775634,41848381,72747,-,-
BAC84_K07,13,13q14.11,41830000,41965921,135921,-,-
BAC230_C07,13,13q14.11,41845334,41927528,82194,-,-
BAC17_P13,13,13q14.11,41861162,41965921,104759,-,-
BAC156_I20,13,13q14.11,41881808,41965921,84113,-,-
BAC148_I15,13,13q14.11,42003305,42081583,78278,-,-
BAC26_I05,13,13q14.11,42003316,42135878,132562,-,-
BAC97_D12,13,13q14.11,42054970,42194407,139437,-,-
BAC49_O03,13,13q14.11,42073091,42179383,106292,-,-
BAC124_N01,13,13q14.11,42077823,42201039,123216,-,-
BAC119_M11,13,13q14.11,42081588,42196487,114899,-,-
BAC37_N08,13,13q14.11,42352699,42466938,114239,-,-
BAC41_F22,13,13q14.11,42455064,42556949,101885,-,-
BAC189_F20,13,13q14.11,42472199,42550869,78670,-,-
BAC77_F04,13,13q14.11,42543943,42660928,116985,-,-
BAC128_J05,13,13q14.11,42551027,42634235,83208,-,-
BAC37_A18,13,13q14.11,42649209,42751489,102280,-,-
BAC161_N18,13,13q14.11,42671454,42751489,80035,-,-
BAC35_E17,13,13q14.11,42703189,42798487,95298,-,-
BAC195_F09,13,13q14.11,42706219,42859000,152781,-,-
BAC177_A24,13,13q14.11,42706219,42772072,65853,-,-
BAC73_L22,13,13q14.11,42714675,42792824,78149,-,-
BAC204_L11,13,13q14.11,42714964,42804900,89936,-,-
BAC136_N09,13,13q14.11,42936294,43041200,104906,-,-
BAC106_L21,13,13q14.11,42955613,43077966,122353,-,-
BAC31_O09,13,13q14.11,42957636,43094173,136537,-,-
BAC102_J14,13,13q14.11,42966474,43048474,82000,-,-
BAC67_O17,13,13q14.11,42972314,43053685,81371,-,-
BAC198_G18,13,13q14.11,42983406,43081882,98476,-,-
BAC63_B06,13,13q14.11,42988467,43081880,93413,-,-
BAC167_G10,13,13q14.11,43041219,43129111,87892,-,-
BAC154_E08,13,13q14.11,43116678,43204231,87553,-,-
BAC48_K17,13,13q14.11,43442404,43519394,76990,-,-
BAC214_E05,13,13q14.11,43472958,43557614,84656,-,-
BAC34_P04,13,13q14.11,43507164,43628718,121554,-,-
BAC55_I23,13,13q14.11,43507164,43628722,121558,-,-
BAC162_N10,13,13q14.11,43507182,43645544,138362,-,-
BAC226_B12,13,13q14.11,43516684,43616532,99848,-,-
BAC140_D13,13,13q14.11,43662215,43773933,111718,-,-
BAC50_J11,13,13q14.11,43667549,43773924,106375,-,-
BAC180_H05,13,13q14.11,43739925,43850998,111073,-,-
BAC147_I15,13,13q14.11,43793561,43896747,103186,-,-
BAC88_E02,13,13q14.11,43806488,43897723,91235,-,-
BAC25_M10,13,13q14.11,43840591,43935442,94851,-,-
BAC27_E06,13,13q14.11,43907390,44008093,100703,-,-
BAC233_O20,13,13q14.11,43935489,44025065,89576,-,-
BAC32_N08,13,13q14.11,43935529,44030543,95014,-,-
BAC104_J02,13,13q14.11,43980610,44123574,142964,-,-
BAC82_O19,13,13q14.11,44027271,44134936,107665,-,-
BAC40_O03,13,13q14.11,44027941,44113860,85919,-,-
BAC101_F16,13,13q14.11,44030537,44134936,104399,-,-
BAC233_A22,13,13q14.11,44038957,44134936,95979,-,-
BAC125_M03,13,13q14.11,44051377,44139925,88548,-,-
BAC119_B24,13,13q14.11,44076281,44222075,145794,-,-
BAC64_P19,13,13q14.11,44160475,44248445,87970,-,-
BAC80_F19,13,13q14.11-13q14.12,44208744,44382611,173867,-,-
BAC176_B09,13,13q14.11-13q14.12,44223761,44345491,121730,-,-
BAC68_K08,13,13q14.11-13q14.12,44223785,44323916,100131,-,-
BAC37_I17,13,13q14.11-13q14.12,44242649,44349380,106731,-,-
BAC153_B04,13,13q14.11-13q14.12,44282124,44385662,103538,-,-
BAC132_F19,13,13q14.11-13q14.12,44282124,44363574,81450,-,-
BAC212_C17,13,13q14.12,44316756,44397492,80736,-,-
BAC100_P04,13,13q14.12,44425333,44512379,87046,-,-
BAC236_C21,13,13q14.12,44452776,44533576,80800,-,-
BAC228_P21,13,13q14.12,44506684,44594080,87396,-,-
BAC143_H01,13,13q14.12,44512371,44588591,76220,-,-
BAC42_F10,13,13q14.12,44539976,44653929,113953,-,-
BAC249_B16,13,13q14.12,44581352,44665355,84003,-,-
BAC61_I08,13,13q14.12,44586566,44694788,108222,-,-
BAC176_I21,13,13q14.12,44604597,44683038,78441,-,-
BAC172_D19,13,13q14.12,44735746,44829385,93639,-,-
BAC63_E07,13,13q14.12,44777610,44865835,88225,-,-
BAC197_D17,13,13q14.12,44989761,45062254,72493,-,-
BAC105_L10,13,13q14.12,44990154,45088179,98025,-,-
BAC101_E02,13,13q14.12,44990154,45088189,98035,-,-
BAC44_P02,13,13q14.12,44991467,45115463,123996,-,-
BAC122_H01,13,13q14.12,45062248,45148322,86074,-,-
BAC218_C12,13,13q14.12,45220263,45345026,124763,-,-
BAC140_C10,13,13q14.12,45239073,45343959,104886,-,-
BAC128_C02,13,13q14.12,45282119,45459675,177556,-,-
BAC43_D22,13,13q14.12,45282175,45382371,100196,-,-
BAC39_D21,13,13q14.12,45344305,45437079,92774,-,-
BAC176_A17,13,13q14.12,45383944,45462096,78152,-,-
BAC67_P24,13,13q14.12,45409562,45503362,93800,-,-
BAC126_I04,13,13q14.12,45409567,45503362,93795,-,-
BAC31_L06,13,13q14.12,45444831,45546160,101329,-,-
BAC55_A01,13,13q14.12,45566446,45640145,73699,-,-
BAC151_O15,13,13q14.12,45590038,45692603,102565,-,-
BAC168_A11,13,13q14.12,45692802,45786331,93529,-,-
BAC41_L10,13,13q14.12-13q14.13,45740876,45902612,161736,-,-
BAC66_N06,13,13q14.12,45751258,45838847,87589,-,-
BAC176_I15,13,13q14.12,45782446,45870694,88248,-,-
BAC248_L13,13,13q14.12-13q14.13,45815149,45902607,87458,-,-
BAC250_J23,13,13q14.12-13q14.13,45826996,45903765,76769,-,-
BAC50_M14,13,13q14.12-13q14.13,45885205,45981170,95965,-,-
BAC59_N03,13,13q14.13,45920907,46018790,97883,-,-
BAC148_J14,13,13q14.13,45993340,46081509,88169,-,-
BAC70_P13,13,13q14.13-13q14.2,46103214,46246837,143623,-,-
BAC241_F01,13,13q14.13,46115985,46197636,81651,-,-
BAC156_A24,13,13q14.2,46363782,46504460,140678,-,-
BAC163_H14,13,13q14.2,46372567,46453311,80744,-,-
BAC187_O20,13,13q14.2,46386235,46469530,83295,-,-
BAC241_H21,13,13q14.2,46605268,46726059,120791,-,-
BAC42_C22,13,13q14.2,46731944,46841592,109648,-,-
BAC196_I10,13,13q14.2,46899689,47043023,143334,-,-
BAC113_K12,13,13q14.2,46925650,47020328,94678,-,-
BAC244_O08,13,13q14.2,46968092,47068318,100226,-,-
BAC109_M18,13,13q14.2,47016071,47095423,79352,-,-
BAC139_D21,13,13q14.2,47064371,47179862,115491,-,-
BAC175_N13,13,13q14.2,47073428,47172220,98792,-,-
BAC67_C04,13,13q14.2,47181495,47315315,133820,-,-
BAC177_A19,13,13q14.2,47208261,47298863,90602,-,-
BAC37_G05,13,13q14.2,47330782,47434987,104205,-,-
BAC235_C07,13,13q14.2,47440804,47515782,74978,-,-
BAC55_M22,13,13q14.2,47469008,47590434,121426,-,-
BAC104_L04,13,13q14.2,47469972,47561183,91211,-,-
BAC89_E11,13,13q14.2,47493177,47601243,108066,-,-
BAC109_H21,13,13q14.2,47570683,47709095,138412,-,-
BAC10_F09,13,13q14.2,47613135,47720844,107709,-,-
BAC132_B10,13,13q14.2,47620868,47691528,70660,-,-
BAC48_F12,13,13q14.2,47708963,47784155,75192,-,-
BAC180_M19,13,13q14.2,47726224,47811470,85246,-,-
BAC92_M09,13,13q14.2,47734514,47835693,101179,-,-
BAC30_N05,13,13q14.2,47738418,47870290,131872,-,-
BAC64_J16,13,13q14.2,47742100,47835693,93593,-,-
BAC181_L23,13,13q14.2,47742214,47877005,134791,-,-
BAC50_G14,13,13q14.2,47765694,47889354,123660,-,-
BAC126_N17,13,13q14.2,47765694,47865362,99668,-,-
BAC39_J11,13,13q14.2,47919787,48016299,96512,-,-
BAC132_G23,13,13q14.2,48069658,48163194,93536,-,-
BAC78_G09,13,13q14.2,48163667,48265381,101714,-,-
BAC158_M10,13,13q14.2,48181253,48265369,84116,-,-
BAC25_J03,13,13q14.2,48192741,48307741,115000,-,-
BAC150_K24,13,13q14.2,48390119,48472315,82196,-,-
BAC31_J12,13,13q14.2,48460997,48590801,129804,-,-
BAC170_J17,13,13q14.2,48494882,48590798,95916,-,-
BAC19_J05,13,13q14.2,48501697,48611016,109319,-,-
BAC195_H02,13,13q14.2,48539695,48634505,94810,-,-
BAC72_P01,13,13q14.2,48554121,48656817,102696,-,-
BAC180_O21,13,13q14.2,48609908,48720040,110132,-,-
BAC116_P23,13,13q14.2,48674022,48768448,94426,-,-
BAC196_J17,13,13q14.2,48720032,48822560,102528,-,-
BAC116_F20,13,13q14.2,48722691,48846871,124180,-,-
BAC221_N17,13,13q14.2,48785635,48897296,111661,-,-
BAC148_A01,13,13q14.2-13q14.3,48830281,48935635,105354,-,-
BAC145_F10,13,13q14.2-13q14.3,48846883,48927351,80468,-,-
BAC168_D08,13,13q14.3,48906025,49018043,112018,-,-
BAC8_N17,13,13q14.3,48910170,48999023,88853,-,-
BAC24_M24,13,13q14.3,48910333,49017765,107432,-,-
BAC226_B06,13,13q14.3,48920899,49014901,94002,-,-
BAC90_A07,13,13q14.3,48927345,49014901,87556,-,-
BAC109_F12,13,13q14.3,49013729,49114242,100513,-,-
BAC5_L03,13,13q14.3,49038693,49133947,95254,-,-
BAC246_C03,13,13q14.3,49056406,49154783,98377,-,-
BAC18_E16,13,13q14.3,49154776,49252317,97541,-,-
BAC136_F05,13,13q14.3,49278869,49366209,87340,-,-
BAC64_L11,13,13q14.3,49287023,49390102,103079,-,-
BAC18_A02,13,13q14.3,49290241,49392387,102146,-,-
BAC193_E13,13,13q14.3,49299941,49401445,101504,-,-
BAC191_J20,13,13q14.3,49370084,49449475,79391,-,-
BAC235_D20,13,13q14.3,49390215,49504346,114131,-,-
BAC30_I11,13,13q14.3,49413979,49501470,87491,-,-
BAC66_B10,13,13q14.3,49506469,49628580,122111,-,-
BAC90_O23,13,13q14.3,49827820,49925102,97282,-,-
BAC252_H14,13,13q14.3,49827820,49951238,123418,-,-
BAC236_J01,13,13q14.3,49865774,49935821,70047,-,-
BAC83_P05,13,13q14.3,49892219,49993950,101731,-,-
BAC92_J05,13,13q14.3,49898386,50016161,117775,-,-
BAC168_O05,13,13q14.3,49944150,50053790,109640,-,-
BAC78_E20,13,13q14.3,50001856,50097013,95157,-,-
BAC42_J11,13,13q14.3,50012124,50111664,99540,-,-
BAC17_P11,13,13q14.3,50016172,50137501,121329,-,-
BAC27_O11,13,13q14.3,50061285,50172961,111676,-,-
BAC202_F06,13,13q14.3,50272932,50367301,94369,-,-
BAC248_L14,13,13q14.3,50370205,50484178,113973,-,-
BAC134_A08,13,13q14.3,50506617,50600393,93776,-,-
BAC186_I05,13,13q14.3,50516636,50604566,87930,-,-
BAC50_H16,13,13q14.3,50559008,50655898,96890,-,-
BAC39_I18,13,13q14.3,50656209,50735033,78824,-,-
BAC16_C15,13,13q14.3,50670178,50774935,104757,-,-
BAC22_L20,13,13q14.3,50673123,50789451,116328,-,-
BAC127_N14,13,13q14.3,50740111,50878590,138479,-,-
BAC159_A10,13,13q14.3,50758722,50872554,113832,-,-
BAC55_M10,13,13q14.3,50785709,51002192,216483,-,-
BAC12_A01,13,13q14.3,50785709,50915526,129817,-,-
BAC161_I22,13,13q14.3,50797345,50882343,84998,-,-
BAC227_L15,13,13q14.3,50815486,50903311,87825,-,-
BAC238_E03,13,13q14.3,50915870,51022715,106845,-,-
BAC86_P10,13,13q14.3,50918131,51042937,124806,-,-
BAC26_G16,13,13q14.3,50970822,51098301,127479,-,-
BAC119_H10,13,13q14.3,51002265,51098301,96036,-,-
BAC182_A05,13,13q14.3,51068692,51164704,96012,-,-
BAC235_E07,13,13q14.3,51111367,51233418,122051,-,-
BAC158_O07,13,13q14.3,51122922,51211964,89042,-,-
BAC78_C21,13,13q14.3,51185202,51293792,108590,yes,-
BAC120_L22,13,13q14.3,51199143,51337340,138197,yes,-
BAC167_D22,13,13q14.3,51211979,51306215,94236,yes,-
BAC184_A09,13,13q14.3,51213444,51306214,92770,yes,-
BAC173_J13,13,13q14.3,51213445,51357189,143744,yes,-
BAC187_M01,13,13q14.3,51230459,51313943,83484,yes,-
BAC199_J04,13,13q14.3,51230710,51306214,75504,yes,-
BAC102_E11,13,13q14.3,51246027,51354507,108480,-,-
BAC142_P11,13,13q14.3,51260525,51342523,81998,-,-
BAC26_D08,13,13q14.3,51364049,51455329,91280,-,-
BAC233_O17,13,13q14.3,51365975,51450995,85020,-,-
BAC252_J05,13,13q14.3,51365975,51467869,101894,-,-
BAC244_E07,13,13q14.3,51455366,51560065,104699,-,-
BAC54_M09,13,13q14.3,51475353,51548379,73026,-,-
BAC237_I12,13,13q14.3,51500515,51588670,88155,-,-
BAC39_F02,13,13q14.3,51565183,51682632,117449,-,-
BAC43_E07,13,13q14.3,51571077,51688496,117419,-,-
BAC193_P06,13,13q14.3,51604630,51683087,78457,-,-
BAC165_H07,13,13q14.3,51615643,51717405,101762,-,-
BAC182_O09,13,13q14.3,51640241,51723090,82849,-,-
BAC92_I16,13,13q14.3,51693463,51795593,102130,-,-
BAC46_G12,13,13q14.3,51709641,51813551,103910,-,-
BAC170_N17,13,13q14.3,51724428,51835585,111157,-,-
BAC43_M05,13,13q14.3,51795627,51886307,90680,-,-
BAC218_C23,13,13q14.3,51813561,51925067,111506,-,-
BAC161_J14,13,13q14.3,51825741,51888061,62320,-,-
BAC120_E09,13,13q14.3,51928368,52033003,104635,-,-
BAC179_E09,13,13q14.3,51950883,52055316,104433,-,-
BAC168_E05,13,13q14.3,51956282,52055316,99034,-,-
BAC119_J18,13,13q14.3,51956298,52058160,101862,-,-
BAC71_K15,13,13q14.3,52055623,52189820,134197,-,-
BAC5_L01,13,13q14.3-13q21.1,52122009,52238447,116438,-,-
BAC33_L24,13,13q14.3-13q21.1,52139137,52239216,100079,-,-
BAC29_C16,13,13q21.1,52214679,52321497,106818,-,-
BAC237_K24,13,13q21.1,52224945,52353410,128465,-,-
BAC239_D13,13,13q21.1,52265386,52412364,146978,-,-
BAC150_B15,13,13q21.1,52333974,52446308,112334,-,-
BAC147_F03,13,13q21.1,52336873,52422315,85442,-,-
BAC91_J06,13,13q21.1,52343067,52446308,103241,-,-
BAC57_G24,13,13q21.1,52402855,52490248,87393,-,-
BAC4_D12,13,13q21.1,52453805,52538329,84524,-,-
BAC121_M19,13,13q21.1,52462534,52597807,135273,-,-
BAC108_D11,13,13q21.1,52470078,52597807,127729,-,-
BAC148_E18,13,13q21.1,52529979,52641974,111995,-,-
BAC60_K16,13,13q21.1,52541031,52684192,143161,-,-
BAC248_F08,13,13q21.1,52541854,52647712,105858,-,-
BAC228_M14,13,13q21.1,52597989,52696289,98300,-,-
BAC105_P17,13,13q21.1,53040144,53158790,118646,-,-
BAC32_F24,13,13q21.1,53331056,53454274,123218,-,-
BAC149_L20,13,13q21.1,53439021,53527652,88631,-,-
BAC100_M20,13,13q21.1,53468497,53617675,149178,-,-
BAC213_K04,13,13q21.1,53597666,53692252,94586,-,-
BAC226_K08,13,13q21.1,53727703,53840170,112467,-,-
BAC53_K12,13,13q21.1,53742364,53876506,134142,-,-
BAC82_L02,13,13q21.1,53789112,53922165,133053,-,-
BAC43_I19,13,13q21.1,53806418,53897463,91045,-,-
BAC145_H02,13,13q21.1,53875780,53980144,104364,-,-
BAC247_I01,13,13q21.1,53876643,53963085,86442,-,-
BAC175_N19,13,13q21.1,53938114,54040224,102110,-,-
BAC29_G22,13,13q21.1,53938127,54016687,78560,-,-
BAC231_B11,13,13q21.1,53945571,54040197,94626,-,-
BAC106_M14,13,13q21.1,54057791,54151805,94014,-,-
BAC77_O01,13,13q21.1,54151800,54243610,91810,-,-
BAC137_H17,13,13q21.1,54195694,54290060,94366,-,-
BAC104_I23,13,13q21.1,54293219,54384274,91055,-,-
BAC194_I13,13,13q21.1,54337550,54438544,100994,-,-
BAC17_C03,13,13q21.1,54413815,54561647,147832,-,-
BAC91_J02,13,13q21.1,54507102,54551019,43917,-,-
BAC103_G11,13,13q21.1,54825772,54947350,121578,-,-
BAC63_A16,13,13q21.1,54851397,54961321,109924,-,-
BAC102_N10,13,13q21.1,54994283,55085948,91665,-,-
BAC55_F09,13,13q21.1,55025184,55117448,92264,-,-
BAC50_K10,13,13q21.1,55032918,55129474,96556,-,-
BAC155_P02,13,13q21.1,55421676,55507184,85508,-,-
BAC233_E13,13,13q21.1,55498965,55595499,96534,-,-
BAC184_F13,13,13q21.1,55571434,55665493,94059,-,-
BAC84_J17,13,13q21.1,55695174,55790057,94883,-,-
BAC219_C17,13,13q21.1,55905149,55980320,75171,-,-
BAC55_K11,13,13q21.1,55987332,56096286,108954,-,-
BAC102_A18,13,13q21.1,56047987,56138211,90224,-,-
BAC78_I01,13,13q21.1,56210079,56325736,115657,-,-
BAC217_P08,13,13q21.1,56251154,56341485,90331,-,-
BAC40_N19,13,13q21.1,56284830,56390974,106144,-,-
BAC157_G18,13,13q21.1,56432519,56527023,94504,-,-
BAC157_H18,13,13q21.1,56432523,56527023,94500,-,-
BAC189_C22,13,13q21.1,57245848,57336120,90272,-,-
BAC132_N04,13,13q21.1,57251026,57337636,86610,-,-
BAC241_F12,13,13q21.1,57531799,57591752,59953,-,-
BAC120_M09,13,13q21.2,57602584,57698677,96093,-,-
BAC21_O19,13,13q21.2,57698672,57789593,90921,-,-
BAC64_M10,13,13q21.2,57785697,57915558,129861,-,-
BAC68_M02,13,13q21.2,57905783,58033259,127476,-,-
BAC1_M02,13,13q21.2,57915553,58064451,148898,-,-
BAC33_D08,13,13q21.2,58127324,58255188,127864,-,-
BAC146_M10,13,13q21.2,58138875,58281635,142760,-,-
BAC177_M19,13,13q21.2,58179881,58267537,87656,-,-
BAC72_J04,13,13q21.2,58276381,58382586,106205,-,-
BAC243_N20,13,13q21.2,58286755,58372499,85744,-,-
BAC21_P14,13,13q21.2,58353353,58452367,99014,-,-
BAC149_F14,13,13q21.2,58456339,58542780,86441,-,-
BAC249_H07,13,13q21.2,58462171,58554309,92138,-,-
BAC118_J13,13,13q21.2,58479765,58567808,88043,-,-
BAC199_D04,13,13q21.2,58515341,58599770,84429,-,-
BAC57_H17,13,13q21.2,58523205,58647489,124284,-,-
BAC169_G03,13,13q21.2,58595776,58676438,80662,-,-
BAC86_E10,13,13q21.2,58682624,58830277,147653,-,-
BAC217_D12,13,13q21.2,58758100,58850036,91936,-,-
BAC241_P08,13,13q21.2,58764134,58850034,85900,-,-
BAC63_I22,13,13q21.2,58807910,58935613,127703,-,-
BAC19_K08,13,13q21.2,58870617,58967970,97353,-,-
BAC43_F01,13,13q21.2,59165908,59248093,82185,-,-
BAC2_C06,13,13q21.2,59216668,59309254,92586,-,-
BAC220_F02,13,13q21.2,59378984,59484744,105760,-,-
BAC73_P13,13,13q21.2,59470085,59596268,126183,-,-
BAC236_K04,13,13q21.2,59470517,59615360,144843,-,-
BAC68_H08,13,13q21.2,59472101,59573567,101466,-,-
BAC114_H15,13,13q21.2,59480762,59568884,88122,-,-
BAC12_L07,13,13q21.2,59573802,59672807,99005,-,-
BAC175_P02,13,13q21.2,59580850,59669638,88788,-,-
BAC157_O24,13,13q21.2,59701237,59806294,105057,-,-
BAC157_L24,13,13q21.2,59701237,59806286,105049,-,-
BAC148_O23,13,13q21.2,59933726,60031561,97835,-,-
BAC50_N18,13,13q21.2,60112198,60195356,83158,-,-
BAC159_G03,13,13q21.2,60195234,60298494,103260,-,-
BAC162_M08,13,13q21.2,60207589,60309197,101608,-,-
BAC61_B22,13,13q21.2,60260727,60352996,92269,-,-
BAC198_H17,13,13q21.2-13q21.31,60484250,60614232,129982,-,-
BAC90_H09,13,13q21.31,60509534,60603408,93874,-,-
BAC86_K22,13,13q21.31,60526044,60596239,70195,-,-
BAC243_G19,13,13q21.31,60834358,60917308,82950,-,-
BAC115_K10,13,13q21.31,60877226,60970437,93211,-,-
BAC90_E13,13,13q21.31,60972779,61084765,111986,-,-
BAC243_K24,13,13q21.31,61267999,61359499,91500,-,-
BAC51_G23,13,13q21.31,61357192,61478021,120829,-,-
BAC187_M18,13,13q21.31,61592466,61679093,86627,-,-
BAC192_B06,13,13q21.31,61619178,61698541,79363,-,-
BAC177_J05,13,13q21.31,61621432,61680945,59513,-,-
BAC135_O03,13,13q21.31,61708361,61820641,112280,-,-
BAC170_A20,13,13q21.31,61711308,61826576,115268,-,-
BAC117_M10,13,13q21.31,61846195,61987631,141436,-,-
BAC76_F14,13,13q21.31,61862435,61989677,127242,-,-
BAC172_N04,13,13q21.31,61865264,61971847,106583,-,-
BAC33_F05,13,13q21.31,61865264,61951262,85998,-,-
BAC96_L12,13,13q21.31,62065650,62178000,112350,-,-
BAC52_N24,13,13q21.31,62098464,62178000,79536,-,-
BAC237_M16,13,13q21.31,62132352,62205489,73137,-,-
BAC67_J12,13,13q21.31,62433850,62531618,97768,-,-
BAC169_L18,13,13q21.31,62521943,62600511,78568,-,-
BAC100_A17,13,13q21.31,62544888,62654555,109667,-,-
BAC145_L20,13,13q21.31,62569584,62684963,115379,-,-
BAC41_E06,13,13q21.31,62590647,62684951,94304,-,-
BAC129_M15,13,13q21.31,62640305,62717655,77350,-,-
BAC197_I20,13,13q21.31,62896045,62988560,92515,-,-
BAC116_J03,13,13q21.31,63089717,63175657,85940,-,-
BAC30_N08,13,13q21.31,63508145,63593282,85137,-,-
BAC150_C24,13,13q21.31,63508734,63592425,83691,-,-
BAC96_H11,13,13q21.31,63585922,63679662,93740,-,-
BAC66_L18,13,13q21.31,63737898,63855687,117789,-,-
BAC82_P10,13,13q21.31,63881301,63964188,82887,-,-
BAC62_O04,13,13q21.31-13q21.32,64042731,64155875,113144,-,-
BAC27_H15,13,13q21.31-13q21.32,64053172,64132406,79234,-,-
BAC237_K23,13,13q21.31-13q21.32,64069448,64155874,86426,-,-
BAC66_F17,13,13q21.32,64536575,64649728,113153,-,-
BAC24_D12,13,13q21.32,64546942,64649686,102744,-,-
BAC60_G03,13,13q21.32,64571926,64649728,77802,-,-
BAC158_H11,13,13q21.32,64671226,64753645,82419,-,-
BAC51_L06,13,13q21.32,64781366,64885950,104584,-,-
BAC90_M16,13,13q21.32,64798989,64939096,140107,-,-
BAC189_F03,13,13q21.32,64877585,64960990,83405,-,-
BAC100_G18,13,13q21.32,64955474,65051089,95615,-,-
BAC11_M12,13,13q21.32,64960992,65058028,97036,-,-
BAC250_A04,13,13q21.32,65146737,65287842,141105,-,-
BAC137_L13,13,13q21.32,65335864,65415616,79752,-,-
BAC188_B04,13,13q21.32,65518461,65624357,105896,-,-
BAC237_A14,13,13q21.32,65589798,65712231,122433,-,-
BAC153_L16,13,13q21.32,65833921,65955016,121095,-,-
BAC171_J15,13,13q21.32,65936557,66035883,99326,-,-
BAC78_G03,13,13q21.32,65988488,66074456,85968,-,-
BAC116_H21,13,13q21.32,65997932,66057870,59938,-,-
BAC133_H09,13,13q21.32,66082506,66188904,106398,-,-
BAC95_H21,13,13q21.32,66082506,66185549,103043,-,-
BAC2_F02,13,13q21.32,66082506,66176328,93822,-,-
BAC168_M20,13,13q21.32,66095754,66179124,83370,-,-
BAC168_N10,13,13q21.32,66125295,66206377,81082,-,-
BAC195_K01,13,13q21.32,66137257,66240493,103236,-,-
BAC23_B15,13,13q21.32,66184731,66299493,114762,-,-
BAC116_N15,13,13q21.32,66258531,66386475,127944,-,-
BAC51_K04,13,13q21.32,66569807,66699202,129395,-,-
BAC199_B09,13,13q21.33,67566862,67647514,80652,-,-
BAC152_M13,13,13q21.33,67832008,67924486,92478,-,-
BAC233_E12,13,13q21.33,67873465,67959821,86356,-,-
BAC250_J13,13,13q21.33,68036715,68128095,91380,-,-
BAC96_O21,13,13q21.33,68148628,68267871,119243,-,-
BAC189_A15,13,13q21.33,68257212,68342249,85037,-,-
BAC188_L02,13,13q21.33,68267865,68361472,93607,-,-
BAC63_M15,13,13q21.33,68551918,68679532,127614,-,-
BAC222_B12,13,13q21.33,68671649,68803294,131645,-,-
BAC197_F01,13,13q21.33,69045811,69139650,93839,-,-
BAC175_F04,13,13q21.33,69148307,69272425,124118,-,-
BAC144_B12,13,13q21.33,69179034,69272425,93391,-,-
BAC219_G04,13,13q21.33,69196945,69272423,75478,-,-
BAC171_G09,13,13q21.33,69198511,69291569,93058,-,-
BAC178_F12,13,13q21.33,69249033,69330570,81537,-,-
BAC58_H05,13,13q21.33,69385467,69504430,118963,-,-
BAC139_I18,13,13q21.33,69434715,69517701,82986,-,-
BAC124_A18,13,13q21.33,69485887,69517414,31527,-,-
BAC247_O01,13,13q21.33,69763329,69877420,114091,-,-
BAC81_D01,13,13q21.33,70022423,70143666,121243,-,-
BAC237_D01,13,13q21.33,70172656,70263115,90459,-,-
BAC129_P18,13,13q21.33,70202794,70285628,82834,-,-
BAC190_J18,13,13q21.33,70315840,70396771,80931,-,-
BAC29_D04,13,13q21.33,70415856,70503339,87483,-,-
BAC144_G17,13,13q21.33,70434957,70530221,95264,-,-
BAC183_B20,13,13q21.33,70488929,70564376,75447,-,-
BAC115_K18,13,13q21.33,70662196,70743509,81313,-,-
BAC165_F14,13,13q21.33,70765040,70866219,101179,-,-
BAC237_L04,13,13q21.33,70889635,71005553,115918,-,-
BAC117_L08,13,13q21.33,71082845,71171865,89020,-,-
BAC142_K08,13,13q21.33,71096844,71180959,84115,-,-
BAC17_L14,13,13q21.33,71166814,71254085,87271,-,-
BAC28_K10,13,13q21.33,71181004,71287078,106074,-,-
BAC163_J07,13,13q21.33,71351707,71430497,78790,-,-
BAC65_N24,13,13q21.33,71384878,71489128,104250,-,-
BAC149_B01,13,13q21.33,71448905,71527553,78648,-,-
BAC51_I01,13,13q21.33,71488307,71620185,131878,-,-
BAC96_N17,13,13q21.33,71489126,71580462,91336,-,-
BAC36_P04,13,13q21.33,71489126,71586952,97826,-,-
BAC243_P09,13,13q21.33,71547060,71634091,87031,-,-
BAC119_F22,13,13q21.33,71560650,71643023,82373,-,-
BAC66_G03,13,13q21.33,71775516,71859360,83844,-,-
BAC151_P06,13,13q21.33,71785682,71867198,81516,-,-
BAC149_O08,13,13q21.33,71913676,71990319,76643,-,-
BAC237_P24,13,13q21.33,71970035,72071453,101418,-,-
BAC163_A10,13,13q21.33-13q22.1,72009280,72107001,97721,-,-
BAC218_E07,13,13q21.33-13q22.1,72023363,72107000,83637,-,-
BAC129_H17,13,13q22.1,72118160,72205760,87600,-,-
BAC34_L11,13,13q22.1,72125393,72227382,101989,-,-
BAC61_L14,13,13q22.1,72128855,72233663,104808,-,-
BAC50_M07,13,13q22.1,72203367,72322703,119336,-,-
BAC10_B15,13,13q22.1,72203505,72304668,101163,-,-
BAC220_D22,13,13q22.1,72225981,72299821,73840,-,-
BAC149_O11,13,13q22.1,72233863,72322703,88840,-,-
BAC26_F10,13,13q22.1,72289133,72419358,130225,-,-
BAC11_J04,13,13q22.1,72299405,72383393,83988,-,-
BAC155_C09,13,13q22.1,72369000,72451535,82535,-,-
BAC37_P07,13,13q22.1,72402764,72483514,80750,-,-
BAC84_P15,13,13q22.1,72425090,72535841,110751,-,-
BAC60_H11,13,13q22.1,72541891,72649694,107803,-,-
BAC143_E03,13,13q22.1,72547292,72639549,92257,-,-
BAC120_D08,13,13q22.1,72583539,72691926,108387,-,-
BAC151_E19,13,13q22.1,72631489,72730080,98591,-,-
BAC178_A01,13,13q22.1,72658650,72747102,88452,-,-
BAC135_F13,13,13q22.1,72673394,72762653,89259,-,-
BAC130_A16,13,13q22.1,72687190,72780543,93353,-,-
BAC161_G04,13,13q22.1,72692268,72789066,96798,-,-
BAC118_O14,13,13q22.1,72816361,72901981,85620,-,-
BAC105_M02,13,13q22.1,72988443,73091397,102954,-,-
BAC190_F02,13,13q22.1,73028036,73126678,98642,-,-
BAC233_H13,13,13q22.1,73035336,73135108,99772,-,-
BAC60_D21,13,13q22.1,73270368,73362378,92010,-,-
BAC226_F12,13,13q22.1,73291959,73374606,82647,-,-
BAC27_M17,13,13q22.1,73291962,73384613,92651,-,-
BAC220_L20,13,13q22.1,73393835,73472787,78952,-,-
BAC228_J04,13,13q22.1,73438567,73521416,82849,-,-
BAC37_F22,13,13q22.1,73481648,73588328,106680,-,-
BAC96_B06,13,13q22.1,73492569,73593559,100990,-,-
BAC127_E21,13,13q22.1,73497716,73600259,102543,-,-
BAC194_P04,13,13q22.1,73623880,73738527,114647,-,-
BAC230_A22,13,13q22.1,73738564,73826579,88015,-,-
BAC154_E21,13,13q22.1,73756569,73826216,69647,-,-
BAC2_P24,13,13q22.1,73817517,73915112,97595,-,-
BAC102_G10,13,13q22.1,73826575,73943808,117233,-,-
BAC188_K02,13,13q22.1,73826877,73915118,88241,-,-
BAC118_G10,13,13q22.1,73826887,73916945,90058,-,-
BAC192_G03,13,13q22.1,73871406,73996745,125339,-,-
BAC229_M10,13,13q22.1,73996739,74086864,90125,-,-
BAC177_I17,13,13q22.2,74536952,74633341,96389,-,-
BAC213_M23,13,13q22.2,74597854,74677175,79321,-,-
BAC139_H16,13,13q22.2,74633752,74711250,77498,-,-
BAC101_B08,13,13q22.2,74672813,74763159,90346,-,-
BAC213_N20,13,13q22.2,74681900,74762871,80971,-,-
BAC68_F06,13,13q22.2,74687778,74778779,91001,-,-
BAC57_K16,13,13q22.2,74749891,74843786,93895,-,-
BAC60_F12,13,13q22.2,74757401,74903103,145702,-,-
BAC74_M22,13,13q22.2,74763153,74903103,139950,-,-
BAC218_K02,13,13q22.2,74873346,74979590,106244,-,-
BAC16_H22,13,13q22.2,74883368,75022446,139078,-,-
BAC19_H02,13,13q22.2,74899750,75022768,123018,-,-
BAC93_I18,13,13q22.2,74923924,75022857,98933,-,-
BAC12_M22,13,13q22.2,75023004,75104889,81885,-,-
BAC226_P21,13,13q22.2,75084648,75175082,90434,-,-
BAC133_O23,13,13q22.2,75105462,75229882,124420,-,-
BAC172_O23,13,13q22.2,75146013,75223743,77730,-,-
BAC44_E16,13,13q22.2,75295838,75384790,88952,-,-
BAC228_D05,13,13q22.2,75319218,75407055,87837,-,-
BAC107_D12,13,13q22.2,75375694,75493734,118040,-,-
BAC91_I06,13,13q22.2,75608043,75726691,118648,-,-
BAC40_B05,13,13q22.2,75786328,75907735,121407,-,-
BAC89_B01,13,13q22.2-13q22.3,75966415,76058793,92378,-,-
BAC116_M18,13,13q22.2-13q22.3,75973711,76065410,91699,-,-
BAC150_M13,13,13q22.2-13q22.3,75998871,76089224,90353,-,-
BAC120_N22,13,13q22.3,76058829,76156001,97172,-,-
BAC129_O15,13,13q22.3,76170915,76261228,90313,-,-
BAC186_F23,13,13q22.3,76201812,76311400,109588,-,-
BAC160_K11,13,13q22.3,76367968,76474144,106176,-,-
BAC166_A20,13,13q22.3,76370590,76494530,123940,-,-
BAC107_F13,13,13q22.3,76370590,76442349,71759,-,-
BAC22_L07,13,13q22.3,76389061,76474144,85083,-,-
BAC149_D03,13,13q22.3,76469740,76571804,102064,-,-
BAC32_E08,13,13q22.3,76497415,76590434,93019,-,-
BAC247_H07,13,13q22.3,76547861,76650360,102499,-,-
BAC230_A15,13,13q22.3,76730247,76834883,104636,-,-
BAC66_M19,13,13q22.3,76764152,76873419,109267,-,-
BAC193_A13,13,13q22.3,76764152,76838966,74814,-,-
BAC167_H08,13,13q22.3,76830282,76920655,90373,-,-
BAC171_L01,13,13q22.3,76898317,76997529,99212,-,-
BAC40_L16,13,13q22.3,77069857,77167550,97693,-,-
BAC149_L01,13,13q31.1,77809945,77895079,85134,-,-
BAC177_O07,13,13q31.1,77873900,77970363,96463,-,-
BAC68_C15,13,13q31.1,77901996,78022148,120152,-,-
BAC23_F09,13,13q31.1,77916157,77995199,79042,-,-
BAC30_G07,13,13q31.1,77921097,78036344,115247,-,-
BAC103_G21,13,13q31.1,78040947,78116180,75233,-,-
BAC228_P04,13,13q31.1,78212809,78302064,89255,-,-
BAC127_I19,13,13q31.1,78303004,78407127,104123,-,-
BAC6_N18,13,13q31.1,78332700,78429034,96334,-,-
BAC69_H06,13,13q31.1,78375734,78449136,73402,-,-
BAC90_K12,13,13q31.1,78556405,78677023,120618,-,-
BAC247_E01,13,13q31.1,78584843,78664205,79362,-,-
BAC97_A19,13,13q31.1,78664305,78768725,104420,-,-
BAC195_H08,13,13q31.1,78677248,78787288,110040,-,-
BAC103_D09,13,13q31.1,78683409,78773404,89995,-,-
BAC162_N15,13,13q31.1,78805311,78905020,99709,-,-
BAC22_P04,13,13q31.1,78981254,79139071,157817,-,-
BAC156_I02,13,13q31.1,79024189,79114610,90421,-,-
BAC36_C08,13,13q31.1,79025696,79111070,85374,-,-
BAC126_D01,13,13q31.1,79025696,79118402,92706,-,-
BAC162_I20,13,13q31.1,79266486,79407282,140796,-,-
BAC115_I21,13,13q31.1,79482181,79594577,112396,-,-
BAC247_F15,13,13q31.1,79626215,79690540,64325,-,-
BAC127_N12,13,13q31.1,79697454,79790617,93163,-,-
BAC150_G16,13,13q31.1,79704471,79783099,78628,-,-
BAC180_D16,13,13q31.1,79733744,79820740,86996,-,-
BAC230_O20,13,13q31.1,79778625,79873407,94782,-,-
BAC29_A04,13,13q31.1,79983169,80137921,154752,-,-
BAC67_A19,13,13q31.1,80334293,80423926,89633,-,-
BAC34_M04,13,13q31.1,80376850,80481196,104346,-,-
BAC186_B24,13,13q31.1,80388340,80500326,111986,-,-
BAC233_O23,13,13q31.1,80477478,80554973,77495,-,-
BAC141_B21,13,13q31.1,80546265,80620597,74332,-,-
BAC15_B20,13,13q31.1,80558471,80652381,93910,-,-
BAC148_E19,13,13q31.1,80576187,80679333,103146,-,-
BAC168_G15,13,13q31.1,80649717,80754547,104830,-,-
BAC38_P15,13,13q31.1,80879461,80971597,92136,-,-
BAC247_L16,13,13q31.1,80934083,81080808,146725,-,-
BAC231_P15,13,13q31.1,81017340,81114787,97447,-,-
BAC200_G01,13,13q31.1,81062868,81131150,68282,-,-
BAC45_B15,13,13q31.1,81369682,81452485,82803,-,-
BAC163_H20,13,13q31.1,81436910,81512582,75672,-,-
BAC197_K13,13,13q31.1,81652774,81668764,15990,-,-
BAC25_I17,13,13q31.1,81713129,81814066,100937,-,-
BAC51_K17,13,13q31.1,81713163,81863178,150015,-,-
BAC51_J02,13,13q31.1,81744361,81908801,164440,-,-
BAC197_E08,13,13q31.1,81753720,81851722,98002,-,-
BAC73_O08,13,13q31.1,81761864,81851348,89484,-,-
BAC55_F10,13,13q31.1,81799898,81871630,71732,-,-
BAC82_C09,13,13q31.1,82036927,82175900,138973,-,-
BAC125_A14,13,13q31.1,82222527,82327758,105231,-,-
BAC231_P11,13,13q31.1,82254764,82326592,71828,-,-
BAC38_B03,13,13q31.1,82305844,82403126,97282,-,-
BAC84_D21,13,13q31.1,82314566,82414687,100121,-,-
BAC139_I22,13,13q31.1,82711988,82853115,141127,-,-
BAC127_F17,13,13q31.1,82961896,83072385,110489,-,-
BAC40_G17,13,13q31.1,83029104,83114835,85731,-,-
BAC101_G24,13,13q31.1,83114827,83230051,115224,-,-
BAC4_P09,13,13q31.1,83114837,83264893,150056,-,-
BAC190_K07,13,13q31.1,83285413,83366660,81247,-,-
BAC242_H01,13,13q31.1,83500348,83587644,87296,-,-
BAC142_D22,13,13q31.1,83820866,83911414,90548,-,-
BAC34_M03,13,13q31.1,83914877,83995332,80455,-,-
BAC18_P09,13,13q31.1,83982012,84058533,76521,-,-
BAC90_I10,13,13q31.1,84240376,84329018,88642,-,-
BAC76_N01,13,13q31.1,84379297,84442384,63087,-,-
BAC190_D18,13,13q31.1,84430294,84526216,95922,-,-
BAC16_P15,13,13q31.1,84430294,84525909,95615,-,-
BAC51_F10,13,13q31.1,84546788,84620365,73577,-,-
BAC89_O04,13,13q31.1,84566312,84694551,128239,-,-
BAC66_H02,13,13q31.1,84578548,84667289,88741,-,-
BAC197_M02,13,13q31.1,84774347,84878650,104303,-,-
BAC196_P12,13,13q31.1,84944151,85048401,104250,-,-
BAC43_K01,13,13q31.1,84996424,85110699,114275,-,-
BAC116_J07,13,13q31.1,85007642,85078375,70733,-,-
BAC246_N20,13,13q31.1,85024934,85107463,82529,-,-
BAC193_N21,13,13q31.1,85024934,85110738,85804,-,-
BAC53_N12,13,13q31.1,85119190,85246632,127442,-,-
BAC140_C20,13,13q31.1,85137033,85225047,88014,-,-
BAC101_F24,13,13q31.1,85198682,85297339,98657,-,-
BAC84_N09,13,13q31.1,85224563,85327840,103277,-,-
BAC50_A01,13,13q31.1,85225116,85339219,114103,-,-
BAC53_J05,13,13q31.1,85231304,85367465,136161,-,-
BAC107_H18,13,13q31.1,85239701,85339219,99518,-,-
BAC64_B15,13,13q31.1,85391016,85455690,64674,-,-
BAC157_N01,13,13q31.1,85469029,85559085,90056,-,-
BAC75_G17,13,13q31.1,85709070,85812858,103788,-,-
BAC100_J07,13,13q31.1,85753559,85845338,91779,-,-
BAC82_B10,13,13q31.1,85801906,85909999,108093,-,-
BAC226_L23,13,13q31.1,85812033,85893843,81810,-,-
BAC106_O11,13,13q31.1,85842891,85961717,118826,-,-
BAC93_C23,13,13q31.1,85845620,85980154,134534,-,-
BAC54_O20,13,13q31.1,85998474,86112423,113949,-,-
BAC106_O19,13,13q31.1,85999418,86119408,119990,-,-
BAC224_N24,13,13q31.1,86110284,86193308,83024,-,-
BAC141_J07,13,13q31.1,86135400,86222753,87353,-,-
BAC140_I08,13,13q31.1,86289115,86351444,62329,-,-
BAC230_E07,13,13q31.1,86289784,86364678,74894,-,-
BAC233_F08,13,13q31.1,86297423,86376432,79009,-,-
BAC80_B23,13,13q31.1,86308398,86410039,101641,-,-
BAC81_K12,13,13q31.1,86317980,86410057,92077,-,-
BAC81_M20,13,13q31.2,86507281,86652319,145038,-,-
BAC171_E15,13,13q31.2,86533813,86614559,80746,-,-
BAC179_L11,13,13q31.2,86568454,86647195,78741,-,-
BAC196_D22,13,13q31.2,86662969,86780360,117391,-,-
BAC124_O16,13,13q31.2,86696362,86820914,124552,-,-
BAC149_A16,13,13q31.2,86717107,86808411,91304,-,-
BAC226_C01,13,13q31.2,86948710,87036794,88084,-,-
BAC29_K13,13,13q31.2,87075757,87183246,107489,-,-
BAC42_N02,13,13q31.2,87174104,87259553,85449,-,-
BAC242_K11,13,13q31.2,87329959,87416596,86637,-,-
BAC62_F16,13,13q31.2,87339690,87423416,83726,-,-
BAC65_H03,13,13q31.2,87391318,87479091,87773,-,-
BAC184_O12,13,13q31.2,87563189,87644535,81346,-,-
BAC124_O18,13,13q31.2,87592007,87755122,163115,-,-
BAC52_H12,13,13q31.2,87606925,87755098,148173,-,-
BAC236_O09,13,13q31.2,87791495,87878509,87014,-,-
BAC116_M05,13,13q31.2,87836516,87924515,87999,-,-
BAC84_I16,13,13q31.2,87878697,88012321,133624,-,-
BAC235_A16,13,13q31.2,87911171,87990752,79581,-,-
BAC60_I01,13,13q31.2,87936823,88012905,76082,-,-
BAC3_F10,13,13q31.2,88069991,88188736,118745,-,-
BAC92_O23,13,13q31.2,88235783,88334833,99050,-,-
BAC38_I22,13,13q31.2,88347609,88430194,82585,-,-
BAC153_A16,13,13q31.2-13q31.3,88714408,88811532,97124,-,-
BAC244_J20,13,13q31.3,88832620,88932795,100175,-,-
BAC179_D06,13,13q31.3,89036344,89111461,75117,-,-
BAC40_I11,13,13q31.3,89084356,89204544,120188,-,-
BAC100_F08,13,13q31.3,89479631,89564642,85011,-,-
BAC183_J19,13,13q31.3,89549576,89619643,70067,-,-
BAC182_H18,13,13q31.3,89556652,89645323,88671,-,-
BAC181_N18,13,13q31.3,89559098,89640472,81374,-,-
BAC30_E11,13,13q31.3,89559113,89686503,127390,-,-
BAC62_E20,13,13q31.3,89564669,89672291,107622,-,-
BAC169_B02,13,13q31.3,89619638,89707184,87546,-,-
BAC150_F02,13,13q31.3,89640528,89726985,86457,-,-
BAC247_O22,13,13q31.3,89751054,89850796,99742,-,-
BAC156_J19,13,13q31.3,89771945,89855054,83109,-,-
BAC153_I09,13,13q31.3,89797429,89878034,80605,-,-
BAC6_P18,13,13q31.3,89816433,89897321,80888,-,-
BAC126_E22,13,13q31.3,89841161,89921803,80642,-,-
BAC226_N15,13,13q31.3,89938508,90021461,82953,-,-
BAC143_G23,13,13q31.3,89939353,90036661,97308,-,-
BAC46_O12,13,13q31.3,90007926,90130940,123014,-,-
BAC70_P02,13,13q31.3,90032606,90124734,92128,-,-
BAC246_A16,13,13q31.3,90167438,90250615,83177,-,-
BAC76_G09,13,13q31.3,90245711,90329558,83847,-,-
BAC224_M14,13,13q31.3,90281968,90367711,85743,-,-
BAC16_P08,13,13q31.3,90282366,90368494,86128,-,-
BAC238_F10,13,13q31.3,90369169,90441801,72632,-,-
BAC116_P24,13,13q31.3,90441944,90521527,79583,-,-
BAC51_L11,13,13q31.3,90738042,90840059,102017,-,-
BAC90_I11,13,13q31.3,90820336,90929800,109464,-,-
BAC67_O07,13,13q31.3,90867726,90985644,117918,-,-
BAC24_G19,13,13q31.3,90995105,91109463,114358,-,-
BAC137_A05,13,13q31.3,91115172,91223979,108807,-,-
BAC197_I13,13,13q31.3,91131318,91230696,99378,-,-
BAC146_N01,13,13q31.3,91135889,91229104,93215,-,-
BAC31_D22,13,13q31.3,91345907,91464745,118838,-,-
BAC140_E22,13,13q31.3,91365098,91396480,31382,-,-
BAC60_G24,13,13q31.3,91519247,91611293,92046,-,-
BAC239_J05,13,13q31.3,91546864,91653291,106427,-,-
BAC238_P21,13,13q31.3,91627893,91729860,101967,-,-
BAC20_B03,13,13q31.3,91640372,91730007,89635,-,-
BAC188_N05,13,13q31.3,91650166,91732368,82202,-,-
BAC22_D11,13,13q31.3,91803965,91911237,107272,-,-
BAC31_L15,13,13q31.3,91985900,92102069,116169,-,-
BAC244_M17,13,13q31.3,92047956,92132791,84835,-,-
BAC27_L20,13,13q31.3,92065634,92169149,103515,-,-
BAC120_E21,13,13q31.3,92102064,92198130,96066,-,-
BAC61_J20,13,13q31.3,92372650,92504448,131798,-,-
BAC152_C10,13,13q31.3,92481658,92566160,84502,-,-
BAC173_K03,13,13q31.3,92532814,92613321,80507,-,-
BAC215_N20,13,13q31.3,92569124,92652302,83178,-,-
BAC234_C18,13,13q31.3,92652446,92748857,96411,-,-
BAC91_M12,13,13q31.3,92655531,92748857,93326,-,-
BAC64_D22,13,13q31.3,92797952,92880005,82053,-,-
BAC91_L05,13,13q31.3,92901487,92966348,64861,-,-
BAC152_A14,13,13q31.3,93174355,93267173,92818,-,-
BAC185_G05,13,13q31.3,93326073,93421995,95922,-,-
BAC14_E09,13,13q31.3,93548807,93641864,93057,-,-
BAC129_O07,13,13q31.3-13q32.1,93796245,93918232,121987,-,-
BAC179_C18,13,13q32.1,93868481,93945401,76920,-,-
BAC28_N07,13,13q32.1,93945507,94118027,172520,-,-
BAC69_L21,13,13q32.1,94006441,94098738,92297,-,-
BAC166_A03,13,13q32.1,94065227,94155096,89869,-,-
BAC75_F16,13,13q32.1,94123192,94275638,152446,-,-
BAC73_E24,13,13q32.1,94123197,94233221,110024,-,-
BAC21_M22,13,13q32.1,94275700,94408670,132970,-,-
BAC40_H20,13,13q32.1,94351467,94467748,116281,-,-
BAC144_F18,13,13q32.1,94484732,94568510,83778,-,-
BAC118_K21,13,13q32.1,94491525,94591146,99621,-,-
BAC186_K17,13,13q32.1,94491962,94612613,120651,-,-
BAC96_P24,13,13q32.1,94568718,94591149,22431,-,-
BAC145_M24,13,13q32.1,94601141,94692228,91087,-,-
BAC235_K14,13,13q32.1,94691254,94773138,81884,-,-
BAC125_B18,13,13q32.1,94692222,94825189,132967,-,-
BAC90_K14,13,13q32.1,94701558,94865961,164403,-,-
BAC159_I11,13,13q32.1,94701559,94812280,110721,-,-
BAC204_B22,13,13q32.1,94749830,94839207,89377,-,-
BAC185_A13,13,13q32.1,94771196,94860265,89069,-,-
BAC175_F20,13,13q32.1,94773301,94867622,94321,-,-
BAC116_H22,13,13q32.1,94812405,94933551,121146,-,-
BAC179_L15,13,13q32.1,94900775,94992316,91541,-,-
BAC55_D22,13,13q32.1,94992358,95081250,88892,-,-
BAC230_E04,13,13q32.1,95040525,95174092,133567,-,-
BAC175_P17,13,13q32.1,95043595,95147539,103944,-,-
BAC197_J21,13,13q32.1,95081785,95174092,92307,-,-
BAC211_C16,13,13q32.1,95085474,95155106,69632,-,-
BAC10_G14,13,13q32.1,95155481,95271828,116347,-,-
BAC196_F17,13,13q32.1,95174086,95262761,88675,-,-
BAC185_O22,13,13q32.1,95358360,95436875,78515,-,-
BAC63_K04,13,13q32.1,95407805,95506051,98246,-,-
BAC37_F21,13,13q32.1,95430652,95575700,145048,-,-
BAC181_F14,13,13q32.1,95547599,95651493,103894,-,-
BAC172_O13,13,13q32.1,95640869,95720820,79951,-,-
BAC184_N08,13,13q32.1,95664855,95741811,76956,-,-
BAC96_P14,13,13q32.1,95707354,95807048,99694,-,-
BAC84_E11,13,13q32.1,95759873,95869725,109852,-,-
BAC115_K14,13,13q32.1,95825187,95924550,99363,-,-
BAC224_N13,13,13q32.1,95866339,95961614,95275,-,-
BAC123_N05,13,13q32.1,95866340,95978927,112587,-,-
BAC172_K21,13,13q32.1,95877310,95973933,96623,-,-
BAC154_C20,13,13q32.1,95877310,95974784,97474,-,-
BAC147_P21,13,13q32.1,95973922,96057038,83116,-,-
BAC13_B07,13,13q32.1,96003982,96093740,89758,-,-
BAC177_J13,13,13q32.1,96017947,96107039,89092,-,-
BAC119_I05,13,13q32.1,96107280,96227078,119798,-,-
BAC73_N16,13,13q32.1,96260887,96384880,123993,-,-
BAC219_O12,13,13q32.1,96286604,96375427,88823,-,-
BAC92_L14,13,13q32.1,96296309,96394131,97822,-,-
BAC10_N13,13,13q32.1,96356333,96459458,103125,-,-
BAC26_M19,13,13q32.1,96356333,96481120,124787,-,-
BAC81_P12,13,13q32.1,96362556,96459458,96902,-,-
BAC63_N04,13,13q32.1,96402704,96505042,102338,-,-
BAC214_F18,13,13q32.1,96442092,96556842,114750,-,-
BAC239_G07,13,13q32.1,96449558,96556821,107263,-,-
BAC230_N03,13,13q32.1,96459805,96602469,142664,-,-
BAC188_A02,13,13q32.1,96595640,96690327,94687,-,-
BAC8_C18,13,13q32.1,96626342,96733503,107161,-,-
BAC244_P19,13,13q32.1,96662271,96745898,83627,-,-
BAC224_E18,13,13q32.1,96662271,96745898,83627,-,-
BAC84_I04,13,13q32.1,96693078,96802271,109193,-,-
BAC95_M06,13,13q32.1,96900380,96998154,97774,-,-
BAC95_E16,13,13q32.1-13q32.2,96916479,97014050,97571,-,-
BAC74_M17,13,13q32.1-13q32.2,96922950,97049447,126497,-,-
BAC158_O19,13,13q32.2,97164162,97283129,118967,-,-
BAC194_J11,13,13q32.2,97167987,97283131,115144,-,-
BAC34_L19,13,13q32.2,97201306,97275825,74519,-,-
BAC77_A07,13,13q32.2,97243100,97335525,92425,-,-
BAC194_N24,13,13q32.2,97335696,97406890,71194,-,-
BAC96_J17,13,13q32.2,97350266,97471636,121370,-,-
BAC97_F10,13,13q32.2,97450950,97547057,96107,-,-
BAC181_L17,13,13q32.2,97465108,97548203,83095,-,-
BAC184_P06,13,13q32.2,97488218,97568267,80049,-,-
BAC83_E07,13,13q32.2,97488218,97624844,136626,-,-
BAC72_P13,13,13q32.2,97536346,97641535,105189,-,-
BAC244_H20,13,13q32.2,97537207,97683864,146657,-,-
BAC66_O15,13,13q32.2,97586604,97698861,112257,-,-
BAC222_I17,13,13q32.2,97592810,97691713,98903,-,-
BAC125_A22,13,13q32.2,97595010,97679940,84930,-,-
BAC69_E08,13,13q32.2,97667173,97755915,88742,-,-
BAC141_K05,13,13q32.2,97674080,97756517,82437,-,-
BAC234_N11,13,13q32.2,97681711,97799901,118190,-,-
BAC67_K06,13,13q32.2,97694940,97797764,102824,-,-
BAC238_D22,13,13q32.2,97705778,97799901,94123,-,-
BAC240_B06,13,13q32.2,97723468,97828455,104987,-,-
BAC23_F18,13,13q32.2,97731737,97892903,161166,-,-
BAC85_M15,13,13q32.2,97871494,97882172,10678,-,-
BAC143_B05,13,13q32.2,97959169,98037751,78582,-,-
BAC57_E15,13,13q32.3,98119687,98215905,96218,-,-
BAC51_F13,13,13q32.3,98136899,98250861,113962,-,-
BAC33_J13,13,13q32.3,98136899,98288364,151465,-,-
BAC96_P07,13,13q32.3,98136901,98224929,88028,-,-
BAC170_B16,13,13q32.3,98159944,98250867,90923,-,-
BAC180_L19,13,13q32.3,98169542,98247061,77519,-,-
BAC200_C11,13,13q32.3,98231818,98327170,95352,-,-
BAC150_C02,13,13q32.3,98255178,98340711,85533,-,-
BAC51_G17,13,13q32.3,98255182,98365352,110170,-,-
BAC165_K19,13,13q32.3,98258529,98340711,82182,-,-
BAC192_M13,13,13q32.3,98340705,98462511,121806,-,-
BAC55_I20,13,13q32.3,98470792,98622367,151575,-,-
BAC181_E23,13,13q32.3,98514894,98601751,86857,-,-
BAC148_G08,13,13q32.3,98516825,98601751,84926,-,-
BAC31_I17,13,13q32.3,98567158,98698116,130958,-,-
BAC65_H02,13,13q32.3,98614537,98716737,102200,-,-
BAC35_A18,13,13q32.3,98614616,98762326,147710,-,-
BAC221_A04,13,13q32.3,98622381,98698116,75735,-,-
BAC227_E04,13,13q32.3,98660386,98749704,89318,-,-
BAC236_O04,13,13q32.3,98697485,98788710,91225,-,-
BAC101_L15,13,13q32.3,98784888,98870717,85829,-,-
BAC36_L19,13,13q32.3,98815466,98897172,81706,-,-
BAC109_K10,13,13q32.3,98834679,98929468,94789,-,-
BAC64_F06,13,13q32.3,98855867,98990651,134784,-,-
BAC64_J15,13,13q32.3,98871071,98953154,82083,-,-
BAC210_K04,13,13q32.3,98897470,99029732,132262,-,-
BAC95_N11,13,13q32.3,98907209,99012718,105509,-,-
BAC38_D10,13,13q32.3,99033399,99127728,94329,-,-
BAC18_J08,13,13q32.3,99034654,99206759,172105,-,-
BAC30_H21,13,13q32.3,99043709,99135480,91771,-,-
BAC10_G19,13,13q32.3,99071207,99280239,209032,-,-
BAC83_E12,13,13q32.3,99098886,99202854,103968,-,-
BAC237_N07,13,13q32.3,99139547,99241615,102068,-,-
BAC70_I16,13,13q32.3,99172339,99260780,88441,-,-
BAC143_H10,13,13q32.3,99203026,99288162,85136,-,-
BAC129_K17,13,13q32.3,99207293,99294861,87568,-,-
BAC37_D10,13,13q32.3,99277956,99413126,135170,-,-
BAC64_J11,13,13q32.3,99288157,99397299,109142,-,-
BAC223_J17,13,13q32.3,99306652,99399860,93208,-,-
BAC153_G08,13,13q32.3,99312251,99397299,85048,-,-
BAC33_I12,13,13q32.3,99313557,99447147,133590,-,-
BAC104_K11,13,13q32.3,99413126,99494185,81059,-,-
BAC34_E04,13,13q32.3,99413158,99531602,118444,-,-
BAC142_E08,13,13q32.3,99530542,99645500,114958,-,-
BAC145_E21,13,13q32.3,99531598,99619177,87579,-,-
BAC80_I20,13,13q32.3,99648770,99747707,98937,-,-
BAC63_F19,13,13q32.3,99696133,99795453,99320,-,-
BAC26_I06,13,13q32.3,99750639,99855232,104593,-,-
BAC92_A24,13,13q32.3,99858340,99941755,83415,-,-
BAC90_C07,13,13q32.3,99885022,100012384,127362,-,-
BAC192_K17,13,13q32.3,99941938,100021726,79788,-,-
BAC193_H17,13,13q32.3,100002325,100096620,94295,-,-
BAC57_C04,13,13q32.3,100021786,100107884,86098,-,-
BAC244_H09,13,13q32.3,100074912,100164855,89943,-,-
BAC190_P06,13,13q32.3,100097265,100201694,104429,-,-
BAC178_F11,13,13q32.3,100170277,100259403,89126,-,-
BAC57_N15,13,13q32.3,100250972,100330477,79505,-,-
BAC211_A14,13,13q32.3,100251271,100335327,84056,-,-
BAC184_E07,13,13q32.3,100262475,100334995,72520,-,-
BAC73_O17,13,13q32.3,100262478,100347614,85136,-,-
BAC239_A22,13,13q32.3,100298149,100379208,81059,-,-
BAC148_B01,13,13q32.3,100326958,100410263,83305,-,-
BAC247_O12,13,13q32.3-13q33.1,100453711,100549536,95825,-,-
BAC24_K15,13,13q32.3-13q33.1,100453711,100537831,84120,-,-
BAC186_N03,13,13q32.3-13q33.1,100453712,100551437,97725,-,-
BAC50_B22,13,13q32.3-13q33.1,100481294,100595144,113850,-,-
BAC239_N14,13,13q32.3-13q33.1,100488375,100562547,74172,-,-
BAC244_J04,13,13q33.1,100501725,100599642,97917,-,-
BAC73_I15,13,13q33.1,100501725,100647277,145552,-,-
BAC29_F03,13,13q33.1,100599823,100685984,86161,-,-
BAC228_H20,13,13q33.1,100685994,100779719,93725,-,-
BAC187_H01,13,13q33.1,100700769,100794393,93624,-,-
BAC235_J13,13,13q33.1,101084754,101208193,123439,-,-
BAC59_J10,13,13q33.1,101085564,101232125,146561,-,-
BAC162_P07,13,13q33.1,101181762,101270347,88585,-,-
BAC125_N12,13,13q33.1,101287818,101435420,147602,-,-
BAC78_K21,13,13q33.1,101460883,101602744,141861,-,-
BAC88_I07,13,13q33.1,101462874,101563205,100331,-,-
BAC235_D02,13,13q33.1,101483868,101576301,92433,-,-
BAC37_I06,13,13q33.1,101483877,101600299,116422,-,-
BAC123_K24,13,13q33.1,101496675,101593962,97287,-,-
BAC129_L17,13,13q33.1,101592957,101686379,93422,-,-
BAC12_D12,13,13q33.1,101636128,101741819,105691,-,-
BAC180_F08,13,13q33.1,101640508,101719417,78909,-,-
BAC61_L23,13,13q33.1,101650241,101759486,109245,-,-
BAC167_O11,13,13q33.1,101730155,101812602,82447,-,-
BAC227_L13,13,13q33.1,101773877,101882409,108532,-,-
BAC143_B21,13,13q33.1,101884374,101952252,67878,-,-
BAC224_N22,13,13q33.1,101901824,101988137,86313,-,-
BAC172_P08,13,13q33.1,102154900,102238572,83672,-,-
BAC155_B10,13,13q33.1,102257528,102352664,95136,-,-
BAC101_E13,13,13q33.1,102306136,102444361,138225,-,-
BAC64_O24,13,13q33.1,102481336,102549988,68652,-,-
BAC233_L22,13,13q33.1,102537738,102617458,79720,-,-
BAC121_N20,13,13q33.1,102647623,102734850,87227,-,-
BAC123_N10,13,13q33.1,102680435,102769558,89123,-,-
BAC101_J12,13,13q33.1,102680441,102809840,129399,-,-
BAC144_C05,13,13q33.1,102771370,102834770,63400,-,-
BAC117_K18,13,13q33.1,102807522,102931937,124415,-,-
BAC243_J23,13,13q33.1,103154956,103262987,108031,-,-
BAC128_A11,13,13q33.1,103197843,103278656,80813,-,-
BAC124_M04,13,13q33.1,103215123,103297212,82089,-,-
BAC1_N08,13,13q33.1,103271247,103382110,110863,-,-
BAC108_M06,13,13q33.1,103309339,103410192,100853,-,-
BAC91_D05,13,13q33.1,103328676,103441484,112808,-,-
BAC63_O05,13,13q33.1-13q33.2,103635761,103722175,86414,-,-
BAC156_P15,13,13q33.2,103746869,103852576,105707,-,-
BAC86_B12,13,13q33.2,103858846,103953995,95149,-,-
BAC49_C05,13,13q33.2,103893356,104010774,117418,-,-
BAC186_P10,13,13q33.2,103994269,104072390,78121,-,-
BAC144_K17,13,13q33.2,104015481,104100449,84968,-,-
BAC102_L01,13,13q33.2,104025639,104112151,86512,-,-
BAC145_B24,13,13q33.2,104072494,104156429,83935,-,-
BAC1_A06,13,13q33.2,104108133,104215460,107327,-,-
BAC161_J13,13,13q33.2,104112382,104199030,86648,-,-
BAC157_G22,13,13q33.2,104228646,104322473,93827,-,-
BAC192_E01,13,13q33.2,104329724,104432046,102322,-,-
BAC199_J18,13,13q33.2,104374958,104460794,85836,-,-
BAC145_B15,13,13q33.2,104473509,104579139,105630,-,-
BAC168_I17,13,13q33.2,104489335,104579153,89818,-,-
BAC141_H22,13,13q33.2,104579147,104677202,98055,-,-
BAC43_M09,13,13q33.2,104756401,104841954,85553,-,-
BAC167_A09,13,13q33.2,104797058,104903905,106847,-,-
BAC80_A20,13,13q33.2,105025805,105115653,89848,-,-
BAC89_H11,13,13q33.2,105093357,105184666,91309,-,-
BAC81_G19,13,13q33.2,105175541,105283030,107489,-,-
BAC220_G04,13,13q33.2,105236373,105339419,103046,-,-
BAC249_I02,13,13q33.2,105291267,105372863,81596,-,-
BAC166_G11,13,13q33.2,105321210,105452802,131592,-,-
BAC25_L08,13,13q33.2,105369293,105499284,129991,-,-
BAC156_O15,13,13q33.2,105392772,105470019,77247,-,-
BAC34_O06,13,13q33.2,105494959,105622801,127842,-,-
BAC57_L07,13,13q33.2,105558353,105667470,109117,-,-
BAC242_P15,13,13q33.2,105596271,105663038,66767,-,-
BAC167_O13,13,13q33.2,105607004,105698334,91330,-,-
BAC182_C19,13,13q33.2,105637637,105708960,71323,-,-
BAC70_O10,13,13q33.2,105648718,105736291,87573,-,-
BAC58_A05,13,13q33.2,105663135,105770104,106969,-,-
BAC110_J04,13,13q33.2,105678503,105764553,86050,-,-
BAC151_L01,13,13q33.2,105681516,105780593,99077,-,-
BAC118_C02,13,13q33.2-13q33.3,105780602,105956803,176201,-,-
BAC193_H21,13,13q33.3,105855693,105937545,81852,-,-
BAC101_K20,13,13q33.3,105861080,105957949,96869,-,-
BAC63_N03,13,13q33.3,105871653,105956800,85147,-,-
BAC133_G23,13,13q33.3,105875452,105978338,102886,-,-
BAC32_I20,13,13q33.3,105945875,106038536,92661,-,-
BAC105_N20,13,13q33.3,105980666,106106853,126187,-,-
BAC73_I13,13,13q33.3,105980666,106073762,93096,-,-
BAC40_K07,13,13q33.3,106026661,106150038,123377,-,-
BAC25_C09,13,13q33.3,106145970,106162600,16630,-,-
BAC217_J10,13,13q33.3,106325354,106431252,105898,-,-
BAC165_P01,13,13q33.3,106345189,106449974,104785,-,-
BAC153_I14,13,13q33.3,106345189,106454659,109470,-,-
BAC175_J06,13,13q33.3,106405834,106494368,88534,-,-
BAC37_M15,13,13q33.3,106449969,106616142,166173,-,-
BAC117_A18,13,13q33.3,106471071,106599506,128435,-,-
BAC224_G22,13,13q33.3,106580904,106667789,86885,-,-
BAC131_L02,13,13q33.3,106601156,106684269,83113,-,-
BAC171_B15,13,13q33.3,106650617,106771819,121202,-,-
BAC218_N12,13,13q33.3,106667927,106762771,94844,-,-
BAC76_K18,13,13q33.3,106820372,106909723,89351,-,-
BAC156_D14,13,13q33.3,106820373,106913917,93544,-,-
BAC42_E16,13,13q33.3,106822257,106930683,108426,-,-
BAC237_O15,13,13q33.3,106908130,106994668,86538,-,-
BAC233_I22,13,13q33.3,106932243,107010073,77830,-,-
BAC250_O15,13,13q33.3,107088958,107183120,94162,-,-
BAC101_E10,13,13q33.3,107132264,107227380,95116,-,-
BAC172_A17,13,13q33.3,107295630,107398637,103007,-,-
BAC243_K20,13,13q33.3,107323186,107410155,86969,-,-
BAC222_N10,13,13q33.3,107393410,107472178,78768,-,-
BAC126_M23,13,13q33.3,107526758,107609365,82607,-,-
BAC206_M19,13,13q33.3,107569780,107651758,81978,-,-
BAC106_G20,13,13q33.3,107573896,107726781,152885,-,-
BAC249_N10,13,13q33.3,107785620,107907504,121884,-,-
BAC75_L04,13,13q33.3,107826905,107916692,89787,-,-
BAC30_J23,13,13q33.3,107928710,108071468,142758,-,-
BAC139_K23,13,13q33.3,108003663,108084733,81070,-,-
BAC55_P10,13,13q33.3,108101065,108189741,88676,-,-
BAC165_K21,13,13q33.3,108237307,108338671,101364,-,-
BAC115_E15,13,13q33.3,108338665,108430637,91972,-,-
BAC45_P13,13,13q33.3,108348069,108500834,152765,-,-
BAC75_H02,13,13q33.3,108348071,108430609,82538,-,-
BAC18_F22,13,13q33.3,108360078,108501214,141136,-,-
BAC32_A20,13,13q33.3,108362905,108445245,82340,-,-
BAC77_A24,13,13q33.3,108445479,108604222,158743,-,-
BAC158_A21,13,13q33.3,108481908,108515538,33630,-,-
BAC70_J02,13,13q33.3,108494299,108647176,152877,-,-
BAC10_H09,13,13q33.3,108651049,108777385,126336,-,-
BAC181_E01,13,13q33.3,108654441,108773968,119527,-,-
BAC73_G01,13,13q33.3,108703053,108799042,95989,-,-
BAC143_P04,13,13q33.3,108715255,108821728,106473,-,-
BAC49_C06,13,13q33.3,108841166,108961729,120563,-,-
BAC36_P21,13,13q33.3,108841166,108917248,76082,-,-
BAC182_M02,13,13q33.3,108941355,109065221,123866,-,-
BAC176_P05,13,13q33.3,108956886,109049157,92271,-,-
BAC57_M22,13,13q33.3-13q34,109065221,109175851,110630,-,-
BAC224_C09,13,13q33.3-13q34,109065243,109155158,89915,-,-
BAC52_B24,13,13q33.3-13q34,109076879,109168236,91357,-,-
BAC182_L06,13,13q34,109158698,109239773,81075,yes,-
BAC155_P19,13,13q34,109175847,109250563,74716,yes,-
BAC41_E02,13,13q34,109240027,109321614,81587,-,-
BAC139_M18,13,13q34,109308079,109402680,94601,-,-
BAC71_P07,13,13q34,109312918,109555855,242937,-,-
BAC101_L05,13,13q34,109327163,109432067,104904,-,-
BAC29_H05,13,13q34,109383385,109486108,102723,-,-
BAC149_D10,13,13q34,109395548,109476843,81295,-,-
BAC70_A04,13,13q34,109411082,109490152,79070,-,-
BAC83_J10,13,13q34,109428260,109545578,117318,-,-
BAC189_K15,13,13q34,109444289,109580492,136203,-,-
BAC4_L14,13,13q34,109476908,109559781,82873,-,-
BAC116_B15,13,13q34,109618954,109723753,104799,-,-
BAC196_K13,13,13q34,109618954,109693623,74669,-,-
BAC227_E06,13,13q34,109656513,109751301,94788,-,-
BAC179_H22,13,13q34,109733174,109850235,117061,-,-
BAC203_K22,13,13q34,109733573,109838468,104895,-,-
BAC46_E07,13,13q34,109743597,109872833,129236,-,-
BAC67_L05,13,13q34,109838349,109961325,122976,-,-
BAC119_G23,13,13q34,109838356,109939257,100901,-,-
BAC125_I13,13,13q34,109893443,109997588,104145,-,-
BAC153_M11,13,13q34,109893703,109990407,96704,-,-
BAC124_H10,13,13q34,109901714,110070557,168843,-,-
BAC252_B11,13,13q34,109901714,110037960,136246,-,-
BAC50_J19,13,13q34,109901714,109999548,97834,-,-
BAC162_L06,13,13q34,109993009,110095270,102261,-,-
BAC81_I09,13,13q34,109999565,110087758,88193,-,-
BAC123_J22,13,13q34,110099891,110191589,91698,-,-
BAC11_D12,13,13q34,110123716,110245540,121824,-,-
BAC92_G16,13,13q34,110139889,110308111,168222,-,-
BAC33_N03,13,13q34,110150263,110305513,155250,-,-
BAC38_K14,13,13q34,110167378,110303069,135691,-,-
BAC136_E15,13,13q34,110213812,110303081,89269,-,-
BAC218_A06,13,13q34,110473823,110578437,104614,-,-
BAC157_D07,13,13q34,110484521,110560657,76136,-,-
BAC233_K15,13,13q34,110533776,110618760,84984,-,-
BAC60_G10,13,13q34,110618753,110704047,85294,-,-
BAC131_B05,13,13q34,110619056,110747631,128575,-,-
BAC137_C08,13,13q34,110663300,110749339,86039,-,-
BAC131_N07,13,13q34,110680274,110759678,79404,-,-
BAC169_N12,13,13q34,110681260,110759678,78418,-,-
BAC149_N08,13,13q34,110699751,110779948,80197,-,-
BAC24_F21,13,13q34,110731585,110896715,165130,-,-
BAC222_D06,13,13q34,110755324,110886965,131641,-,-
BAC179_J14,13,13q34,110779454,110879620,100166,-,-
BAC183_C03,13,13q34,110784995,110868759,83764,-,-
BAC242_I07,13,13q34,110784995,110868756,83761,-,-
BAC234_O10,13,13q34,110785342,110886904,101562,-,-
BAC59_B15,13,13q34,110785342,110879620,94278,-,-
BAC127_B01,13,13q34,110868763,110951196,82433,-,-
BAC27_O07,13,13q34,110886958,111076650,189692,-,-
BAC198_M12,13,13q34,110921370,111047873,126503,-,-
BAC140_K16,13,13q34,110934487,111024795,90308,-,-
BAC106_D12,13,13q34,110951280,111063773,112493,-,-
BAC28_N14,13,13q34,110998350,111119881,121531,-,-
BAC154_H07,13,13q34,111050225,111143321,93096,-,-
BAC169_H09,13,13q34,111562289,111670193,107904,-,-
BAC14_F05,13,13q34,111571208,111665893,94685,-,-
BAC19_D05,13,13q34,111571224,111670185,98961,-,-
BAC88_D17,13,13q34,111576231,111733247,157016,-,-
BAC139_P24,13,13q34,111576496,111652801,76305,-,-
BAC116_D11,13,13q34,111595265,111700978,105713,-,-
BAC220_L23,13,13q34,111609828,111700979,91151,-,-
BAC59_L18,13,13q34,111754486,111858915,104429,-,-
BAC38_K02,13,13q34,111814678,111971386,156708,-,-
BAC56_H03,13,13q34,111833075,111934380,101305,-,-
BAC178_O17,13,13q34,111858910,111922477,63567,-,-
BAC237_L17,13,13q34,111954250,112037678,83428,-,-
BAC153_C19,13,13q34,112003930,112080870,76940,-,-
BAC166_A09,13,13q34,112014195,112101807,87612,-,-
BAC161_N01,13,13q34,112048968,112143052,94084,-,-
BAC235_H06,13,13q34,112083055,112163706,80651,-,-
BAC231_N17,13,13q34,112104579,112163671,59092,-,-
BAC78_J12,13,13q34,112110344,112222391,112047,-,-
BAC41_F14,13,13q34,112130328,112257835,127507,-,-
BAC45_P15,13,13q34,112163701,112271220,107519,-,-
BAC19_I21,13,13q34,112188036,112261471,73435,-,-
BAC39_I22,13,13q34,112222584,112319064,96480,-,-
BAC141_A04,13,13q34,112288199,112422673,134474,-,-
BAC227_L18,13,13q34,112299737,112390746,91009,-,-
BAC39_G09,13,13q34,112372170,112518081,145911,-,-
BAC120_A14,13,13q34,112376028,112502421,126393,-,-
BAC235_J14,13,13q34,112416980,112502421,85441,-,-
BAC33_J17,13,13q34,112428314,112518084,89770,-,-
BAC58_B13,13,13q34,112428314,112518350,90036,-,-
BAC170_F10,13,13q34,112432275,112493416,61141,-,-
BAC81_E07,13,13q34,112432278,112551709,119431,-,-
BAC179_E13,13,13q34,112494800,112590827,96027,-,-
BAC42_L08,13,13q34,112502543,112590828,88285,-,-
BAC17_B09,13,13q34,112502730,112590645,87915,-,-
BAC168_B08,13,13q34,112518082,112590827,72745,-,-
BAC59_L20,13,13q34,112545138,112679773,134635,-,-
BAC84_K16,13,13q34,112545138,112663418,118280,-,-
BAC161_D18,13,13q34,112551020,112663418,112398,-,-
BAC130_F06,13,13q34,112590817,112694965,104148,-,-
BAC247_L14,13,13q34,112590823,112710115,119292,-,-
BAC153_B16,13,13q34,112606709,112710127,103418,-,-
BAC41_O06,13,13q34,112672379,112824290,151911,-,-
BAC211_E09,13,13q34,112685196,112775731,90535,-,-
BAC105_D10,13,13q34,112685197,112782809,97612,-,-
BAC204_D02,13,13q34,112710250,112833988,123738,-,-
BAC132_M02,13,13q34,112710250,112782808,72558,-,-
BAC214_P07,13,13q34,112782801,112878214,95413,-,-
BAC175_H18,13,13q34,112852253,112933997,81744,-,-
BAC193_O13,13,13q34,112878325,112994158,115833,-,-
BAC103_M23,13,13q34,112915863,112984357,68494,-,-
BAC72_B03,13,13q34,112919764,113034992,115228,-,-
BAC226_A05,13,13q34,112924471,113030231,105760,-,-
BAC195_A08,13,13q34,112940865,113047472,106607,-,-
BAC166_A11,13,13q34,112949357,113026873,77516,-,-
BAC132_J07,13,13q34,112970293,113058097,87804,-,-
BAC58_F12,13,13q34,112976535,113082730,106195,-,-
BAC23_O17,13,13q34,112994280,113126708,132428,-,-
BAC232_G07,13,13q34,113034986,113108890,73904,-,-
BAC175_D22,13,13q34,113177430,113263957,86527,-,-
BAC71_M10,13,13q34,113209678,113314157,104479,-,-
BAC96_A02,13,13q34,113209682,113314157,104475,-,-
BAC19_D12,13,13q34,113233646,113334333,100687,-,-
BAC142_F23,13,13q34,113254101,113343266,89165,-,-
BAC230_O02,13,13q34,113261461,113341446,79985,-,-
BAC70_N19,13,13q34,113553318,113643422,90104,-,-
BAC169_I19,13,13q34,113782804,113894229,111425,-,-
BAC53_B11,13,13q34,113815904,113894229,78325,-,-
BAC66_C04,13,13q34,113860776,113878497,17721,-,-
BAC97_H05,13,13q34,113953350,114041755,88405,-,-
BAC218_I16,14,14q11.1,18454742,18539822,85080,-,-
BAC61_C07,14,14q11.1,18545991,18707639,161648,-,-
BAC162_H14,14,14q11.1,18614509,18713974,99465,-,-
BAC250_H12,14,14q11.1,18761666,18852959,91293,-,-
BAC195_D09,14,14q11.1,18819777,18896042,76265,-,-
BAC91_G11,14,14q11.1,18829794,18923665,93871,-,-
BAC31_C17,14,14q11.1,18950250,19042642,92392,-,-
BAC73_K15,14,14q11.1,18958613,19045779,87166,-,-
BAC40_F02,14,14q11.1,18962597,19048712,86115,-,-
BAC127_M16,14,14q11.1-14q11.2,19051351,19167476,116125,-,-
BAC50_N14,14,14q11.1-14q11.2,19061236,19217777,156541,-,-
BAC172_N02,14,14q11.2,19308183,19417944,109761,yes,-
BAC148_K07,14,14q11.2,19466312,19551348,85036,yes,-
BAC56_F19,14,14q11.2,19488150,19591531,103381,yes,-
BAC137_N24,14,14q11.2,19495152,19596561,101409,-,-
BAC26_D22,14,14q11.2,19495157,19588668,93511,yes,-
BAC78_D12,14,14q11.2,19521074,19633603,112529,yes,-
BAC62_H03,14,14q11.2,19536412,19550498,14086,yes,-
BAC226_B22,14,14q11.2,19586175,19677826,91651,yes,-
BAC90_E14,14,14q11.2,19612150,19754403,142253,-,-
BAC150_I18,14,14q11.2,19754396,19834429,80033,-,-
BAC210_O22,14,14q11.2,19803134,19876535,73401,-,-
BAC148_I19,14,14q11.2,19865161,19950061,84900,-,-
BAC122_K10,14,14q11.2,19918659,20058307,139648,-,-
BAC20_C15,14,14q11.2,19967784,20086328,118544,-,-
BAC157_O13,14,14q11.2,19993401,20107918,114517,-,-
BAC78_G22,14,14q11.2,20033116,20143738,110622,-,-
BAC199_D20,14,14q11.2,20105714,20192112,86398,-,-
BAC21_I03,14,14q11.2,20105714,20213072,107358,-,-
BAC154_N06,14,14q11.2,20105714,20175526,69812,-,-
BAC226_L17,14,14q11.2,20197658,20269353,71695,-,-
BAC161_B08,14,14q11.2,20270528,20344873,74345,-,-
BAC1_C14,14,14q11.2,20270597,20356435,85838,-,-
BAC221_J19,14,14q11.2,20439291,20559335,120044,-,-
BAC24_K06,14,14q11.2,20461968,20559277,97309,-,-
BAC53_N16,14,14q11.2,20461968,20574545,112577,-,-
BAC43_N14,14,14q11.2,20467090,20574549,107459,-,-
BAC28_N08,14,14q11.2,20474490,20615796,141306,-,-
BAC241_L05,14,14q11.2,20487137,20559335,72198,-,-
BAC142_N15,14,14q11.2,20494816,20586290,91474,-,-
BAC97_D19,14,14q11.2,20543745,20612795,69050,-,-
BAC220_E06,14,14q11.2,20568021,20685217,117196,-,-
BAC10_N15,14,14q11.2,20694954,20833910,138956,-,-
BAC80_N18,14,14q11.2,20705311,20858028,152717,-,-
BAC36_H01,14,14q11.2,20708172,20818078,109906,-,-
BAC246_D05,14,14q11.2,20736612,20845505,108893,-,-
BAC195_C12,14,14q11.2,20736612,20821196,84584,-,-
BAC33_M15,14,14q11.2,20740882,20833917,93035,-,-
BAC234_N02,14,14q11.2,20837597,20941513,103916,-,-
BAC77_H06,14,14q11.2,20850129,20976039,125910,-,-
BAC88_A22,14,14q11.2,20858063,21008298,150235,-,-
BAC153_G11,14,14q11.2,20872403,20972490,100087,-,-
BAC181_G02,14,14q11.2,20872427,20952918,80491,-,-
BAC226_E16,14,14q11.2,20872440,20972490,100050,-,-
BAC38_N21,14,14q11.2,20922685,21010820,88135,-,-
BAC131_C09,14,14q11.2,21036874,21121313,84439,-,-
BAC230_G17,14,14q11.2,21087532,21193772,106240,-,-
BAC136_B19,14,14q11.2,21096877,21269789,172912,-,-
BAC12_N17,14,14q11.2,21115180,21230585,115405,-,-
BAC124_H01,14,14q11.2,21192550,21292989,100439,-,-
BAC165_B03,14,14q11.2,21232539,21319071,86532,-,-
BAC124_E15,14,14q11.2,21232540,21316379,83839,-,-
BAC124_B10,14,14q11.2,21237295,21341968,104673,-,-
BAC39_J20,14,14q11.2,21258713,21376629,117916,-,-
BAC239_I12,14,14q11.2,21362880,21447600,84720,-,-
BAC175_L22,14,14q11.2,21395230,21484991,89761,-,-
BAC23_F06,14,14q11.2,21445509,21650125,204616,-,-
BAC188_N16,14,14q11.2,21600067,21698388,98321,-,-
BAC231_O23,14,14q11.2,21700958,21804027,103069,-,-
BAC90_P08,14,14q11.2,21717966,21818383,100417,-,-
BAC72_H06,14,14q11.2,21739196,21816473,77277,-,-
BAC100_N01,14,14q11.2,21739196,21810474,71278,-,-
BAC195_N06,14,14q11.2,21804022,21885985,81963,-,-
BAC18_E06,14,14q11.2,21810660,21964689,154029,-,-
BAC172_N20,14,14q11.2,21819337,21921015,101678,-,-
BAC25_N18,14,14q11.2,21971113,22059256,88143,-,-
BAC72_L13,14,14q11.2,22168853,22273463,104610,-,-
BAC33_M08,14,14q11.2,22183052,22341450,158398,-,-
BAC169_D09,14,14q11.2,22269276,22388268,118992,-,-
BAC27_E03,14,14q11.2,22299740,22388268,88528,-,-
BAC190_J06,14,14q11.2,22323846,22405259,81413,-,-
BAC140_D20,14,14q11.2,22323846,22442820,118974,-,-
BAC155_P17,14,14q11.2,22336000,22435052,99052,-,-
BAC41_I23,14,14q11.2,22340223,22446962,106739,-,-
BAC186_E20,14,14q11.2,22431578,22583419,151841,-,-
BAC144_O03,14,14q11.2,22435333,22522282,86949,-,-
BAC101_L09,14,14q11.2,22442813,22564463,121650,-,-
BAC250_N07,14,14q11.2,22504130,22611419,107289,-,-
BAC75_I04,14,14q11.2,22522288,22634424,112136,-,-
BAC80_D20,14,14q11.2,22524982,22611401,86419,-,-
BAC247_M12,14,14q11.2,22534275,22629141,94866,-,-
BAC59_O07,14,14q11.2,22561297,22680334,119037,-,-
BAC130_I02,14,14q11.2,22690826,22790421,99595,-,-
BAC57_H24,14,14q11.2,22733870,22811735,77865,-,-
BAC123_A24,14,14q11.2,22733870,22868035,134165,-,-
BAC180_B06,14,14q11.2,22814693,22913744,99051,-,-
BAC155_A21,14,14q11.2,22868072,22948241,80169,-,-
BAC236_F24,14,14q11.2,22882169,22975980,93811,-,-
BAC189_L04,14,14q11.2,22905059,22975980,70921,-,-
BAC147_B11,14,14q11.2,22948231,23049466,101235,-,-
BAC180_I09,14,14q11.2,22962083,23062947,100864,-,-
BAC79_D21,14,14q11.2,22974588,23070082,95494,-,-
BAC97_G01,14,14q11.2,23046971,23151052,104081,-,-
BAC43_F05,14,14q11.2,23148024,23303996,155972,-,-
BAC158_G09,14,14q11.2,23151319,23228161,76842,-,-
BAC127_O18,14,14q11.2,23160990,23263096,102106,-,-
BAC39_K18,14,14q11.2,23163185,23261845,98660,-,-
BAC182_J09,14,14q11.2,23192296,23272653,80357,-,-
BAC129_B21,14,14q11.2,23280022,23361828,81806,-,-
BAC161_O17,14,14q11.2,23346043,23428943,82900,-,-
BAC110_L06,14,14q11.2,23361836,23534657,172821,yes,-
BAC34_O24,14,14q11.2,23376276,23477314,101038,-,-
BAC22_P13,14,14q11.2,23382469,23579236,196767,yes,-
BAC56_B11,14,14q11.2-14q12,23511575,23664075,152500,yes,-
BAC1_O24,14,14q11.2-14q12,23562420,23638422,76002,-,-
BAC139_J12,14,14q12,23602850,23706814,103964,-,-
BAC134_G14,14,14q12,23664068,23801587,137519,-,-
BAC131_P10,14,14q12,23664285,23760124,95839,-,-
BAC84_H07,14,14q12,23683260,23772398,89138,-,-
BAC77_F16,14,14q12,23740183,23875181,134998,-,-
BAC100_F22,14,14q12,23761441,23854063,92622,-,-
BAC196_P04,14,14q12,23772391,23859112,86721,-,-
BAC141_I12,14,14q12,23854057,23939342,85285,-,-
BAC74_D08,14,14q12,23905054,23988984,83930,-,-
BAC195_B10,14,14q12,23946340,24031907,85567,-,-
BAC218_D05,14,14q12,23954550,24045592,91042,-,-
BAC119_C11,14,14q12,24077386,24185466,108080,-,-
BAC27_I15,14,14q12,24095601,24192918,97317,-,-
BAC167_N07,14,14q12,24147617,24244186,96569,-,-
BAC71_J16,14,14q12,24162134,24291701,129567,-,-
BAC97_E01,14,14q12,24170154,24256608,86454,-,-
BAC125_B13,14,14q12,24170154,24244188,74034,-,-
BAC127_M07,14,14q12,24170154,24291701,121547,-,-
BAC25_C16,14,14q12,24360731,24529705,168974,-,-
BAC26_F20,14,14q12,24416115,24519753,103638,-,-
BAC156_D07,14,14q12,24418424,24510349,91925,-,-
BAC62_O03,14,14q12,24478058,24573118,95060,-,-
BAC187_G18,14,14q12,24531570,24663019,131449,-,-
BAC65_D09,14,14q12,24545417,24680249,134832,-,-
BAC4_B16,14,14q12,24680361,24787182,106821,-,-
BAC37_J04,14,14q12,24988637,25109835,121198,-,-
BAC142_I17,14,14q12,25012614,25104142,91528,-,-
BAC155_H08,14,14q12,25050036,25124479,74443,-,-
BAC18_B15,14,14q12,25423664,25522027,98363,-,-
BAC224_J11,14,14q12,25908634,25993303,84669,-,-
BAC222_N17,14,14q12,25953348,26052309,98961,-,-
BAC101_H04,14,14q12,26293444,26396549,103105,-,-
BAC165_J20,14,14q12,26366700,26440618,73918,-,-
BAC124_D05,14,14q12,26425210,26512964,87754,-,-
BAC101_E09,14,14q12,26541591,26625409,83818,-,-
BAC72_C12,14,14q12,26997810,27133739,135929,-,-
BAC148_I21,14,14q12,27022189,27113907,91718,-,-
BAC30_J02,14,14q12,27140376,27243684,103308,-,-
BAC106_F24,14,14q12,27154848,27236709,81861,-,-
BAC63_P17,14,14q12,27271781,27356815,85034,-,-
BAC22_C15,14,14q12,27372173,27476140,103967,-,-
BAC106_P21,14,14q12,27424410,27583290,158880,-,-
BAC77_P16,14,14q12,27479361,27559331,79970,-,-
BAC247_L11,14,14q12,27498628,27567583,68955,-,-
BAC88_N08,14,14q12,27512118,27668919,156801,-,-
BAC59_F09,14,14q12,27635950,27764011,128061,-,-
BAC238_C15,14,14q12,27686121,27756947,70826,-,-
BAC63_P16,14,14q12,27803232,27882457,79225,-,-
BAC248_N03,14,14q12,27886285,27981161,94876,-,-
BAC8_M06,14,14q12,27988642,28131391,142749,-,-
BAC222_H09,14,14q12,28171756,28294171,122415,-,-
BAC242_N16,14,14q12,28248231,28331740,83509,-,-
BAC244_A03,14,14q12,28294403,28380986,86583,-,-
BAC238_I15,14,14q12,28348709,28458670,109961,-,-
BAC31_A15,14,14q12,28351322,28491299,139977,-,-
BAC147_P24,14,14q12,28360737,28420625,59888,-,-
BAC46_B16,14,14q12,28364129,28461868,97739,-,-
BAC231_D21,14,14q12,28788403,28874824,86421,-,-
BAC198_N18,14,14q12,28792571,28892858,100287,-,-
BAC170_H11,14,14q12,28852643,28956707,104064,-,-
BAC133_A13,14,14q12,28898315,28991113,92798,-,-
BAC248_B23,14,14q12,28955426,29041328,85902,-,-
BAC145_P20,14,14q12,29041489,29119022,77533,-,-
BAC176_J20,14,14q12,29086335,29193587,107252,-,-
BAC177_H19,14,14q12,29095709,29180372,84663,-,-
BAC24_B11,14,14q12,29132566,29238561,105995,-,-
BAC42_H22,14,14q12,29223944,29315461,91517,-,-
BAC10_H01,14,14q12,29398614,29483775,85161,-,-
BAC23_K03,14,14q12,29709871,29799063,89192,-,-
BAC223_P11,14,14q12,29809760,29910087,100327,-,-
BAC183_H11,14,14q12,29904257,29981853,77596,-,-
BAC155_D10,14,14q12,29974390,30065176,90786,-,-
BAC24_G23,14,14q12,29990272,30089192,98920,-,-
BAC140_E12,14,14q12,29998820,30067367,68547,-,-
BAC8_I04,14,14q12,30097380,30178940,81560,-,-
BAC120_G20,14,14q12,30309980,30418523,108543,-,-
BAC157_E16,14,14q12,30333470,30407400,73930,-,-
BAC33_O03,14,14q12,30396822,30530512,133690,-,-
BAC119_F21,14,14q12,30415947,30522098,106151,-,-
BAC205_I23,14,14q12,30470261,30564675,94414,-,-
BAC103_G17,14,14q12,30492549,30616204,123655,-,-
BAC233_J14,14,14q12,30522159,30615882,93723,-,-
BAC12_D18,14,14q12,30522161,30615882,93721,-,-
BAC162_B19,14,14q12,30522522,30604061,81539,-,-
BAC176_A13,14,14q12,30537307,30615882,78575,-,-
BAC39_J10,14,14q12,30657471,30800044,142573,-,-
BAC247_J11,14,14q12,30676104,30786707,110603,-,-
BAC146_K18,14,14q12,30737448,30807203,69755,-,-
BAC60_O08,14,14q12,30745221,30850287,105066,-,-
BAC56_O19,14,14q12,30796280,30881876,85596,-,-
BAC73_E13,14,14q12,30860110,30980940,120830,-,-
BAC157_P13,14,14q12,30885406,30995905,110499,-,-
BAC41_O08,14,14q12,30891220,30970872,79652,-,-
BAC146_K24,14,14q12,30911201,31017716,106515,-,-
BAC52_O20,14,14q12,30940501,31117536,177035,-,-
BAC122_P04,14,14q12,30970920,31081901,110981,-,-
BAC21_E12,14,14q12,31027261,31107220,79959,-,-
BAC69_I17,14,14q12,31055208,31181132,125924,-,-
BAC86_H02,14,14q12,31091111,31248906,157795,-,-
BAC160_O24,14,14q12,31130730,31228541,97811,-,-
BAC1_D12,14,14q12,31137825,31228613,90788,-,-
BAC37_B19,14,14q12,31142826,31307309,164483,-,-
BAC46_G18,14,14q12,31172569,31261863,89294,-,-
BAC93_M19,14,14q12,31191507,31300115,108608,-,-
BAC126_D07,14,14q12,31307418,31433388,125970,-,-
BAC37_H02,14,14q12,31458062,31587747,129685,-,-
BAC125_P15,14,14q12,31501228,31584108,82880,-,-
BAC57_B12,14,14q12,31587746,31691319,103573,-,-
BAC217_I04,14,14q12,31616962,31696763,79801,-,-
BAC248_M03,14,14q12,31687772,31772148,84376,-,-
BAC33_C01,14,14q12-14q13.1,31724704,31824477,99773,-,-
BAC23_P17,14,14q13.1,31893648,32000324,106676,-,-
BAC12_P08,14,14q13.1,32041874,32141925,100051,-,-
BAC141_D20,14,14q13.1,32103202,32213391,110189,-,-
BAC221_D11,14,14q13.1,32324563,32360524,35961,-,-
BAC118_F09,14,14q13.1,32527485,32644713,117228,-,-
BAC202_A02,14,14q13.1,32544210,32630716,86506,-,-
BAC155_D21,14,14q13.1,32564155,32642435,78280,-,-
BAC148_E08,14,14q13.1,32692050,32800251,108201,-,-
BAC70_F20,14,14q13.1,32736583,32826162,89579,-,-
BAC96_C16,14,14q13.1,32770071,32848527,78456,-,-
BAC162_N24,14,14q13.1,32943960,33043073,99113,-,-
BAC176_H12,14,14q13.1,32967629,33060017,92388,-,-
BAC22_E01,14,14q13.1,33051075,33164524,113449,-,-
BAC189_C04,14,14q13.1,33102949,33171896,68947,-,-
BAC146_K22,14,14q13.1,33113712,33171896,58184,-,-
BAC39_I01,14,14q13.1,33131971,33237419,105448,-,-
BAC93_J19,14,14q13.1,33200452,33286535,86083,-,-
BAC86_D07,14,14q13.1,33226128,33309323,83195,-,-
BAC101_F23,14,14q13.1,33271826,33420454,148628,-,-
BAC170_A03,14,14q13.1,33375425,33448200,72775,-,-
BAC199_J05,14,14q13.1,33412681,33496679,83998,-,-
BAC229_B13,14,14q13.1,33426242,33508636,82394,-,-
BAC67_A20,14,14q13.1,33426243,33527890,101647,-,-
BAC106_P10,14,14q13.1,33492008,33573470,81462,-,-
BAC61_A13,14,14q13.1,33495626,33641206,145580,-,-
BAC37_F23,14,14q13.1,33573465,33679373,105908,-,-
BAC141_P16,14,14q13.1,33621652,33707420,85768,-,-
BAC233_F01,14,14q13.1,33635906,33736383,100477,-,-
BAC69_I16,14,14q13.1,33643963,33731640,87677,-,-
BAC67_A22,14,14q13.1,33736421,33816315,79894,-,-
BAC100_B17,14,14q13.1,33738591,33834842,96251,-,-
BAC147_I12,14,14q13.1,33799406,33906448,107042,-,-
BAC218_F19,14,14q13.1,33852875,33976520,123645,-,-
BAC144_A17,14,14q13.1,33904178,33991202,87024,-,-
BAC169_H24,14,14q13.1,33979904,34076921,97017,-,-
BAC145_E17,14,14q13.1-14q13.2,34004508,34117894,113386,-,-
BAC57_B14,14,14q13.1-14q13.2,34004508,34116465,111957,-,-
BAC32_H19,14,14q13.1-14q13.2,34004508,34116426,111918,-,-
BAC232_H15,14,14q13.1-14q13.2,34005517,34130652,125135,-,-
BAC39_D07,14,14q13.1-14q13.2,34022129,34116467,94338,-,-
BAC144_I20,14,14q13.2,34116466,34234580,118114,-,-
BAC252_A23,14,14q13.2,34131989,34233345,101356,-,-
BAC55_K07,14,14q13.2,34137681,34233342,95661,-,-
BAC66_L19,14,14q13.2,34233668,34329824,96156,-,-
BAC204_H12,14,14q13.2,34369746,34453351,83605,-,-
BAC45_G13,14,14q13.2,34420191,34529324,109133,-,-
BAC196_B13,14,14q13.2,34448256,34547246,98990,-,-
BAC12_M21,14,14q13.2,34471823,34577466,105643,-,-
BAC71_E02,14,14q13.2,34547111,34642634,95523,-,-
BAC78_G11,14,14q13.2,34547240,34661826,114586,-,-
BAC169_C08,14,14q13.2,34547251,34627818,80567,-,-
BAC235_I19,14,14q13.2,34584753,34677449,92696,-,-
BAC41_M02,14,14q13.2,34620231,34709082,88851,-,-
BAC124_H03,14,14q13.2,34640456,34738971,98515,-,-
BAC86_C21,14,14q13.2,34700140,34789458,89318,-,-
BAC24_I15,14,14q13.2,34792796,34878121,85325,-,-
BAC208_F15,14,14q13.2,34792896,34878119,85223,-,-
BAC226_N08,14,14q13.2,34878110,34970930,92820,-,-
BAC72_O17,14,14q13.2,35150071,35267574,117503,-,-
BAC200_F13,14,14q13.2,35231557,35311238,79681,-,-
BAC230_B20,14,14q13.2,35267707,35349572,81865,-,-
BAC229_B03,14,14q13.2,35346317,35454874,108557,-,-
BAC61_M13,14,14q13.2,35374444,35476092,101648,-,-
BAC157_J01,14,14q13.2-14q13.3,35509352,35607254,97902,-,-
BAC235_I02,14,14q13.2-14q13.3,35535579,35615198,79619,-,-
BAC148_M01,14,14q13.3,35624858,35756917,132059,-,-
BAC10_J21,14,14q13.3,35807533,35905652,98119,-,-
BAC39_N07,14,14q13.3,35833282,35907900,74618,-,-
BAC219_G01,14,14q13.3,35866902,35949708,82806,-,-
BAC232_B17,14,14q13.3,35900391,35986760,86369,-,-
BAC166_D04,14,14q13.3,35908272,36009634,101362,-,-
BAC129_G23,14,14q13.3,35964799,36053034,88235,-,-
BAC82_M11,14,14q13.3,36076049,36165996,89947,-,-
BAC96_D15,14,14q13.3,36086899,36195498,108599,-,-
BAC67_E08,14,14q13.3,36086899,36164388,77489,-,-
BAC23_C11,14,14q13.3,36097115,36203997,106882,-,-
BAC40_O01,14,14q13.3,36112314,36203992,91678,-,-
BAC59_D05,14,14q13.3,36164268,36317100,152832,-,-
BAC61_K06,14,14q13.3,36175525,36274768,99243,-,-
BAC38_P05,14,14q13.3,36195496,36294969,99473,-,-
BAC78_P23,14,14q13.3,36240174,36392014,151840,-,-
BAC190_F09,14,14q13.3,36304087,36388637,84550,-,-
BAC162_H18,14,14q13.3,36355472,36481107,125635,-,-
BAC163_O10,14,14q13.3,36430924,36527815,96891,-,-
BAC6_N20,14,14q13.3,36488203,36578831,90628,-,-
BAC132_J11,14,14q13.3,36519505,36690618,171113,-,-
BAC152_H19,14,14q13.3,36530274,36616220,85946,-,-
BAC21_A14,14,14q13.3,36720990,36818160,97170,-,-
BAC108_H15,14,14q13.3,36720997,36822782,101785,-,-
BAC60_L03,14,14q13.3-14q21.1,36827143,36919735,92592,-,-
BAC63_E15,14,14q13.3-14q21.1,36842212,36951053,108841,-,-
BAC18_L04,14,14q13.3-14q21.1,36848664,36957636,108972,-,-
BAC227_N18,14,14q13.3-14q21.1,36870153,36957636,87483,-,-
BAC247_I08,14,14q13.3-14q21.1,36870381,36951024,80643,-,-
BAC230_C20,14,14q21.1,37202728,37295677,92949,-,-
BAC120_O23,14,14q21.1,37370877,37438571,67694,-,-
BAC19_N02,14,14q21.1,37443510,37469282,25772,-,-
BAC228_G20,14,14q21.1,37643535,37723544,80009,-,-
BAC244_G12,14,14q21.1,37666271,37746522,80251,-,-
BAC49_F19,14,14q21.1,37743812,37850639,106827,-,-
BAC36_M01,14,14q21.1,37800130,37904904,104774,-,-
BAC144_B11,14,14q21.1,37800130,37904916,104786,-,-
BAC181_A18,14,14q21.1,37897160,37976988,79828,-,-
BAC168_C18,14,14q21.1,37902637,38000161,97524,-,-
BAC117_L23,14,14q21.1,38153764,38253052,99288,-,-
BAC115_L02,14,14q21.1,38228302,38325690,97388,-,-
BAC182_K10,14,14q21.1,38330906,38412784,81878,-,-
BAC95_J24,14,14q21.1,38544745,38658579,113834,-,-
BAC110_P17,14,14q21.1,38569740,38701199,131459,-,-
BAC73_N15,14,14q21.1,38573765,38658579,84814,-,-
BAC59_C05,14,14q21.1,38594632,38702980,108348,-,-
BAC96_M01,14,14q21.1,38709067,38783524,74457,-,-
BAC70_F08,14,14q21.1,38806059,38890076,84017,-,-
BAC97_K17,14,14q21.1,38831219,38931851,100632,-,-
BAC132_O06,14,14q21.1,38858485,38938805,80320,-,-
BAC76_M10,14,14q21.1,38897312,39024084,126772,-,-
BAC103_K14,14,14q21.1,38933837,39073972,140135,-,-
BAC86_B18,14,14q21.1,38961631,39105455,143824,-,-
BAC154_I02,14,14q21.1,39024079,39106963,82884,-,-
BAC84_C15,14,14q21.1,39376065,39489808,113743,-,-
BAC149_I01,14,14q21.1,39411979,39498810,86831,-,-
BAC91_P04,14,14q21.1,39438633,39540478,101845,-,-
BAC49_L15,14,14q21.1,39620964,39724115,103151,-,-
BAC45_I07,14,14q21.1,39842951,39926174,83223,-,-
BAC134_J13,14,14q21.1,40021497,40115981,94484,-,-
BAC103_A24,14,14q21.1,40500637,40592411,91774,-,-
BAC236_K10,14,14q21.1,40598067,40683347,85280,-,-
BAC103_M10,14,14q21.1,40619903,40776497,156594,-,-
BAC102_M18,14,14q21.1,40853142,40963140,109998,-,-
BAC243_C09,14,14q21.1-14q21.2,40969134,41086476,117342,-,-
BAC132_E05,14,14q21.2,41005263,41102526,97263,-,-
BAC156_I18,14,14q21.2,41033840,41102186,68346,-,-
BAC60_D07,14,14q21.2,41239572,41375961,136389,-,-
BAC43_E18,14,14q21.2,41571977,41692471,120494,-,-
BAC125_C20,14,14q21.2,41767409,41861055,93646,-,-
BAC106_B17,14,14q21.2,41773844,41926125,152281,-,-
BAC74_N14,14,14q21.2,42140385,42235977,95592,-,-
BAC36_J23,14,14q21.2,42197786,42301690,103904,-,-
BAC217_F08,14,14q21.2,42452055,42508818,56763,-,-
BAC10_G06,14,14q21.2,42604944,42717606,112662,-,-
BAC175_I15,14,14q21.2,42692373,42777256,84883,-,-
BAC35_J12,14,14q21.2,42763205,42839651,76446,-,-
BAC217_F14,14,14q21.2,42842377,42938578,96201,-,-
BAC76_I14,14,14q21.2,43004516,43103866,99350,-,-
BAC156_C13,14,14q21.2,43075893,43153089,77196,-,-
BAC228_A17,14,14q21.2,43083549,43147263,63714,-,-
BAC78_N24,14,14q21.2,43083549,43161035,77486,-,-
BAC252_N23,14,14q21.3,43340688,43424995,84307,-,-
BAC252_P11,14,14q21.3,43340688,43424995,84307,-,-
BAC225_C15,14,14q21.3,43641671,43725620,83949,-,-
BAC90_M08,14,14q21.3,43811048,43910683,99635,-,-
BAC139_K11,14,14q21.3,43969339,44050775,81436,-,-
BAC219_K05,14,14q21.3,43969361,44049547,80186,-,-
BAC38_O13,14,14q21.3,44004081,44106767,102686,-,-
BAC73_L15,14,14q21.3,44032186,44138594,106408,-,-
BAC24_D01,14,14q21.3,44155889,44241350,85461,-,-
BAC240_C14,14,14q21.3,44264420,44348098,83678,-,-
BAC83_N21,14,14q21.3,44279946,44422091,142145,-,-
BAC105_O14,14,14q21.3,44355635,44453472,97837,-,-
BAC206_O21,14,14q21.3,44408569,44501433,92864,-,-
BAC101_H01,14,14q21.3,44411557,44502974,91417,-,-
BAC75_F19,14,14q21.3,44524618,44640323,115705,-,-
BAC250_C21,14,14q21.3,44578336,44690323,111987,-,-
BAC32_G04,14,14q21.3,44578336,44691443,113107,-,-
BAC112_I04,14,14q21.3,44635401,44747763,112362,-,-
BAC128_F22,14,14q21.3,44668795,44780497,111702,-,-
BAC156_G03,14,14q21.3,44676044,44800522,124478,-,-
BAC69_L24,14,14q21.3,44679845,44811121,131276,-,-
BAC177_M09,14,14q21.3,44683491,44811121,127630,-,-
BAC39_P01,14,14q21.3,44686280,44780497,94217,-,-
BAC107_N16,14,14q21.3,44721117,44816960,95843,-,-
BAC191_C18,14,14q21.3,44739692,44816960,77268,-,-
BAC84_I08,14,14q21.3,44750838,44863887,113049,-,-
BAC89_M10,14,14q21.3,44854627,44943197,88570,-,-
BAC71_N05,14,14q21.3,45096779,45191309,94530,-,-
BAC244_F09,14,14q21.3,45097176,45175819,78643,-,-
BAC172_A02,14,14q21.3,45130401,45210770,80369,-,-
BAC86_N15,14,14q21.3,45165144,45267752,102608,-,-
BAC190_A08,14,14q21.3,45314028,45397559,83531,-,-
BAC117_K23,14,14q21.3,45743007,45858040,115033,-,-
BAC11_N15,14,14q21.3,45744647,45832196,87549,-,-
BAC28_F14,14,14q21.3,45746890,45935139,188249,-,-
BAC90_M15,14,14q21.3,45832192,45925636,93444,-,-
BAC33_A15,14,14q21.3,45918868,46025683,106815,-,-
BAC48_J11,14,14q21.3,46210720,46318421,107701,-,-
BAC182_N14,14,14q21.3,46238638,46318425,79787,-,-
BAC37_K09,14,14q21.3,46529853,46639288,109435,-,-
BAC44_P06,14,14q21.3,46619859,46726870,107011,-,-
BAC147_C19,14,14q21.3,46646503,46727989,81486,-,-
BAC198_M17,14,14q21.3,46752205,46866806,114601,-,-
BAC159_K12,14,14q21.3,46848876,46931712,82836,-,-
BAC117_A14,14,14q21.3,46867068,46973001,105933,-,-
BAC51_B18,14,14q21.3,46987130,47091232,104102,-,-
BAC68_O04,14,14q21.3,47170898,47282550,111652,-,-
BAC60_B18,14,14q21.3,47194850,47301219,106369,-,-
BAC169_I17,14,14q21.3,47251542,47344597,93055,-,-
BAC228_G16,14,14q21.3,47402908,47478332,75424,-,-
BAC226_P23,14,14q21.3,47439290,47529701,90411,-,-
BAC113_M03,14,14q21.3,47583172,47665160,81988,-,-
BAC196_N07,14,14q21.3,47590989,47708649,117660,-,-
BAC225_E07,14,14q21.3,47644303,47729695,85392,-,-
BAC49_B03,14,14q21.3,47769713,47862920,93207,-,-
BAC113_G18,14,14q21.3,47910732,48013220,102488,-,-
BAC110_J06,14,14q21.3,47927338,48031398,104060,-,-
BAC146_L07,14,14q21.3,47960854,48041811,80957,-,-
BAC123_G13,14,14q21.3,47995866,48080828,84962,-,-
BAC68_G13,14,14q21.3,48138613,48246392,107779,-,-
BAC146_J16,14,14q21.3,48154185,48252616,98431,-,-
BAC123_A11,14,14q21.3,48154189,48252616,98427,-,-
BAC244_M01,14,14q21.3,48169329,48235431,66102,-,-
BAC56_E06,14,14q22.1,48588507,48690352,101845,-,-
BAC8_L13,14,14q22.1,48589181,48669079,79898,-,-
BAC219_N15,14,14q22.1,48629786,48732079,102293,-,-
BAC146_J23,14,14q22.1,48659870,48720537,60667,-,-
BAC249_D16,14,14q22.1,48698182,48768753,70571,-,-
BAC181_M23,14,14q22.1,48871898,48952953,81055,-,-
BAC116_J23,14,14q22.1,48871917,48993385,121468,-,-
BAC118_P03,14,14q22.1,49054700,49169383,114683,-,-
BAC38_N09,14,14q22.1,49073081,49189193,116112,-,-
BAC124_F13,14,14q22.1,49087612,49188969,101357,-,-
BAC118_F13,14,14q22.1,49124483,49262125,137642,-,-
BAC43_O09,14,14q22.1,49176275,49246623,70348,-,-
BAC158_G08,14,14q22.1,49191479,49291493,100014,-,-
BAC49_H05,14,14q22.1,49191500,49289491,97991,-,-
BAC158_H08,14,14q22.1,49191557,49291489,99932,-,-
BAC76_M15,14,14q22.1,49233423,49319306,85883,-,-
BAC37_D08,14,14q22.1,49257254,49394153,136899,-,-
BAC224_E14,14,14q22.1,49360306,49448843,88537,-,-
BAC64_H22,14,14q22.1,49393809,49495018,101209,-,-
BAC192_A24,14,14q22.1,49393830,49489853,96023,-,-
BAC88_G14,14,14q22.1,49394150,49509063,114913,-,-
BAC65_M17,14,14q22.1,49401036,49494708,93672,-,-
BAC108_L11,14,14q22.1,49405530,49490128,84598,-,-
BAC161_O06,14,14q22.1,49405553,49490128,84575,-,-
BAC238_B08,14,14q22.1,49444258,49570040,125782,-,-
BAC2_D11,14,14q22.1,49444323,49527864,83541,-,-
BAC176_I20,14,14q22.1,49490122,49638157,148035,-,-
BAC167_M14,14,14q22.1,49508148,49589746,81598,-,-
BAC218_I20,14,14q22.1,49536936,49633578,96642,-,-
BAC224_K07,14,14q22.1,49536946,49606311,69365,-,-
BAC100_J12,14,14q22.1,49606698,49711671,104973,-,-
BAC237_C10,14,14q22.1,49623873,49711675,87802,-,-
BAC143_A23,14,14q22.1,49623896,49711675,87779,-,-
BAC136_O07,14,14q22.1,49653815,49751168,97353,-,-
BAC140_L01,14,14q22.1,49679816,49762474,82658,-,-
BAC86_B09,14,14q22.1,49698977,49787032,88055,-,-
BAC43_P18,14,14q22.1,49718477,49818923,100446,-,-
BAC31_K10,14,14q22.1,49769119,49891372,122253,-,-
BAC58_P23,14,14q22.1,49769136,49875735,106599,-,-
BAC131_G21,14,14q22.1,49787028,49914189,127161,-,-
BAC30_F05,14,14q22.1,49872795,49962106,89311,-,-
BAC72_B06,14,14q22.1,49875729,49960636,84907,-,-
BAC160_H23,14,14q22.1,49966868,50034168,67300,-,-
BAC78_L14,14,14q22.1,49973178,50107873,134695,-,-
BAC89_K11,14,14q22.1,50168709,50255748,87039,-,-
BAC50_D21,14,14q22.1,50170130,50282212,112082,-,-
BAC38_F23,14,14q22.1,50239219,50355185,115966,-,-
BAC144_F16,14,14q22.1,50255743,50322974,67231,-,-
BAC172_G02,14,14q22.1,50293501,50376225,82724,-,-
BAC167_F01,14,14q22.1,50334013,50439436,105423,-,-
BAC228_D14,14,14q22.1,50376220,50513326,137106,-,-
BAC82_K09,14,14q22.1,50399167,50496364,97197,-,-
BAC112_A02,14,14q22.1,50399167,50517448,118281,-,-
BAC143_G20,14,14q22.1,50418049,50517448,99399,-,-
BAC218_M12,14,14q22.1,50434893,50510483,75590,-,-
BAC176_L02,14,14q22.1,50466470,50577099,110629,-,-
BAC155_L18,14,14q22.1,50471179,50564769,93590,-,-
BAC199_N12,14,14q22.1,50518328,50611415,93087,-,-
BAC124_G01,14,14q22.1,50577134,50726005,148871,-,-
BAC167_L22,14,14q22.1,50662664,50747133,84469,-,-
BAC149_C05,14,14q22.1,50807906,50897683,89777,-,-
BAC45_P03,14,14q22.1,50814521,50927493,112972,-,-
BAC181_I21,14,14q22.1,50852399,50943199,90800,-,-
BAC227_H05,14,14q22.1,50889251,50927545,38294,-,-
BAC39_O09,14,14q22.1,50927566,51048884,121318,-,-
BAC80_E03,14,14q22.1,50955209,51050091,94882,-,-
BAC154_E24,14,14q22.1,50956194,51047492,91298,-,-
BAC96_H03,14,14q22.1,51045245,51148135,102890,-,-
BAC57_M23,14,14q22.1,51048878,51152440,103562,-,-
BAC140_B05,14,14q22.1,51270158,51341158,71000,-,-
BAC64_E19,14,14q22.1,51345047,51501548,156501,-,-
BAC152_N23,14,14q22.1,51345047,51408619,63572,-,-
BAC92_H21,14,14q22.1,51383327,51467257,83930,-,-
BAC240_N24,14,14q22.1,51398676,51512101,113425,-,-
BAC72_P15,14,14q22.1,51417570,51488823,71253,-,-
BAC176_P19,14,14q22.1,51417570,51512101,94531,-,-
BAC228_D03,14,14q22.1,51422596,51512101,89505,-,-
BAC57_P22,14,14q22.1,51454683,51536979,82296,-,-
BAC154_I22,14,14q22.1,51476589,51566940,90351,-,-
BAC179_C06,14,14q22.1,51480971,51577554,96583,-,-
BAC60_B05,14,14q22.1,51593280,51695597,102317,-,-
BAC38_G06,14,14q22.1,51817640,51900604,82964,-,-
BAC89_A16,14,14q22.1,51817665,51900720,83055,-,-
BAC88_I22,14,14q22.1,51819728,51918710,98982,-,-
BAC136_P21,14,14q22.1,51829096,51924409,95313,-,-
BAC191_I14,14,14q22.1,51837094,51918963,81869,-,-
BAC61_E05,14,14q22.1,51858060,52028455,170395,-,-
BAC221_F01,14,14q22.1,51940824,52032211,91387,-,-
BAC150_M20,14,14q22.1,51967692,52063022,95330,-,-
BAC105_M18,14,14q22.1,52101822,52237565,135743,-,-
BAC234_F20,14,14q22.1,52158983,52248616,89633,-,-
BAC148_A19,14,14q22.1-14q22.2,52293484,52380177,86693,-,-
BAC58_N04,14,14q22.1-14q22.2,52299377,52381929,82552,-,-
BAC208_E05,14,14q22.2,52380264,52493912,113648,-,-
BAC108_D14,14,14q22.2,52396856,52517855,120999,-,-
BAC111_N22,14,14q22.2,52402174,52503332,101158,-,-
BAC44_P03,14,14q22.2,52432876,52517853,84977,-,-
BAC213_O13,14,14q22.2,52442888,52556871,113983,-,-
BAC149_I19,14,14q22.2,52474563,52557020,82457,-,-
BAC18_P24,14,14q22.2,52524798,52656065,131267,-,-
BAC131_C23,14,14q22.2,52529201,52654420,125219,-,-
BAC234_N13,14,14q22.2,52663494,52740054,76560,-,-
BAC23_G22,14,14q22.2,52692403,52785911,93508,-,-
BAC60_M22,14,14q22.2,52692403,52786320,93917,-,-
BAC176_I16,14,14q22.2,52753253,52834472,81219,-,-
BAC33_A01,14,14q22.2,52794549,52926354,131805,-,-
BAC196_H13,14,14q22.2,52874640,52954645,80005,-,-
BAC49_D08,14,14q22.2,52882940,52973372,90432,-,-
BAC118_F02,14,14q22.2,52954639,53089616,134977,-,-
BAC113_N16,14,14q22.2,53062382,53182739,120357,-,-
BAC220_P05,14,14q22.2,53089610,53182917,93307,-,-
BAC219_I17,14,14q22.2,53103777,53218518,114741,-,-
BAC240_J20,14,14q22.2,53110921,53193290,82369,-,-
BAC170_L20,14,14q22.2,53341218,53434526,93308,-,-
BAC113_F17,14,14q22.2,53351518,53455895,104377,-,-
BAC45_I05,14,14q22.2,53467461,53603240,135779,-,-
BAC136_N21,14,14q22.2,53496190,53603261,107071,-,-
BAC235_A08,14,14q22.2,53500822,53603261,102439,-,-
BAC68_P04,14,14q22.2,53580685,53683156,102471,-,-
BAC26_L21,14,14q22.2,53610940,53730454,119514,-,-
BAC169_E22,14,14q22.2,53675948,53777180,101232,-,-
BAC58_P12,14,14q22.2,53703018,53825303,122285,-,-
BAC107_P04,14,14q22.2,53708731,53874346,165615,-,-
BAC150_J09,14,14q22.2,53726273,53825306,99033,-,-
BAC82_F05,14,14q22.2,53758494,53863823,105329,-,-
BAC167_B12,14,14q22.2,53777270,53918696,141426,-,-
BAC51_J23,14,14q22.2,53870711,53886698,15987,-,-
BAC25_M16,14,14q22.2,54088050,54265391,177341,-,-
BAC242_L08,14,14q22.2,54193411,54280361,86950,-,-
BAC154_B22,14,14q22.2-14q22.3,54327591,54423681,96090,-,-
BAC67_N17,14,14q22.2-14q22.3,54350698,54471776,121078,-,-
BAC160_E03,14,14q22.2-14q22.3,54350857,54451523,100666,-,-
BAC42_I11,14,14q22.2-14q22.3,54350889,54474205,123316,-,-
BAC126_K16,14,14q22.2-14q22.3,54384152,54596202,212050,-,-
BAC43_F18,14,14q22.3,54424439,54531902,107463,-,-
BAC139_D24,14,14q22.3,54437851,54522412,84561,-,-
BAC89_F18,14,14q22.3,54451641,54560997,109356,-,-
BAC232_I22,14,14q22.3,54474199,54548845,74646,-,-
BAC124_M11,14,14q22.3,54503787,54602806,99019,-,-
BAC158_E24,14,14q22.3,54503801,54567781,63980,-,-
BAC190_J14,14,14q22.3,54523921,54608640,84719,-,-
BAC61_N05,14,14q22.3,54567776,54655629,87853,-,-
BAC100_I19,14,14q22.3,54568723,54682476,113753,-,-
BAC40_O13,14,14q22.3,54582728,54755760,173032,-,-
BAC102_D16,14,14q22.3,54596196,54684298,88102,-,-
BAC15_A15,14,14q22.3,54615060,54737710,122650,-,-
BAC243_F19,14,14q22.3,54690922,54805011,114089,-,-
BAC183_D04,14,14q22.3,54724186,54805226,81040,-,-
BAC63_B13,14,14q22.3,54758531,54906072,147541,-,-
BAC81_C18,14,14q22.3,54759648,54898027,138379,-,-
BAC168_K08,14,14q22.3,54759648,54869716,110068,-,-
BAC78_H08,14,14q22.3,54807324,54882661,75337,-,-
BAC155_C08,14,14q22.3,54818487,54898027,79540,-,-
BAC24_D23,14,14q22.3,54882660,55025380,142720,-,-
BAC25_H17,14,14q22.3,54898036,54976569,78533,-,-
BAC122_K12,14,14q22.3,54900117,55041825,141708,-,-
BAC66_F23,14,14q22.3,54906121,55020286,114165,-,-
BAC126_B07,14,14q22.3,54918600,55078495,159895,-,-
BAC67_I07,14,14q22.3,55009757,55093341,83584,-,-
BAC102_N12,14,14q22.3,55022625,55124207,101582,-,-
BAC168_A04,14,14q22.3,55064758,55170025,105267,-,-
BAC224_G02,14,14q22.3,55070434,55180536,110102,-,-
BAC247_K07,14,14q22.3,55242202,55328362,86160,-,-
BAC120_F03,14,14q22.3,55288817,55432354,143537,-,-
BAC50_L08,14,14q22.3,55329745,55468255,138510,-,-
BAC165_P17,14,14q22.3,55356628,55468269,111641,-,-
BAC178_L05,14,14q22.3,55421214,55527031,105817,-,-
BAC115_N22,14,14q22.3,55490191,55587688,97497,-,-
BAC204_G12,14,14q22.3,55547818,55648661,100843,-,-
BAC239_K10,14,14q22.3,55688730,55773588,84858,-,-
BAC248_H14,14,14q22.3-14q23.1,55774053,55864627,90574,-,-
BAC131_J20,14,14q22.3-14q23.1,55785649,55913579,127930,-,-
BAC80_J19,14,14q22.3-14q23.1,55788298,55895235,106937,-,-
BAC1_O14,14,14q23.1,55834586,55937391,102805,-,-
BAC134_N15,14,14q23.1,55846713,55965921,119208,-,-
BAC52_J11,14,14q23.1,55929099,56032526,103427,-,-
BAC26_C06,14,14q23.1,55931447,56021510,90063,-,-
BAC155_O15,14,14q23.1,55937383,56037249,99866,-,-
BAC29_L05,14,14q23.1,56073713,56212472,138759,-,-
BAC121_F24,14,14q23.1,56134311,56223006,88695,-,-
BAC42_O19,14,14q23.1,56179769,56335564,155795,-,-
BAC133_J18,14,14q23.1,56185032,56278999,93967,-,-
BAC74_M20,14,14q23.1,56194527,56278995,84468,-,-
BAC20_F23,14,14q23.1,56202212,56316362,114150,-,-
BAC26_D01,14,14q23.1,56223063,56316365,93302,-,-
BAC97_H01,14,14q23.1,56223065,56323464,100399,-,-
BAC79_J20,14,14q23.1,56316365,56426133,109768,-,-
BAC65_O19,14,14q23.1,56316554,56399329,82775,-,-
BAC248_N04,14,14q23.1,56329010,56435191,106181,-,-
BAC120_J12,14,14q23.1,56338332,56439031,100699,-,-
BAC29_D06,14,14q23.1,56435196,56523082,87886,-,-
BAC12_M13,14,14q23.1,56459688,56535575,75887,-,-
BAC58_G08,14,14q23.1,56462687,56546254,83567,-,-
BAC133_L20,14,14q23.1,56748912,56851553,102641,-,-
BAC79_C07,14,14q23.1,56851591,56932181,80590,-,-
BAC149_E10,14,14q23.1,56895009,56989352,94343,-,-
BAC83_L02,14,14q23.1,56917205,57005892,88687,-,-
BAC41_I08,14,14q23.1,56981353,57042464,61111,-,-
BAC187_H17,14,14q23.1,56981805,57065478,83673,-,-
BAC157_K02,14,14q23.1,57063654,57150110,86456,-,-
BAC104_E09,14,14q23.1,57185038,57303278,118240,-,-
BAC57_K17,14,14q23.1,57277925,57430902,152977,-,-
BAC200_P04,14,14q23.1,57472756,57560612,87856,-,-
BAC56_I09,14,14q23.1,57537799,57640708,102909,-,-
BAC173_A06,14,14q23.1,57561147,57640663,79516,-,-
BAC187_K02,14,14q23.1,57622936,57711091,88155,-,-
BAC179_B15,14,14q23.1,57721350,57802138,80788,-,-
BAC12_B05,14,14q23.1,57731543,57826998,95455,-,-
BAC156_A06,14,14q23.1,57812365,57889155,76790,-,-
BAC73_P16,14,14q23.1,57827065,57896947,69882,-,-
BAC40_E23,14,14q23.1,57877743,57985886,108143,-,-
BAC41_K04,14,14q23.1,57942818,58075738,132920,-,-
BAC59_E11,14,14q23.1,58062331,58145512,83181,-,-
BAC102_F05,14,14q23.1,58071896,58172368,100472,-,-
BAC42_A12,14,14q23.1,58086906,58242540,155634,-,-
BAC48_G07,14,14q23.1,58105969,58244763,138794,-,-
BAC56_K02,14,14q23.1,58236239,58325212,88973,-,-
BAC229_J06,14,14q23.1,58348449,58435630,87181,-,-
BAC57_A07,14,14q23.1,58564834,58660540,95706,-,-
BAC80_M23,14,14q23.1,58646248,58751977,105729,-,-
BAC50_I09,14,14q23.1,58784060,58905688,121628,-,-
BAC170_H08,14,14q23.1,58927555,59015384,87829,-,-
BAC238_K09,14,14q23.1,58940985,59016613,75628,-,-
BAC148_I05,14,14q23.1,58949588,59037509,87921,-,-
BAC107_B08,14,14q23.1,59084219,59261877,177658,-,-
BAC234_N20,14,14q23.1,59099636,59196116,96480,-,-
BAC126_H16,14,14q23.1,59158938,59261877,102939,-,-
BAC229_H02,14,14q23.1,59170218,59265156,94938,-,-
BAC42_H12,14,14q23.1,59258206,59369048,110842,-,-
BAC26_P22,14,14q23.1,59261213,59373502,112289,-,-
BAC80_J23,14,14q23.1,59307949,59493363,185414,-,-
BAC150_H13,14,14q23.1,59340672,59419141,78469,-,-
BAC100_C24,14,14q23.1,59409874,59499251,89377,-,-
BAC239_J14,14,14q23.1,59409887,59481016,71129,-,-
BAC20_L16,14,14q23.1,59481631,59596649,115018,-,-
BAC153_F03,14,14q23.1,59596669,59700619,103950,-,-
BAC232_H19,14,14q23.1,59779648,59886668,107020,-,-
BAC195_B22,14,14q23.1,59782792,59865052,82260,-,-
BAC120_P21,14,14q23.1,59830291,59914547,84256,-,-
BAC59_D22,14,14q23.1,59919485,60011213,91728,-,-
BAC82_F16,14,14q23.1,60025145,60118785,93640,-,-
BAC106_H23,14,14q23.1,60031584,60116898,85314,-,-
BAC149_D05,14,14q23.1,60064128,60163979,99851,-,-
BAC48_F02,14,14q23.1,60068621,60166652,98031,-,-
BAC96_P02,14,14q23.1,60163392,60269291,105899,-,-
BAC215_K18,14,14q23.1,60182569,60269010,86441,-,-
BAC34_F08,14,14q23.1,60219571,60290678,71107,-,-
BAC32_J16,14,14q23.1,60273127,60419544,146417,-,-
BAC55_E15,14,14q23.1,60286774,60369997,83223,-,-
BAC200_H04,14,14q23.1,60287024,60366162,79138,-,-
BAC50_H02,14,14q23.1,60520520,60637570,117050,-,-
BAC67_H07,14,14q23.1,60520520,60626242,105722,-,-
BAC160_L17,14,14q23.1,60558385,60686963,128578,-,-
BAC43_M20,14,14q23.1,60569316,60671228,101912,-,-
BAC74_O02,14,14q23.1,60571298,60703910,132612,-,-
BAC150_P08,14,14q23.1,60618354,60703911,85557,-,-
BAC197_O09,14,14q23.1,60671218,60750637,79419,-,-
BAC235_B21,14,14q23.1,60684713,60775314,90601,-,-
BAC147_O06,14,14q23.1,60693644,60790423,96779,-,-
BAC75_M20,14,14q23.1,60701330,60833501,132171,-,-
BAC31_B23,14,14q23.1,60776108,60856334,80226,-,-
BAC252_N07,14,14q23.1,60790725,60881306,90581,-,-
BAC72_A14,14,14q23.1,60802601,60884383,81782,-,-
BAC243_L11,14,14q23.1,60828274,60929995,101721,-,-
BAC192_G20,14,14q23.1,60881299,60986327,105028,-,-
BAC208_M17,14,14q23.1,60881475,61019200,137725,-,-
BAC199_D17,14,14q23.1,60884376,60965170,80794,-,-
BAC18_I08,14,14q23.1,60914709,61019782,105073,-,-
BAC115_C09,14,14q23.1,60997202,61125415,128213,-,-
BAC191_M10,14,14q23.1,61019784,61107436,87652,-,-
BAC157_B04,14,14q23.1,61019784,61106681,86897,-,-
BAC56_D10,14,14q23.1,61057116,61153134,96018,-,-
BAC30_O15,14,14q23.1-14q23.2,61118185,61217457,99272,-,-
BAC185_E04,14,14q23.1-14q23.2,61165684,61265888,100204,-,-
BAC252_P13,14,14q23.1-14q23.2,61168219,61278892,110673,-,-
BAC114_B14,14,14q23.2,61276560,61350744,74184,-,-
BAC218_M05,14,14q23.2,61278886,61349984,71098,-,-
BAC131_L19,14,14q23.2,61303388,61326694,23306,-,-
BAC220_H12,14,14q23.2,61307822,61421238,113416,-,-
BAC8_N13,14,14q23.2,61307836,61409690,101854,-,-
BAC125_E18,14,14q23.2,61310824,61409690,98866,-,-
BAC82_H20,14,14q23.2,61440278,61588840,148562,-,-
BAC172_O07,14,14q23.2,61594834,61679849,85015,-,-
BAC70_M14,14,14q23.2,61679902,61804141,124239,-,-
BAC36_E07,14,14q23.2,61891796,62002397,110601,-,-
BAC234_N03,14,14q23.2,61892128,61979087,86959,-,-
BAC244_H17,14,14q23.2,62058888,62144753,85865,-,-
BAC119_B15,14,14q23.2,62167284,62284075,116791,-,-
BAC57_H09,14,14q23.2,62277118,62358742,81624,-,-
BAC54_G09,14,14q23.2,62278782,62372074,93292,-,-
BAC132_I01,14,14q23.2,62455676,62526741,71065,-,-
BAC155_G23,14,14q23.2,62723036,62791936,68900,-,-
BAC24_N10,14,14q23.2,62765973,62894622,128649,-,-
BAC83_K01,14,14q23.2,62829541,62914872,85331,-,-
BAC17_B13,14,14q23.2,62829547,62918035,88488,-,-
BAC224_F02,14,14q23.2,62914866,62992529,77663,-,-
BAC123_C08,14,14q23.2,62943798,63036199,92401,-,-
BAC228_K08,14,14q23.2,62948852,63026215,77363,-,-
BAC41_D03,14,14q23.2,62970160,63067050,96890,-,-
BAC103_I03,14,14q23.2,63011960,63099683,87723,-,-
BAC192_M05,14,14q23.2,63023933,63100518,76585,-,-
BAC57_E12,14,14q23.2,63050145,63067950,17805,-,-
BAC235_O14,14,14q23.2,63079254,63183531,104277,-,-
BAC145_F05,14,14q23.2,63080025,63165409,85384,-,-
BAC118_P24,14,14q23.2,63080033,63180560,100527,-,-
BAC215_I08,14,14q23.2,63080082,63153864,73782,-,-
BAC63_D22,14,14q23.2,63165579,63247022,81443,-,-
BAC128_B02,14,14q23.2,63168189,63247037,78848,-,-
BAC92_L04,14,14q23.2,63199686,63300704,101018,-,-
BAC241_O03,14,14q23.2,63220431,63300701,80270,-,-
BAC76_G20,14,14q23.2,63252341,63348365,96024,-,-
BAC15_A17,14,14q23.2,63279265,63427313,148048,-,-
BAC81_F19,14,14q23.2,63438530,63556857,118327,-,-
BAC40_P03,14,14q23.2,63460461,63556840,96379,-,-
BAC190_N21,14,14q23.2,63486302,63556857,70555,-,-
BAC148_P18,14,14q23.2,63504847,63603990,99143,-,-
BAC75_P11,14,14q23.2,63547062,63650667,103605,-,-
BAC69_N24,14,14q23.2,63556854,63640489,83635,-,-
BAC46_P23,14,14q23.2,63556855,63667548,110693,-,-
BAC205_G16,14,14q23.2,63561720,63641424,79704,-,-
BAC67_P21,14,14q23.2,63575643,63650667,75024,-,-
BAC57_D01,14,14q23.2,63640486,63739083,98597,-,-
BAC88_E12,14,14q23.2,63641418,63737396,95978,-,-
BAC27_J21,14,14q23.2,63826292,63906003,79711,-,-
BAC63_G15,14,14q23.2,63826305,63910823,84518,-,-
BAC60_O15,14,14q23.2,63826314,63924136,97822,-,-
BAC52_O13,14,14q23.2,63833163,63978615,145452,-,-
BAC83_P13,14,14q23.2-14q23.3,63953170,64031099,77929,-,-
BAC154_P23,14,14q23.2-14q23.3,63955500,64055185,99685,-,-
BAC160_F13,14,14q23.2-14q23.3,63987197,64079174,91977,-,-
BAC42_L01,14,14q23.3,64060629,64179049,118420,-,-
BAC224_A21,14,14q23.3,64123994,64269232,145238,-,-
BAC158_G17,14,14q23.3,64129110,64228697,99587,-,-
BAC46_P17,14,14q23.3,64129127,64235854,106727,-,-
BAC83_H09,14,14q23.3,64142598,64238080,95482,-,-
BAC117_D11,14,14q23.3,64246547,64332556,86009,-,-
BAC36_D06,14,14q23.3,64254610,64345032,90422,-,-
BAC52_G15,14,14q23.3,64386667,64475541,88874,-,-
BAC26_D23,14,14q23.3,64426922,64558651,131729,-,-
BAC150_D23,14,14q23.3,64455329,64525591,70262,-,-
BAC218_M21,14,14q23.3,64476971,64558655,81684,-,-
BAC234_I18,14,14q23.3,64629513,64714390,84877,-,-
BAC58_J08,14,14q23.3,64636039,64763297,127258,-,-
BAC162_H21,14,14q23.3,64671988,64765264,93276,-,-
BAC7_H21,14,14q23.3,64732498,64812213,79715,-,-
BAC246_E16,14,14q23.3,64740881,64834470,93589,-,-
BAC150_E19,14,14q23.3,64838697,64947046,108349,-,-
BAC16_C18,14,14q23.3,64844690,64952078,107388,-,-
BAC140_J17,14,14q23.3,64870875,64943424,72549,-,-
BAC124_H16,14,14q23.3,64891062,64999904,108842,-,-
BAC102_O09,14,14q23.3,64891062,64980408,89346,-,-
BAC83_M23,14,14q23.3,65100798,65207429,106631,-,-
BAC184_B12,14,14q23.3,65247347,65340315,92968,-,-
BAC107_H05,14,14q23.3,65554631,65587305,32674,-,-
BAC27_M19,14,14q23.3,65607021,65727868,120847,-,-
BAC25_N15,14,14q23.3,65619734,65738832,119098,-,-
BAC225_H12,14,14q23.3,65628870,65726773,97903,-,-
BAC228_D19,14,14q23.3,65630051,65760288,130237,-,-
BAC27_C07,14,14q23.3,65630051,65713110,83059,-,-
BAC248_M18,14,14q23.3,65638562,65715735,77173,-,-
BAC173_O09,14,14q23.3,65669148,65773796,104648,-,-
BAC41_E15,14,14q23.3,65715729,65805494,89765,-,-
BAC249_F15,14,14q23.3,65728155,65841629,113474,-,-
BAC165_F10,14,14q23.3,65856077,65939968,83891,-,-
BAC218_F17,14,14q23.3,65951066,66027191,76125,-,-
BAC197_H15,14,14q23.3,66092861,66194004,101143,-,-
BAC62_C17,14,14q23.3,66093123,66177298,84175,-,-
BAC102_D04,14,14q23.3,66133174,66229310,96136,-,-
BAC125_I12,14,14q23.3,66203376,66314088,110712,-,-
BAC220_C04,14,14q23.3,66229305,66314088,84783,-,-
BAC113_J18,14,14q23.3,66233257,66326833,93576,-,-
BAC187_O10,14,14q23.3,66235971,66326866,90895,-,-
BAC221_M10,14,14q23.3,66254048,66342622,88574,-,-
BAC235_N11,14,14q23.3,66460594,66558434,97840,-,-
BAC250_H06,14,14q23.3,66682839,66774524,91685,-,-
BAC1_C18,14,14q23.3,66705004,66819218,114214,-,-
BAC8_O18,14,14q23.3,66706915,66868970,162055,-,-
BAC126_F04,14,14q23.3,66747502,66848591,101089,-,-
BAC124_B22,14,14q23.3,66785805,66934231,148426,-,-
BAC142_N03,14,14q23.3,66792767,66868967,76200,-,-
BAC35_A06,14,14q23.3,66793036,66934225,141189,-,-
BAC116_H07,14,14q23.3-14q24.1,66868964,67007826,138862,-,-
BAC158_L11,14,14q23.3-14q24.1,66917370,67002613,85243,-,-
BAC249_A15,14,14q24.1,67001328,67112487,111159,-,-
BAC69_F05,14,14q24.1,67002610,67127531,124921,-,-
BAC238_J15,14,14q24.1,67008245,67121406,113161,-,-
BAC158_K12,14,14q24.1,67008245,67112508,104263,-,-
BAC234_H08,14,14q24.1,67022016,67112511,90495,-,-
BAC214_N10,14,14q24.1,67128041,67223341,95300,-,-
BAC42_N05,14,14q24.1,67143134,67246868,103734,-,-
BAC50_F10,14,14q24.1,67148653,67223338,74685,-,-
BAC53_H14,14,14q24.1,67180645,67274554,93909,-,-
BAC11_E07,14,14q24.1,67272520,67348891,76371,-,-
BAC22_J21,14,14q24.1,67326818,67433540,106722,-,-
BAC96_F22,14,14q24.1,67327662,67411791,84129,-,-
BAC120_F24,14,14q24.1,67349103,67479039,129936,-,-
BAC86_C14,14,14q24.1,67572610,67696583,123973,-,-
BAC52_J14,14,14q24.1,67611515,67704356,92841,-,-
BAC155_F19,14,14q24.1,67945024,68051784,106760,-,-
BAC166_E05,14,14q24.1,67945024,68061541,116517,-,-
BAC183_B17,14,14q24.1,67994475,68093391,98916,-,-
BAC199_D13,14,14q24.1,68027164,68112157,84993,-,-
BAC35_H03,14,14q24.1,68061630,68166632,105002,-,-
BAC195_B02,14,14q24.1,68179163,68285468,106305,-,-
BAC8_H14,14,14q24.1,68230472,68350051,119579,-,-
BAC56_L12,14,14q24.1,68241803,68319603,77800,-,-
BAC50_F17,14,14q24.1,68259315,68375012,115697,-,-
BAC103_B06,14,14q24.1,68264445,68422856,158411,-,-
BAC128_J08,14,14q24.1,68285463,68320763,35300,-,-
BAC182_C15,14,14q24.1,68308825,68416242,107417,-,-
BAC156_G01,14,14q24.1,68375009,68483418,108409,-,-
BAC61_G11,14,14q24.1,68437079,68543605,106526,-,-
BAC156_A15,14,14q24.1,68441433,68591171,149738,-,-
BAC117_A23,14,14q24.1,68483423,68619258,135835,-,-
BAC222_M14,14,14q24.1,68483444,68583786,100342,-,-
BAC177_N22,14,14q24.1,68498435,68609439,111004,-,-
BAC249_N08,14,14q24.1,68503853,68581691,77838,-,-
BAC81_G18,14,14q24.1,68503853,68616227,112374,-,-
BAC222_H07,14,14q24.1,68544808,68616169,71361,-,-
BAC158_G21,14,14q24.1,68640905,68739361,98456,-,-
BAC22_B15,14,14q24.1,68651404,68739360,87956,-,-
BAC32_E23,14,14q24.1,68662902,68803800,140898,-,-
BAC80_K11,14,14q24.1,68662964,68802015,139051,-,-
BAC171_M05,14,14q24.1,68681470,68760991,79521,-,-
BAC28_L21,14,14q24.1,68799858,68913384,113526,-,-
BAC11_E18,14,14q24.1,68877794,68979464,101670,-,-
BAC217_N06,14,14q24.1,68931634,69030358,98724,-,-
BAC252_K09,14,14q24.1,68957263,69060286,103023,-,-
BAC90_K24,14,14q24.1,68994672,69085610,90938,-,-
BAC239_O19,14,14q24.1,69026356,69108735,82379,-,-
BAC175_I01,14,14q24.1,69026356,69104768,78412,-,-
BAC136_D23,14,14q24.1,69085821,69181519,95698,-,-
BAC85_C15,14,14q24.1,69104812,69208711,103899,-,-
BAC227_H17,14,14q24.1,69116594,69206114,89520,-,-
BAC240_J13,14,14q24.1,69132109,69215967,83858,-,-
BAC157_B09,14,14q24.1-14q24.2,69206108,69302238,96130,-,-
BAC106_A16,14,14q24.1,69206194,69290393,84199,-,-
BAC161_G03,14,14q24.1,69209420,69290382,80962,-,-
BAC219_K10,14,14q24.1,69212024,69295527,83503,-,-
BAC243_G03,14,14q24.1,69220532,69295527,74995,-,-
BAC50_M12,14,14q24.2,69345308,69443195,97887,-,-
BAC158_E02,14,14q24.2,69390990,69493834,102844,-,-
BAC1_I24,14,14q24.2,69424843,69561707,136864,-,-
BAC194_J04,14,14q24.2,69443342,69542898,99556,-,-
BAC241_O12,14,14q24.2,69465807,69530026,64219,-,-
BAC15_E12,14,14q24.2,69499442,69615359,115917,-,-
BAC107_N06,14,14q24.2,69504561,69520997,16436,-,-
BAC125_D01,14,14q24.2,69526632,69642214,115582,-,-
BAC232_A06,14,14q24.2,69561804,69687225,125421,-,-
BAC232_F04,14,14q24.2,69758976,69882666,123690,-,-
BAC32_J11,14,14q24.2,69758997,69843823,84826,-,-
BAC100_O07,14,14q24.2,69759266,69852471,93205,-,-
BAC153_F06,14,14q24.2,69785419,69887517,102098,-,-
BAC100_L07,14,14q24.2,69839451,69922843,83392,-,-
BAC227_L09,14,14q24.2,69839613,69922508,82895,-,-
BAC84_K21,14,14q24.2,69934100,70038278,104178,-,-
BAC76_N06,14,14q24.2,69950910,70038278,87368,-,-
BAC153_F04,14,14q24.2,69969703,70074428,104725,-,-
BAC193_E10,14,14q24.2,70060303,70167125,106822,-,-
BAC19_P14,14,14q24.2,70065341,70206522,141181,-,-
BAC83_J17,14,14q24.2,70074421,70189043,114622,-,-
BAC247_C19,14,14q24.2,70083734,70167125,83391,-,-
BAC150_G01,14,14q24.2,70129456,70214364,84908,-,-
BAC200_B02,14,14q24.2,70188582,70271458,82876,-,-
BAC217_B16,14,14q24.2,70206544,70301973,95429,-,-
BAC54_K13,14,14q24.2,70210832,70327759,116927,-,-
BAC240_C07,14,14q24.2,70214618,70316132,101514,-,-
BAC235_O04,14,14q24.2,70274959,70361329,86370,-,-
BAC139_N07,14,14q24.2,70302277,70391293,89016,-,-
BAC124_E18,14,14q24.2,70327818,70414812,86994,-,-
BAC112_D02,14,14q24.2,70361340,70456488,95148,-,-
BAC40_N10,14,14q24.2,70364024,70474974,110950,-,-
BAC229_H05,14,14q24.2,70395778,70474974,79196,-,-
BAC215_O03,14,14q24.2,70395986,70479232,83246,-,-
BAC36_I02,14,14q24.2,70421384,70590752,169368,-,-
BAC120_I10,14,14q24.2,70429363,70548608,119245,-,-
BAC155_B12,14,14q24.2,70701220,70773338,72118,-,-
BAC157_A13,14,14q24.2,70807083,70891062,83979,-,-
BAC150_L14,14,14q24.2,70841396,70920101,78705,-,-
BAC145_J06,14,14q24.2,71002265,71112559,110294,-,-
BAC238_A23,14,14q24.2,71064109,71153295,89186,-,-
BAC6_J23,14,14q24.2,71081048,71197005,115957,-,-
BAC160_G13,14,14q24.2,71086425,71175275,88850,-,-
BAC236_J12,14,14q24.2,71086425,71193201,106776,-,-
BAC83_F24,14,14q24.2,71141528,71262342,120814,-,-
BAC154_F04,14,14q24.2,71175267,71266409,91142,-,-
BAC25_G14,14,14q24.2,71201906,71333541,131635,-,-
BAC159_K02,14,14q24.2,71246476,71369816,123340,-,-
BAC109_N11,14,14q24.2,71317624,71428032,110408,-,-
BAC31_N20,14,14q24.2,71342850,71433803,90953,-,-
BAC233_M23,14,14q24.2,71381806,71463540,81734,-,-
BAC230_I20,14,14q24.2,71544055,71639700,95645,-,-
BAC131_N06,14,14q24.2,71735953,71905628,169675,-,-
BAC20_A19,14,14q24.2,71749727,71835995,86268,-,-
BAC95_E18,14,14q24.2,71757804,71848644,90840,-,-
BAC80_G03,14,14q24.2,71760288,71854153,93865,-,-
BAC25_A18,14,14q24.2,71854148,71980825,126677,-,-
BAC78_K19,14,14q24.2,72013386,72084788,71402,-,-
BAC55_M18,14,14q24.2,72069786,72177765,107979,-,-
BAC66_I14,14,14q24.2,72079471,72183340,103869,-,-
BAC234_D06,14,14q24.2,72096701,72213487,116786,-,-
BAC162_A17,14,14q24.2,72101413,72213511,112098,-,-
BAC224_K15,14,14q24.2,72101831,72177765,75934,-,-
BAC230_A19,14,14q24.2,72131962,72212951,80989,-,-
BAC21_C12,14,14q24.2,72135482,72235498,100016,-,-
BAC137_C09,14,14q24.2,72149156,72254271,105115,-,-
BAC140_E16,14,14q24.2,72188734,72273630,84896,-,-
BAC105_G19,14,14q24.2,72331852,72432995,101143,-,-
BAC101_P20,14,14q24.2,72360561,72461841,101280,-,-
BAC231_K19,14,14q24.2,72404383,72503623,99240,-,-
BAC199_N19,14,14q24.2,72412145,72499351,87206,-,-
BAC234_E15,14,14q24.2,72413372,72511940,98568,-,-
BAC51_D07,14,14q24.2,72415235,72499354,84119,-,-
BAC97_G08,14,14q24.2,72428526,72511940,83414,-,-
BAC66_L05,14,14q24.2,72499347,72596256,96909,-,-
BAC26_K06,14,14q24.2,72503621,72642359,138738,-,-
BAC97_D07,14,14q24.2,72526875,72615507,88632,-,-
BAC22_M04,14,14q24.2,72534409,72653080,118671,-,-
BAC182_M16,14,14q24.2,72541978,72642677,100699,-,-
BAC2_B23,14,14q24.2,72586988,72705594,118606,-,-
BAC100_D09,14,14q24.2,72591759,72730010,138251,-,-
BAC165_K22,14,14q24.2,72618200,72712346,94146,-,-
BAC166_B12,14,14q24.2,72620003,72719301,99298,-,-
BAC95_N15,14,14q24.2,72735194,72825320,90126,-,-
BAC177_H20,14,14q24.2,72802370,72883954,81584,-,-
BAC72_I04,14,14q24.2-14q24.3,72824413,72939164,114751,-,-
BAC14_C05,14,14q24.2-14q24.3,72825525,72952490,126965,-,-
BAC8_L18,14,14q24.3,72999931,73175636,175705,yes,-
BAC59_C01,14,14q24.3,73037118,73180679,143561,yes,-
BAC151_A10,14,14q24.3,73043791,73180679,136888,yes,-
BAC24_F05,14,14q24.3,73104821,73321036,216215,yes,-
BAC130_L18,14,14q24.3,73173612,73291471,117859,-,-
BAC10_C18,14,14q24.3,73180994,73292221,111227,-,-
BAC171_G05,14,14q24.3,73192589,73292226,99637,-,-
BAC48_K03,14,14q24.3,73198444,73315441,116997,-,-
BAC135_N23,14,14q24.3,73201109,73292226,91117,-,-
BAC185_G07,14,14q24.3,73204892,73292226,87334,-,-
BAC122_F04,14,14q24.3,73208088,73320083,111995,-,-
BAC160_I08,14,14q24.3,73234460,73314292,79832,-,-
BAC22_K04,14,14q24.3,73234461,73314818,80357,-,-
BAC217_L22,14,14q24.3,73315093,73408416,93323,-,-
BAC246_F02,14,14q24.3,73315100,73397421,82321,-,-
BAC37_C02,14,14q24.3,73320078,73408422,88344,-,-
BAC18_A04,14,14q24.3,73441408,73532041,90633,-,-
BAC145_I17,14,14q24.3,73510238,73593259,83021,-,-
BAC5_P11,14,14q24.3,73539847,73654823,114976,-,-
BAC42_G21,14,14q24.3,73549963,73643537,93574,-,-
BAC226_F11,14,14q24.3,73581781,73654360,72579,-,-
BAC116_J01,14,14q24.3,73688947,73786361,97414,-,-
BAC80_P09,14,14q24.3,73715600,73817533,101933,-,-
BAC10_A04,14,14q24.3,73719874,73833465,113591,-,-
BAC234_F24,14,14q24.3,73756668,73835169,78501,-,-
BAC242_J12,14,14q24.3,73756686,73835169,78483,-,-
BAC244_N10,14,14q24.3,73824054,73974900,150846,-,-
BAC39_K04,14,14q24.3,73879997,73998374,118377,-,-
BAC74_L02,14,14q24.3,73924245,74038798,114553,-,-
BAC176_A10,14,14q24.3,73955559,74049098,93539,-,-
BAC142_M15,14,14q24.3,74024479,74106772,82293,-,-
BAC18_F02,14,14q24.3,74045563,74125667,80104,-,-
BAC70_C17,14,14q24.3,74156811,74249053,92242,-,-
BAC21_G07,14,14q24.3,74177547,74313514,135967,-,-
BAC52_H14,14,14q24.3,74189815,74277687,87872,-,-
BAC246_H11,14,14q24.3,74197150,74270920,73770,-,-
BAC83_N16,14,14q24.3,74219387,74313511,94124,-,-
BAC113_I04,14,14q24.3,74220705,74320159,99454,-,-
BAC124_I01,14,14q24.3,74249049,74335987,86938,-,-
BAC204_G18,14,14q24.3,74249052,74335963,86911,-,-
BAC77_L18,14,14q24.3,74320177,74421662,101485,-,-
BAC82_H08,14,14q24.3,74325697,74438082,112385,-,-
BAC11_L17,14,14q24.3,74352328,74430551,78223,-,-
BAC237_A19,14,14q24.3,74391023,74517078,126055,-,-
BAC31_O16,14,14q24.3,74395581,74490617,95036,-,-
BAC95_O11,14,14q24.3,74421670,74534711,113041,-,-
BAC40_K08,14,14q24.3,74554806,74689688,134882,-,-
BAC252_M03,14,14q24.3,74560675,74684695,124020,-,-
BAC64_H07,14,14q24.3,74570690,74668344,97654,-,-
BAC170_A18,14,14q24.3,74573559,74657682,84123,-,-
BAC147_E15,14,14q24.3,74573559,74718007,144448,-,-
BAC181_I03,14,14q24.3,74662037,74803619,141582,-,-
BAC61_H13,14,14q24.3,74718061,74841321,123260,-,-
BAC180_P08,14,14q24.3,74849830,74979804,129974,-,-
BAC153_P13,14,14q24.3,74849830,74972019,122189,-,-
BAC72_M11,14,14q24.3,74887500,74912974,25474,-,-
BAC29_E19,14,14q24.3,74887500,75032201,144701,-,-
BAC178_N07,14,14q24.3,74902403,75005145,102742,-,-
BAC33_I21,14,14q24.3,74967471,75157045,189574,-,-
BAC119_F08,14,14q24.3,74972014,75062178,90164,-,-
BAC120_F17,14,14q24.3,74977616,75076077,98461,-,-
BAC188_B09,14,14q24.3,74992837,75111438,118601,-,-
BAC204_H04,14,14q24.3,75064201,75144827,80626,-,-
BAC115_N13,14,14q24.3,75108024,75246483,138459,-,-
BAC124_O17,14,14q24.3,75130358,75248515,118157,-,-
BAC157_J20,14,14q24.3,75145634,75275547,129913,-,-
BAC163_C07,14,14q24.3,75153719,75256820,103101,-,-
BAC141_G13,14,14q24.3,75239953,75337119,97166,-,-
BAC123_J20,14,14q24.3,75245174,75340596,95422,-,-
BAC72_J13,14,14q24.3,75293943,75388019,94076,-,-
BAC248_H23,14,14q24.3,75337112,75418757,81645,-,-
BAC16_I09,14,14q24.3,75414331,75505611,91280,-,-
BAC230_N05,14,14q24.3,75416909,75505611,88702,-,-
BAC120_H16,14,14q24.3,75437157,75512994,75837,-,-
BAC57_M11,14,14q24.3,75480172,75596075,115903,-,-
BAC175_L13,14,14q24.3,75491189,75643208,152019,-,-
BAC146_G20,14,14q24.3,75510896,75643208,132312,-,-
BAC250_E06,14,14q24.3,75537299,75642949,105650,-,-
BAC240_H22,14,14q24.3,75545463,75619731,74268,-,-
BAC78_D23,14,14q24.3,75555865,75661242,105377,-,-
BAC172_A18,14,14q24.3,75622964,75712107,89143,-,-
BAC108_D07,14,14q24.3,75680810,75770628,89818,-,-
BAC77_A08,14,14q24.3,75708274,75783013,74739,-,-
BAC125_I01,14,14q24.3,75720868,75816081,95213,-,-
BAC161_B14,14,14q24.3,75770825,75877961,107136,-,-
BAC179_C10,14,14q24.3,75783004,75866764,83760,-,-
BAC119_J21,14,14q24.3,75793123,76000986,207863,-,-
BAC51_J12,14,14q24.3,75794818,75921309,126491,-,-
BAC21_F12,14,14q24.3,75860718,75960462,99744,-,-
BAC65_P07,14,14q24.3,75904786,76002556,97770,-,-
BAC175_E17,14,14q24.3,75907736,76040065,132329,-,-
BAC100_L13,14,14q24.3,75907736,76101410,193674,-,-
BAC155_O14,14,14q24.3,75920328,76006516,86188,-,-
BAC237_H16,14,14q24.3,75960457,76085848,125391,-,-
BAC20_C17,14,14q24.3,76040068,76176601,136533,-,-
BAC45_G05,14,14q24.3,76041090,76140391,99301,-,-
BAC92_I17,14,14q24.3,76104416,76182311,77895,-,-
BAC76_I17,14,14q24.3,76104416,76182311,77895,-,-
BAC171_N21,14,14q24.3,76105239,76222579,117340,-,-
BAC219_A20,14,14q24.3,76158421,76265481,107060,-,-
BAC246_L05,14,14q24.3,76176595,76267125,90530,-,-
BAC121_O22,14,14q24.3,76225258,76302408,77150,-,-
BAC109_D07,14,14q24.3,76265475,76357252,91777,-,-
BAC97_I21,14,14q24.3,76288815,76390398,101583,-,-
BAC51_L01,14,14q24.3,76323712,76430498,106786,-,-
BAC142_E05,14,14q24.3,76351149,76438102,86953,-,-
BAC163_G17,14,14q24.3,76378838,76459317,80479,-,-
BAC32_E16,14,14q24.3,76378941,76517941,139000,-,-
BAC31_P19,14,14q24.3,76438095,76534615,96520,-,-
BAC161_D23,14,14q24.3,76470047,76573243,103196,-,-
BAC236_E10,14,14q24.3,76488145,76594986,106841,-,-
BAC100_C23,14,14q24.3,76489380,76670715,181335,-,-
BAC57_G13,14,14q24.3,76491829,76578514,86685,-,-
BAC199_M08,14,14q24.3,76631390,76716086,84696,-,-
BAC182_N09,14,14q24.3,76661915,76820109,158194,-,-
BAC227_B22,14,14q24.3,76671832,76740958,69126,-,-
BAC217_P20,14,14q24.3,76671844,76748960,77116,-,-
BAC56_P17,14,14q24.3,76671844,76811694,139850,-,-
BAC63_O11,14,14q24.3,76716134,76840351,124217,-,-
BAC102_L12,14,14q24.3,76804328,76919749,115421,-,-
BAC148_P15,14,14q24.3,76827686,76905319,77633,-,-
BAC160_B17,14,14q24.3,76877043,76963484,86441,-,-
BAC7_E06,14,14q24.3,76886186,77054619,168433,-,-
BAC146_K08,14,14q24.3,76935350,77053339,117989,-,-
BAC44_G10,14,14q24.3,76942744,77054580,111836,-,-
BAC60_L07,14,14q24.3,76952255,77159168,206913,-,-
BAC65_N03,14,14q24.3,76963521,77158601,195080,-,-
BAC147_B01,14,14q24.3,77021954,77092408,70454,-,-
BAC13_C01,14,14q24.3,77040560,77191520,150960,-,-
BAC41_I11,14,14q24.3,77054785,77155451,100666,-,-
BAC185_F22,14,14q24.3,77079008,77154421,75413,-,-
BAC53_G21,14,14q24.3,77092670,77234219,141549,-,-
BAC74_A17,14,14q24.3,77096315,77191536,95221,-,-
BAC22_K18,14,14q24.3,77108892,77244363,135471,-,-
BAC172_B23,14,14q24.3,77159281,77233169,73888,-,-
BAC77_C01,14,14q24.3,77164765,77255428,90663,-,-
BAC34_L10,14,14q24.3,77251243,77393081,141838,-,-
BAC100_N22,14,14q24.3,77302246,77401958,99712,-,-
BAC168_K18,14,14q24.3,77304844,77384431,79587,-,-
BAC180_B23,14,14q24.3,77401950,77520337,118387,-,-
BAC68_C22,14,14q24.3,77401952,77475259,73307,-,-
BAC131_J08,14,14q24.3,77522958,77641972,119014,-,-
BAC252_C09,14,14q24.3,77524941,77627642,102701,-,-
BAC29_F12,14,14q24.3,77532592,77624416,91824,-,-
BAC218_O01,14,14q24.3,77559830,77678681,118851,-,-
BAC247_D07,14,14q24.3,77723972,77816753,92781,-,-
BAC129_J19,14,14q24.3,77727328,77816749,89421,-,-
BAC57_H15,14,14q24.3,77763644,77846904,83260,-,-
BAC120_M06,14,14q24.3,77871665,77954996,83331,-,-
BAC238_K21,14,14q24.3,77947202,78075084,127882,-,-
BAC48_E03,14,14q24.3,78035984,78123105,87121,-,-
BAC106_L17,14,14q24.3,78047287,78133598,86311,-,-
BAC26_K16,14,14q24.3,78159162,78251434,92272,-,-
BAC1_B10,14,14q24.3,78211655,78309661,98006,-,-
BAC158_O21,14,14q24.3,78245037,78370889,125852,-,-
BAC165_O10,14,14q24.3,78264373,78372141,107768,-,-
BAC8_H09,14,14q24.3-14q31.1,78283501,78476183,192682,-,-
BAC39_G05,14,14q24.3,78285460,78386231,100771,-,-
BAC10_B16,14,14q24.3,78298947,78380012,81065,-,-
BAC195_B07,14,14q24.3-14q31.1,78311082,78401685,90603,-,-
BAC158_K09,14,14q24.3-14q31.1,78323781,78401683,77902,-,-
BAC133_D08,14,14q31.1,78476366,78622028,145662,-,-
BAC202_K06,14,14q31.1,78477816,78579967,102151,-,-
BAC200_C02,14,14q31.1,78506690,78619251,112561,-,-
BAC65_C12,14,14q31.1,78517881,78632698,114817,-,-
BAC102_N05,14,14q31.1,78578406,78720848,142442,-,-
BAC69_C20,14,14q31.1,78583744,78683615,99871,-,-
BAC24_O16,14,14q31.1,78629289,78712040,82751,-,-
BAC81_C24,14,14q31.1,78746976,78844551,97575,-,-
BAC179_A07,14,14q31.1,78811087,78896714,85627,-,-
BAC38_G13,14,14q31.1,78961021,79052149,91128,-,-
BAC21_N20,14,14q31.1,78988474,79096060,107586,-,-
BAC153_P15,14,14q31.1,79195789,79271952,76163,-,-
BAC25_E17,14,14q31.1,79239268,79333860,94592,-,-
BAC65_A06,14,14q31.1,79265958,79333827,67869,-,-
BAC113_J14,14,14q31.1,79285598,79457785,172187,-,-
BAC91_F11,14,14q31.1,79295800,79411025,115225,-,-
BAC150_E09,14,14q31.1,79303153,79383976,80823,-,-
BAC117_N04,14,14q31.1,79480189,79624078,143889,-,-
BAC23_M10,14,14q31.1,79604461,79720006,115545,-,-
BAC237_O22,14,14q31.1,79777736,79860990,83254,-,-
BAC113_M16,14,14q31.1,79840881,79936834,95953,-,-
BAC246_J20,14,14q31.1,79910491,80008251,97760,-,-
BAC142_E21,14,14q31.1,79910491,80013733,103242,-,-
BAC168_D24,14,14q31.1,79917699,80013447,95748,-,-
BAC219_C08,14,14q31.1,79946334,80065206,118872,-,-
BAC237_A18,14,14q31.1,80018577,80110079,91502,-,-
BAC160_J16,14,14q31.1,80058999,80157329,98330,-,-
BAC107_L12,14,14q31.1,80086932,80186889,99957,-,-
BAC61_F12,14,14q31.1,80110078,80144643,34565,-,-
BAC162_K09,14,14q31.1,80275065,80323494,48429,-,-
BAC151_L23,14,14q31.1,80324073,80396476,72403,-,-
BAC23_C05,14,14q31.1,80379384,80528958,149574,-,-
BAC227_H20,14,14q31.1,80472743,80552707,79964,-,-
BAC78_L15,14,14q31.1,80556811,80679296,122485,-,-
BAC248_M08,14,14q31.1,80562857,80644440,81583,-,-
BAC88_J06,14,14q31.1,80749708,80865480,115772,-,-
BAC53_C22,14,14q31.1,80749710,80899546,149836,-,-
BAC112_A05,14,14q31.1,80750758,80836432,85674,-,-
BAC27_P02,14,14q31.1,80776356,80865482,89126,-,-
BAC66_N08,14,14q31.1,80803957,80911761,107804,-,-
BAC155_B15,14,14q31.1,80823249,80922648,99399,-,-
BAC83_J23,14,14q31.1,80823260,80941557,118297,-,-
BAC109_A03,14,14q31.1,80825202,80911700,86498,-,-
BAC235_M21,14,14q31.1,80833007,80919097,86090,-,-
BAC153_D08,14,14q31.1,80931062,81029605,98543,-,-
BAC152_M21,14,14q31.1,80941636,81037774,96138,-,-
BAC233_P09,14,14q31.1,80968058,81103995,135937,-,-
BAC218_P24,14,14q31.1,81037780,81149756,111976,-,-
BAC62_C01,14,14q31.1,81057205,81159146,101941,-,-
BAC169_I06,14,14q31.1,81115602,81221980,106378,-,-
BAC219_N01,14,14q31.1,81159142,81257807,98665,-,-
BAC51_A14,14,14q31.1,81223550,81346642,123092,-,-
BAC238_N22,14,14q31.1,81263424,81366937,103513,-,-
BAC25_P04,14,14q31.1,81263424,81295737,32313,-,-
BAC137_J13,14,14q31.1,81291190,81390982,99792,-,-
BAC149_O09,14,14q31.1,81366122,81453716,87594,-,-
BAC124_B17,14,14q31.1,81367464,81486007,118543,-,-
BAC121_I18,14,14q31.1,81390974,81521590,130616,-,-
BAC228_E16,14,14q31.1,81391013,81485969,94956,-,-
BAC170_O14,14,14q31.1,81497060,81570531,73471,-,-
BAC100_O02,14,14q31.1,81521637,81609073,87436,-,-
BAC167_E11,14,14q31.1,81521680,81638724,117044,-,-
BAC65_M22,14,14q31.1,81549236,81650597,101361,-,-
BAC235_O16,14,14q31.1,81672110,81761944,89834,-,-
BAC150_N11,14,14q31.1,82018504,82108003,89499,-,-
BAC29_F17,14,14q31.1,82145691,82246757,101066,-,-
BAC35_E18,14,14q31.1,82146643,82221607,74964,-,-
BAC78_P05,14,14q31.1,82161701,82246757,85056,-,-
BAC247_I11,14,14q31.1,82190892,82273512,82620,-,-
BAC100_O17,14,14q31.1,82332365,82438960,106595,-,-
BAC148_C16,14,14q31.1-14q31.2,82551792,82655300,103508,-,-
BAC179_D03,14,14q31.2,82621325,82727153,105828,-,-
BAC175_D05,14,14q31.2,82685525,82810669,125144,-,-
BAC44_L08,14,14q31.2,82989849,83084284,94435,-,-
BAC114_M21,14,14q31.2,83118128,83242252,124124,-,-
BAC62_H12,14,14q31.2,83256581,83390874,134293,-,-
BAC145_N08,14,14q31.2,83330527,83409938,79411,-,-
BAC60_C20,14,14q31.2,83404608,83573902,169294,-,-
BAC45_D12,14,14q31.2,83455075,83618718,163643,-,-
BAC83_C15,14,14q31.2,83462127,83549370,87243,-,-
BAC2_C16,14,14q31.2,83512382,83618021,105639,-,-
BAC90_M03,14,14q31.2,83549713,83650760,101047,-,-
BAC136_H17,14,14q31.2,83618012,83698026,80014,-,-
BAC65_D07,14,14q31.2,83665457,83754919,89462,-,-
BAC105_D11,14,14q31.2,83676516,83784563,108047,-,-
BAC240_M08,14,14q31.2,83680063,83778086,98023,-,-
BAC45_A12,14,14q31.3,84231803,84331533,99730,-,-
BAC238_M14,14,14q31.3,84354883,84515023,160140,-,-
BAC106_A04,14,14q31.3,84386208,84451512,65304,-,-
BAC197_O24,14,14q31.3,84466777,84580278,113501,-,-
BAC89_K10,14,14q31.3,84515317,84595804,80487,-,-
BAC69_D04,14,14q31.3,84559285,84666010,106725,-,-
BAC223_N04,14,14q31.3,84599058,84695490,96432,-,-
BAC195_C13,14,14q31.3,84681182,84764170,82988,-,-
BAC146_I14,14,14q31.3,84915260,84997880,82620,-,-
BAC141_B10,14,14q31.3,84989952,85134312,144360,-,-
BAC180_I15,14,14q31.3,85007227,85134262,127035,-,-
BAC193_H02,14,14q31.3,85023297,85157554,134257,-,-
BAC11_N10,14,14q31.3,85117915,85219573,101658,-,-
BAC211_B23,14,14q31.3,85291104,85377130,86026,-,-
BAC71_G04,14,14q31.3,85536792,85629174,92382,-,-
BAC192_E17,14,14q31.3,85665449,85766052,100603,-,-
BAC166_E19,14,14q31.3,85766608,85850214,83606,-,-
BAC52_K21,14,14q31.3,85768444,85877360,108916,-,-
BAC130_I23,14,14q31.3,85932311,86002031,69720,-,-
BAC122_C09,14,14q31.3,86051777,86163674,111897,-,-
BAC140_J08,14,14q31.3,86106488,86206416,99928,-,-
BAC154_E12,14,14q31.3,86140338,86237882,97544,-,-
BAC64_M15,14,14q31.3,86211299,86302818,91519,-,-
BAC92_C22,14,14q31.3,86452387,86561708,109321,-,-
BAC33_G08,14,14q31.3,86518671,86623513,104842,-,-
BAC53_M21,14,14q31.3,86754625,86834904,80279,-,-
BAC104_E03,14,14q31.3,86754675,86853400,98725,-,-
BAC37_E17,14,14q31.3,86944083,87014673,70590,-,-
BAC54_M07,14,14q31.3,87054214,87156115,101901,-,-
BAC96_I15,14,14q31.3,87060624,87202144,141520,-,-
BAC137_N19,14,14q31.3,87068987,87156120,87133,-,-
BAC69_K22,14,14q31.3,87163877,87285625,121748,-,-
BAC46_L03,14,14q31.3,87214659,87319198,104539,-,-
BAC142_P02,14,14q31.3,87245754,87316225,70471,-,-
BAC89_O08,14,14q31.3,87285621,87403138,117517,-,-
BAC97_B24,14,14q31.3,87409893,87495110,85217,-,-
BAC209_P16,14,14q31.3,87426111,87506801,80690,-,-
BAC210_D01,14,14q31.3,87697964,87774001,76037,-,-
BAC22_P14,14,14q31.3,87706303,87814634,108331,-,-
BAC100_P15,14,14q31.3,87720513,87814634,94121,-,-
BAC192_L21,14,14q31.3,87761164,87855681,94517,-,-
BAC238_J13,14,14q31.3,87809024,87889966,80942,-,-
BAC68_L04,14,14q31.3,87809024,87896065,87041,-,-
BAC83_H11,14,14q31.3,87814622,87929349,114727,-,-
BAC12_C12,14,14q31.3,87868281,87990022,121741,-,-
BAC96_B18,14,14q31.3,87956286,88078326,122040,-,-
BAC219_D18,14,14q31.3,88005746,88092697,86951,-,-
BAC90_K07,14,14q31.3,88017469,88132717,115248,-,-
BAC179_F07,14,14q31.3,88037500,88131622,94122,-,-
BAC121_K23,14,14q31.3,88140711,88305478,164767,-,-
BAC83_E18,14,14q31.3,88204064,88284593,80529,-,-
BAC57_J05,14,14q31.3,88204103,88301580,97477,-,-
BAC27_I18,14,14q31.3,88216470,88344201,127731,-,-
BAC61_P07,14,14q31.3,88216470,88301158,84688,-,-
BAC156_G10,14,14q31.3,88259023,88344209,85186,-,-
BAC199_C20,14,14q31.3,88363953,88476176,112223,-,-
BAC114_L01,14,14q31.3,88403469,88487897,84428,-,-
BAC115_K07,14,14q31.3,88444991,88607178,162187,-,-
BAC180_B01,14,14q31.3,88475154,88571920,96766,-,-
BAC193_B03,14,14q31.3,88487985,88576257,88272,-,-
BAC158_I02,14,14q31.3,88488028,88576235,88207,-,-
BAC186_D23,14,14q31.3,88493454,88580534,87080,-,-
BAC88_G07,14,14q31.3,88534811,88648551,113740,-,-
BAC200_H14,14,14q31.3,88637348,88735404,98056,-,-
BAC199_O18,14,14q31.3,88653598,88772170,118572,-,-
BAC218_O03,14,14q31.3,88677349,88790451,113102,-,-
BAC72_A09,14,14q31.3,88677349,88772170,94821,-,-
BAC194_P20,14,14q31.3,88683204,88816869,133665,-,-
BAC51_L10,14,14q31.3,88790445,88892765,102320,-,-
BAC184_M07,14,14q31.3,88816861,88892765,75904,-,-
BAC100_I21,14,14q31.3-14q32.11,88816861,88918924,102063,-,-
BAC101_B18,14,14q31.3-14q32.11,88822910,88916587,93677,-,-
BAC220_A06,14,14q31.3,88823047,88892765,69718,-,-
BAC236_C13,14,14q31.3-14q32.11,88851927,88944292,92365,-,-
BAC92_A06,14,14q32.11,88918040,89014345,96305,-,-
BAC39_D20,14,14q32.11,88919147,89006950,87803,-,-
BAC22_D12,14,14q32.11,88989674,89138311,148637,-,-
BAC225_F13,14,14q32.11,89069816,89178174,108358,-,-
BAC227_K23,14,14q32.11,89112648,89194839,82191,-,-
BAC200_F14,14,14q32.11,89188299,89297182,108883,-,-
BAC199_N05,14,14q32.11,89214613,89311660,97047,-,-
BAC123_J01,14,14q32.11,89235171,89329483,94312,-,-
BAC24_J14,14,14q32.11,89235185,89369746,134561,-,-
BAC179_P16,14,14q32.11,89235272,89329398,94126,-,-
BAC81_E17,14,14q32.11,89261874,89364490,102616,-,-
BAC38_I02,14,14q32.11,89262811,89411992,149181,-,-
BAC57_O11,14,14q32.11,89273623,89364355,90732,-,-
BAC35_C15,14,14q32.11,89311764,89419239,107475,-,-
BAC38_L23,14,14q32.11,89498412,89638847,140435,-,-
BAC156_H01,14,14q32.11,89520948,89611966,91018,-,-
BAC220_B09,14,14q32.11,89528437,89614101,85664,-,-
BAC111_G07,14,14q32.11,89529408,89638497,109089,-,-
BAC241_P16,14,14q32.11,89575149,89659077,83928,-,-
BAC120_B05,14,14q32.11,89619345,89745228,125883,-,-
BAC89_B08,14,14q32.11,89648384,89757850,109466,-,-
BAC26_L04,14,14q32.11,89659071,89773219,114148,-,-
BAC135_I16,14,14q32.11,89712236,89773227,60991,-,-
BAC75_E13,14,14q32.11,89715433,89885710,170277,-,-
BAC236_D07,14,14q32.11,89728318,89819051,90733,-,-
BAC170_E24,14,14q32.11,89865296,89977076,111780,-,-
BAC69_D24,14,14q32.11,89870751,89906067,35316,-,-
BAC26_O04,14,14q32.11,89910173,89993400,83227,-,-
BAC32_K10,14,14q32.11,90024078,90177288,153210,-,-
BAC106_E13,14,14q32.11,90044691,90177501,132810,-,-
BAC42_G12,14,14q32.11,90089775,90177526,87751,-,-
BAC2_G10,14,14q32.11,90165574,90252242,86668,-,-
BAC217_G19,14,14q32.11,90239130,90318753,79623,-,-
BAC149_E20,14,14q32.11,90283413,90383081,99668,-,-
BAC83_A24,14,14q32.11,90318805,90434229,115424,-,-
BAC64_O20,14,14q32.11,90334439,90445871,111432,-,-
BAC129_A15,14,14q32.11,90364990,90463397,98407,-,-
BAC110_N07,14,14q32.11,90383991,90441350,57359,-,-
BAC80_O02,14,14q32.11,90383991,90476267,92276,-,-
BAC146_A10,14,14q32.12,90567439,90648047,80608,-,-
BAC158_B05,14,14q32.12,90573812,90657421,83609,-,-
BAC218_O24,14,14q32.12,90618570,90698994,80424,-,-
BAC13_O18,14,14q32.12,90705328,90814528,109200,-,-
BAC26_C16,14,14q32.12,90705520,90792951,87431,-,-
BAC44_E04,14,14q32.12,90814612,90927154,112542,-,-
BAC182_E10,14,14q32.12,90817101,90900214,83113,-,-
BAC235_G21,14,14q32.12,90823321,90927231,103910,-,-
BAC75_D20,14,14q32.12,90911523,91004097,92574,-,-
BAC36_M15,14,14q32.12,90924167,91042025,117858,-,-
BAC60_J12,14,14q32.12,90957363,91044751,87388,-,-
BAC20_N17,14,14q32.12,91003412,91205424,202012,-,-
BAC26_K23,14,14q32.12,91082656,91211173,128517,-,-
BAC61_C01,14,14q32.12,91107580,91282263,174683,yes,-
BAC83_C08,14,14q32.12,91133335,91239638,106303,-,-
BAC107_H07,14,14q32.12,91134365,91263125,128760,-,-
BAC55_M16,14,14q32.12,91324787,91492943,168156,-,-
BAC124_C01,14,14q32.12,91327866,91421417,93551,-,-
BAC144_P13,14,14q32.12,91355795,91445099,89304,-,-
BAC86_E04,14,14q32.12,91359729,91466484,106755,-,-
BAC163_P01,14,14q32.12,91383759,91466496,82737,-,-
BAC86_J07,14,14q32.12,91394273,91497013,102740,-,-
BAC143_E06,14,14q32.12,91403564,91486879,83315,-,-
BAC35_F03,14,14q32.12,91426282,91555433,129151,-,-
BAC217_C09,14,14q32.12,91451370,91569634,118264,-,-
BAC240_H04,14,14q32.12,91517506,91637429,119923,-,-
BAC50_E23,14,14q32.12,91537741,91655641,117900,-,-
BAC150_H18,14,14q32.12,91572084,91663757,91673,-,-
BAC169_M14,14,14q32.12,91625133,91705330,80197,yes,-
BAC107_E17,14,14q32.12,91636318,91736324,100006,-,-
BAC58_J07,14,14q32.12,91660182,91769977,109795,-,-
BAC37_D07,14,14q32.12,91705436,91811136,105700,-,-
BAC167_C12,14,14q32.12,91710453,91805931,95478,-,-
BAC157_I09,14,14q32.12,91728168,91807974,79806,-,-
BAC222_B01,14,14q32.12,91754956,91851550,96594,-,-
BAC139_I07,14,14q32.12,91768324,91842955,74631,-,-
BAC57_C02,14,14q32.12,91777159,91907956,130797,-,-
BAC27_L07,14,14q32.12,91865213,91963534,98321,-,-
BAC211_B16,14,14q32.12,91880451,92016742,136291,-,-
BAC58_M08,14,14q32.12,91892814,92017248,124434,-,-
BAC243_N12,14,14q32.12,91907951,92002640,94689,-,-
BAC182_C16,14,14q32.12,91956650,92047150,90500,-,-
BAC105_K10,14,14q32.12,91963570,92045314,81744,-,-
BAC84_B03,14,14q32.12,92016903,92106419,89516,-,-
BAC40_B06,14,14q32.12,92041088,92138267,97179,-,-
BAC161_J07,14,14q32.12,92047179,92142060,94881,-,-
BAC204_A10,14,14q32.12,92056149,92137269,81120,-,-
BAC134_B19,14,14q32.12,92071449,92166410,94961,-,-
BAC158_J09,14,14q32.12,92198637,92296237,97600,-,-
BAC140_L22,14,14q32.12,92202545,92283587,81042,-,-
BAC135_I09,14,14q32.12,92285727,92366134,80407,-,-
BAC11_I14,14,14q32.12,92316942,92503527,186585,-,-
BAC167_O15,14,14q32.12,92344403,92428391,83988,-,-
BAC169_C06,14,14q32.12,92366518,92495807,129289,-,-
BAC49_I04,14,14q32.12,92372813,92458526,85713,-,-
BAC74_E22,14,14q32.12,92375656,92475079,99423,-,-
BAC26_K11,14,14q32.12,92375656,92475120,99464,-,-
BAC84_K15,14,14q32.12,92383772,92466604,82832,-,-
BAC83_I04,14,14q32.12,92383772,92503573,119801,-,-
BAC40_E07,14,14q32.12,92466634,92582494,115860,-,-
BAC189_B19,14,14q32.12,92475141,92576768,101627,-,-
BAC135_O04,14,14q32.12,92478077,92559658,81581,-,-
BAC131_D12,14,14q32.12,92496114,92617864,121750,-,-
BAC22_K13,14,14q32.12,92496114,92582448,86334,-,-
BAC230_K07,14,14q32.12,92504986,92630728,125742,-,-
BAC148_C18,14,14q32.12,92533643,92662129,128486,-,-
BAC130_L04,14,14q32.12,92557208,92649522,92314,-,-
BAC233_G13,14,14q32.12,92561837,92649519,87682,-,-
BAC76_P05,14,14q32.12,92647363,92743151,95788,-,-
BAC100_B22,14,14q32.12-14q32.13,92649512,92818073,168561,-,-
BAC170_N11,14,14q32.12,92671991,92795286,123295,-,-
BAC232_O20,14,14q32.12,92683900,92763606,79706,-,-
BAC195_G19,14,14q32.12,92714220,92795094,80874,-,-
BAC191_P05,14,14q32.12-14q32.13,92715552,92818045,102493,-,-
BAC125_D07,14,14q32.12-14q32.13,92715552,92826314,110762,-,-
BAC75_P04,14,14q32.12-14q32.13,92715597,92829649,114052,-,-
BAC228_O02,14,14q32.12-14q32.13,92763601,92845897,82296,-,-
BAC244_L05,14,14q32.12-14q32.13,92763612,92870197,106585,-,-
BAC25_M11,14,14q32.13,92806811,92909319,102508,-,-
BAC95_N20,14,14q32.13,92832408,92953384,120976,-,-
BAC210_L14,14,14q32.13,92832456,92927350,94894,-,-
BAC124_J23,14,14q32.13,92920789,93070098,149309,-,-
BAC51_E24,14,14q32.13,92951713,93108898,157185,-,-
BAC152_A02,14,14q32.13,93004795,93090003,85208,-,-
BAC50_N19,14,14q32.13,93028259,93147508,119249,-,-
BAC65_A11,14,14q32.13,93032450,93142112,109662,-,-
BAC120_K02,14,14q32.13,93050275,93142434,92159,-,-
BAC122_A11,14,14q32.13,93070859,93163115,92256,-,-
BAC126_P08,14,14q32.13,93147822,93242234,94412,-,-
BAC126_G13,14,14q32.13,93147822,93242194,94372,-,-
BAC166_C04,14,14q32.13,93265917,93366693,100776,-,-
BAC230_O23,14,14q32.13,93314516,93399036,84520,-,-
BAC52_I12,14,14q32.13,93314535,93443261,128726,-,-
BAC175_B20,14,14q32.13,93327630,93419333,91703,-,-
BAC235_M01,14,14q32.13,93327630,93436822,109192,-,-
BAC111_O23,14,14q32.13,93327830,93436822,108992,-,-
BAC141_B08,14,14q32.13,93366699,93456009,89310,-,-
BAC126_P03,14,14q32.13,93366701,93456009,89308,-,-
BAC109_E18,14,14q32.13,93399121,93512646,113525,-,-
BAC51_N08,14,14q32.13,93402901,93555711,152810,-,-
BAC39_P02,14,14q32.13,93445004,93557400,112396,-,-
BAC193_J10,14,14q32.13,93511306,93603375,92069,-,-
BAC158_I14,14,14q32.13,93535718,93618085,82367,-,-
BAC19_P22,14,14q32.13,93603505,93749197,145692,-,-
BAC227_H18,14,14q32.13,93646871,93746215,99344,-,-
BAC163_O11,14,14q32.13,93676165,93788233,112068,-,-
BAC117_B22,14,14q32.13,93685116,93783068,97952,-,-
BAC75_K19,14,14q32.13,93783116,93871195,88079,-,-
BAC195_C20,14,14q32.13,93853858,93963296,109438,yes,-
BAC171_A22,14,14q32.13,93875986,93910509,34523,yes,-
BAC66_F13,14,14q32.13,93889752,94028457,138705,yes,-
BAC228_H06,14,14q32.13,93889787,93997239,107452,yes,-
BAC180_K23,14,14q32.13,93945418,94039992,94574,-,-
BAC183_E22,14,14q32.13,93952764,94044045,91281,-,-
BAC32_O01,14,14q32.13,94115517,94168649,53132,-,-
BAC26_N17,14,14q32.13,94168647,94265029,96382,-,-
BAC230_F01,14,14q32.13,94184130,94272720,88590,-,-
BAC123_E01,14,14q32.13,94184165,94272720,88555,-,-
BAC157_C06,14,14q32.13,94197806,94300912,103106,-,-
BAC170_J03,14,14q32.13,94197847,94272720,74873,-,-
BAC5_O04,14,14q32.13,94198163,94298990,100827,-,-
BAC31_E15,14,14q32.13,94199176,94300912,101736,-,-
BAC240_C06,14,14q32.13,94377822,94495554,117732,-,-
BAC60_H21,14,14q32.13,94377822,94478990,101168,-,-
BAC97_P17,14,14q32.13,94377894,94511457,133563,-,-
BAC154_J11,14,14q32.13,94385769,94495556,109787,-,-
BAC195_P10,14,14q32.13,94431533,94515140,83607,-,-
BAC188_P07,14,14q32.13,94445535,94558075,112540,-,-
BAC192_C09,14,14q32.13,94633352,94732374,99022,-,-
BAC131_C10,14,14q32.13,94676838,94780530,103692,-,-
BAC43_F19,14,14q32.13,94685976,94780534,94558,-,-
BAC84_H05,14,14q32.13,94685989,94757751,71762,-,-
BAC53_L06,14,14q32.13,94957840,95084115,126275,-,-
BAC128_K06,14,14q32.13,94983408,95085901,102493,-,-
BAC41_J11,14,14q32.13,94998429,95082848,84419,-,-
BAC123_C07,14,14q32.13,95074307,95164279,89972,-,-
BAC37_H19,14,14q32.13,95088659,95238792,150133,-,-
BAC50_P06,14,14q32.13,95090471,95258350,167879,-,-
BAC84_P04,14,14q32.13,95108532,95164281,55749,-,-
BAC168_N15,14,14q32.13,95157660,95252386,94726,-,-
BAC244_O16,14,14q32.13,95171202,95261802,90600,-,-
BAC160_D24,14,14q32.13,95264589,95352783,88194,-,-
BAC102_D12,14,14q32.13-14q32.2,95309954,95433584,123630,-,-
BAC31_E04,14,14q32.13-14q32.2,95326791,95416761,89970,-,-
BAC44_C09,14,14q32.13-14q32.2,95344248,95538892,194644,-,-
BAC97_N03,14,14q32.13-14q32.2,95354840,95457705,102865,-,-
BAC196_P08,14,14q32.2,95400067,95491822,91755,-,-
BAC66_M10,14,14q32.2,95433995,95585404,151409,-,-
BAC233_D19,14,14q32.2,95498220,95612750,114530,-,-
BAC188_N08,14,14q32.2,95534073,95613130,79057,-,-
BAC137_H21,14,14q32.2,95550726,95632836,82110,-,-
BAC249_I23,14,14q32.2,95553491,95656752,103261,-,-
BAC154_K04,14,14q32.2,95683730,95816359,132629,-,-
BAC54_C17,14,14q32.2,95713987,95858028,144041,-,-
BAC66_H07,14,14q32.2,95742269,95881256,138987,-,-
BAC139_L01,14,14q32.2,95754344,95858180,103836,-,-
BAC233_M07,14,14q32.2,95754344,95836900,82556,-,-
BAC168_L03,14,14q32.2,95758503,95887250,128747,-,-
BAC60_N03,14,14q32.2,95765607,95980207,214600,-,-
BAC29_B03,14,14q32.2,95801720,95921751,120031,-,-
BAC226_G12,14,14q32.2,95848287,95945263,96976,-,-
BAC242_C19,14,14q32.2,95859434,95942453,83019,-,-
BAC60_M17,14,14q32.2,95892917,95980268,87351,-,-
BAC113_C02,14,14q32.2,95942487,96060035,117548,-,-
BAC204_A08,14,14q32.2,96055956,96144803,88847,-,-
BAC226_C20,14,14q32.2,96060632,96144805,84173,-,-
BAC50_A08,14,14q32.2,96067777,96166252,98475,-,-
BAC41_G08,14,14q32.2,96113002,96209836,96834,-,-
BAC210_I04,14,14q32.2,96113029,96222801,109772,-,-
BAC200_G09,14,14q32.2,96115044,96192836,77792,-,-
BAC53_I07,14,14q32.2,96126400,96209636,83236,-,-
BAC219_H06,14,14q32.2,96148588,96231297,82709,-,-
BAC219_C12,14,14q32.2,96150976,96230950,79974,-,-
BAC132_E06,14,14q32.2,96187678,96294658,106980,-,-
BAC21_K15,14,14q32.2,96218170,96319102,100932,-,-
BAC117_I19,14,14q32.2,96222795,96319114,96319,-,-
BAC242_E18,14,14q32.2,96231150,96358682,127532,-,-
BAC135_G22,14,14q32.2,96231290,96324407,93117,-,-
BAC8_K10,14,14q32.2,96231295,96337712,106417,-,-
BAC197_K16,14,14q32.2,96261691,96356214,94523,-,-
BAC103_P13,14,14q32.2,96392583,96489387,96804,-,-
BAC170_B09,14,14q32.2,96418153,96501941,83788,-,-
BAC226_G14,14,14q32.2,96434335,96536030,101695,-,-
BAC24_M05,14,14q32.2,96441093,96550915,109822,-,-
BAC21_K17,14,14q32.2,96443007,96623555,180548,-,-
BAC46_B13,14,14q32.2,96447387,96611333,163946,-,-
BAC40_G03,14,14q32.2,96478280,96542502,64222,-,-
BAC38_L11,14,14q32.2,96583890,96704855,120965,-,-
BAC90_D15,14,14q32.2,96633479,96753263,119784,-,-
BAC44_E07,14,14q32.2,96643434,96742305,98871,-,-
BAC224_M17,14,14q32.2,96676378,96781648,105270,-,-
BAC55_M07,14,14q32.2,96711927,96831896,119969,-,-
BAC40_M18,14,14q32.2,96854159,97005611,151452,-,-
BAC252_I11,14,14q32.2,97054812,97142536,87724,-,-
BAC127_K01,14,14q32.2,97125049,97245411,120362,-,-
BAC81_N17,14,14q32.2,97127269,97237396,110127,-,-
BAC69_A20,14,14q32.2,97153966,97257063,103097,-,-
BAC26_P05,14,14q32.2,97223097,97339172,116075,-,-
BAC221_H02,14,14q32.2,97225430,97348312,122882,-,-
BAC37_I01,14,14q32.2,97235343,97333809,98466,-,-
BAC18_A08,14,14q32.2,97270364,97348305,77941,-,-
BAC242_D05,14,14q32.2,97312993,97398010,85017,-,-
BAC143_A20,14,14q32.2,97365586,97497162,131576,-,-
BAC90_C12,14,14q32.2,97384833,97488607,103774,-,-
BAC101_G22,14,14q32.2,97564560,97665583,101023,-,-
BAC67_O24,14,14q32.2,97646166,97774255,128089,-,-
BAC200_K15,14,14q32.2,97734817,97824944,90127,-,-
BAC134_M01,14,14q32.2,97905336,98007502,102166,-,-
BAC67_A03,14,14q32.2,97941265,98151159,209894,-,-
BAC95_E10,14,14q32.2,98040815,98114854,74039,-,-
BAC152_J18,14,14q32.2,98042202,98130420,88218,-,-
BAC71_I07,14,14q32.2,98050408,98181876,131468,-,-
BAC56_L21,14,14q32.2,98063607,98203671,140064,-,-
BAC27_F06,14,14q32.2,98076061,98203739,127678,-,-
BAC102_A12,14,14q32.2,98192426,98274444,82018,-,-
BAC219_K14,14,14q32.2,98232389,98332336,99947,-,-
BAC89_I01,14,14q32.2,98240808,98340333,99525,-,-
BAC61_E22,14,14q32.2,98278227,98380027,101800,-,-
BAC108_M04,14,14q32.2,98278512,98398611,120099,-,-
BAC236_A04,14,14q32.2,98302413,98415131,112718,-,-
BAC198_C17,14,14q32.2,98332329,98413240,80911,-,-
BAC238_F23,14,14q32.2,98549233,98707501,158268,-,-
BAC36_I09,14,14q32.2,98549233,98650451,101218,-,-
BAC132_K03,14,14q32.2,98558414,98652403,93989,-,-
BAC151_A02,14,14q32.2,98569466,98674848,105382,-,-
BAC220_N23,14,14q32.2,98614926,98702042,87116,-,-
BAC31_D03,14,14q32.2,98702041,98797968,95927,-,-
BAC217_J15,14,14q32.2,98775566,98871078,95512,-,-
BAC45_N09,14,14q32.2,98871108,98980128,109020,-,-
BAC183_E07,14,14q32.2,98952690,99031267,78577,-,-
BAC89_F12,14,14q32.2,98952690,99126184,173494,-,-
BAC49_N14,14,14q32.2,98974611,99096013,121402,-,-
BAC243_K10,14,14q32.2,99005078,99085281,80203,-,-
BAC152_H23,14,14q32.2,99031261,99126192,94931,-,-
BAC136_A04,14,14q32.2,99035147,99126192,91045,-,-
BAC154_L02,14,14q32.2,99126186,99226360,100174,-,-
BAC243_F07,14,14q32.2,99130802,99224743,93941,-,-
BAC230_P14,14,14q32.2,99130805,99224743,93938,-,-
BAC192_M18,14,14q32.2,99257432,99352945,95513,-,-
BAC229_L07,14,14q32.2,99257697,99366527,108830,-,-
BAC53_J16,14,14q32.2,99257726,99366482,108756,-,-
BAC217_K24,14,14q32.2,99286054,99375365,89311,-,-
BAC241_A06,14,14q32.2,99286058,99378365,92307,-,-
BAC19_D16,14,14q32.2,99286073,99415916,129843,-,-
BAC35_F13,14,14q32.2,99291483,99375303,83820,-,-
BAC176_K10,14,14q32.2,99344685,99410944,66259,-,-
BAC226_F15,14,14q32.2,99375357,99453977,78620,-,-
BAC56_L20,14,14q32.2,99375358,99517974,142616,-,-
BAC150_I04,14,14q32.2,99383669,99497181,113512,-,-
BAC134_E05,14,14q32.2,99438242,99540830,102588,-,-
BAC21_H08,14,14q32.2,99541194,99687441,146247,-,-
BAC223_O12,14,14q32.2,99541202,99616649,75447,-,-
BAC205_I21,14,14q32.2,99616704,99691381,74677,-,-
BAC37_O15,14,14q32.2,99766895,99887018,120123,-,-
BAC115_N23,14,14q32.2,99777360,99902867,125507,-,-
BAC171_C07,14,14q32.2,99831895,99922224,90329,-,-
BAC248_A03,14,14q32.2,99831914,99988507,156593,-,-
BAC177_H21,14,14q32.2,99846273,99897580,51307,-,-
BAC141_C10,14,14q32.2,99892216,99988511,96295,-,-
BAC161_D06,14,14q32.2,100000311,100128025,127714,-,-
BAC219_I18,14,14q32.2,100128094,100195489,67395,-,-
BAC69_L22,14,14q32.2,100155096,100242893,87797,-,-
BAC70_E10,14,14q32.2,100290712,100391259,100547,-,-
BAC116_J04,14,14q32.2-14q32.31,100299712,100432668,132956,-,-
BAC239_G03,14,14q32.2-14q32.31,100311718,100443912,132194,-,-
BAC118_P20,14,14q32.2-14q32.31,100325768,100503408,177640,-,-
BAC91_P18,14,14q32.2-14q32.31,100325768,100400310,74542,-,-
BAC101_O15,14,14q32.31,100503542,100635568,132026,-,-
BAC31_B09,14,14q32.31,100541177,100705827,164650,-,-
BAC236_B23,14,14q32.31,100547374,100656951,109577,-,-
BAC142_F11,14,14q32.31,100585827,100682954,97127,-,-
BAC14_E01,14,14q32.31,100619935,100716612,96677,-,-
BAC221_H07,14,14q32.31,100622671,100705827,83156,-,-
BAC202_J06,14,14q32.31,100655173,100768500,113327,-,-
BAC162_H03,14,14q32.31,100673235,100784023,110788,-,-
BAC134_A03,14,14q32.31,100755678,100836507,80829,-,-
BAC88_M20,14,14q32.31,100786564,100866156,79592,-,-
BAC101_B07,14,14q32.31,100884864,101002070,117206,-,-
BAC248_K10,14,14q32.31,100886143,100973648,87505,-,-
BAC95_L11,14,14q32.31,100886143,101091719,205576,-,-
BAC88_C21,14,14q32.31,100908963,101037205,128242,-,-
BAC141_E17,14,14q32.31,100998321,101110862,112541,-,-
BAC178_A03,14,14q32.31,101024739,101109354,84615,-,-
BAC31_J06,14,14q32.31,101050850,101180141,129291,-,-
BAC190_H11,14,14q32.31,101087033,101167093,80060,-,-
BAC187_K24,14,14q32.31,101140329,101216583,76254,-,-
BAC86_P15,14,14q32.31,101140329,101282688,142359,-,-
BAC146_P16,14,14q32.31,101140340,101224568,84228,-,-
BAC235_O22,14,14q32.31,101306746,101405511,98765,-,-
BAC184_L05,14,14q32.31,101331490,101415143,83653,-,-
BAC176_B08,14,14q32.31,101331490,101434973,103483,-,-
BAC102_G06,14,14q32.31,101331490,101440160,108670,-,-
BAC246_H01,14,14q32.31,101385976,101459416,73440,-,-
BAC81_M18,14,14q32.31,101385976,101494354,108378,-,-
BAC62_K23,14,14q32.31,101396028,101494646,98618,-,-
BAC33_C21,14,14q32.31,101405506,101533670,128164,-,-
BAC23_B19,14,14q32.31,101426706,101514739,88033,-,-
BAC67_M02,14,14q32.31,101426885,101525250,98365,-,-
BAC151_F21,14,14q32.31,101449345,101551695,102350,-,-
BAC181_G04,14,14q32.31,101499425,101629573,130148,-,-
BAC60_H16,14,14q32.31,101514733,101535115,20382,-,-
BAC233_O10,14,14q32.31,101523707,101619008,95301,-,-
BAC96_L16,14,14q32.31,101523759,101629573,105814,-,-
BAC10_B08,14,14q32.31,101523779,101663128,139349,-,-
BAC161_L07,14,14q32.31,101621047,101720550,99503,-,-
BAC139_L10,14,14q32.31,101637062,101773270,136208,-,-
BAC144_G13,14,14q32.31,101800940,101892036,91096,-,-
BAC77_F20,14,14q32.31,101892029,102021109,129080,-,-
BAC160_O02,14,14q32.31,101892030,101967105,75075,-,-
BAC71_J17,14,14q32.31,101976315,102066175,89860,-,-
BAC187_L22,14,14q32.31,102021745,102037633,15888,-,-
BAC120_B18,14,14q32.31,102077886,102170450,92564,-,-
BAC82_E02,14,14q32.31,102104705,102198593,93888,-,-
BAC171_J19,14,14q32.31-14q32.32,102104705,102264725,160020,-,-
BAC234_P15,14,14q32.31-14q32.32,102181606,102327861,146255,-,-
BAC154_L21,14,14q32.31-14q32.32,102199925,102316609,116684,-,-
BAC42_J22,14,14q32.32,102205709,102274180,68471,-,-
BAC6_P10,14,14q32.32,102239592,102359652,120060,-,-
BAC149_J20,14,14q32.32,102264569,102365857,101288,-,-
BAC143_A05,14,14q32.32,102265161,102345586,80425,-,-
BAC26_I17,14,14q32.32,102274174,102433744,159570,-,-
BAC232_F13,14,14q32.32,102303566,102409843,106277,-,-
BAC48_O09,14,14q32.32,102322117,102433709,111592,-,-
BAC195_E14,14,14q32.32,102346505,102433780,87275,-,-
BAC95_D23,14,14q32.32,102365326,102473935,108609,-,-
BAC109_F10,14,14q32.32,102365852,102520462,154610,-,-
BAC227_J17,14,14q32.32,102366091,102479568,113477,-,-
BAC144_B13,14,14q32.32,102366091,102479600,113509,-,-
BAC134_F23,14,14q32.32,102366091,102461195,95104,-,-
BAC96_I13,14,14q32.32,102385161,102495386,110225,-,-
BAC146_H04,14,14q32.32,102407504,102506305,98801,-,-
BAC82_C04,14,14q32.32,102425357,102532129,106772,-,-
BAC11_D06,14,14q32.32,102683365,102806810,123445,-,-
BAC155_M15,14,14q32.32,102696105,102811898,115793,-,-
BAC74_F16,14,14q32.32,102697774,102784096,86322,-,-
BAC28_F11,14,14q32.32,102748477,102846428,97951,-,-
BAC83_J03,14,14q32.32,102748488,102868610,120122,-,-
BAC66_I18,14,14q32.32,102806143,102910837,104694,-,-
BAC25_E04,14,14q32.32,102811894,102916542,104648,-,-
BAC126_E18,14,14q32.32,102811894,102926556,114662,-,-
BAC34_I06,14,14q32.32-14q32.33,102932766,103026611,93845,-,-
BAC86_M02,14,14q32.32-14q32.33,102944619,103049615,104996,-,-
BAC37_P01,14,14q32.32-14q32.33,102952169,103049639,97470,-,-
BAC237_A15,14,14q32.32-14q32.33,102952171,103056964,104793,-,-
BAC68_K13,14,14q32.32-14q32.33,102962380,103049639,87259,-,-
BAC51_L12,14,14q32.32-14q32.33,102964640,103090710,126070,-,-
BAC106_N15,14,14q32.32-14q32.33,102986079,103090691,104612,-,-
BAC40_O20,14,14q32.32-14q32.33,102989348,103123273,133925,-,-
BAC188_E17,14,14q32.32-14q32.33,102989769,103076732,86963,-,-
BAC206_C07,14,14q32.33,103123273,103199164,75891,-,-
BAC161_P03,14,14q32.33,103126342,103204554,78212,-,-
BAC49_H09,14,14q32.33,103144740,103280679,135939,-,-
BAC145_N15,14,14q32.33,103175601,103273491,97890,-,-
BAC105_M17,14,14q32.33,103185862,103279898,94036,-,-
BAC52_E18,14,14q32.33,103241216,103333399,92183,-,-
BAC166_E01,14,14q32.33,103254686,103353508,98822,-,-
BAC180_I16,14,14q32.33,103513747,103572824,59077,-,-
BAC55_G20,14,14q32.33,103513769,103601122,87353,-,-
BAC30_G13,14,14q32.33,103573089,103702721,129632,-,-
BAC194_D13,14,14q32.33,103813658,103877263,63605,-,-
BAC86_I04,14,14q32.33,103977552,104098054,120502,-,-
BAC133_E15,14,14q32.33,104003759,104097704,93945,-,-
BAC231_M17,14,14q32.33,104023123,104133850,110727,-,-
BAC124_F23,14,14q32.33,104061053,104156021,94968,-,-
BAC187_F10,14,14q32.33,104111989,104197809,85820,-,-
BAC60_K06,14,14q32.33,104111989,104222731,110742,-,-
BAC179_F09,14,14q32.33,104156015,104292681,136666,-,-
BAC53_E08,14,14q32.33,104165341,104292678,127337,-,-
BAC194_L09,14,14q32.33,104165386,104292681,127295,-,-
BAC189_B16,14,14q32.33,104196867,104294774,97907,-,-
BAC84_P05,14,14q32.33,104197803,104315975,118172,-,-
BAC76_H08,14,14q32.33,104197803,104324189,126386,-,-
BAC243_I11,14,14q32.33,104380576,104477958,97382,-,-
BAC72_G15,14,14q32.33,104472295,104594554,122259,-,-
BAC191_P14,14,14q32.33,104474292,104556955,82663,-,-
BAC113_P07,14,14q32.33,104497344,104597264,99920,-,-
BAC175_L24,14,14q32.33,104574161,104655681,81520,-,-
BAC53_M01,14,14q32.33,104736478,104843125,106647,-,-
BAC236_F16,14,14q32.33,104788177,104885116,96939,-,-
BAC240_P03,14,14q32.33,104796312,104900634,104322,-,-
BAC152_N05,14,14q32.33,104805960,104893720,87760,-,-
BAC80_E02,14,14q32.33,104805960,104892469,86509,-,-
BAC221_F18,14,14q32.33,104819884,104892469,72585,-,-
BAC20_B23,14,14q32.33,104819905,104941537,121632,-,-
BAC235_F02,14,14q32.33,104893765,104983152,89387,-,-
BAC213_C18,14,14q32.33,104941531,105054623,113092,yes,-
BAC125_N01,14,14q32.33,104983143,105078998,95855,yes,-
BAC140_D11,14,14q32.33,104989569,105078999,89430,yes,-
BAC178_M10,14,14q32.33,104995019,105076957,81938,yes,-
BAC132_P09,14,14q32.33,105167344,105293178,125834,-,-
BAC235_M22,14,14q32.33,105498035,105569140,71105,yes,-
BAC134_E23,14,14q32.33,105498590,105610816,112226,yes,-
BAC79_B08,14,14q32.33,105541523,105648911,107388,-,-
BAC193_I04,14,14q32.33,105651806,105738361,86555,-,-
BAC69_K17,14,14q32.33,105775348,105892005,116657,-,-
BAC52_J15,14,14q32.33,105779688,105867271,87583,-,-
BAC13_B06,14,14q32.33,105786956,105922793,135837,-,-
BAC199_C04,14,14q32.33,105798107,105867314,69207,-,-
BAC232_G16,14,14q32.33,105821330,105907482,86152,-,-
BAC231_C17,14,14q32.33,105848157,105976306,128149,-,-
BAC61_H15,14,14q32.33,105849327,106036827,187500,-,-
BAC38_P13,14,14q32.33,105867346,106060004,192658,-,-
BAC31_J18,14,14q32.33,105917437,106066428,148991,-,-
BAC160_I16,14,14q32.33,105922786,105976330,53544,-,-
BAC54_D22,14,14q32.33,105922820,106085595,162775,-,-
BAC35_N11,14,14q32.33,105922912,106036807,113895,-,-
BAC102_B24,14,14q32.33,105976324,106066427,90103,-,-
BAC27_E18,14,14q32.33,106076117,106165873,89756,-,-
BAC27_B07,14,14q32.33,106118134,106253102,134968,-,-
BAC18_D24,14,14q32.33,106183363,106302058,118695,-,-
BAC59_I18,14,14q32.33,106183363,106284462,101099,-,-
BAC191_E06,14,14q32.33,106195010,106285188,90178,-,-
BAC250_L17,14,14q32.33,106241676,106318383,76707,-,-
BAC199_K18,14,14q32.33,106245973,106343568,97595,-,-
BAC2_M20,15,15q11.1,18287763,18385852,98089,-,-
BAC141_C03,15,15q11.1-15q11.2,18385845,18509882,124037,-,-
BAC179_K08,15,15q11.2,18414826,18509875,95049,-,-
BAC246_K11,15,15q11.2,18459326,18537626,78300,-,-
BAC88_B16,15,15q11.2,18501996,19147268,645272,-,-
BAC63_A03,15,15q11.2,18510962,19597052,1086090,-,-
BAC91_F06,15,15q11.2,18511002,18585764,74762,-,-
BAC186_E15,15,15q11.2,18537620,18630299,92679,-,-
BAC223_L02,15,15q11.2,18555362,18643623,88261,-,-
BAC243_F13,15,15q11.2,18586124,18692290,106166,-,-
BAC65_A01,15,15q11.2,18716457,18817229,100772,-,-
BAC2_L07,15,15q11.2,18716465,18797968,81503,-,-
BAC18_M24,15,15q11.2,18720829,18817222,96393,-,-
BAC55_G12,15,15q11.2,18748516,18848542,100026,-,-
BAC109_M07,15,15q11.2,18756957,18848540,91583,-,-
BAC167_P01,15,15q11.2,18772861,18848542,75681,-,-
BAC11_B12,15,15q11.2,18772861,18898414,125553,-,-
BAC35_E14,15,15q11.2,18772869,18886530,113661,-,-
BAC1_P16,15,15q11.2,18778052,18872534,94482,-,-
BAC107_K10,15,15q11.2,18828727,18922539,93812,-,-
BAC14_B21,15,15q11.2,18828727,18928835,100108,-,-
BAC103_L07,15,15q11.2,18843546,18955163,111617,-,-
BAC34_G19,15,15q11.2,18853903,18970051,116148,-,-
BAC172_B18,15,15q11.2,18879125,18970080,90955,-,-
BAC236_O02,15,15q11.2,18881005,18958308,77303,-,-
BAC20_G11,15,15q11.2,18884147,20986963,2102816,-,-
BAC230_I03,15,15q11.2,18939607,20999704,2060097,-,-
BAC148_N19,15,15q11.2,18939607,19035984,96377,-,-
BAC43_I10,15,15q11.2,18982301,19085278,102977,-,-
BAC28_D16,15,15q11.2,18983959,21213147,2229188,-,-
BAC118_L12,15,15q11.2,19018906,19118188,99282,-,-
BAC30_F14,15,15q11.2,19018906,19170757,151851,-,-
BAC73_M10,15,15q11.2,19027097,19123041,95944,-,-
BAC66_M12,15,15q11.2,19036007,20226387,1190380,-,-
BAC108_J23,15,15q11.2,19051669,19154349,102680,-,-
BAC120_D01,15,15q11.2,19056312,19170775,114463,-,-
BAC107_E19,15,15q11.2,19087774,19204023,116249,-,-
BAC188_A07,15,15q11.2,19103440,19254614,151174,yes,-
BAC83_C02,15,15q11.2,19108421,19236343,127922,yes,-
BAC120_M08,15,15q11.2,19168150,19266965,98815,-,-
BAC182_O07,15,15q11.2,19169294,19254614,85320,-,-
BAC144_A10,15,15q11.2,19169294,19262027,92733,-,-
BAC123_E02,15,15q11.2,19172502,19266965,94463,-,-
BAC80_A21,15,15q11.2,19204018,19322630,118612,-,-
BAC132_D08,15,15q11.2,19234634,19358977,124343,-,-
BAC73_E23,15,15q11.2,19262314,19370770,108456,-,-
BAC232_J20,15,15q11.2,19283774,19364688,80914,-,-
BAC191_I24,15,15q11.2,19283774,19360162,76388,-,-
BAC100_H13,15,15q11.2,19321665,19403198,81533,-,-
BAC243_J13,15,15q11.2,19344338,19429173,84835,-,-
BAC217_O02,15,15q11.2,19360157,19395369,35212,-,-
BAC146_C18,15,15q11.2,19370681,19468917,98236,yes,-
BAC140_H23,15,15q11.2,19456248,19872290,416042,-,-
BAC176_G05,15,15q11.2,19468925,19549460,80535,-,-
BAC107_A12,15,15q11.2,19780165,19881669,101504,-,-
BAC80_L19,15,15q11.2,19941698,20072904,131206,-,-
BAC248_A08,15,15q11.2,19943094,20066248,123154,-,-
BAC146_H15,15,15q11.2,19958102,20081471,123369,-,-
BAC71_N13,15,15q11.2,19958119,20053879,95760,-,-
BAC247_N02,15,15q11.2,19983261,20066248,82987,-,-
BAC185_A21,15,15q11.2,19995354,20086737,91383,-,-
BAC146_J04,15,15q11.2,20258774,20341154,82380,-,-
BAC143_C20,15,15q11.2,20258774,20336710,77936,-,-
BAC10_E02,15,15q11.2,20287252,21178182,890930,-,-
BAC92_A20,15,15q11.2,20332290,20425474,93184,yes,-
BAC15_C11,15,15q11.2,20367782,20485873,118091,yes,-
BAC42_J12,15,15q11.2,20414788,20568943,154155,-,-
BAC82_A01,15,15q11.2,20414800,20519281,104481,-,-
BAC97_H23,15,15q11.2,20425467,20510069,84602,-,-
BAC244_M09,15,15q11.2,20485905,20574078,88173,-,-
BAC96_G19,15,15q11.2,20485905,20611153,125248,yes,-
BAC123_I24,15,15q11.2,20552679,20669357,116678,yes,-
BAC89_J16,15,15q11.2,20634238,20736769,102531,-,-
BAC136_C10,15,15q11.2,20690101,20774862,84761,-,-
BAC222_D04,15,15q11.2,20707814,20795310,87496,-,-
BAC95_G21,15,15q11.2,20719569,20807110,87541,-,-
BAC93_A23,15,15q11.2,20790759,20890539,99780,-,-
BAC151_I05,15,15q11.2,20795362,20878704,83342,-,-
BAC141_K24,15,15q11.2,20881360,20986963,105603,-,-
BAC250_N01,15,15q11.2,20951477,21049483,98006,-,-
BAC234_N19,15,15q11.2,21142571,21209514,66943,-,-
BAC84_J11,15,15q11.2,21142571,21249616,107045,-,-
BAC61_D19,15,15q11.2,21209535,21310217,100682,-,-
BAC38_K16,15,15q11.2,21300145,21445243,145098,-,-
BAC186_H01,15,15q11.2,21306255,21370387,64132,-,-
BAC169_M13,15,15q11.2,21334219,21451281,117062,-,-
BAC148_L16,15,15q11.2,21341827,21435275,93448,-,-
BAC73_A20,15,15q11.2,21341865,21435257,93392,-,-
BAC31_M12,15,15q11.2,21355293,21457473,102180,-,-
BAC218_E03,15,15q11.2,21355605,21435275,79670,-,-
BAC111_B02,15,15q11.2,21418138,21499547,81409,-,-
BAC1_L18,15,15q11.2,21446107,21548109,102002,-,-
BAC56_G11,15,15q11.2,21457934,21601381,143447,-,-
BAC189_D10,15,15q11.2,21494829,21592639,97810,-,-
BAC84_I09,15,15q11.2,21499812,21616857,117045,-,-
BAC34_E16,15,15q11.2,21499812,21592639,92827,-,-
BAC223_H07,15,15q11.2,21518511,21607017,88506,-,-
BAC2_G20,15,15q11.2,21520344,21630302,109958,-,-
BAC188_N24,15,15q11.2,21607011,21719880,112869,-,-
BAC46_D01,15,15q11.2,21611941,21647116,35175,-,-
BAC237_N23,15,15q11.2,21687209,21785970,98761,-,-
BAC185_J12,15,15q11.2,21693259,21802018,108759,-,-
BAC11_E11,15,15q11.2,21756985,21872216,115231,-,-
BAC187_K14,15,15q11.2,21759011,21831602,72591,-,-
BAC155_L14,15,15q11.2,21853125,21945398,92273,-,-
BAC247_M05,15,15q11.2,21877714,21973974,96260,-,-
BAC8_P02,15,15q11.2,21908083,22028261,120178,-,-
BAC243_D24,15,15q11.2,21912884,22020231,107347,-,-
BAC12_O11,15,15q11.2,22018025,22150783,132758,-,-
BAC59_O10,15,15q11.2,22028069,22141801,113732,-,-
BAC131_N04,15,15q11.2,22110911,22196358,85447,-,-
BAC173_O14,15,15q11.2,22113493,22200068,86575,-,-
BAC12_F11,15,15q11.2,22432540,22539158,106618,-,-
BAC189_O02,15,15q11.2,22487420,22599823,112403,-,-
BAC220_P13,15,15q11.2,22521962,22601800,79838,-,-
BAC183_O14,15,15q11.2,22526679,22612882,86203,-,-
BAC219_F10,15,15q11.2,22539183,22601799,62616,-,-
BAC180_F11,15,15q11.2,22655943,22731635,75692,-,-
BAC223_H02,15,15q11.2,22694476,22779891,85415,-,-
BAC217_F02,15,15q11.2,22767885,22856153,88268,-,-
BAC230_G04,15,15q11.2,22814397,22909487,95090,-,-
BAC155_J02,15,15q11.2,22823301,22909997,86696,-,-
BAC133_K17,15,15q11.2,22830570,22956730,126160,-,-
BAC88_I16,15,15q11.2,22856147,22956701,100554,-,-
BAC80_D21,15,15q11.2,22956738,23063068,106330,yes,-
BAC226_D17,15,15q11.2,22981330,23053188,71858,yes,-
BAC147_A15,15,15q11.2,23006058,23106997,100939,yes,-
BAC71_A18,15,15q11.2,23101822,23188315,86493,-,-
BAC5_L18,15,15q11.2-15q12,23211569,23311228,99659,-,-
BAC36_N10,15,15q11.2-15q12,23251651,23334482,82831,-,-
BAC163_D17,15,15q11.2-15q12,23269876,23365748,95872,-,-
BAC108_C16,15,15q11.2-15q12,23295808,23389756,93948,-,-
BAC110_P13,15,15q12,23328721,23454983,126262,-,-
BAC55_A23,15,15q12,23333993,23415442,81449,-,-
BAC106_F15,15,15q12,23339217,23415444,76227,-,-
BAC21_C02,15,15q12,23368568,23486442,117874,-,-
BAC226_K20,15,15q12,23397521,23484702,87181,-,-
BAC135_F07,15,15q12,23415437,23498768,83331,-,-
BAC162_N18,15,15q12,23431354,23524097,92743,-,-
BAC68_N10,15,15q12,23547253,23662522,115269,-,-
BAC12_A24,15,15q12,23547335,23689937,142602,-,-
BAC192_P17,15,15q12,23551942,23666446,114504,-,-
BAC92_A21,15,15q12,23583553,23677879,94326,-,-
BAC142_G09,15,15q12,23635966,23729331,93365,-,-
BAC148_G03,15,15q12,23636125,23738860,102735,-,-
BAC78_H03,15,15q12,23636125,23731790,95665,-,-
BAC189_M21,15,15q12,23637837,23737648,99811,-,-
BAC46_M10,15,15q12,23637837,23729326,91489,-,-
BAC249_C08,15,15q12,23666448,23758193,91745,-,-
BAC160_H06,15,15q12,23666449,23779842,113393,-,-
BAC38_K10,15,15q12,23823850,23906633,82783,-,-
BAC107_G18,15,15q12,23886394,24005177,118783,-,-
BAC79_C22,15,15q12,23900881,24053910,153029,-,-
BAC178_K14,15,15q12,23915116,23990301,75185,-,-
BAC187_J01,15,15q12,24007155,24092114,84959,-,-
BAC56_J08,15,15q12,24024804,24108659,83855,-,-
BAC106_F07,15,15q12,24119333,24218072,98739,-,-
BAC247_G10,15,15q12,24168882,24256346,87464,-,-
BAC50_P08,15,15q12,24173257,24258208,84951,-,-
BAC123_N23,15,15q12,24175594,24267102,91508,-,-
BAC248_C13,15,15q12,24281096,24383877,102781,-,-
BAC78_F07,15,15q12,24369659,24485628,115969,-,-
BAC180_J22,15,15q12,24398126,24505662,107536,-,-
BAC199_J15,15,15q12,24401176,24480800,79624,-,-
BAC21_O06,15,15q12,24429411,24553835,124424,-,-
BAC105_L07,15,15q12,24456681,24577646,120965,-,-
BAC144_F12,15,15q12,24735226,24858688,123462,-,-
BAC162_H22,15,15q12,24765029,24887822,122793,-,-
BAC181_E03,15,15q12,24796553,24883376,86823,-,-
BAC62_B05,15,15q12,24907597,25012372,104775,-,-
BAC23_C04,15,15q12,24914507,25036347,121840,-,-
BAC157_H01,15,15q12,24929864,25017993,88129,-,-
BAC205_G15,15,15q12,24929912,25012303,82391,-,-
BAC218_C05,15,15q12,25043684,25067749,24065,-,-
BAC55_E23,15,15q12,25287056,25401470,114414,-,-
BAC8_E18,15,15q12,25327630,25434246,106616,-,-
BAC106_O13,15,15q12,25351652,25474078,122426,-,-
BAC187_J13,15,15q12,25432730,25563758,131028,-,-
BAC236_A03,15,15q12,25454978,25556710,101732,-,-
BAC176_J19,15,15q12,25473059,25561632,88573,-,-
BAC187_N03,15,15q12,25498064,25596925,98861,-,-
BAC82_P01,15,15q12,25571886,25668721,96835,-,-
BAC91_O02,15,15q12-15q13.1,25614355,25746088,131733,-,-
BAC137_H09,15,15q12-15q13.1,25639425,25727937,88512,-,-
BAC25_G19,15,15q13.1,25735965,25852260,116295,-,-
BAC33_E07,15,15q13.1,25824160,25940424,116264,-,-
BAC84_O23,15,15q13.1,25874221,25983944,109723,-,-
BAC111_H22,15,15q13.1,26142045,26239522,97477,-,-
BAC136_O23,15,15q13.1,26150901,26239522,88621,-,-
BAC62_C05,15,15q13.1,26150916,26251770,100854,-,-
BAC113_D11,15,15q13.1,26749354,26856279,106925,-,-
BAC196_K07,15,15q13.1,27005116,27113459,108343,-,-
BAC33_G10,15,15q13.1,27098143,27271600,173457,-,-
BAC29_F11,15,15q13.1,27113537,27241237,127700,-,-
BAC196_I03,15,15q13.1,27115456,27215288,99832,-,-
BAC218_L02,15,15q13.1,27197709,27363727,166018,-,-
BAC73_H09,15,15q13.1,27216174,27303419,87245,-,-
BAC66_D02,15,15q13.1,27237243,27330065,92822,-,-
BAC118_D19,15,15q13.1,27241231,27363727,122496,-,-
BAC139_H03,15,15q13.1,27241258,27330065,88807,-,-
BAC43_H20,15,15q13.1,27330060,27459205,129145,-,-
BAC46_I18,15,15q13.1,27374541,27510560,136019,-,-
BAC64_N21,15,15q13.1,27516738,27610878,94140,-,-
BAC140_F21,15,15q13.1,27581099,27691440,110341,-,-
BAC182_D23,15,15q13.1,27598327,27678174,79847,-,-
BAC84_A10,15,15q13.1,27613004,27714387,101383,-,-
BAC238_J20,15,15q13.1,27695991,27799505,103514,-,-
BAC53_B04,15,15q13.1,27719890,27858271,138381,-,-
BAC24_E18,15,15q13.1,27733520,27836097,102577,-,-
BAC242_C09,15,15q13.1,27778153,27869354,91201,-,-
BAC43_E23,15,15q13.1,27816729,27907374,90645,-,-
BAC240_P07,15,15q13.1,27836090,27955643,119553,-,-
BAC46_D04,15,15q13.2,28039444,28139064,99620,-,-
BAC237_E04,15,15q13.2,28064878,28186941,122063,-,-
BAC142_D15,15,15q13.2,28064878,28169770,104892,-,-
BAC143_H23,15,15q13.2,28064878,28169770,104892,-,-
BAC243_O04,15,15q13.2,28086641,28191321,104680,-,-
BAC38_L21,15,15q13.2,28122502,28258554,136052,-,-
BAC90_I21,15,15q13.2,28296859,28423060,126201,-,-
BAC147_C07,15,15q13.2,28339491,28417686,78195,-,-
BAC37_L06,15,15q13.2,28339491,28454324,114833,-,-
BAC91_M01,15,15q13.2,28397682,28525635,127953,yes,-
BAC28_F20,15,15q13.2,28435137,28586793,151656,yes,-
BAC135_A04,15,15q13.2,28486809,28583670,96861,-,-
BAC150_N13,15,15q13.2,28503681,28609162,105481,-,-
BAC143_E18,15,15q13.2,28638418,28716739,78321,-,-
BAC228_K02,15,15q13.2,28732599,28828613,96014,-,-
BAC19_G18,15,15q13.2,28743214,28858533,115319,-,-
BAC64_E04,15,15q13.2,28771754,28845815,74061,-,-
BAC69_C17,15,15q13.2,28850067,28968960,118893,-,-
BAC173_E06,15,15q13.2-15q13.3,28969930,29048283,78353,-,-
BAC66_J05,15,15q13.3,29010518,29115922,105404,-,-
BAC242_O02,15,15q13.3,29082692,29169296,86604,-,-
BAC91_I01,15,15q13.3,29093781,29187979,94198,-,-
BAC19_L10,15,15q13.3,29101543,29231603,130060,-,-
BAC100_C18,15,15q13.3,29274419,29399173,124754,-,-
BAC173_P11,15,15q13.3,29367019,29461518,94499,-,-
BAC83_O23,15,15q13.3,29412164,29498481,86317,-,-
BAC233_L15,15,15q13.3,29415465,29507987,92522,-,-
BAC36_N21,15,15q13.3,29474973,29615833,140860,-,-
BAC167_N16,15,15q13.3,29474981,29573566,98585,-,-
BAC171_B11,15,15q13.3,29489112,29556301,67189,-,-
BAC171_K22,15,15q13.3,29498514,29587129,88615,-,-
BAC26_K14,15,15q13.3,29580631,29667814,87183,-,-
BAC36_D08,15,15q13.3,29702060,29832637,130577,-,-
BAC171_K10,15,15q13.3,29716691,29799473,82782,-,-
BAC52_C08,15,15q13.3,29726557,29798929,72372,-,-
BAC50_A04,15,15q13.3,29726557,29817307,90750,-,-
BAC228_H19,15,15q13.3,29740043,29854305,114262,-,-
BAC147_A09,15,15q13.3,29764062,29855459,91397,-,-
BAC89_K01,15,15q13.3,29769752,29861418,91666,-,-
BAC45_F17,15,15q13.3,29769758,29898119,128361,-,-
BAC247_I03,15,15q13.3,29792919,29867411,74492,-,-
BAC175_A22,15,15q13.3,29934876,30018163,83287,-,-
BAC230_B04,15,15q13.3,30032906,30133175,100269,-,-
BAC177_J21,15,15q13.3,30062798,30151245,88447,-,-
BAC229_A20,15,15q13.3,30149318,30229424,80106,-,-
BAC151_L17,15,15q13.3,30245082,30367070,121988,-,-
BAC238_I20,15,15q13.3,30277235,30364905,87670,-,-
BAC129_F03,15,15q13.3,30277236,30379628,102392,-,-
BAC41_A16,15,15q13.3,30309371,30419594,110223,-,-
BAC237_K11,15,15q13.3,30413621,30526703,113082,-,-
BAC101_D07,15,15q13.3,30559645,30709434,149789,-,-
BAC191_N03,15,15q13.3,30582980,30673375,90395,-,-
BAC248_H20,15,15q13.3,30706728,30801789,95061,yes,-
BAC114_L13,15,15q13.3,30783685,30886602,102917,yes,-
BAC27_K03,15,15q13.3,30801837,30898421,96584,-,-
BAC132_K14,15,15q13.3,30808535,30886602,78067,-,-
BAC120_D15,15,15q13.3,31019497,31109590,90093,-,-
BAC19_K22,15,15q13.3,31037208,31140225,103017,-,-
BAC50_F19,15,15q13.3,31172708,31360949,188241,-,-
BAC122_N21,15,15q13.3,31207152,31293427,86275,-,-
BAC218_O13,15,15q13.3,31271308,31355145,83837,-,-
BAC111_F04,15,15q13.3,31276578,31373569,96991,-,-
BAC26_D07,15,15q13.3-15q14,31276579,31452308,175729,-,-
BAC53_P12,15,15q13.3,31294328,31379107,84779,-,-
BAC19_B07,15,15q13.3-15q14,31297382,31415214,117832,-,-
BAC80_H18,15,15q13.3-15q14,31309595,31415215,105620,-,-
BAC81_N23,15,15q13.3-15q14,31328831,31461637,132806,-,-
BAC82_D20,15,15q13.3-15q14,31386341,31507664,121323,-,-
BAC80_L05,15,15q13.3-15q14,31392971,31503266,110295,-,-
BAC248_J22,15,15q14,31415252,31507664,92412,-,-
BAC243_M11,15,15q14,31484091,31628236,144145,-,-
BAC41_C03,15,15q14,31505153,31608240,103087,-,-
BAC8_F11,15,15q14,31556597,31712520,155923,-,-
BAC121_B19,15,15q14,31589585,31699757,110172,-,-
BAC200_M14,15,15q14,31592766,31680303,87537,-,-
BAC122_L19,15,15q14,31606784,31695091,88307,-,-
BAC25_K09,15,15q14,31609085,31712529,103444,-,-
BAC88_E07,15,15q14,31618312,31699777,81465,-,-
BAC183_H14,15,15q14,31705489,31788846,83357,-,-
BAC92_E24,15,15q14,31714600,31825793,111193,-,-
BAC241_P21,15,15q14,31774414,31854505,80091,-,-
BAC63_O23,15,15q14,31838423,31939423,101000,-,-
BAC155_C12,15,15q14,31854765,31929509,74744,-,-
BAC180_E02,15,15q14,31856773,31942655,85882,-,-
BAC171_M10,15,15q14,31859575,31970037,110462,-,-
BAC127_N19,15,15q14,31859575,31970035,110460,-,-
BAC219_B07,15,15q14,31859580,31942651,83071,-,-
BAC190_H15,15,15q14,31859580,31977623,118043,-,-
BAC29_C06,15,15q14,31920289,32034535,114246,-,-
BAC176_K23,15,15q14,31954281,32048754,94473,-,-
BAC159_O02,15,15q14,31970035,32073854,103819,-,-
BAC10_H19,15,15q14,32002682,32129835,127153,-,-
BAC214_F17,15,15q14,32037681,32129741,92060,-,-
BAC77_F03,15,15q14,32109177,32209670,100493,yes,-
BAC199_D21,15,15q14,32256237,32414222,157985,-,-
BAC6_P15,15,15q14,32287065,32383704,96639,-,-
BAC169_B03,15,15q14,32414216,32641165,226949,yes,-
BAC120_B13,15,15q14,32490957,32590796,99839,-,-
BAC146_F05,15,15q14,32558151,32641168,83017,-,-
BAC54_A09,15,15q14,32641362,32734743,93381,-,-
BAC120_A10,15,15q14,32651302,32734625,83323,-,-
BAC182_K03,15,15q14,32745237,32846661,101424,-,-
BAC231_G05,15,15q14,32804831,32893818,88987,-,-
BAC134_I22,15,15q14,32805015,32910536,105521,-,-
BAC170_H09,15,15q14,32839355,32942591,103236,-,-
BAC175_N11,15,15q14,32867843,32953075,85232,-,-
BAC27_H01,15,15q14,32920056,33019707,99651,-,-
BAC222_K02,15,15q14,32977939,33080308,102369,-,-
BAC55_F01,15,15q14,33054181,33185538,131357,-,-
BAC90_H23,15,15q14,33061921,33148724,86803,-,-
BAC31_M04,15,15q14,33077885,33185536,107651,-,-
BAC157_E10,15,15q14,33080303,33174656,94353,-,-
BAC60_K11,15,15q14,33255322,33350453,95131,-,-
BAC250_A10,15,15q14,33272021,33378109,106088,-,-
BAC45_E18,15,15q14,33289170,33379637,90467,-,-
BAC163_P19,15,15q14,33338105,33424936,86831,-,-
BAC142_H23,15,15q14,33338105,33410183,72078,-,-
BAC44_P10,15,15q14,33350764,33463218,112454,-,-
BAC218_A23,15,15q14,33378125,33463249,85124,-,-
BAC161_E23,15,15q14,33485331,33565255,79924,-,-
BAC160_P12,15,15q14,33645795,33778269,132474,-,-
BAC153_G01,15,15q14,33738718,33828894,90176,-,-
BAC197_N21,15,15q14,33821343,33941813,120470,-,-
BAC115_H22,15,15q14,33892018,33989915,97897,-,-
BAC249_H05,15,15q14,33892519,33974494,81975,-,-
BAC222_L11,15,15q14,33906461,33989815,83354,-,-
BAC77_H24,15,15q14,33974717,34064029,89312,-,-
BAC77_C13,15,15q14,33981766,34064029,82263,-,-
BAC20_N09,15,15q14,34285832,34406666,120834,-,-
BAC48_P15,15,15q14,34355107,34371809,16702,-,-
BAC10_L16,15,15q14,34455508,34554922,99414,-,-
BAC79_H24,15,15q14,34512881,34609713,96832,-,-
BAC22_A19,15,15q14,34537940,34626998,89058,-,-
BAC221_I21,15,15q14,34593146,34676587,83441,-,-
BAC171_G19,15,15q14,34637365,34729885,92520,-,-
BAC223_P15,15,15q14,34753968,34873097,119129,-,-
BAC24_N04,15,15q14,34768289,34873097,104808,-,-
BAC17_L11,15,15q14,34810967,34923910,112943,-,-
BAC66_K21,15,15q14,34891569,34992991,101422,-,-
BAC65_N23,15,15q14,34898979,35092280,193301,-,-
BAC63_B21,15,15q14,34919863,34998194,78331,-,-
BAC156_O16,15,15q14,34956853,35116514,159661,-,-
BAC122_G14,15,15q14,34967635,35050168,82533,-,-
BAC217_K06,15,15q14,34998189,35092347,94158,-,-
BAC160_O17,15,15q14,35034975,35126790,91815,-,-
BAC141_B17,15,15q14,35128997,35218275,89278,-,-
BAC25_G07,15,15q14,35165461,35301702,136241,-,-
BAC90_E02,15,15q14,35188344,35301741,113397,-,-
BAC69_D07,15,15q14,35194235,35275654,81419,-,-
BAC226_E18,15,15q14,35577693,35677468,99775,-,-
BAC102_B15,15,15q14,35597829,35688070,90241,-,-
BAC43_M07,15,15q14,35641162,35809829,168667,-,-
BAC5_P23,15,15q14,35677492,35790690,113198,-,-
BAC63_K06,15,15q14,35858484,35954437,95953,-,-
BAC209_C08,15,15q14,35877847,35982564,104717,-,-
BAC144_O16,15,15q14,35897552,35974302,76750,-,-
BAC185_I12,15,15q14,35920006,36009429,89423,-,-
BAC110_L08,15,15q14,36095133,36189594,94461,-,-
BAC195_K03,15,15q14,36191380,36275728,84348,-,-
BAC18_B05,15,15q14,36232674,36324240,91566,-,-
BAC193_H05,15,15q14,36287621,36370924,83303,-,-
BAC178_H21,15,15q14,36322713,36431229,108516,-,-
BAC20_D10,15,15q14,36324557,36445813,121256,-,-
BAC78_B12,15,15q14,36340258,36453877,113619,-,-
BAC198_F21,15,15q14,36549749,36643291,93542,-,-
BAC118_G22,15,15q14,36552230,36678201,125971,-,-
BAC182_H19,15,15q14,36666527,36750614,84087,-,-
BAC169_P23,15,15q14,36676959,36763756,86797,-,-
BAC107_C14,15,15q14,36703829,36794274,90445,-,-
BAC115_B12,15,15q14,36720909,36836899,115990,-,-
BAC153_O07,15,15q14,36732152,36827513,95361,-,-
BAC91_N05,15,15q14,36759373,36855460,96087,-,-
BAC218_H18,15,15q14,36764114,36865836,101722,-,-
BAC139_K19,15,15q14,36832652,36914196,81544,-,-
BAC179_G22,15,15q14,36847497,36955517,108020,-,-
BAC139_G12,15,15q14,36857874,36952439,94565,-,-
BAC127_G01,15,15q14,36857879,36942148,84269,-,-
BAC170_L08,15,15q14,36923629,37009430,85801,-,-
BAC96_M18,15,15q14,36951634,37041535,89901,-,-
BAC173_E12,15,15q14,37020343,37122202,101859,-,-
BAC82_B19,15,15q14,37076319,37199503,123184,-,-
BAC102_P02,15,15q14,37350515,37436899,86384,-,-
BAC157_O09,15,15q14,37382308,37392837,10529,-,-
BAC161_F23,15,15q14,37479137,37544802,65665,-,-
BAC182_L10,15,15q14,37528658,37611947,83289,-,-
BAC71_I05,15,15q14,37610030,37700968,90938,-,-
BAC5_D20,15,15q14,37610075,37697497,87422,-,-
BAC161_L14,15,15q14,37697499,37792046,94547,-,-
BAC171_E17,15,15q14,37704743,37799307,94564,-,-
BAC129_N21,15,15q14,37727177,37820415,93238,-,-
BAC59_J19,15,15q14,37749390,37837455,88065,-,-
BAC123_E17,15,15q14,37761345,37892236,130891,-,-
BAC115_M02,15,15q14,37787095,37868116,81021,-,-
BAC52_G21,15,15q14-15q15.1,37833754,37928344,94590,-,-
BAC83_E21,15,15q14-15q15.1,37896575,37999223,102648,-,-
BAC8_A01,15,15q15.1,37988921,38127791,138870,-,-
BAC230_C15,15,15q15.1,38006774,38078555,71781,-,-
BAC119_O23,15,15q15.1,38017604,38108748,91144,-,-
BAC124_D21,15,15q15.1,38025637,38101674,76037,-,-
BAC115_C18,15,15q15.1,38078598,38161044,82446,-,-
BAC217_I03,15,15q15.1,38101751,38183988,82237,-,-
BAC180_L21,15,15q15.1,38161036,38259341,98305,-,-
BAC142_G20,15,15q15.1,38186619,38279483,92864,-,-
BAC177_I07,15,15q15.1,38222266,38289341,67075,-,-
BAC23_H19,15,15q15.1,38296731,38400932,104201,-,-
BAC40_M13,15,15q15.1,38322098,38469175,147077,-,-
BAC83_O15,15,15q15.1,38369162,38469173,100011,-,-
BAC10_H07,15,15q15.1,38369190,38480236,111046,-,-
BAC193_F21,15,15q15.1,38404972,38486326,81354,-,-
BAC247_P08,15,15q15.1,38407829,38465719,57890,-,-
BAC217_I07,15,15q15.1,38407829,38486866,79037,-,-
BAC11_O14,15,15q15.1,38466534,38674279,207745,-,-
BAC50_I13,15,15q15.1,38469192,38608688,139496,-,-
BAC90_B08,15,15q15.1,38480254,38605223,124969,-,-
BAC68_N08,15,15q15.1,38514426,38629723,115297,-,-
BAC166_G08,15,15q15.1,38627930,38733548,105618,-,-
BAC215_J03,15,15q15.1,38708681,38821893,113212,-,-
BAC175_L04,15,15q15.1,38726029,38844215,118186,-,-
BAC40_K14,15,15q15.1,38726369,38858713,132344,-,-
BAC64_H15,15,15q15.1,38731331,38844215,112884,-,-
BAC139_G08,15,15q15.1,38736567,38844215,107648,-,-
BAC58_F15,15,15q15.1,38743422,38864585,121163,-,-
BAC38_H03,15,15q15.1,38844218,39002693,158475,-,-
BAC137_D16,15,15q15.1,38873165,39002685,129520,-,-
BAC31_P18,15,15q15.1,38873181,38968591,95410,-,-
BAC178_D04,15,15q15.1,38875560,39010143,134583,-,-
BAC148_D02,15,15q15.1,38875560,38964954,89394,-,-
BAC218_L24,15,15q15.1,38886044,39010143,124099,-,-
BAC182_H16,15,15q15.1,38888653,38968926,80273,-,-
BAC148_E12,15,15q15.1,38963855,39044052,80197,-,-
BAC40_O10,15,15q15.1,38985382,39122398,137016,-,-
BAC66_C03,15,15q15.1,38987654,39097435,109781,-,-
BAC183_O09,15,15q15.1,38989040,39069444,80404,-,-
BAC172_M20,15,15q15.1,39010148,39093532,83384,-,-
BAC247_G22,15,15q15.1,39042826,39118486,75660,-,-
BAC102_C05,15,15q15.1,39177767,39274483,96716,-,-
BAC163_J11,15,15q15.1,39179008,39274437,95429,-,-
BAC68_N02,15,15q15.1,39179008,39274483,95475,-,-
BAC135_M03,15,15q15.1,39179282,39274403,95121,-,-
BAC139_O17,15,15q15.1,39184780,39274483,89703,-,-
BAC115_E02,15,15q15.1,39274506,39396218,121712,-,-
BAC234_I05,15,15q15.1,39296853,39384592,87739,-,-
BAC236_H08,15,15q15.1,39339903,39374617,34714,-,-
BAC172_F12,15,15q15.1,39437647,39576806,139159,-,-
BAC140_J09,15,15q15.1,39456227,39539069,82842,-,-
BAC81_M13,15,15q15.1,39460136,39604391,144255,-,-
BAC155_J16,15,15q15.1,39476758,39491845,15087,-,-
BAC51_N14,15,15q15.1,39476758,39558425,81667,-,-
BAC163_I22,15,15q15.1,39588156,39680445,92289,yes,-
BAC249_J05,15,15q15.1,39604433,39681437,77004,yes,-
BAC140_P20,15,15q15.1,39655701,39726518,70817,-,-
BAC161_M10,15,15q15.1,39744612,39828816,84204,-,-
BAC186_L22,15,15q15.1,39807259,39911522,104263,-,-
BAC158_L18,15,15q15.1,39849895,39952478,102583,-,-
BAC124_K02,15,15q15.1,39882329,39966415,84086,-,-
BAC162_K11,15,15q15.1,39911516,40017191,105675,-,-
BAC107_F14,15,15q15.1,39960871,40079077,118206,-,-
BAC165_H21,15,15q15.1,39966410,40046211,79801,-,-
BAC107_I04,15,15q15.1,39971398,40046211,74813,-,-
BAC41_I07,15,15q15.1,39971402,40086080,114678,-,-
BAC243_E19,15,15q15.1,40004784,40085879,81095,-,-
BAC218_P01,15,15q15.1,40111619,40185282,73663,yes,-
BAC180_G06,15,15q15.1,40131788,40251699,119911,yes,-
BAC252_L17,15,15q15.1,40132300,40218411,86111,yes,-
BAC59_G13,15,15q15.1,40154720,40279011,124291,-,-
BAC46_C24,15,15q15.1,40194449,40330509,136060,-,-
BAC175_M15,15,15q15.1,40218415,40363226,144811,-,-
BAC227_J06,15,15q15.1,40352308,40444337,92029,-,-
BAC91_O04,15,15q15.1,40372569,40479066,106497,-,-
BAC136_A09,15,15q15.1,40444332,40481707,37375,-,-
BAC75_I13,15,15q15.1,40499098,40597102,98004,-,-
BAC101_M12,15,15q15.1,40541156,40650463,109307,-,-
BAC88_O20,15,15q15.1,40541156,40689531,148375,-,-
BAC223_F01,15,15q15.1,40551615,40657379,105764,-,-
BAC126_E23,15,15q15.1,40588717,40671915,83198,-,-
BAC145_D24,15,15q15.1-15q15.2,40622058,40725968,103910,-,-
BAC159_J01,15,15q15.1-15q15.2,40645281,40765599,120318,-,-
BAC185_B11,15,15q15.1-15q15.2,40664771,40748197,83426,-,-
BAC238_J02,15,15q15.1-15q15.2,40683217,40759474,76257,-,-
BAC227_H23,15,15q15.2,40834970,40915445,80475,-,-
BAC233_D04,15,15q15.2,40866007,40967336,101329,-,-
BAC61_A23,15,15q15.2,40872325,41019573,147248,-,-
BAC4_I23,15,15q15.2,40911017,40998626,87609,-,-
BAC42_E05,15,15q15.2,40915584,41037355,121771,-,-
BAC102_E05,15,15q15.2,40915593,40999658,84065,-,-
BAC244_L23,15,15q15.2,40922239,41043150,120911,-,-
BAC224_G11,15,15q15.2,40926743,41011471,84728,-,-
BAC43_A18,15,15q15.2,40927034,41043350,116316,-,-
BAC217_L08,15,15q15.2,40972686,41032310,59624,-,-
BAC101_L13,15,15q15.2,40972686,41108580,135894,-,-
BAC219_B08,15,15q15.2,40991578,41076792,85214,-,-
BAC251_D13,15,15q15.2,41007826,41151016,143190,-,-
BAC32_P12,15,15q15.2,41019633,41165866,146233,-,-
BAC123_B02,15,15q15.2,41183496,41274113,90617,-,-
BAC146_C22,15,15q15.2,41183795,41270279,86484,-,-
BAC172_P11,15,15q15.2,41183795,41270279,86484,-,-
BAC22_A18,15,15q15.2,41183795,41296749,112954,-,-
BAC81_M01,15,15q15.2,41183795,41277749,93954,-,-
BAC57_J18,15,15q15.2,41294020,41365719,71699,-,-
BAC10_O18,15,15q15.2-15q15.3,41329962,41455767,125805,-,-
BAC31_I01,15,15q15.2-15q15.3,41392501,41495936,103435,-,-
BAC199_E04,15,15q15.3,41418056,41524999,106943,-,-
BAC46_F07,15,15q15.3,41438476,41573284,134808,-,-
BAC105_P11,15,15q15.3,41535846,41657440,121594,-,-
BAC103_I01,15,15q15.3,41535846,41646321,110475,-,-
BAC223_L18,15,15q15.3,41537552,41621538,83986,-,-
BAC73_E22,15,15q15.3,41555445,41640910,85465,-,-
BAC226_B20,15,15q15.3,41555784,41639058,83274,-,-
BAC218_O04,15,15q15.3,41579779,41689466,109687,yes,-
BAC59_D17,15,15q15.3,41579792,41656949,77157,-,-
BAC84_C06,15,15q15.3,41579797,41718326,138529,yes,-
BAC78_H02,15,15q15.3,41672674,41925013,252339,yes,-
BAC108_A14,15,15q15.3,41689531,41777093,87562,yes,-
BAC59_E22,15,15q15.3,41689531,41876379,186848,yes,-
BAC25_E18,15,15q15.3,41814856,41955719,140863,-,-
BAC64_B13,15,15q15.3,41821638,41925014,103376,-,-
BAC115_M10,15,15q15.3,41829814,41940730,110916,-,-
BAC90_E05,15,15q15.3,41848736,41933002,84266,-,-
BAC137_G19,15,15q15.3,41855010,41959356,104346,-,-
BAC102_H14,15,15q15.3,41866024,41955746,89722,-,-
BAC230_F09,15,15q15.3,41879984,41968232,88248,-,-
BAC131_K16,15,15q15.3,41955740,42070191,114451,-,-
BAC106_I16,15,15q15.3,42003606,42137291,133685,-,-
BAC53_A22,15,15q15.3,42041186,42129652,88466,-,-
BAC102_C03,15,15q15.3,42058478,42149915,91437,-,-
BAC38_I20,15,15q15.3,42108360,42135025,26665,-,-
BAC38_E11,15,15q15.3,42127354,42153754,26400,-,-
BAC29_D03,15,15q15.3,42201172,42282441,81269,-,-
BAC67_E20,15,15q15.3,42239199,42367517,128318,-,-
BAC172_H20,15,15q15.3,42287661,42362515,74854,-,-
BAC231_F09,15,15q15.3,42391870,42424026,32156,-,-
BAC32_L05,15,15q15.3,42403296,42493924,90628,-,-
BAC109_D22,15,15q15.3,42433274,42511123,77849,-,-
BAC57_K14,15,15q15.3,42490785,42600883,110098,-,-
BAC86_I21,15,15q15.3,42490787,42580651,89864,-,-
BAC120_L06,15,15q15.3,42511226,42617193,105967,-,-
BAC66_O17,15,15q15.3,42602952,42683362,80410,-,-
BAC97_N19,15,15q15.3-15q21.1,42621615,42725507,103892,-,-
BAC79_E10,15,15q15.3-15q21.1,42669780,42747429,77649,-,-
BAC58_K18,15,15q21.1,42701822,42808758,106936,-,-
BAC35_D01,15,15q21.1,42725627,42816666,91039,-,-
BAC240_H02,15,15q21.1,42775984,42855808,79824,-,-
BAC68_E08,15,15q21.1,42786306,42915940,129634,-,-
BAC20_P16,15,15q21.1,42838547,42931472,92925,-,-
BAC231_F15,15,15q21.1,42940324,43019976,79652,-,-
BAC77_E22,15,15q21.1,42953919,43050462,96543,-,-
BAC247_C08,15,15q21.1,42961156,43090116,128960,-,-
BAC79_D13,15,15q21.1,43148359,43282976,134617,-,-
BAC110_B05,15,15q21.1,43194201,43282978,88777,-,-
BAC239_L07,15,15q21.1,43214502,43282993,68491,-,-
BAC131_L03,15,15q21.1,43238516,43346325,107809,-,-
BAC162_D16,15,15q21.1,43238559,43346325,107766,-,-
BAC166_K02,15,15q21.1,43282065,43394838,112773,-,-
BAC43_A11,15,15q21.1,43288181,43394835,106654,-,-
BAC241_B21,15,15q21.1,43431776,43512776,81000,-,-
BAC60_D18,15,15q21.1,43437703,43586242,148539,-,-
BAC193_O11,15,15q21.1,43493199,43586242,93043,-,-
BAC127_N10,15,15q21.1,43593376,43713688,120312,-,-
BAC76_D08,15,15q21.1,43608959,43719354,110395,-,-
BAC142_H14,15,15q21.1,43633173,43760922,127749,-,-
BAC34_H19,15,15q21.1,43747003,43837100,90097,-,-
BAC60_L23,15,15q21.1,43750151,43878568,128417,-,-
BAC219_C10,15,15q21.1,43969412,44068363,98951,-,-
BAC218_I14,15,15q21.1,43977899,44063423,85524,-,-
BAC44_D14,15,15q21.1,44042181,44130563,88382,-,-
BAC105_H06,15,15q21.1,44049703,44138449,88746,-,-
BAC21_C03,15,15q21.1,44212060,44332364,120304,-,-
BAC152_L12,15,15q21.1,44320024,44425306,105282,-,-
BAC32_F12,15,15q21.1,44425309,44514528,89219,-,-
BAC190_L19,15,15q21.1,44502678,44608498,105820,-,-
BAC184_A06,15,15q21.1,44568623,44658813,90190,-,-
BAC34_O11,15,15q21.1,44642916,44721023,78107,-,-
BAC200_M19,15,15q21.1,44766695,44862372,95677,-,-
BAC54_B02,15,15q21.1,44862367,44962157,99790,-,-
BAC144_N02,15,15q21.1,44935749,45023973,88224,-,-
BAC150_H12,15,15q21.1,45049580,45139097,89517,-,-
BAC22_J02,15,15q21.1,45135767,45271267,135500,-,-
BAC184_L07,15,15q21.1,45225204,45319388,94184,-,-
BAC31_H21,15,15q21.1,45233019,45321452,88433,-,-
BAC19_B12,15,15q21.1,45408687,45530417,121730,-,-
BAC73_I09,15,15q21.1,45463241,45491800,28559,-,-
BAC41_L07,15,15q21.1,45488696,45590554,101858,-,-
BAC8_E13,15,15q21.1,45751912,45854864,102952,-,-
BAC100_H20,15,15q21.1,45753927,45844164,90237,-,-
BAC237_B23,15,15q21.1,45770244,45854864,84620,-,-
BAC96_P05,15,15q21.1,45793939,45898396,104457,-,-
BAC55_K13,15,15q21.1,45952613,46053805,101192,-,-
BAC186_M10,15,15q21.1,46102721,46217666,114945,-,-
BAC90_I18,15,15q21.1,46185192,46275879,90687,-,-
BAC170_H04,15,15q21.1,46245840,46331912,86072,-,-
BAC119_O10,15,15q21.1,46245850,46356581,110731,-,-
BAC66_J01,15,15q21.1,46363539,46501108,137569,-,-
BAC163_B01,15,15q21.1,46381001,46499227,118226,-,-
BAC48_G14,15,15q21.1,46381001,46516930,135929,-,-
BAC178_G09,15,15q21.1,46400226,46516930,116704,-,-
BAC198_D17,15,15q21.1,46413527,46499327,85800,-,-
BAC104_L01,15,15q21.1,46418777,46553139,134362,-,-
BAC102_K04,15,15q21.1,46516924,46644732,127808,-,-
BAC231_O21,15,15q21.1,46567549,46653056,85507,-,-
BAC24_K11,15,15q21.1,46591058,46772298,181240,-,-
BAC175_H16,15,15q21.1,46605544,46732415,126871,-,-
BAC53_E19,15,15q21.1,46605548,46772059,166511,-,-
BAC79_N10,15,15q21.1,46613498,46754204,140706,-,-
BAC178_K16,15,15q21.1,46636419,46734018,97599,-,-
BAC88_K12,15,15q21.1,46636432,46753558,117126,-,-
BAC139_A05,15,15q21.1,46649733,46712866,63133,-,-
BAC31_E11,15,15q21.1,46653051,46773485,120434,-,-
BAC107_E12,15,15q21.1,46653051,46802449,149398,-,-
BAC172_C23,15,15q21.1,46665133,46760656,95523,-,-
BAC226_J05,15,15q21.1,46796124,46910054,113930,-,-
BAC123_I01,15,15q21.1,46804931,46890695,85764,-,-
BAC118_F20,15,15q21.1,46954650,47051437,96787,-,-
BAC146_M05,15,15q21.1,47004873,47104678,99805,-,-
BAC45_M05,15,15q21.1,47016049,47142690,126641,-,-
BAC68_N06,15,15q21.1,47140859,47234223,93364,-,-
BAC148_J19,15,15q21.1,47223987,47322414,98427,-,-
BAC42_M06,15,15q21.1,47236745,47322411,85666,-,-
BAC186_D14,15,15q21.1,47288712,47381876,93164,-,-
BAC175_K07,15,15q21.1,47299121,47427124,128003,-,-
BAC40_C05,15,15q21.1,47401913,47517679,115766,-,-
BAC162_O01,15,15q21.1-15q21.2,47497661,47602140,104479,-,-
BAC173_G16,15,15q21.1-15q21.2,47515515,47602140,86625,-,-
BAC74_B06,15,15q21.2,47642152,47773580,131428,-,-
BAC24_F02,15,15q21.2,47746220,47876309,130089,-,-
BAC46_B05,15,15q21.2,47759222,47848989,89767,-,-
BAC123_O07,15,15q21.2,47848982,47987105,138123,-,-
BAC156_O22,15,15q21.2,48164716,48269798,105082,-,-
BAC68_C12,15,15q21.2,48316689,48441890,125201,-,-
BAC105_M11,15,15q21.2,48319517,48425632,106115,-,-
BAC156_D18,15,15q21.2,48330986,48425632,94646,-,-
BAC226_N06,15,15q21.2,48333866,48421770,87904,-,-
BAC8_J17,15,15q21.2,48481281,48639969,158688,-,-
BAC179_A16,15,15q21.2,48486223,48575969,89746,-,-
BAC110_I16,15,15q21.2,48486745,48609458,122713,-,-
BAC40_K13,15,15q21.2,48504442,48576437,71995,-,-
BAC122_A20,15,15q21.2,48622634,48806863,184229,-,-
BAC181_M13,15,15q21.2,48628433,48721791,93358,-,-
BAC84_C02,15,15q21.2,48633441,48721888,88447,-,-
BAC142_N13,15,15q21.2,48633441,48728376,94935,-,-
BAC83_M17,15,15q21.2,48678849,48790075,111226,-,-
BAC59_G10,15,15q21.2,48678849,48791878,113029,-,-
BAC188_E13,15,15q21.2,48702475,48777171,74696,-,-
BAC10_O08,15,15q21.2,48702475,48870748,168273,-,-
BAC100_F04,15,15q21.2,48707399,48790076,82677,-,-
BAC53_L22,15,15q21.2,48721789,48802317,80528,-,-
BAC220_B05,15,15q21.2,48800025,48897986,97961,-,-
BAC156_I08,15,15q21.2,48809665,48897989,88324,-,-
BAC237_N15,15,15q21.2,48838422,48916752,78330,-,-
BAC176_I08,15,15q21.2,48838422,48935346,96924,-,-
BAC80_H16,15,15q21.2,49143444,49349673,206229,-,-
BAC187_A04,15,15q21.2,49208499,49335294,126795,-,-
BAC45_I18,15,15q21.2,49215669,49345586,129917,-,-
BAC222_P21,15,15q21.2,49221409,49333281,111872,-,-
BAC172_L17,15,15q21.2,49229232,49306308,77076,-,-
BAC184_B06,15,15q21.2,49329420,49423873,94453,-,-
BAC49_D23,15,15q21.2,49329479,49398644,69165,-,-
BAC76_G13,15,15q21.2,49362283,49461223,98940,-,-
BAC236_E23,15,15q21.2,49368414,49471774,103360,-,-
BAC27_C11,15,15q21.2,49389304,49477388,88084,-,-
BAC31_H24,15,15q21.2,49422659,49526906,104247,-,-
BAC95_N23,15,15q21.2,49583554,49674197,90643,-,-
BAC236_O10,15,15q21.2,49648731,49750744,102013,-,-
BAC108_O10,15,15q21.2,49674192,49780676,106484,-,-
BAC44_A04,15,15q21.2,49691480,49785830,94350,-,-
BAC29_M07,15,15q21.2,49715933,49791897,75964,-,-
BAC89_N07,15,15q21.2,49750747,49867652,116905,-,-
BAC175_B24,15,15q21.2,49780780,49894262,113482,-,-
BAC50_I14,15,15q21.2,49790564,49922349,131785,-,-
BAC152_O10,15,15q21.2,49818314,49934084,115770,-,-
BAC144_H04,15,15q21.2,49853279,49936883,83604,-,-
BAC177_B05,15,15q21.2,49946741,50060960,114219,-,-
BAC8_O12,15,15q21.2,49978388,50060888,82500,-,-
BAC90_I14,15,15q21.2,49990290,50100786,110496,-,-
BAC136_N01,15,15q21.2,49994915,50084220,89305,-,-
BAC117_O15,15,15q21.2,50100889,50193203,92314,-,-
BAC190_K14,15,15q21.2,50144277,50235779,91502,-,-
BAC69_H11,15,15q21.2,50158431,50250827,92396,-,-
BAC127_N08,15,15q21.2,50193622,50294012,100390,-,-
BAC154_J01,15,15q21.2,50239023,50326027,87004,-,-
BAC226_D05,15,15q21.2,50239024,50336051,97027,-,-
BAC230_H04,15,15q21.2,50321766,50437444,115678,-,-
BAC61_O07,15,15q21.2,50336291,50439907,103616,-,-
BAC219_O03,15,15q21.2,50342705,50444983,102278,-,-
BAC176_M12,15,15q21.2,50342705,50442813,100108,-,-
BAC53_B12,15,15q21.2,50473217,50573476,100259,-,-
BAC67_O05,15,15q21.2,50476113,50575264,99151,-,-
BAC131_O01,15,15q21.2,50596372,50674643,78271,-,-
BAC235_J12,15,15q21.2,50658367,50741744,83377,-,-
BAC142_O07,15,15q21.2,50779921,50870287,90366,-,-
BAC10_D05,15,15q21.2,50828820,50965248,136428,-,-
BAC123_M10,15,15q21.2,50857234,50947084,89850,-,-
BAC237_E11,15,15q21.2,50912672,51014210,101538,-,-
BAC123_G22,15,15q21.2,50947185,51064765,117580,-,-
BAC37_E22,15,15q21.2-15q21.3,51063045,51158456,95411,-,-
BAC218_P17,15,15q21.2-15q21.3,51071421,51160213,88792,-,-
BAC55_G04,15,15q21.3,51203409,51307047,103638,-,-
BAC157_F05,15,15q21.3,51240817,51313803,72986,-,-
BAC40_P16,15,15q21.3,51264080,51370315,106235,-,-
BAC95_B22,15,15q21.3,51266341,51357301,90960,-,-
BAC148_G10,15,15q21.3,51307074,51401832,94758,-,-
BAC67_B21,15,15q21.3,51329909,51435125,105216,-,-
BAC229_H07,15,15q21.3,51386089,51487363,101274,-,-
BAC132_C21,15,15q21.3,51490205,51580181,89976,-,-
BAC219_M01,15,15q21.3,51503415,51592642,89227,-,-
BAC117_C23,15,15q21.3,51510778,51638543,127765,-,-
BAC122_H06,15,15q21.3,51536194,51636382,100188,-,-
BAC124_E13,15,15q21.3,51537361,51642934,105573,-,-
BAC154_A06,15,15q21.3,51671280,51759758,88478,-,-
BAC240_P04,15,15q21.3,51694221,51779812,85591,-,-
BAC182_E18,15,15q21.3,51767340,51865569,98229,-,-
BAC82_A08,15,15q21.3,51801553,51910288,108735,-,-
BAC154_G06,15,15q21.3,51801900,51900576,98676,-,-
BAC157_H22,15,15q21.3,51821606,51908740,87134,-,-
BAC58_B16,15,15q21.3,51821606,51931846,110240,-,-
BAC29_O07,15,15q21.3,51924325,52042859,118534,-,-
BAC83_A10,15,15q21.3,52062876,52151149,88273,-,-
BAC119_K12,15,15q21.3,52201251,52325487,124236,-,-
BAC167_B10,15,15q21.3,52306345,52386800,80455,-,-
BAC44_D10,15,15q21.3,52320583,52440646,120063,-,-
BAC28_L15,15,15q21.3,52590443,52700067,109624,-,-
BAC191_L21,15,15q21.3,52742447,52818131,75684,-,-
BAC148_K19,15,15q21.3,52745405,52829908,84503,-,-
BAC82_O12,15,15q21.3,52939654,52985875,46221,-,-
BAC188_N21,15,15q21.3,52954965,53060381,105416,-,-
BAC73_F21,15,15q21.3,53003635,53115601,111966,-,-
BAC120_C13,15,15q21.3,53021077,53164052,142975,-,-
BAC55_E06,15,15q21.3,53050534,53198851,148317,-,-
BAC96_P11,15,15q21.3,53060416,53170674,110258,-,-
BAC240_G21,15,15q21.3,53079371,53170674,91303,-,-
BAC117_A03,15,15q21.3,53122324,53223442,101118,-,-
BAC92_H02,15,15q21.3,53164046,53269020,104974,-,-
BAC139_M14,15,15q21.3,53197897,53311275,113378,-,-
BAC12_K11,15,15q21.3,53299095,53407844,108749,-,-
BAC31_D04,15,15q21.3,53407842,53536466,128624,-,-
BAC162_N12,15,15q21.3,53453497,53572738,119241,-,-
BAC70_C13,15,15q21.3,53639789,53738674,98885,-,-
BAC14_G04,15,15q21.3,53644089,53738674,94585,-,-
BAC92_D09,15,15q21.3,53763941,53938252,174311,-,-
BAC175_G22,15,15q21.3,53778724,53864049,85325,-,-
BAC19_L23,15,15q21.3,53791282,53922890,131608,-,-
BAC154_G11,15,15q21.3,53834720,53909828,75108,-,-
BAC83_E06,15,15q21.3,53838012,53938259,100247,-,-
BAC64_F01,15,15q21.3,53853994,53946145,92151,-,-
BAC131_B02,15,15q21.3,54097258,54229509,132251,-,-
BAC141_D19,15,15q21.3,54262061,54325078,63017,-,-
BAC113_L09,15,15q21.3,54279827,54389106,109279,-,-
BAC70_E19,15,15q21.3,54432690,54552453,119763,-,-
BAC102_L13,15,15q21.3,54451769,54552453,100684,-,-
BAC157_I17,15,15q21.3,54472201,54560465,88264,-,-
BAC25_A20,15,15q21.3,54479831,54569377,89546,-,-
BAC127_N02,15,15q21.3,54482262,54573342,91080,-,-
BAC80_B22,15,15q21.3,54534762,54612662,77900,-,-
BAC204_K11,15,15q21.3,54549676,54560445,10769,-,-
BAC91_H03,15,15q21.3,54614970,54724968,109998,-,-
BAC11_J07,15,15q21.3,54617323,54801026,183703,-,-
BAC62_L04,15,15q21.3,54677415,54808607,131192,-,-
BAC241_E02,15,15q21.3,54724981,54808644,83663,-,-
BAC76_M18,15,15q21.3,54787654,54890906,103252,-,-
BAC165_N22,15,15q21.3,54861860,54962732,100872,-,-
BAC50_B03,15,15q21.3,54878492,54951647,73155,-,-
BAC195_K20,15,15q21.3,54879493,54971414,91921,-,-
BAC63_I20,15,15q21.3,54891061,55003365,112304,-,-
BAC80_E15,15,15q21.3,54921070,55027559,106489,-,-
BAC35_A07,15,15q21.3,55097971,55199292,101321,-,-
BAC43_C03,15,15q21.3,55156143,55264780,108637,-,-
BAC68_J16,15,15q21.3,55218053,55318012,99959,-,-
BAC236_N15,15,15q21.3,55267116,55371864,104748,-,-
BAC52_L22,15,15q21.3,55332562,55467162,134600,-,-
BAC150_K11,15,15q21.3,55381417,55471282,89865,-,-
BAC54_I03,15,15q21.3,55416084,55521572,105488,-,-
BAC181_L14,15,15q21.3,55460083,55565173,105090,-,-
BAC189_P16,15,15q21.3,55467157,55566546,99389,-,-
BAC232_P03,15,15q21.3,55511234,55623021,111787,-,-
BAC21_K13,15,15q21.3,55514115,55623430,109315,-,-
BAC105_J17,15,15q21.3,55569263,55663415,94152,-,-
BAC170_A17,15,15q21.3,55596456,55676823,80367,-,-
BAC40_J17,15,15q21.3,55609803,55777619,167816,-,-
BAC242_O08,15,15q21.3-15q22.1,55760353,55863631,103278,-,-
BAC72_H03,15,15q22.1,55815660,55891000,75340,-,-
BAC244_E03,15,15q22.1,55856095,55977402,121307,-,-
BAC169_B18,15,15q22.1,55892877,55957391,64514,-,-
BAC250_A18,15,15q22.1,55928353,56037565,109212,-,-
BAC142_K19,15,15q22.1,55991079,56073232,82153,-,-
BAC124_I17,15,15q22.1,55991079,56093241,102162,-,-
BAC249_J10,15,15q22.1,56348541,56432610,84069,-,-
BAC60_C10,15,15q22.1,56388400,56501277,112877,-,-
BAC49_G15,15,15q22.1,56432655,56545175,112520,-,-
BAC133_F20,15,15q22.1,56439271,56523038,83767,-,-
BAC78_I19,15,15q22.1,56449174,56560407,111233,-,-
BAC182_H05,15,15q22.1,56475821,56560113,84292,-,-
BAC125_A21,15,15q22.1,56505336,56675577,170241,-,-
BAC158_I16,15,15q22.1,56560463,56647807,87344,-,-
BAC46_I05,15,15q22.1,56614726,56754200,139474,-,-
BAC57_A04,15,15q22.1,56626657,56654840,28183,-,-
BAC86_M21,15,15q22.1,56668818,56750670,81852,-,-
BAC36_A20,15,15q22.1,56668822,56821508,152686,-,-
BAC213_A23,15,15q22.1,56750939,56830004,79065,-,-
BAC136_E09,15,15q22.1,56821502,56945970,124468,-,-
BAC118_D09,15,15q22.1,56830308,56931778,101470,-,-
BAC165_L05,15,15q22.1,56840240,56931778,91538,-,-
BAC69_L14,15,15q22.1,56860479,56977681,117202,-,-
BAC48_N02,15,15q22.1,56868057,56960397,92340,-,-
BAC142_E19,15,15q22.1,56931907,57011139,79232,-,-
BAC148_K09,15,15q22.1-15q22.2,56966960,57101656,134696,-,-
BAC243_P21,15,15q22.1,56997873,57081242,83369,-,-
BAC113_C15,15,15q22.2,57101650,57175866,74216,-,-
BAC96_L10,15,15q22.2,57118248,57202189,83941,-,-
BAC237_A17,15,15q22.2,57180311,57287113,106802,-,-
BAC186_O16,15,15q22.2,57196493,57297916,101423,-,-
BAC42_J21,15,15q22.2,57202182,57346017,143835,-,-
BAC68_D17,15,15q22.2,57205056,57312286,107230,-,-
BAC57_A19,15,15q22.2,57214069,57314313,100244,-,-
BAC116_J24,15,15q22.2,57252562,57358411,105849,-,-
BAC106_O12,15,15q22.2,57287569,57431749,144180,-,-
BAC84_C13,15,15q22.2,57304723,57366668,61945,-,-
BAC188_F20,15,15q22.2,57316806,57414167,97361,-,-
BAC162_A23,15,15q22.2,57324451,57439302,114851,-,-
BAC193_L14,15,15q22.2,57335312,57420429,85117,-,-
BAC114_D13,15,15q22.2,57346172,57452475,106303,-,-
BAC199_H14,15,15q22.2,57358405,57431763,73358,-,-
BAC224_M02,15,15q22.2,57421859,57498049,76190,-,-
BAC107_F10,15,15q22.2,57519166,57649474,130308,-,-
BAC29_B12,15,15q22.2,57549995,57653899,103904,-,-
BAC117_O06,15,15q22.2,57661504,57779285,117781,-,-
BAC91_H18,15,15q22.2,57704457,57831915,127458,-,-
BAC76_F16,15,15q22.2,57749623,57839265,89642,-,-
BAC128_I04,15,15q22.2,57788290,57883336,95046,-,-
BAC55_O22,15,15q22.2,57914909,58024207,109298,-,-
BAC39_O16,15,15q22.2,57914911,58014861,99950,-,-
BAC117_B07,15,15q22.2,57929589,58030252,100663,-,-
BAC252_B10,15,15q22.2,58035250,58170171,134921,-,-
BAC190_I15,15,15q22.2,58057029,58127059,70030,-,-
BAC130_H22,15,15q22.2,58096235,58181472,85237,-,-
BAC247_H15,15,15q22.2,58105520,58205407,99887,-,-
BAC46_A13,15,15q22.2,58105524,58192478,86954,-,-
BAC122_G13,15,15q22.2,58190546,58280830,90284,-,-
BAC76_P19,15,15q22.2,58205404,58316581,111177,-,-
BAC150_F20,15,15q22.2,58212545,58291804,79259,-,-
BAC65_H11,15,15q22.2,58220338,58316581,96243,-,-
BAC200_K16,15,15q22.2,58316576,58432746,116170,-,-
BAC88_O14,15,15q22.2,58352476,58471004,118528,-,-
BAC180_N17,15,15q22.2,58443481,58521621,78140,-,-
BAC69_P07,15,15q22.2,58534620,58631774,97154,-,-
BAC29_H23,15,15q22.2,58588304,58707114,118810,-,-
BAC160_H22,15,15q22.2,58630263,58713890,83627,-,-
BAC57_A15,15,15q22.2,58754331,58875897,121566,-,-
BAC142_M06,15,15q22.2,58770581,58875897,105316,-,-
BAC243_I06,15,15q22.2,58789306,58877434,88128,-,-
BAC101_E11,15,15q22.2,58789306,58875897,86591,-,-
BAC189_K02,15,15q22.2,58856111,58939903,83792,-,-
BAC238_K03,15,15q22.2,58894049,58971456,77407,-,-
BAC118_O05,15,15q22.2,58925020,59042613,117593,-,-
BAC148_P19,15,15q22.2,58926469,59011734,85265,-,-
BAC143_H12,15,15q22.2,59048672,59140452,91780,-,-
BAC217_P02,15,15q22.2,59115078,59209146,94068,-,-
BAC40_F24,15,15q22.2,59152919,59257807,104888,-,-
BAC184_I20,15,15q22.2,59160896,59271240,110344,-,-
BAC185_F10,15,15q22.2,59231247,59349889,118642,-,-
BAC211_H11,15,15q22.2,59236920,59318847,81927,-,-
BAC221_J22,15,15q22.2,59298413,59420775,122362,-,-
BAC60_I16,15,15q22.2,59360348,59461993,101645,-,-
BAC86_H07,15,15q22.2,59463004,59558888,95884,-,-
BAC141_M19,15,15q22.2,59473200,59558266,85066,-,-
BAC218_A07,15,15q22.2,59520794,59615480,94686,-,-
BAC193_F08,15,15q22.2,59626780,59733289,106509,-,-
BAC63_D03,15,15q22.2,59642208,59740010,97802,-,-
BAC168_K01,15,15q22.2,59663862,59746438,82576,-,-
BAC36_M20,15,15q22.2,59670660,59791506,120846,-,-
BAC153_D04,15,15q22.2,59672157,59787508,115351,-,-
BAC76_M05,15,15q22.2,59672565,59814585,142020,-,-
BAC191_G20,15,15q22.2,59858175,59955248,97073,-,-
BAC22_E23,15,15q22.2,59866724,60015189,148465,-,-
BAC95_D13,15,15q22.2,60015183,60111916,96733,-,-
BAC184_C06,15,15q22.2,60018898,60107325,88427,-,-
BAC63_F10,15,15q22.2,60061910,60169857,107947,-,-
BAC131_N23,15,15q22.2,60111911,60220559,108648,-,-
BAC243_O07,15,15q22.2,60160860,60234523,73663,-,-
BAC194_M14,15,15q22.2,60170729,60268136,97407,-,-
BAC34_L12,15,15q22.2,60185752,60344005,158253,-,-
BAC178_L03,15,15q22.2,60191663,60289844,98181,-,-
BAC141_K12,15,15q22.2,60191663,60280649,88986,-,-
BAC178_N09,15,15q22.2,60205573,60289855,84282,-,-
BAC35_M10,15,15q22.2,60286824,60382148,95324,-,-
BAC227_B05,15,15q22.2,60391792,60483304,91512,-,-
BAC127_E07,15,15q22.2,60421167,60529851,108684,-,-
BAC127_E08,15,15q22.2,60421167,60529851,108684,-,-
BAC28_L10,15,15q22.2,60434384,60581522,147138,-,-
BAC205_B14,15,15q22.2,60434738,60483339,48601,-,-
BAC128_I09,15,15q22.2,60452716,60558632,105916,-,-
BAC238_I09,15,15q22.2,60601029,60704104,103075,-,-
BAC63_N16,15,15q22.2,60608770,60716820,108050,-,-
BAC41_H05,15,15q22.2,60704103,60832413,128310,-,-
BAC77_G04,15,15q22.2,60716852,60816302,99450,-,-
BAC12_P21,15,15q22.2,60719532,60840282,120750,-,-
BAC167_M02,15,15q22.2,60804474,60910289,105815,-,-
BAC151_J12,15,15q22.2,60816297,60910289,93992,-,-
BAC65_I16,15,15q22.2,60876417,60995303,118886,-,-
BAC179_P18,15,15q22.2,60876469,60962280,85811,-,-
BAC169_M09,15,15q22.2,60897089,60976022,78933,-,-
BAC143_J18,15,15q22.2,61021685,61114112,92427,-,-
BAC192_J07,15,15q22.2,61095704,61190390,94686,-,-
BAC88_H08,15,15q22.2,61124590,61213545,88955,-,-
BAC179_B20,15,15q22.2,61162145,61239506,77361,-,-
BAC51_D11,15,15q22.2,61180727,61296857,116130,-,-
BAC146_N02,15,15q22.2,61206690,61286591,79901,-,-
BAC176_G02,15,15q22.2,61275128,61388642,113514,-,-
BAC180_H10,15,15q22.2,61286830,61384828,97998,-,-
BAC158_H15,15,15q22.2,61357817,61441492,83675,-,-
BAC246_E09,15,15q22.2,61384822,61487016,102194,-,-
BAC148_G21,15,15q22.2,61405771,61487037,81266,-,-
BAC222_O21,15,15q22.2-15q22.31,61452778,61539969,87191,-,-
BAC171_N03,15,15q22.31,61526750,61650202,123452,-,-
BAC185_M21,15,15q22.31,61532401,61611190,78789,-,-
BAC90_G03,15,15q22.31,61664099,61793422,129323,-,-
BAC42_M24,15,15q22.31,61786794,61873614,86820,-,-
BAC56_F20,15,15q22.31,61786802,61874317,87515,-,-
BAC243_E01,15,15q22.31,61813989,61916467,102478,-,-
BAC40_I06,15,15q22.31,61823928,61947505,123577,-,-
BAC193_D04,15,15q22.31,61831761,61921250,89489,-,-
BAC105_E16,15,15q22.31,61883112,61978519,95407,-,-
BAC167_B21,15,15q22.31,61999065,62090011,90946,-,-
BAC61_M10,15,15q22.31,62081013,62205338,124325,-,-
BAC141_H21,15,15q22.31,62119309,62202628,83319,-,-
BAC8_M15,15,15q22.31,62119444,62242679,123235,-,-
BAC235_F03,15,15q22.31,62148737,62213705,64968,-,-
BAC186_G24,15,15q22.31,62253629,62344189,90560,-,-
BAC29_I09,15,15q22.31,62414025,62512855,98830,-,-
BAC76_P06,15,15q22.31,62421044,62512855,91811,-,-
BAC37_B13,15,15q22.31,62424606,62509597,84991,-,-
BAC19_B10,15,15q22.31,62429636,62552090,122454,-,-
BAC100_F18,15,15q22.31,62465912,62592836,126924,-,-
BAC151_E12,15,15q22.31,62581297,62690553,109256,-,-
BAC175_D09,15,15q22.31,62583449,62713948,130499,-,-
BAC77_A09,15,15q22.31,62602239,62700222,97983,-,-
BAC191_E17,15,15q22.31,62681148,62777676,96528,-,-
BAC149_M06,15,15q22.31,62681148,62762309,81161,-,-
BAC168_L02,15,15q22.31,62689636,62777680,88044,-,-
BAC21_C14,15,15q22.31,62690548,62822064,131516,-,-
BAC180_L08,15,15q22.31,62786823,62861969,75146,-,-
BAC114_C22,15,15q22.31,62858619,62957690,99071,-,-
BAC113_E04,15,15q22.31,62862077,62957690,95613,-,-
BAC63_L10,15,15q22.31,62881731,62989212,107481,-,-
BAC157_N11,15,15q22.31,62881731,63001003,119272,-,-
BAC140_A06,15,15q22.31,62917697,62999888,82191,-,-
BAC127_G21,15,15q22.31,63089647,63197257,107610,-,-
BAC84_I11,15,15q22.31,63228471,63323343,94872,-,-
BAC91_H04,15,15q22.31,63294319,63379207,84888,-,-
BAC31_I04,15,15q22.31,63461989,63597752,135763,-,-
BAC217_L21,15,15q22.31,63541012,63648909,107897,-,-
BAC211_O17,15,15q22.31,63549264,63622832,73568,-,-
BAC231_M01,15,15q22.31,63559960,63648909,88949,-,-
BAC11_E09,15,15q22.31,63580934,63686634,105700,-,-
BAC2_K02,15,15q22.31,63597924,63707207,109283,-,-
BAC40_K10,15,15q22.31,63686650,63775582,88932,-,-
BAC128_I21,15,15q22.31,63785348,63870760,85412,-,-
BAC160_L02,15,15q22.31,63804007,63914681,110674,-,-
BAC184_J14,15,15q22.31,63845693,63939422,93729,-,-
BAC75_D09,15,15q22.31,63845695,64008735,163040,-,-
BAC221_J18,15,15q22.31,63871100,63939421,68321,-,-
BAC40_M17,15,15q22.31,63986338,64102053,115715,-,-
BAC157_D09,15,15q22.31,64026691,64107581,80890,-,-
BAC161_H13,15,15q22.31,64048438,64143268,94830,-,-
BAC175_N05,15,15q22.31,64102548,64180844,78296,-,-
BAC172_F02,15,15q22.31,64107574,64206267,98693,-,-
BAC26_H11,15,15q22.31,64143264,64220622,77358,-,-
BAC203_G06,15,15q22.31,64212190,64320192,108002,-,-
BAC174_B11,15,15q22.31,64219183,64320226,101043,-,-
BAC186_M08,15,15q22.31,64220702,64335944,115242,-,-
BAC24_B10,15,15q22.31,64320252,64475674,155422,-,-
BAC236_D21,15,15q22.31,64339116,64464525,125409,-,-
BAC23_F05,15,15q22.31,64345771,64479900,134129,-,-
BAC15_M03,15,15q22.31,64345812,64496438,150626,-,-
BAC145_I14,15,15q22.31,64394314,64492703,98389,-,-
BAC83_C04,15,15q22.31,64416300,64507081,90781,-,-
BAC80_N11,15,15q22.31,64492697,64573654,80957,-,-
BAC29_J19,15,15q22.31,64496325,64597122,100797,-,-
BAC229_A04,15,15q22.31,64496431,64579730,83299,-,-
BAC172_A07,15,15q22.31,64573656,64660587,86931,-,-
BAC210_C14,15,15q22.31,64597398,64695264,97866,-,-
BAC243_G11,15,15q22.31,64597413,64753418,156005,-,-
BAC163_O14,15,15q22.31,64658163,64806211,148048,-,-
BAC88_G08,15,15q22.31,64658232,64815807,157575,-,-
BAC71_F02,15,15q22.31,64660580,64736375,75795,-,-
BAC226_A18,15,15q22.31,64679109,64759992,80883,-,-
BAC233_K01,15,15q22.31,64778652,64873810,95158,-,-
BAC2_B14,15,15q22.31-15q22.32,64793280,64901282,108002,-,-
BAC88_C18,15,15q22.31-15q22.32,64837706,64973064,135358,-,-
BAC26_L14,15,15q22.31-15q22.32,64837706,64983681,145975,-,-
BAC66_B15,15,15q22.32-15q22.33,64901930,65041073,139143,-,-
BAC161_K09,15,15q22.32-15q22.33,64904642,65009305,104663,-,-
BAC221_H05,15,15q22.32,64908003,64983686,75683,-,-
BAC91_O06,15,15q22.32-15q22.33,64983969,65063196,79227,-,-
BAC229_H13,15,15q22.33,65019822,65107225,87403,-,-
BAC218_B24,15,15q22.33,65041071,65126432,85361,-,-
BAC176_L14,15,15q22.33,65050790,65163409,112619,-,-
BAC224_I20,15,15q22.33,65066871,65173624,106753,-,-
BAC75_N16,15,15q22.33,65066871,65163405,96534,-,-
BAC149_L11,15,15q22.33,65110054,65216959,106905,-,-
BAC56_H21,15,15q22.33,65118834,65234066,115232,-,-
BAC10_A20,15,15q22.33,65125224,65229197,103973,-,-
BAC105_O10,15,15q22.33,65151524,65240104,88580,-,-
BAC88_F18,15,15q22.33,65152593,65266241,113648,-,-
BAC148_G19,15,15q22.33,65158329,65247839,89510,-,-
BAC104_A14,15,15q22.33-15q23,65231873,65342113,110240,-,-
BAC156_A04,15,15q22.33-15q23,65261748,65367503,105755,-,-
BAC92_L11,15,15q22.33-15q23,65278845,65433229,154384,-,-
BAC160_E17,15,15q22.33-15q23,65278856,65381553,102697,-,-
BAC217_P17,15,15q23,65342305,65450086,107781,-,-
BAC34_E18,15,15q23,65435710,65554185,118475,-,-
BAC59_N12,15,15q23,65485561,65588013,102452,-,-
BAC165_J18,15,15q23,65532532,65643382,110850,-,-
BAC140_H18,15,15q23,65532532,65607340,74808,-,-
BAC67_M05,15,15q23,65554204,65649823,95619,-,-
BAC48_L02,15,15q23,65606185,65690189,84004,-,-
BAC77_H18,15,15q23,65634837,65755083,120246,-,-
BAC37_H23,15,15q23,65693486,65793127,99641,-,-
BAC146_H23,15,15q23,65694101,65793127,99026,-,-
BAC37_N13,15,15q23,65694101,65850166,156065,-,-
BAC76_K20,15,15q23,65703005,65790987,87982,-,-
BAC158_L20,15,15q23,65791086,65888473,97387,-,-
BAC158_K20,15,15q23,65791086,65888473,97387,-,-
BAC171_O04,15,15q23,65812066,65933286,121220,-,-
BAC141_I09,15,15q23,65823798,65897964,74166,-,-
BAC66_B12,15,15q23,65862230,65981628,119398,-,-
BAC200_G14,15,15q23,65897530,65996954,99424,-,-
BAC37_F13,15,15q23,65898865,65983360,84495,-,-
BAC97_F12,15,15q23,65981623,66135635,154012,-,-
BAC74_N12,15,15q23,65981739,66125829,144090,-,-
BAC242_L05,15,15q23,66016305,66138042,121737,-,-
BAC115_P04,15,15q23,66029288,66112791,83503,-,-
BAC76_F23,15,15q23,66074770,66160090,85320,-,-
BAC69_N16,15,15q23,66080469,66193132,112663,-,-
BAC131_J24,15,15q23,66109924,66358739,248815,-,-
BAC6_L06,15,15q23,66225694,66336700,111006,-,-
BAC124_M13,15,15q23,66250526,66336700,86174,-,-
BAC243_O17,15,15q23,66259869,66344015,84146,-,-
BAC51_B15,15,15q23,66302568,66395013,92445,-,-
BAC125_M07,15,15q23,66309752,66413328,103576,-,-
BAC42_B24,15,15q23,66415799,66515072,99273,-,-
BAC36_L06,15,15q23,66418575,66509009,90434,-,-
BAC243_M09,15,15q23,66423846,66543101,119255,-,-
BAC185_F16,15,15q23,66458785,66542566,83781,-,-
BAC39_A08,15,15q23,66482144,66577337,95193,-,-
BAC248_L04,15,15q23,66492631,66577337,84706,-,-
BAC92_C02,15,15q23,66542560,66670172,127612,-,-
BAC178_J14,15,15q23,66577332,66670261,92929,-,-
BAC128_E12,15,15q23,66577358,66754243,176885,-,-
BAC10_P20,15,15q23,66609128,66697377,88249,-,-
BAC221_C21,15,15q23,66613282,66692876,79594,-,-
BAC13_C18,15,15q23,66613313,66692855,79542,-,-
BAC129_D06,15,15q23,66614106,66697383,83277,-,-
BAC135_M21,15,15q23,66614947,66697383,82436,-,-
BAC21_K08,15,15q23,66615029,66718761,103732,-,-
BAC173_A11,15,15q23,66622101,66711707,89606,-,-
BAC247_C13,15,15q23,66670255,66760314,90059,-,-
BAC175_E08,15,15q23,66718766,66804761,85995,-,-
BAC217_F23,15,15q23,66746981,66853262,106281,-,-
BAC80_G19,15,15q23,66829347,66913270,83923,-,-
BAC103_L12,15,15q23,66860064,66990084,130020,-,-
BAC125_O14,15,15q23,66896087,66996488,100401,-,-
BAC46_G05,15,15q23,66913297,67048020,134723,-,-
BAC29_M11,15,15q23,66931812,67059602,127790,-,-
BAC240_G22,15,15q23,67026260,67114941,88681,-,-
BAC179_G18,15,15q23,67060661,67141695,81034,-,-
BAC107_D02,15,15q23,67072225,67182171,109946,-,-
BAC154_A24,15,15q23,67089694,67213009,123315,-,-
BAC215_N10,15,15q23,67114935,67230952,116017,-,-
BAC197_F12,15,15q23,67290662,67369322,78660,-,-
BAC50_C13,15,15q23,67304594,67480672,176078,-,-
BAC119_P23,15,15q23,67380781,67447052,66271,-,-
BAC84_L01,15,15q23,67441921,67591970,150049,-,-
BAC34_D03,15,15q23,67447157,67546376,99219,-,-
BAC77_A17,15,15q23,67520805,67600905,80100,-,-
BAC6_P16,15,15q23,67541864,67661319,119455,-,-
BAC178_A16,15,15q23,67587100,67707471,120371,-,-
BAC118_A23,15,15q23,67591972,67669205,77233,-,-
BAC178_H05,15,15q23,67596270,67685211,88941,-,-
BAC219_F14,15,15q23,67598054,67710143,112089,-,-
BAC105_E14,15,15q23,67656345,67773252,116907,-,-
BAC84_I01,15,15q23,67656345,67751705,95360,-,-
BAC26_H18,15,15q23,67661322,67751705,90383,-,-
BAC170_B06,15,15q23,67733201,67797501,64300,-,-
BAC244_E08,15,15q23,67794039,67866790,72751,-,-
BAC146_C06,15,15q23,67803647,67920005,116358,-,-
BAC65_F07,15,15q23,67866207,67954879,88672,-,-
BAC200_O12,15,15q23,67986109,68078738,92629,-,-
BAC139_M17,15,15q23,68002810,68121304,118494,-,-
BAC60_N17,15,15q23,68035665,68144239,108574,-,-
BAC117_K05,15,15q23,68038425,68131682,93257,-,-
BAC31_O03,15,15q23,68074424,68087265,12841,-,-
BAC106_K19,15,15q23,68116372,68241836,125464,-,-
BAC102_D19,15,15q23,68121307,68258695,137388,-,-
BAC65_K09,15,15q23,68144317,68274702,130385,-,-
BAC184_A02,15,15q23,68148834,68253612,104778,-,-
BAC125_I03,15,15q23,68156752,68258695,101943,-,-
BAC166_E03,15,15q23,68340651,68439714,99063,-,-
BAC226_M11,15,15q23,68363814,68439714,75900,-,-
BAC60_K21,15,15q23,68379826,68523822,143996,-,-
BAC26_F07,15,15q23,68440969,68575427,134458,-,-
BAC49_P13,15,15q23,68464342,68562980,98638,-,-
BAC235_L07,15,15q23,68513523,68592535,79012,-,-
BAC179_K12,15,15q23,68526802,68630471,103669,-,-
BAC30_I15,15,15q23,68526831,68657452,130621,-,-
BAC1_B17,15,15q23,68575422,68657431,82009,-,-
BAC22_L18,15,15q23,68592621,68707136,114515,-,-
BAC199_L16,15,15q23,68606670,68701643,94973,-,-
BAC165_H22,15,15q23,68657440,68745115,87675,-,-
BAC46_P12,15,15q23,68660262,68794391,134129,-,-
BAC104_D15,15,15q23,68745122,68863735,118613,-,-
BAC64_M13,15,15q23,68763773,68948166,184393,-,-
BAC82_G02,15,15q23,68818761,68929168,110407,-,-
BAC149_A07,15,15q23,68822884,68929171,106287,-,-
BAC181_B17,15,15q23,68839638,68913948,74310,-,-
BAC126_G03,15,15q23,68847065,68929174,82109,-,-
BAC122_J04,15,15q23,68847097,68929174,82077,-,-
BAC54_M23,15,15q23,68871289,68959191,87902,-,-
BAC51_B21,15,15q23,68915314,69027059,111745,-,-
BAC76_A24,15,15q23,68938988,69034804,95816,-,-
BAC61_J08,15,15q23,68951973,69058420,106447,-,-
BAC155_N03,15,15q23,69049753,69208494,158741,-,-
BAC126_H15,15,15q23,69058413,69149804,91391,-,-
BAC66_O03,15,15q23,69061484,69142510,81026,-,-
BAC234_J05,15,15q23,69196014,69260785,64771,-,-
BAC68_J08,15,15q23,69223113,69345643,122530,-,-
BAC50_M10,15,15q23,69288553,69425971,137418,-,-
BAC252_D16,15,15q23,69301784,69442363,140579,-,-
BAC65_A12,15,15q23,69328296,69449015,120719,-,-
BAC237_K03,15,15q23,69345651,69430262,84611,-,-
BAC81_A12,15,15q23,69368191,69466281,98090,-,-
BAC68_B02,15,15q23,69442488,69539254,96766,-,-
BAC160_D20,15,15q23,69539251,69631137,91886,-,-
BAC41_G17,15,15q23,69568234,69674637,106403,-,-
BAC135_F19,15,15q23,69576325,69685161,108836,-,-
BAC115_B23,15,15q23,69599714,69715308,115594,-,-
BAC143_F05,15,15q23,69641585,69725198,83613,-,-
BAC142_G07,15,15q23,69656499,69740136,83637,-,-
BAC59_M09,15,15q23,69657132,69740264,83132,-,-
BAC126_K18,15,15q23,69682669,69794804,112135,-,-
BAC26_C17,15,15q23,69766000,69853703,87703,-,-
BAC167_E20,15,15q23,69768255,69874794,106539,-,-
BAC123_K03,15,15q23,69793836,69881908,88072,-,-
BAC63_L11,15,15q23,69907014,69991524,84510,-,-
BAC48_J08,15,15q23,70024918,70114259,89341,-,-
BAC51_C20,15,15q23,70049057,70172305,123248,-,-
BAC249_E16,15,15q23,70124151,70204624,80473,-,-
BAC219_M05,15,15q23,70170914,70299062,128148,-,-
BAC223_D05,15,15q23,70187208,70299507,112299,-,-
BAC131_L08,15,15q23,70204614,70299467,94853,-,-
BAC139_D04,15,15q23,70269244,70350940,81696,-,-
BAC142_N09,15,15q23,70273819,70363395,89576,-,-
BAC67_N22,15,15q23-15q24.1,70370402,70466810,96408,-,-
BAC161_D05,15,15q24.1,70405701,70484542,78841,-,-
BAC154_P01,15,15q24.1,70408791,70502671,93880,-,-
BAC246_F22,15,15q24.1,70420462,70540570,120108,-,-
BAC53_D18,15,15q24.1,70433585,70540564,106979,-,-
BAC83_K02,15,15q24.1,70448532,70572154,123622,-,-
BAC140_E01,15,15q24.1,70502669,70611434,108765,-,-
BAC55_D23,15,15q24.1,70529814,70609699,79885,-,-
BAC76_N05,15,15q24.1,70541081,70634852,93771,-,-
BAC154_M05,15,15q24.1,70587169,70690949,103780,-,-
BAC106_B15,15,15q24.1,70609693,70690949,81256,-,-
BAC143_B16,15,15q24.1,70611576,70727804,116228,-,-
BAC44_J09,15,15q24.1,70618497,70753297,134800,-,-
BAC230_O21,15,15q24.1,70627266,70701693,74427,-,-
BAC194_M03,15,15q24.1,70753363,70849166,95803,-,-
BAC224_E19,15,15q24.1,70845833,70925587,79754,-,-
BAC159_E09,15,15q24.1,70849159,70966438,117279,-,-
BAC5_O16,15,15q24.1,70932771,71147318,214547,-,-
BAC151_H02,15,15q24.1,70935092,71050748,115656,-,-
BAC23_H11,15,15q24.1,70979368,71072805,93437,-,-
BAC213_J07,15,15q24.1,70982073,71072836,90763,-,-
BAC248_P24,15,15q24.1,71072962,71175067,102105,-,-
BAC71_E13,15,15q24.1,71106898,71235046,128148,-,-
BAC129_L09,15,15q24.1,71118549,71210212,91663,-,-
BAC89_N02,15,15q24.1,71162291,71287923,125632,-,-
BAC65_E08,15,15q24.1,71225173,71329395,104222,-,-
BAC90_B13,15,15q24.1,71236238,71362118,125880,-,-
BAC234_D15,15,15q24.1,71325605,71413100,87495,-,-
BAC135_D13,15,15q24.1,71374541,71452469,77928,-,-
BAC56_D13,15,15q24.1,71378062,71514657,136595,-,-
BAC135_O02,15,15q24.1,71381671,71438155,56484,-,-
BAC45_O04,15,15q24.1,71397115,71486974,89859,-,-
BAC73_J16,15,15q24.1,71415120,71539132,124012,-,-
BAC120_B21,15,15q24.1,71419611,71514662,95051,-,-
BAC181_A22,15,15q24.1,71438150,71529165,91015,-,-
BAC141_A12,15,15q24.1,71505432,71590210,84778,-,-
BAC198_B19,15,15q24.1,71541084,71629452,88368,-,-
BAC69_D18,15,15q24.1,71541084,71637164,96080,-,-
BAC44_M09,15,15q24.1,71543342,71625725,82383,-,-
BAC234_H11,15,15q24.1,71575031,71667606,92575,-,-
BAC141_J15,15,15q24.1,71713058,71790893,77835,-,-
BAC96_M10,15,15q24.1,72028093,72131661,103568,-,-
BAC205_O15,15,15q24.1,72045737,72105038,59301,-,-
BAC125_A10,15,15q24.1,72065765,72152351,86586,-,-
BAC237_M04,15,15q24.1,72152345,72271527,119182,-,-
BAC161_K05,15,15q24.1,72162919,72269739,106820,-,-
BAC56_H11,15,15q24.1,72194629,72308570,113941,-,-
BAC65_K21,15,15q24.1,72244721,72351074,106353,-,-
BAC168_F12,15,15q24.1,72269733,72378984,109251,-,-
BAC84_O22,15,15q24.1,72274341,72378984,104643,-,-
BAC217_E14,15,15q24.1,72274536,72364022,89486,-,-
BAC217_P09,15,15q24.1,72286599,72378984,92385,-,-
BAC170_I14,15,15q24.1,72286614,72369413,82799,-,-
BAC145_A21,15,15q24.1,72342416,72482200,139784,-,-
BAC188_I02,15,15q24.1,72364013,72449291,85278,-,-
BAC242_L11,15,15q24.1,72379293,72496151,116858,-,-
BAC186_H19,15,15q24.1,72452703,72558860,106157,-,-
BAC117_I06,15,15q24.1,72452703,72541128,88425,-,-
BAC208_G01,15,15q24.1,72470256,72574673,104417,-,-
BAC106_A10,15,15q24.1,72501125,72594339,93214,-,-
BAC52_M07,15,15q24.1,72541177,72627947,86770,-,-
BAC82_I19,15,15q24.1,72574672,72682114,107442,-,-
BAC154_G04,15,15q24.1,72634742,72710196,75454,-,-
BAC61_K18,15,15q24.1,72634742,72737047,102305,-,-
BAC132_B15,15,15q24.1,72650624,72737037,86413,-,-
BAC109_B11,15,15q24.1,72692675,72830571,137896,-,-
BAC60_D11,15,15q24.1,72737044,72849551,112507,-,-
BAC197_J09,15,15q24.1,72737058,72849567,112509,-,-
BAC9_C17,15,15q24.1,72755830,72889513,133683,-,-
BAC117_F14,15,15q24.1,72849559,72950425,100866,-,-
BAC33_H07,15,15q24.1,72857229,73005426,148197,-,-
BAC195_O04,15,15q24.1,72889518,72983335,93817,-,-
BAC144_G19,15,15q24.1-15q24.2,72983384,73100121,116737,-,-
BAC232_C05,15,15q24.1,72987323,73072361,85038,-,-
BAC10_F15,15,15q24.1-15q24.2,73034027,73132402,98375,-,-
BAC168_B14,15,15q24.1-15q24.2,73034116,73160754,126638,-,-
BAC92_J06,15,15q24.1-15q24.2,73044185,73132132,87947,-,-
BAC149_C24,15,15q24.1-15q24.2,73047109,73124397,77288,-,-
BAC200_B22,15,15q24.2,73170740,73270522,99782,-,-
BAC152_N11,15,15q24.2,73347543,73438827,91284,-,-
BAC76_J05,15,15q24.2,73384189,73479430,95241,-,-
BAC25_C15,15,15q24.2,73439806,73508995,69189,-,-
BAC116_J05,15,15q24.2,73509892,73621949,112057,-,-
BAC165_N04,15,15q24.2,73544035,73675505,131470,-,-
BAC236_E15,15,15q24.2,73569811,73654838,85027,-,-
BAC149_I11,15,15q24.2,73621971,73713845,91874,-,-
BAC62_P10,15,15q24.2,73756050,73853688,97638,-,-
BAC51_E11,15,15q24.2,73771909,73905157,133248,-,-
BAC152_A10,15,15q24.2,73823501,73922083,98582,-,-
BAC101_L19,15,15q24.2,73844196,73955461,111265,-,-
BAC24_E19,15,15q24.2,73854059,73955461,101402,-,-
BAC97_J15,15,15q24.2,73891491,73987129,95638,-,-
BAC33_P12,15,15q24.2,73891788,73976093,84305,-,-
BAC137_L09,15,15q24.2,73985098,74074065,88967,-,-
BAC59_I10,15,15q24.2,74053132,74137197,84065,-,-
BAC163_A22,15,15q24.2,74064753,74187770,123017,-,-
BAC62_C22,15,15q24.2,74066575,74187784,121209,-,-
BAC240_I15,15,15q24.2,74104395,74187772,83377,-,-
BAC102_F23,15,15q24.2,74111508,74202954,91446,-,-
BAC158_P11,15,15q24.2,74111539,74195639,84100,-,-
BAC177_B01,15,15q24.2,74136186,74220267,84081,-,-
BAC188_L22,15,15q24.2,74187782,74290914,103132,-,-
BAC185_F24,15,15q24.2,74189839,74270466,80627,-,-
BAC182_A18,15,15q24.2,74189839,74288005,98166,-,-
BAC136_F09,15,15q24.2,74195916,74285595,89679,-,-
BAC149_N09,15,15q24.2,74202949,74320309,117360,-,-
BAC192_E08,15,15q24.2,74229634,74315305,85671,-,-
BAC193_H11,15,15q24.2-15q24.3,74327359,74407431,80072,-,-
BAC27_G14,15,15q24.3,74608072,74718358,110286,-,-
BAC122_M14,15,15q24.3,74721844,74817875,96031,-,-
BAC113_K01,15,15q24.3,74744512,74881387,136875,-,-
BAC110_P12,15,15q24.3,74782533,74868818,86285,-,-
BAC80_J20,15,15q24.3,74868813,75022884,154071,-,-
BAC106_L01,15,15q24.3,74929124,75024672,95548,-,-
BAC69_B04,15,15q24.3,74943204,75024938,81734,-,-
BAC22_F20,15,15q24.3,74943208,75026783,83575,-,-
BAC178_I08,15,15q24.3,75149470,75258958,109488,-,-
BAC166_G02,15,15q24.3,75199620,75296818,97198,-,-
BAC65_E17,15,15q24.3,75205437,75327656,122219,-,-
BAC89_B05,15,15q24.3,75205460,75304852,99392,-,-
BAC40_B20,15,15q24.3,75327650,75447274,119624,-,-
BAC67_M01,15,15q24.3,75446824,75576940,130116,-,-
BAC37_L03,15,15q24.3,75491183,75576936,85753,-,-
BAC81_K22,15,15q24.3,75562578,75736523,173945,-,-
BAC9_D08,15,15q24.3,75577253,75682824,105571,-,-
BAC64_N14,15,15q24.3,75577253,75662938,85685,-,-
BAC38_F19,15,15q24.3,75577253,75682820,105567,-,-
BAC145_J22,15,15q24.3,75587887,75687227,99340,-,-
BAC66_B02,15,15q24.3,75604497,75687243,82746,-,-
BAC248_P11,15,15q24.3,75613269,75687239,73970,-,-
BAC6_O22,15,15q24.3,75662932,75782127,119195,-,-
BAC83_N09,15,15q24.3,75687259,75806048,118789,-,-
BAC106_G04,15,15q24.3,75723156,75818965,95809,-,-
BAC139_I02,15,15q24.3,75770148,75859097,88949,-,-
BAC242_F11,15,15q24.3,75789703,75880873,91170,-,-
BAC61_J23,15,15q24.3,75846249,75982036,135787,-,-
BAC130_K14,15,15q24.3,75846710,75932543,85833,-,-
BAC183_I17,15,15q24.3,75856095,75962208,106113,-,-
BAC217_K15,15,15q24.3,75877892,75996629,118737,-,-
BAC226_E11,15,15q24.3,75922558,75996625,74067,-,-
BAC167_I22,15,15q24.3,75949855,76048080,98225,-,-
BAC250_C04,15,15q24.3-15q25.1,76011260,76135417,124157,-,-
BAC6_N07,15,15q24.3-15q25.1,76038608,76174060,135452,-,-
BAC166_C11,15,15q24.3-15q25.1,76059799,76135419,75620,-,-
BAC165_O06,15,15q24.3-15q25.1,76090282,76174062,83780,-,-
BAC152_D20,15,15q25.1,76146769,76226781,80012,-,-
BAC22_P22,15,15q25.1,76174077,76331359,157282,-,-
BAC149_N13,15,15q25.1,76236316,76336837,100521,-,-
BAC177_E11,15,15q25.1,76249825,76336837,87012,-,-
BAC244_C17,15,15q25.1,76250672,76399953,149281,-,-
BAC76_G10,15,15q25.1,76266860,76413081,146221,-,-
BAC208_B09,15,15q25.1,76275030,76428286,153256,-,-
BAC211_K02,15,15q25.1,76275105,76399856,124751,-,-
BAC69_I21,15,15q25.1,76327321,76426727,99406,-,-
BAC162_D17,15,15q25.1,76345743,76472188,126445,-,-
BAC201_E19,15,15q25.1,76345823,76472518,126695,-,-
BAC76_A18,15,15q25.1,76365036,76457701,92665,-,-
BAC92_C06,15,15q25.1,76370690,76461942,91252,-,-
BAC247_L01,15,15q25.1,76386334,76472188,85854,-,-
BAC33_I18,15,15q25.1,76400177,76534676,134499,-,-
BAC152_L01,15,15q25.1,76400177,76498580,98403,-,-
BAC148_H02,15,15q25.1,76400177,76472188,72011,-,-
BAC144_E03,15,15q25.1,76407589,76494627,87038,-,-
BAC59_E14,15,15q25.1,76414162,76534698,120536,-,-
BAC250_M13,15,15q25.1,76426733,76530221,103488,-,-
BAC35_D13,15,15q25.1,76426867,76570793,143926,-,-
BAC91_I24,15,15q25.1,76513767,76602643,88876,-,-
BAC144_G15,15,15q25.1,76529683,76632204,102521,-,-
BAC60_L13,15,15q25.1,76540635,76659676,119041,-,-
BAC156_O08,15,15q25.1,76540635,76621998,81363,-,-
BAC88_K19,15,15q25.1,76622018,76740134,118116,-,-
BAC249_G22,15,15q25.1,76639611,76749056,109445,-,-
BAC192_L15,15,15q25.1,76668500,76748021,79521,-,-
BAC148_H20,15,15q25.1,76748016,76844559,96543,-,-
BAC224_J12,15,15q25.1,76806277,76901445,95168,-,-
BAC63_D16,15,15q25.1,76903870,77060024,156154,-,-
BAC104_K07,15,15q25.1,76950456,77055789,105333,-,-
BAC172_A13,15,15q25.1,77013985,77121279,107294,-,-
BAC80_F24,15,15q25.1,77055983,77150168,94185,-,-
BAC24_C22,15,15q25.1,77094918,77208675,113757,-,-
BAC24_B23,15,15q25.1,77110275,77211792,101517,-,-
BAC217_J16,15,15q25.1,77124608,77207100,82492,-,-
BAC144_M16,15,15q25.1,77126077,77203238,77161,-,-
BAC61_J04,15,15q25.1,77210492,77292486,81994,-,-
BAC161_B19,15,15q25.1,77219415,77335740,116325,-,-
BAC196_A01,15,15q25.1,77258002,77344190,86188,-,-
BAC2_L10,15,15q25.1,77341333,77422585,81252,-,-
BAC168_F09,15,15q25.1,77361002,77449476,88474,-,-
BAC156_P19,15,15q25.1,77363394,77514140,150746,-,-
BAC101_D16,15,15q25.1,77391922,77486604,94682,-,-
BAC35_K18,15,15q25.1,77403824,77539036,135212,-,-
BAC160_D21,15,15q25.1,77447679,77539459,91780,-,-
BAC110_F06,15,15q25.1,77449709,77539459,89750,-,-
BAC33_G06,15,15q25.1,77449713,77543667,93954,-,-
BAC24_J15,15,15q25.1,77488465,77618757,130292,-,-
BAC72_F09,15,15q25.1,77542286,77644583,102297,-,-
BAC230_F24,15,15q25.1,77624474,77720564,96090,-,-
BAC175_E20,15,15q25.1,77715632,77793273,77641,-,-
BAC184_L22,15,15q25.1,77755052,77885870,130818,-,-
BAC188_O08,15,15q25.1,77943553,78025619,82066,-,-
BAC235_B23,15,15q25.1,78025614,78114365,88751,-,-
BAC49_L06,15,15q25.1,78120080,78225965,105885,-,-
BAC139_C17,15,15q25.1,78196108,78282887,86779,-,-
BAC232_C04,15,15q25.1,78236242,78309428,73186,-,-
BAC239_P03,15,15q25.1,78301798,78395154,93356,-,-
BAC29_A09,15,15q25.1,78309490,78396548,87058,-,-
BAC33_L05,15,15q25.1,78377200,78486422,109222,-,-
BAC113_P10,15,15q25.1,78377212,78479433,102221,-,-
BAC135_A08,15,15q25.1,78395150,78503127,107977,-,-
BAC38_D21,15,15q25.1,78437366,78534067,96701,-,-
BAC166_M08,15,15q25.1,78486415,78615944,129529,-,-
BAC194_O05,15,15q25.1,78537762,78551389,13627,-,-
BAC223_N20,15,15q25.1,78544757,78627494,82737,-,-
BAC96_H04,15,15q25.1,78554226,78785548,231322,-,-
BAC205_P23,15,15q25.1,78572561,78661390,88829,-,-
BAC145_I20,15,15q25.1,78627110,78760809,133699,-,-
BAC118_D08,15,15q25.1,78627489,78711403,83914,-,-
BAC240_G13,15,15q25.1,78661913,78745158,83245,-,-
BAC81_J05,15,15q25.1,78711398,78871322,159924,-,-
BAC38_P01,15,15q25.1,78758985,78868247,109262,-,-
BAC238_A02,15,15q25.1,78758985,78846257,87272,-,-
BAC60_K19,15,15q25.1,78785805,78871797,85992,-,-
BAC90_C21,15,15q25.1,78791910,78871797,79887,-,-
BAC10_E08,15,15q25.1,78883923,78994040,110117,-,-
BAC143_A13,15,15q25.1,78938427,79047856,109429,-,-
BAC82_P20,15,15q25.1,78959337,79089069,129732,-,-
BAC233_M20,15,15q25.1,78959473,79045940,86467,-,-
BAC172_J08,15,15q25.1,78970956,79069834,98878,-,-
BAC89_N11,15,15q25.1,79014368,79090237,75869,-,-
BAC180_K18,15,15q25.1,79014376,79150812,136436,-,-
BAC196_D18,15,15q25.1,79069845,79150812,80967,-,-
BAC196_C18,15,15q25.1,79070187,79150812,80625,-,-
BAC33_P05,15,15q25.1,79138307,79252524,114217,-,-
BAC81_I08,15,15q25.1,79239000,79371752,132752,-,-
BAC196_K22,15,15q25.1,79257389,79379110,121721,-,-
BAC29_C07,15,15q25.1,79257402,79379089,121687,-,-
BAC39_E09,15,15q25.1,79299305,79436630,137325,-,-
BAC231_D03,15,15q25.1,79315795,79398108,82313,-,-
BAC40_G10,15,15q25.1,79324117,79414339,90222,-,-
BAC238_H01,15,15q25.1,79349296,79478365,129069,-,-
BAC148_P04,15,15q25.1,79371745,79474456,102711,-,-
BAC119_K24,15,15q25.1,79391315,79478367,87052,-,-
BAC211_C10,15,15q25.1-15q25.2,79398188,79504228,106040,-,-
BAC134_J17,15,15q25.1-15q25.2,79414334,79507806,93472,-,-
BAC36_C17,15,15q25.2,79522911,79608837,85926,-,-
BAC43_I20,15,15q25.2,79565946,79660028,94082,-,-
BAC66_J19,15,15q25.2,79586424,79678367,91943,-,-
BAC70_E08,15,15q25.2,79608844,79691395,82551,-,-
BAC166_G19,15,15q25.2,79967437,80057225,89788,-,-
BAC125_B14,15,15q25.2,79969850,80105164,135314,-,-
BAC100_M17,15,15q25.2,79990284,80094487,104203,-,-
BAC72_I12,15,15q25.2,79990295,80071719,81424,-,-
BAC223_C02,15,15q25.2,80032113,80105164,73051,-,-
BAC56_B14,15,15q25.2,80178394,80254592,76198,-,-
BAC59_P16,15,15q25.2,80214497,80311645,97148,-,-
BAC198_O07,15,15q25.2,80240228,80319933,79705,-,-
BAC188_D22,15,15q25.2,80284532,80371000,86468,-,-
BAC171_M08,15,15q25.2,80363749,80442481,78732,-,-
BAC32_C08,15,15q25.2,80442507,80539377,96870,-,-
BAC57_E23,15,15q25.2,80732619,82673327,1940708,-,-
BAC114_K23,15,15q25.2,80737186,82883987,2146801,-,-
BAC141_H05,15,15q25.2,81013120,81133289,120169,-,-
BAC128_O24,15,15q25.2,81034789,81144234,109445,-,-
BAC128_M21,15,15q25.2,81034789,81144231,109442,-,-
BAC31_G13,15,15q25.2,81105880,81224068,118188,-,-
BAC43_F17,15,15q25.2,81141884,81254498,112614,-,-
BAC132_N12,15,15q25.2,81154625,81224068,69443,-,-
BAC126_H23,15,15q25.2,81154680,81254498,99818,-,-
BAC128_O20,15,15q25.2,81224062,81311376,87314,-,-
BAC233_J16,15,15q25.2,81228851,81327611,98760,-,-
BAC54_G23,15,15q25.2,81270301,81398585,128284,-,-
BAC90_M11,15,15q25.2,81271208,81418380,147172,-,-
BAC25_I24,15,15q25.2,81271211,81357769,86558,-,-
BAC58_F07,15,15q25.2,81357766,81464271,106505,-,-
BAC236_M01,15,15q25.2,81379575,81469911,90336,-,-
BAC137_A07,15,15q25.2,81384288,81513552,129264,-,-
BAC153_B18,15,15q25.2,81429151,81554431,125280,-,-
BAC13_C02,15,15q25.2,81444802,81529772,84970,-,-
BAC27_A05,15,15q25.2,81499791,81614504,114713,-,-
BAC109_B23,15,15q25.2,81508523,81634759,126236,-,-
BAC173_C10,15,15q25.2,81590068,81682630,92562,-,-
BAC139_G21,15,15q25.2,81611976,81749253,137277,-,-
BAC161_G13,15,15q25.2,81710777,81822089,111312,-,-
BAC232_E09,15,15q25.2,81850345,81983216,132871,-,-
BAC137_K10,15,15q25.2,81858204,81938700,80496,-,-
BAC149_D12,15,15q25.2,81862669,81938300,75631,-,-
BAC77_D14,15,15q25.2,81938307,82089574,151267,-,-
BAC88_B17,15,15q25.2,81979683,82068123,88440,-,-
BAC244_A10,15,15q25.2,82027756,82111931,84175,-,-
BAC37_C16,15,15q25.2,82130264,82226849,96585,-,-
BAC240_J21,15,15q25.2,82142745,82226849,84104,-,-
BAC27_F09,15,15q25.2,82149072,82265252,116180,-,-
BAC148_C19,15,15q25.2,82149072,82226849,77777,-,-
BAC127_N13,15,15q25.2,82476892,82562656,85764,-,-
BAC34_G17,15,15q25.2,82585980,82673347,87367,-,-
BAC175_C05,15,15q25.2,82607375,82737203,129828,-,-
BAC42_N11,15,15q25.2,82607387,82732085,124698,-,-
BAC65_J21,15,15q25.2-15q25.3,82647283,83638120,990837,-,-
BAC170_J07,15,15q25.2,82884074,82965710,81636,-,-
BAC132_F23,15,15q25.3,83013743,83134715,120972,-,-
BAC198_C11,15,15q25.3,83047338,83152783,105445,-,-
BAC119_C06,15,15q25.3,83088952,83209227,120275,-,-
BAC130_P06,15,15q25.3,83114939,83234713,119774,-,-
BAC155_H15,15,15q25.3,83150222,83237669,87447,-,-
BAC130_H24,15,15q25.3,83163570,83333293,169723,-,-
BAC40_K15,15,15q25.3,83165299,83295322,130023,-,-
BAC82_J04,15,15q25.3,83169434,83295346,125912,-,-
BAC158_D07,15,15q25.3,83425847,83523672,97825,-,-
BAC200_F24,15,15q25.3,83436591,83521017,84426,-,-
BAC59_A19,15,15q25.3,83626753,83762842,136089,-,-
BAC148_M24,15,15q25.3,83683386,83761336,77950,-,-
BAC249_A04,15,15q25.3,83685352,83775737,90385,-,-
BAC172_P15,15,15q25.3,83840508,83935876,95368,-,-
BAC39_A22,15,15q25.3,83841647,83935233,93586,-,-
BAC11_D08,15,15q25.3,83842829,83950030,107201,-,-
BAC76_M03,15,15q25.3,83863816,83892694,28878,-,-
BAC42_C23,15,15q25.3,83921336,84024459,103123,-,-
BAC1_H15,15,15q25.3,83970592,84140590,169998,-,-
BAC102_H23,15,15q25.3,83984042,84067507,83465,-,-
BAC190_H06,15,15q25.3,84000074,84140548,140474,-,-
BAC18_D13,15,15q25.3,84067699,84209929,142230,-,-
BAC103_A20,15,15q25.3,84100149,84218523,118374,-,-
BAC100_O20,15,15q25.3,84137332,84306807,169475,-,-
BAC66_F15,15,15q25.3,84137332,84239494,102162,-,-
BAC135_I19,15,15q25.3,84172590,84251948,79358,-,-
BAC161_E22,15,15q25.3,84182652,84279060,96408,-,-
BAC75_H15,15,15q25.3,84209164,84330262,121098,-,-
BAC36_B14,15,15q25.3,84261317,84349169,87852,-,-
BAC37_O22,15,15q25.3,84420318,84511167,90849,-,-
BAC115_I17,15,15q25.3,84420352,84511178,90826,-,-
BAC108_N15,15,15q25.3,84420923,84554834,133911,-,-
BAC1_K15,15,15q25.3,84555322,84662248,106926,-,-
BAC219_I10,15,15q25.3,84563615,84661164,97549,-,-
BAC252_B12,15,15q25.3,84563771,84662248,98477,-,-
BAC171_I20,15,15q25.3,84594196,84680154,85958,-,-
BAC31_J01,15,15q25.3,84688537,84836828,148291,-,-
BAC124_B13,15,15q25.3,84691068,84775851,84783,-,-
BAC58_A21,15,15q25.3,84785021,84917695,132674,-,-
BAC162_L01,15,15q25.3,84837038,84929714,92676,-,-
BAC238_I18,15,15q25.3,84945843,85030017,84174,-,-
BAC153_P03,15,15q25.3,85203805,85291561,87756,-,-
BAC128_A23,15,15q25.3,85245028,85359353,114325,-,-
BAC106_N22,15,15q25.3,85245037,85343070,98033,-,-
BAC127_B24,15,15q25.3,85245054,85359374,114320,-,-
BAC36_C01,15,15q25.3,85519122,85704939,185817,-,-
BAC133_E19,15,15q25.3,85731171,85807222,76051,-,-
BAC113_G02,15,15q25.3,85786058,85916958,130900,-,-
BAC153_M04,15,15q25.3,85796283,85879130,82847,-,-
BAC7_I18,15,15q25.3,85796360,85929403,133043,-,-
BAC57_G12,15,15q25.3,85960571,86157760,197189,-,-
BAC198_F15,15,15q25.3,86036872,86158348,121476,-,-
BAC107_I07,15,15q25.3,86080144,86211497,131353,-,-
BAC115_H08,15,15q25.3,86084132,86203092,118960,-,-
BAC169_E02,15,15q25.3,86084138,86196124,111986,-,-
BAC144_C24,15,15q25.3,86187179,86283404,96225,-,-
BAC146_J08,15,15q25.3,86203089,86283404,80315,-,-
BAC102_M10,15,15q25.3,86211490,86343320,131830,-,-
BAC36_K01,15,15q25.3,86242816,86362227,119411,-,-
BAC227_C17,15,15q25.3,86262703,86361659,98956,-,-
BAC177_H09,15,15q25.3,86262818,86362227,99409,-,-
BAC252_D04,15,15q25.3,86283657,86386792,103135,-,-
BAC172_J22,15,15q25.3,86304738,86385759,81021,-,-
BAC182_J04,15,15q25.3,86321790,86410887,89097,-,-
BAC241_F04,15,15q25.3,86344897,86425375,80478,-,-
BAC160_D18,15,15q25.3,86361217,86477704,116487,-,-
BAC170_O08,15,15q25.3,86367448,86460150,92702,-,-
BAC200_H11,15,15q25.3,86383415,86512690,129275,-,-
BAC176_P07,15,15q25.3,86389601,86466589,76988,-,-
BAC143_M08,15,15q25.3,86458873,86536985,78112,-,-
BAC90_I09,15,15q25.3,86458876,86536985,78109,-,-
BAC242_N04,15,15q25.3,86490169,86590082,99913,-,-
BAC146_F23,15,15q25.3,86595206,86702540,107334,-,-
BAC193_D23,15,15q25.3,86604468,86728466,123998,-,-
BAC116_C08,15,15q25.3,86674787,86797143,122356,-,-
BAC45_O06,15,15q25.3-15q26.1,86797227,86923618,126391,-,-
BAC119_E24,15,15q25.3,86798995,86894102,95107,-,-
BAC129_J12,15,15q25.3-15q26.1,86806111,86904011,97900,-,-
BAC59_O19,15,15q25.3-15q26.1,86816111,86920329,104218,-,-
BAC135_P18,15,15q25.3-15q26.1,86841135,86944780,103645,-,-
BAC16_I13,15,15q25.3-15q26.1,86850263,86953643,103380,-,-
BAC166_B04,15,15q26.1,86904009,87019607,115598,-,-
BAC54_P18,15,15q26.1,86904009,87021042,117033,-,-
BAC107_O03,15,15q26.1,86915641,87024250,108609,-,-
BAC172_E20,15,15q26.1,86923616,87043253,119637,-,-
BAC190_E10,15,15q26.1,86940102,87024247,84145,-,-
BAC48_M11,15,15q26.1,87013959,87110627,96668,-,-
BAC57_A16,15,15q26.1,87043454,87133682,90228,-,-
BAC200_L02,15,15q26.1,87179846,87301363,121517,-,-
BAC179_D24,15,15q26.1,87206725,87308793,102068,-,-
BAC248_N08,15,15q26.1,87256003,87339744,83741,-,-
BAC170_D23,15,15q26.1,87267571,87361771,94200,-,-
BAC102_M07,15,15q26.1,87308900,87402533,93633,-,-
BAC73_B01,15,15q26.1,87309376,87412985,103609,-,-
BAC224_M05,15,15q26.1,87354520,87446291,91771,-,-
BAC237_J20,15,15q26.1,87361766,87455446,93680,-,-
BAC55_B08,15,15q26.1,87382867,87482449,99582,-,-
BAC144_G06,15,15q26.1,87482531,87571997,89466,-,-
BAC20_I16,15,15q26.1,87495171,87595925,100754,-,-
BAC143_F21,15,15q26.1,87554281,87672236,117955,-,-
BAC46_P21,15,15q26.1,87561025,87708335,147310,-,-
BAC196_D04,15,15q26.1,87573277,87649902,76625,-,-
BAC61_P20,15,15q26.1,87580655,87663260,82605,-,-
BAC22_O15,15,15q26.1,87602475,87705089,102614,-,-
BAC50_M19,15,15q26.1,87621558,87734205,112647,-,-
BAC188_P17,15,15q26.1,87635902,87724576,88674,-,-
BAC219_I01,15,15q26.1,87703034,87812416,109382,-,-
BAC142_L03,15,15q26.1,87724571,87839193,114622,-,-
BAC215_K07,15,15q26.1,87839533,87963902,124369,-,-
BAC123_E10,15,15q26.1,87862147,87967094,104947,-,-
BAC169_D20,15,15q26.1,87963894,88055084,91190,-,-
BAC86_M07,15,15q26.1,87963899,88088784,124885,-,-
BAC170_A06,15,15q26.1,87967087,88078740,111653,-,-
BAC199_A20,15,15q26.1,87967087,88056594,89507,-,-
BAC132_E11,15,15q26.1,87967099,88056594,89495,-,-
BAC60_M16,15,15q26.1,87975051,88078740,103689,-,-
BAC57_H20,15,15q26.1,88015215,88120328,105113,-,-
BAC70_E06,15,15q26.1,88015215,88106433,91218,-,-
BAC8_C07,15,15q26.1,88098808,88220100,121292,-,-
BAC168_H23,15,15q26.1,88099421,88220100,120679,-,-
BAC106_G01,15,15q26.1,88099421,88205987,106566,-,-
BAC37_N02,15,15q26.1,88142579,88264993,122414,-,-
BAC119_H22,15,15q26.1,88220094,88319764,99670,-,-
BAC236_L15,15,15q26.1,88316748,88430115,113367,-,-
BAC37_H16,15,15q26.1,88390258,88502656,112398,-,-
BAC31_B06,15,15q26.1,88392734,88409370,16636,-,-
BAC119_P03,15,15q26.1,88486086,88589708,103622,-,-
BAC239_J13,15,15q26.1,88502651,88586126,83475,-,-
BAC196_G17,15,15q26.1,88508040,88596749,88709,-,-
BAC43_K16,15,15q26.1,88512866,88602998,90132,-,-
BAC197_J11,15,15q26.1,88539295,88617640,78345,-,-
BAC100_M15,15,15q26.1,88596746,88692295,95549,-,-
BAC166_D08,15,15q26.1,88621145,88722346,101201,-,-
BAC134_M02,15,15q26.1,88692290,88782683,90393,-,-
BAC76_C23,15,15q26.1,88783951,88915663,131712,-,-
BAC97_F23,15,15q26.1,88798758,88956095,157337,-,-
BAC40_M05,15,15q26.1,88821023,88955237,134214,-,-
BAC81_I17,15,15q26.1,88858354,88955243,96889,-,-
BAC237_P06,15,15q26.1,88869102,88955243,86141,-,-
BAC8_I01,15,15q26.1,88906104,88994009,87905,-,-
BAC187_K04,15,15q26.1,88915657,89026754,111097,-,-
BAC163_A20,15,15q26.1,88928491,89027138,98647,-,-
BAC109_G13,15,15q26.1,89022100,89148592,126492,-,-
BAC11_E17,15,15q26.1,89027292,89134224,106932,-,-
BAC48_H08,15,15q26.1,89027422,89134219,106797,-,-
BAC249_H09,15,15q26.1,89046011,89134221,88210,-,-
BAC83_E17,15,15q26.1,89108018,89205216,97198,-,-
BAC22_C17,15,15q26.1,89134862,89266459,131597,-,-
BAC234_E07,15,15q26.1,89152650,89285697,133047,-,-
BAC163_F24,15,15q26.1,89157273,89275502,118229,-,-
BAC145_M14,15,15q26.1,89157273,89270059,112786,-,-
BAC119_I18,15,15q26.1,89157273,89266458,109185,-,-
BAC149_I17,15,15q26.1,89170681,89278145,107464,-,-
BAC135_I14,15,15q26.1,89172388,89312122,139734,-,-
BAC148_L09,15,15q26.1,89172388,89285715,113327,-,-
BAC237_I11,15,15q26.1,89185074,89298377,113303,-,-
BAC219_M13,15,15q26.1,89185074,89276561,91487,-,-
BAC226_N16,15,15q26.1,89204143,89275717,71574,-,-
BAC176_G23,15,15q26.1,89298718,89423831,125113,-,-
BAC249_N05,15,15q26.1,89320821,89432925,112104,-,-
BAC24_G15,15,15q26.1,89325818,89464430,138612,-,-
BAC217_C04,15,15q26.1,89340566,89416520,75954,-,-
BAC80_H15,15,15q26.1,89452645,89545142,92497,-,-
BAC180_J10,15,15q26.1,89471413,89565023,93610,-,-
BAC49_H14,15,15q26.1,89475103,89579184,104081,-,-
BAC165_O07,15,15q26.1,89497857,89579243,81386,-,-
BAC186_I21,15,15q26.1,89500448,89577604,77156,-,-
BAC106_L13,15,15q26.1,89534928,89650634,115706,-,-
BAC217_F10,15,15q26.1,89662637,89757775,95138,-,-
BAC41_K06,15,15q26.1,89675811,89769097,93286,-,-
BAC42_O09,15,15q26.1,89769100,89869498,100398,-,-
BAC26_J11,15,15q26.1,89829778,89942349,112571,-,-
BAC25_M18,15,15q26.1,89870924,89967198,96274,-,-
BAC126_C07,15,15q26.1,90147271,90249041,101770,-,-
BAC122_L05,15,15q26.1,90147271,90249040,101769,-,-
BAC209_J07,15,15q26.1,90214453,90309955,95502,-,-
BAC22_C08,15,15q26.1,90230476,90353977,123501,-,-
BAC41_G02,15,15q26.1,90308111,90394584,86473,-,-
BAC189_L16,15,15q26.1,90354036,90432917,78881,-,-
BAC234_G01,15,15q26.1,90365958,90458537,92579,-,-
BAC219_I06,15,15q26.1,90427846,90520739,92893,-,-
BAC31_H19,15,15q26.1,90488659,90578177,89518,-,-
BAC231_P17,15,15q26.1,90571336,90668275,96939,-,-
BAC185_N08,15,15q26.1,90571336,90663166,91830,-,-
BAC97_J23,15,15q26.1,90616557,90741483,124926,-,-
BAC50_E03,15,15q26.1,90635450,90721634,86184,-,-
BAC168_J18,15,15q26.1,90658034,90755469,97435,-,-
BAC234_H09,15,15q26.1,90755464,90885883,130419,-,-
BAC161_O05,15,15q26.1,90759431,90842677,83246,-,-
BAC119_P14,15,15q26.1,90775255,90912149,136894,-,-
BAC123_F04,15,15q26.1,90803686,90885883,82197,-,-
BAC226_C21,15,15q26.1,90838210,90948392,110182,-,-
BAC172_O19,15,15q26.1,90859129,90961534,102405,-,-
BAC234_J14,15,15q26.1,90912144,91009030,96886,-,-
BAC139_P21,15,15q26.1,90920518,91040064,119546,-,-
BAC78_P11,15,15q26.1,91002319,91140430,138111,-,-
BAC27_F23,15,15q26.1,91009268,91108164,98896,-,-
BAC141_N09,15,15q26.1,91009299,91126987,117688,-,-
BAC15_E09,15,15q26.1,91014046,91124749,110703,-,-
BAC59_N17,15,15q26.1,91017714,91134242,116528,-,-
BAC198_M19,15,15q26.1,91184341,91269542,85201,-,-
BAC147_B13,15,15q26.1,91223050,91318906,95856,-,-
BAC217_E24,15,15q26.1,91294209,91397455,103246,-,-
BAC57_H05,15,15q26.1,91318900,91439055,120155,-,-
BAC186_I06,15,15q26.1,91318901,91428621,109720,-,-
BAC161_P04,15,15q26.1,91348544,91445069,96525,-,-
BAC69_L08,15,15q26.1,91348546,91439072,90526,-,-
BAC234_G11,15,15q26.1,91364942,91445069,80127,-,-
BAC225_D18,15,15q26.1,91403520,91495579,92059,-,-
BAC197_L22,15,15q26.1,91428127,91509101,80974,-,-
BAC182_O13,15,15q26.1,91428724,91520510,91786,-,-
BAC24_F10,15,15q26.1,91428724,91540626,111902,-,-
BAC228_P02,15,15q26.1,91447086,91518292,71206,-,-
BAC178_I21,15,15q26.1,91447092,91537458,90366,-,-
BAC45_K14,15,15q26.1,91468122,91541023,72901,-,-
BAC236_J04,15,15q26.1,91520101,91612167,92066,-,-
BAC66_P02,15,15q26.1,91520101,91616471,96370,-,-
BAC213_A07,15,15q26.1,91531747,91612196,80449,-,-
BAC25_G10,15,15q26.1,91537453,91632958,95505,-,-
BAC39_E24,15,15q26.1,91541245,91632539,91294,-,-
BAC83_K23,15,15q26.1,91576159,91679217,103058,-,-
BAC241_M07,15,15q26.1,91612192,91711428,99236,-,-
BAC118_D15,15,15q26.1,91616099,91711428,95329,-,-
BAC189_G10,15,15q26.1,91616099,91693383,77284,-,-
BAC187_D15,15,15q26.1,91679563,91773809,94246,-,-
BAC52_B05,15,15q26.1,91701287,91873896,172609,-,-
BAC235_N16,15,15q26.1,91711422,91809696,98274,-,-
BAC76_J13,15,15q26.1,91724598,91809696,85098,-,-
BAC180_P10,15,15q26.1,91764641,91855487,90846,-,-
BAC227_K02,15,15q26.1,91764693,91870900,106207,-,-
BAC158_L09,15,15q26.1,91920011,92010365,90354,-,-
BAC89_P06,15,15q26.1,91975806,92050968,75162,-,-
BAC22_N14,15,15q26.1-15q26.2,92044050,92154130,110080,-,-
BAC72_A12,15,15q26.2,92135272,92222852,87580,-,-
BAC209_A19,15,15q26.2,92147038,92236641,89603,-,-
BAC31_D24,15,15q26.2,92237346,92339199,101853,-,-
BAC148_E05,15,15q26.2,92412734,92422884,10150,-,-
BAC41_K02,15,15q26.2,92546166,92709668,163502,-,-
BAC42_O02,15,15q26.2,92590167,92689657,99490,-,-
BAC1_I12,15,15q26.2,92599150,92689662,90512,-,-
BAC218_I24,15,15q26.2,92603956,92693494,89538,-,-
BAC153_B06,15,15q26.2,92615473,92713454,97981,-,-
BAC96_M11,15,15q26.2,92615473,92713454,97981,-,-
BAC127_P12,15,15q26.2,92713448,92805692,92244,-,-
BAC25_J04,15,15q26.2,92728648,92819461,90813,-,-
BAC32_F09,15,15q26.2,92819454,92926711,107257,-,-
BAC142_O05,15,15q26.2,92843577,92926718,83141,-,-
BAC221_C14,15,15q26.2,92867876,92953103,85227,-,-
BAC69_A19,15,15q26.2,93142713,93225337,82624,-,-
BAC105_P04,15,15q26.2,93162698,93328174,165476,-,-
BAC17_D03,15,15q26.2,93162698,93280309,117611,-,-
BAC71_B16,15,15q26.2,93162698,93227259,64561,-,-
BAC68_M08,15,15q26.2,93189397,93280515,91118,-,-
BAC52_O22,15,15q26.2,93357701,93439615,81914,-,-
BAC142_P21,15,15q26.2,93373218,93451293,78075,-,-
BAC70_D07,15,15q26.2,93556150,93655830,99680,-,-
BAC217_D07,15,15q26.2,93621782,93706876,85094,-,-
BAC120_J06,15,15q26.2,93627126,93757100,129974,-,-
BAC176_N17,15,15q26.2,93645745,93749244,103499,-,-
BAC147_O05,15,15q26.2,93706870,93800969,94099,-,-
BAC141_P24,15,15q26.2,93829773,93927092,97319,-,-
BAC100_E14,15,15q26.2,93865904,93957117,91213,-,-
BAC67_J24,15,15q26.2,93914153,94005104,90951,-,-
BAC123_L16,15,15q26.2,93922412,94091351,168939,-,-
BAC181_H21,15,15q26.2,94011190,94102777,91587,-,-
BAC237_E09,15,15q26.2,94097256,94188730,91474,-,-
BAC190_O17,15,15q26.2,94105856,94188681,82825,-,-
BAC34_P17,15,15q26.2,94173439,94311052,137613,-,-
BAC41_M01,15,15q26.2,94201062,94319251,118189,-,-
BAC223_L01,15,15q26.2,94211970,94311010,99040,-,-
BAC159_N06,15,15q26.2,94346466,94418416,71950,-,-
BAC179_L22,15,15q26.2,94380669,94458563,77894,-,-
BAC117_H02,15,15q26.2,94463622,94565351,101729,-,-
BAC41_K03,15,15q26.2,94625429,94735125,109696,-,-
BAC161_I09,15,15q26.2,94852668,94968967,116299,-,-
BAC172_D22,15,15q26.2,94910471,94994528,84057,-,-
BAC4_D16,15,15q26.2,94931910,95015988,84078,-,-
BAC45_K16,15,15q26.2,94957934,95117810,159876,-,-
BAC176_E03,15,15q26.2,94957937,95041358,83421,-,-
BAC48_I02,15,15q26.2,95009781,95129859,120078,-,-
BAC26_O09,15,15q26.2,95093202,95207566,114364,-,-
BAC194_G20,15,15q26.2,95130502,95202454,71952,-,-
BAC200_O24,15,15q26.2,95147403,95240713,93310,-,-
BAC154_N19,15,15q26.2,95417852,95520068,102216,-,-
BAC114_J01,15,15q26.2,95499781,95673895,174114,-,-
BAC52_A09,15,15q26.2,95562015,95728419,166404,-,-
BAC218_C10,15,15q26.2,95583256,95680333,97077,-,-
BAC252_C20,15,15q26.2,95593873,95746260,152387,-,-
BAC113_H05,15,15q26.2,95636762,95738064,101302,-,-
BAC246_D11,15,15q26.2,95652121,95738085,85964,-,-
BAC148_F09,15,15q26.2,95680338,95759913,79575,-,-
BAC32_J24,15,15q26.2,95822750,95916104,93354,-,-
BAC192_M01,15,15q26.2,96072628,96149070,76442,-,-
BAC83_D17,15,15q26.2,96093793,96183881,90088,-,-
BAC51_I15,15,15q26.2-15q26.3,96183904,96313174,129270,-,-
BAC175_O16,15,15q26.2,96209659,96299542,89883,-,-
BAC139_E13,15,15q26.2-15q26.3,96209659,96309227,99568,-,-
BAC181_J05,15,15q26.2-15q26.3,96225502,96308859,83357,-,-
BAC90_A16,15,15q26.3,96376466,96495619,119153,-,-
BAC97_D17,15,15q26.3,96427067,96548873,121806,-,-
BAC132_A13,15,15q26.3,96431681,96510410,78729,-,-
BAC180_E08,15,15q26.3,96449796,96538841,89045,-,-
BAC23_E15,15,15q26.3,96495247,96602361,107114,-,-
BAC249_G10,15,15q26.3,96602497,96712921,110424,-,-
BAC238_M09,15,15q26.3,96611705,96712943,101238,-,-
BAC116_P22,15,15q26.3,96613121,96697828,84707,-,-
BAC175_L08,15,15q26.3,96646168,96730136,83968,-,-
BAC185_K03,15,15q26.3,96681195,96772612,91417,-,-
BAC120_F10,15,15q26.3,96694508,96807251,112743,-,-
BAC184_C16,15,15q26.3,96697823,96808059,110236,-,-
BAC193_M19,15,15q26.3,96800401,96912351,111950,-,-
BAC175_N10,15,15q26.3,96808052,96912351,104299,-,-
BAC184_D17,15,15q26.3,96811870,96904734,92864,-,-
BAC121_I02,15,15q26.3,96822651,96951811,129160,-,-
BAC230_K08,15,15q26.3,96837932,96922584,84652,-,-
BAC224_L24,15,15q26.3,96864476,96951933,87457,-,-
BAC168_E07,15,15q26.3,96948220,97023478,75258,-,-
BAC66_E24,15,15q26.3,96973519,97065740,92221,-,-
BAC199_M18,15,15q26.3,97012500,97114395,101895,-,-
BAC160_F07,15,15q26.3,97012500,97095349,82849,-,-
BAC14_C04,15,15q26.3,97041260,97157791,116531,-,-
BAC27_C24,15,15q26.3,97045175,97139023,93848,-,-
BAC149_E18,15,15q26.3,97065736,97151191,85455,-,-
BAC223_J23,15,15q26.3,97067056,97169977,102921,-,-
BAC181_F11,15,15q26.3,97069657,97152351,82694,-,-
BAC1_K24,15,15q26.3,97122044,97250002,127958,-,-
BAC34_H10,15,15q26.3,97151790,97209311,57521,-,-
BAC201_P09,15,15q26.3,97349788,97427007,77219,-,-
BAC125_C14,15,15q26.3,97479905,97618598,138693,-,-
BAC100_J05,15,15q26.3,97485769,97612364,126595,-,-
BAC171_D21,15,15q26.3,97741110,97835571,94461,-,-
BAC118_N21,15,15q26.3,97746390,97835571,89181,-,-
BAC31_O02,15,15q26.3,97746393,97856411,110018,-,-
BAC237_M17,15,15q26.3,97748798,97835571,86773,-,-
BAC142_O11,15,15q26.3,97755460,97872727,117267,-,-
BAC52_M08,15,15q26.3,98021559,98114016,92457,-,-
BAC81_E10,15,15q26.3,98059293,98150389,91096,-,-
BAC224_G15,15,15q26.3,98317599,98439618,122019,-,-
BAC172_H10,15,15q26.3,98321566,98385869,64303,-,-
BAC36_C14,15,15q26.3,98321581,98429264,107683,-,-
BAC232_F07,15,15q26.3,98331292,98429264,97972,-,-
BAC217_B15,15,15q26.3,98385497,98478898,93401,-,-
BAC227_M06,15,15q26.3,98479034,98565824,86790,-,-
BAC194_P24,15,15q26.3,98482026,98570228,88202,-,-
BAC24_J12,15,15q26.3,98494102,98582620,88518,-,-
BAC15_G23,15,15q26.3,98528542,98668452,139910,-,-
BAC219_E09,15,15q26.3,98595370,98679757,84387,-,-
BAC125_P11,15,15q26.3,98750230,98864681,114451,-,-
BAC8_I18,15,15q26.3,98750230,98862738,112508,-,-
BAC59_P10,15,15q26.3,98750233,98833781,83548,-,-
BAC1_J14,15,15q26.3,98797765,98895076,97311,-,-
BAC105_L03,15,15q26.3,98842256,98968617,126361,-,-
BAC127_M22,15,15q26.3,98864834,98972331,107497,-,-
BAC147_I07,15,15q26.3,98870007,98972331,102324,-,-
BAC175_O09,15,15q26.3,98991831,99090838,99007,-,-
BAC64_F08,15,15q26.3,99006439,99113266,106827,-,-
BAC137_J10,15,15q26.3,99095778,99176884,81106,-,-
BAC8_L09,15,15q26.3,99155342,99274817,119475,-,-
BAC149_B15,15,15q26.3,99169765,99259460,89695,-,-
BAC194_D11,15,15q26.3,99185522,99274817,89295,-,-
BAC166_G05,15,15q26.3,99185522,99259460,73938,-,-
BAC185_M19,15,15q26.3,99266016,99336181,70165,-,-
BAC219_B12,15,15q26.3,99355026,99440651,85625,-,-
BAC88_O05,15,15q26.3,99369757,99484125,114368,-,-
BAC149_N02,15,15q26.3,99440631,99599179,158548,-,-
BAC156_D19,15,15q26.3,99484132,99548025,63893,-,-
BAC161_N16,15,15q26.3,99484178,99564271,80093,-,-
BAC65_P01,15,15q26.3,99486374,99560865,74491,-,-
BAC156_P16,15,15q26.3,99486681,99590140,103459,-,-
BAC60_D16,15,15q26.3,99504123,99597588,93465,-,-
BAC105_A04,15,15q26.3,99570457,99653479,83022,-,-
BAC236_O23,15,15q26.3,99598506,99716843,118337,-,-
BAC73_L12,15,15q26.3,99605903,99722512,116609,-,-
BAC100_P11,15,15q26.3,99616457,99716893,100436,-,-
BAC15_I24,15,15q26.3,99632893,99729464,96571,-,-
BAC96_N08,15,15q26.3,99653473,99758817,105344,-,-
BAC178_K04,15,15q26.3,99865994,99982237,116243,-,-
BAC163_G07,15,15q26.3,99916071,100026241,110170,-,-
BAC53_O14,15,15q26.3,99916210,100025253,109043,-,-
BAC33_L17,15,15q26.3,100020236,100145712,125476,-,-
BAC75_H09,15,15q26.3,100025491,100145624,120133,-,-
BAC150_H22,15,15q26.3,100025929,100132687,106758,-,-
BAC222_B13,15,15q26.3,100038175,100129743,91568,-,-
BAC58_D24,15,15q26.3,100050619,100145708,95089,-,-
BAC178_J04,15,15q26.3,100054894,100129433,74539,-,-
BAC200_C16,15,15q26.3,100081258,100155675,74417,-,-
BAC67_O11,15,15q26.3,100089544,100170298,80754,-,-
BAC66_N09,16,16p13.3,109841,225285,115444,yes,-
BAC113_F07,16,16p13.3,167110,310533,143423,yes,-
BAC142_H12,16,16p13.3,516892,617413,100521,-,-
BAC142_G12,16,16p13.3,516892,617413,100521,yes,-
BAC6_H17,16,16p13.3,595949,701427,105478,yes,-
BAC250_L07,16,16p13.3,605606,704021,98415,yes,-
BAC61_G05,16,16p13.3,635038,734905,99867,yes,-
BAC208_A15,16,16p13.3,721024,804514,83490,yes,-
BAC249_C21,16,16p13.3,734898,812170,77272,yes,-
BAC230_J12,16,16p13.3,734898,845630,110732,yes,-
BAC239_F18,16,16p13.3,834151,906745,72594,-,-
BAC208_D07,16,16p13.3,863067,953908,90841,-,-
BAC61_H17,16,16p13.3,979471,1055445,75974,-,-
BAC35_O10,16,16p13.3,1137307,1255895,118588,yes,-
BAC229_P03,16,16p13.3,1256144,1381478,125334,yes,-
BAC78_M22,16,16p13.3,1256147,1355767,99620,yes,-
BAC92_D12,16,16p13.3,1366758,1468483,101725,-,-
BAC68_D12,16,16p13.3,1409495,1501865,92370,-,-
BAC109_L07,16,16p13.3,1424287,1540677,116390,-,-
BAC8_E11,16,16p13.3,1424294,1525866,101572,-,-
BAC248_B09,16,16p13.3,1540716,1646263,105547,-,-
BAC175_F10,16,16p13.3,1561161,1690151,128990,-,-
BAC247_K17,16,16p13.3,1561165,1679920,118755,-,-
BAC247_B19,16,16p13.3,1561424,1673813,112389,-,-
BAC205_E14,16,16p13.3,1561577,1660672,99095,-,-
BAC160_N03,16,16p13.3,1563801,1679890,116089,-,-
BAC30_J11,16,16p13.3,1563801,1646268,82467,-,-
BAC67_J23,16,16p13.3,1563801,1660670,96869,-,-
BAC204_J01,16,16p13.3,1564099,1693537,129438,-,-
BAC43_H21,16,16p13.3,1595030,1673812,78782,-,-
BAC101_E17,16,16p13.3,1646262,1801046,154784,-,-
BAC60_D04,16,16p13.3,1646262,1750195,103933,-,-
BAC26_C21,16,16p13.3,1660665,1801041,140376,-,-
BAC161_M07,16,16p13.3,1693604,1820593,126989,-,-
BAC95_B15,16,16p13.3,1701584,1824293,122709,-,-
BAC208_N11,16,16p13.3,1750189,1831782,81593,-,-
BAC32_K07,16,16p13.3,1840180,1953690,113510,yes,-
BAC133_O06,16,16p13.3,1848818,1928713,79895,yes,-
BAC124_D13,16,16p13.3,1883102,1970667,87565,yes,-
BAC252_I22,16,16p13.3,2066833,2157882,91049,yes,-
BAC40_G22,16,16p13.3,2066835,2152676,85841,-,-
BAC53_J01,16,16p13.3,2076854,2196477,119623,yes,-
BAC21_B08,16,16p13.3,2076878,2156763,79885,yes,-
BAC19_C21,16,16p13.3,2156758,2288778,132020,-,-
BAC116_P01,16,16p13.3,2156858,2269737,112879,-,-
BAC184_B18,16,16p13.3,2196471,2310964,114493,-,-
BAC221_H21,16,16p13.3,2260368,2352970,92602,-,-
BAC144_E21,16,16p13.3,2269762,2357147,87385,-,-
BAC124_A07,16,16p13.3,2270857,2352970,82113,-,-
BAC41_F23,16,16p13.3,2280376,2379749,99373,-,-
BAC153_B21,16,16p13.3,2328413,2410400,81987,-,-
BAC71_B14,16,16p13.3,2374712,2497340,122628,-,-
BAC236_I05,16,16p13.3,2400725,2491723,90998,-,-
BAC153_A19,16,16p13.3,2406012,2514235,108223,-,-
BAC200_F16,16,16p13.3,2560062,2653929,93867,-,-
BAC107_P15,16,16p13.3,2560062,2658131,98069,-,-
BAC57_E04,16,16p13.3,2581321,2737846,156525,yes,-
BAC172_L09,16,16p13.3,2637623,2737846,100223,yes,-
BAC118_B14,16,16p13.3,2659426,2800643,141217,yes,-
BAC150_A04,16,16p13.3,2797995,2887165,89170,-,-
BAC40_D16,16,16p13.3,2871017,2972002,100985,-,-
BAC67_A23,16,16p13.3,2876678,2962409,85731,-,-
BAC188_G04,16,16p13.3,2962402,3045099,82697,-,-
BAC155_O09,16,16p13.3,2962805,3121824,159019,-,-
BAC144_H13,16,16p13.3,2971997,3088044,116047,-,-
BAC158_C07,16,16p13.3,2971997,3045082,73085,-,-
BAC108_N04,16,16p13.3,2972003,3068966,96963,-,-
BAC59_B08,16,16p13.3,3059703,3142671,82968,-,-
BAC81_K15,16,16p13.3,3067648,3187573,119925,-,-
BAC84_C17,16,16p13.3,3118639,3200991,82352,-,-
BAC193_J09,16,16p13.3,3136321,3222902,86581,-,-
BAC136_D19,16,16p13.3,3142782,3241383,98601,-,-
BAC60_M03,16,16p13.3,3222897,3316511,93614,-,-
BAC49_J01,16,16p13.3,3231296,3366629,135333,-,-
BAC23_K05,16,16p13.3,3287837,3394209,106372,-,-
BAC198_J05,16,16p13.3,3369663,3513528,143865,-,-
BAC136_M14,16,16p13.3,3394225,3479452,85227,-,-
BAC102_D21,16,16p13.3,3435877,3528764,92887,-,-
BAC24_F07,16,16p13.3,3473710,3574756,101046,-,-
BAC178_J13,16,16p13.3,3486156,3592548,106392,-,-
BAC65_A23,16,16p13.3,3498655,3616579,117924,-,-
BAC171_C18,16,16p13.3,3528757,3616580,87823,-,-
BAC19_P16,16,16p13.3,3556915,3661528,104613,-,-
BAC200_A05,16,16p13.3,3601995,3703943,101948,-,-
BAC8_E02,16,16p13.3,3616572,3747878,131306,-,-
BAC176_N19,16,16p13.3,3616574,3717140,100566,-,-
BAC175_E01,16,16p13.3,3661565,3747882,86317,-,-
BAC243_O03,16,16p13.3,3703937,3839752,135815,-,-
BAC77_O20,16,16p13.3,3703946,3808802,104856,-,-
BAC33_C23,16,16p13.3,3739210,3865612,126402,-,-
BAC33_F18,16,16p13.3,3742677,3839385,96708,-,-
BAC114_D19,16,16p13.3,3748067,3865603,117536,-,-
BAC10_J20,16,16p13.3,3819654,3943709,124055,-,-
BAC19_O18,16,16p13.3,3906016,4013128,107112,-,-
BAC65_O23,16,16p13.3,3909859,4049076,139217,-,-
BAC229_B09,16,16p13.3,3943736,4110560,166824,-,-
BAC29_E17,16,16p13.3,4140218,4241338,101120,-,-
BAC151_N12,16,16p13.3,4158257,4261611,103354,-,-
BAC153_I13,16,16p13.3,4158257,4261613,103356,-,-
BAC167_H22,16,16p13.3,4159824,4241345,81521,-,-
BAC72_C06,16,16p13.3,4160298,4270450,110152,-,-
BAC45_N08,16,16p13.3,4205986,4301787,95801,-,-
BAC168_G05,16,16p13.3,4301832,4420370,118538,-,-
BAC42_O01,16,16p13.3,4336740,4434818,98078,-,-
BAC156_J23,16,16p13.3,4364840,4507089,142249,-,-
BAC234_H14,16,16p13.3,4385063,4473104,88041,-,-
BAC235_L13,16,16p13.3,4420581,4507135,86554,-,-
BAC10_M16,16,16p13.3,4447772,4547332,99560,-,-
BAC211_B22,16,16p13.3,4448174,4567592,119418,-,-
BAC196_B08,16,16p13.3,4473227,4567594,94367,-,-
BAC210_A20,16,16p13.3,4473444,4561497,88053,-,-
BAC118_L16,16,16p13.3,4514489,4618081,103592,-,-
BAC224_L21,16,16p13.3,4526433,4669922,143489,-,-
BAC134_C23,16,16p13.3,4547371,4691940,144569,-,-
BAC119_O20,16,16p13.3,4561747,4653905,92158,-,-
BAC140_K07,16,16p13.3,4561870,4672954,111084,-,-
BAC142_C21,16,16p13.3,4561870,4672954,111084,-,-
BAC167_N23,16,16p13.3,4603478,4745054,141576,-,-
BAC55_A12,16,16p13.3,4617220,4691895,74675,-,-
BAC44_A02,16,16p13.3,4653929,4779079,125150,-,-
BAC101_M09,16,16p13.3,4715281,4811838,96557,-,-
BAC198_G05,16,16p13.3,4759651,4855963,96312,-,-
BAC109_N12,16,16p13.3,4847445,4943124,95679,-,-
BAC170_K10,16,16p13.3,4851178,4945502,94324,-,-
BAC226_C04,16,16p13.3,4890776,4976560,85784,-,-
BAC2_E10,16,16p13.3,4890776,4976560,85784,-,-
BAC120_L14,16,16p13.3,4902348,4991139,88791,-,-
BAC218_E19,16,16p13.3,4919991,5022298,102307,-,-
BAC51_I09,16,16p13.3,4952290,5059815,107525,-,-
BAC2_E13,16,16p13.3,4984378,5132094,147716,-,-
BAC190_H14,16,16p13.3,5008174,5149540,141366,-,-
BAC171_K23,16,16p13.3,5029887,5146840,116953,-,-
BAC97_G15,16,16p13.3,5029887,5115268,85381,-,-
BAC244_M04,16,16p13.3,5041121,5133529,92408,-,-
BAC243_O05,16,16p13.3,5059812,5140571,80759,-,-
BAC62_G07,16,16p13.3,5115262,5212653,97391,-,-
BAC36_C15,16,16p13.3,5136640,5269290,132650,-,-
BAC238_N05,16,16p13.3,5265317,5341784,76467,-,-
BAC75_L13,16,16p13.3,5279878,5391494,111616,-,-
BAC24_D20,16,16p13.3,5331627,5496142,164515,-,-
BAC190_A14,16,16p13.3,5341779,5464332,122553,-,-
BAC19_E20,16,16p13.3,5404995,5483022,78027,-,-
BAC14_H19,16,16p13.3,5495168,5638974,143806,-,-
BAC114_K10,16,16p13.3,5496153,5571526,75373,-,-
BAC184_G18,16,16p13.3,5506180,5607875,101695,-,-
BAC64_C21,16,16p13.3,5553601,5653852,100251,-,-
BAC234_M19,16,16p13.3,5571520,5653872,82352,-,-
BAC96_I19,16,16p13.3,5639181,5729822,90641,-,-
BAC90_K16,16,16p13.3,5693022,5815008,121986,-,-
BAC58_J20,16,16p13.3,5708189,5834133,125944,-,-
BAC31_C20,16,16p13.3,5709720,5804389,94669,-,-
BAC120_O17,16,16p13.3,5868084,5965710,97626,-,-
BAC208_M03,16,16p13.3,5912014,6025723,113709,-,-
BAC144_L17,16,16p13.3,5942171,6025849,83678,-,-
BAC59_H17,16,16p13.3,6001697,6122055,120358,-,-
BAC177_H05,16,16p13.3,6091165,6193982,102817,-,-
BAC145_J04,16,16p13.3,6114303,6212356,98053,-,-
BAC58_M10,16,16p13.3-16p13.2,6238493,6348705,110212,-,-
BAC136_F13,16,16p13.3-16p13.2,6257872,6348705,90833,-,-
BAC97_A23,16,16p13.2,6328274,6404610,76336,-,-
BAC147_C23,16,16p13.2,6398030,6472631,74601,-,-
BAC9_J02,16,16p13.2,6500092,6677573,177481,-,-
BAC100_H02,16,16p13.2,6571224,6698979,127755,-,-
BAC124_C16,16,16p13.2,6595047,6697872,102825,-,-
BAC81_M09,16,16p13.2,6773538,6900837,127299,-,-
BAC18_P05,16,16p13.2,6794091,6905354,111263,-,-
BAC31_G11,16,16p13.2,6796289,6808749,12460,-,-
BAC105_C09,16,16p13.2,6808747,6917091,108344,-,-
BAC20_H18,16,16p13.2,6830260,6909771,79511,-,-
BAC184_G08,16,16p13.2,6840283,6918279,77996,-,-
BAC49_L05,16,16p13.2,6867588,6997843,130255,-,-
BAC49_B20,16,16p13.2,6903669,7041844,138175,-,-
BAC149_M09,16,16p13.2,6910862,6991781,80919,-,-
BAC189_H15,16,16p13.2,6936606,7039028,102422,-,-
BAC146_M21,16,16p13.2,6967781,7039028,71247,-,-
BAC198_N10,16,16p13.2,7039224,7136598,97374,-,-
BAC143_M24,16,16p13.2,7072928,7165697,92769,-,-
BAC64_H03,16,16p13.2,7165692,7270250,104558,-,-
BAC18_H16,16,16p13.2,7173767,7264416,90649,-,-
BAC38_I04,16,16p13.2,7236659,7345065,108406,-,-
BAC13_J05,16,16p13.2,7368024,7452725,84701,-,-
BAC131_L21,16,16p13.2,7419530,7512251,92721,-,-
BAC139_K09,16,16p13.2,7421428,7504755,83327,-,-
BAC39_P24,16,16p13.2,7427977,7544160,116183,-,-
BAC241_J04,16,16p13.2,7482442,7568705,86263,-,-
BAC106_G10,16,16p13.2,7544829,7676976,132147,-,-
BAC218_M20,16,16p13.2,7628340,7713692,85352,-,-
BAC243_F24,16,16p13.2,7666648,7743350,76702,-,-
BAC146_N20,16,16p13.2,7769936,7854752,84816,-,-
BAC127_J12,16,16p13.2,7933459,8062442,128983,-,-
BAC103_M18,16,16p13.2,7978682,8094175,115493,-,-
BAC241_M12,16,16p13.2,7978712,8065594,86882,-,-
BAC183_P12,16,16p13.2,7981982,8084352,102370,-,-
BAC18_N09,16,16p13.2,7981982,8062427,80445,-,-
BAC240_G23,16,16p13.2,8002965,8084352,81387,-,-
BAC43_D07,16,16p13.2,8045145,8189426,144281,-,-
BAC180_A02,16,16p13.2,8086545,8196430,109885,-,-
BAC118_P17,16,16p13.2,8189427,8316260,126833,-,-
BAC96_N06,16,16p13.2,8192899,8281123,88224,-,-
BAC247_O21,16,16p13.2,8197177,8285781,88604,-,-
BAC213_H16,16,16p13.2,8332671,8430744,98073,-,-
BAC117_J22,16,16p13.2,8370429,8443650,73221,-,-
BAC110_M09,16,16p13.2,8373844,8515620,141776,-,-
BAC34_M18,16,16p13.2,8373848,8468478,94630,-,-
BAC120_P10,16,16p13.2,8373864,8522926,149062,-,-
BAC6_J11,16,16p13.2,8373864,8476645,102781,-,-
BAC224_C24,16,16p13.2,8439489,8525929,86440,-,-
BAC46_H22,16,16p13.2,8454934,8561801,106867,-,-
BAC217_D05,16,16p13.2,8476640,8563062,86422,-,-
BAC167_K24,16,16p13.2,8600692,8688346,87654,-,-
BAC193_P08,16,16p13.2,8609022,8747533,138511,-,-
BAC186_D24,16,16p13.2,8638807,8725506,86699,-,-
BAC237_M03,16,16p13.2,8638808,8761498,122690,-,-
BAC137_N21,16,16p13.2,8805074,8889850,84776,-,-
BAC158_P10,16,16p13.2,8848128,8949330,101202,-,-
BAC149_K07,16,16p13.2,8855504,8976595,121091,-,-
BAC151_E20,16,16p13.2,8860638,8967650,107012,-,-
BAC187_G07,16,16p13.2,8889873,8956778,66905,-,-
BAC57_L13,16,16p13.2,8976589,9080203,103614,-,-
BAC197_H23,16,16p13.2,8981478,9080203,98725,-,-
BAC105_D02,16,16p13.2,9011375,9094905,83530,-,-
BAC100_J16,16,16p13.2,9011620,9120049,108429,-,-
BAC34_K04,16,16p13.2,9011620,9102345,90725,-,-
BAC25_F24,16,16p13.2,9102391,9215762,113371,-,-
BAC154_F21,16,16p13.2,9128132,9215762,87630,-,-
BAC129_F22,16,16p13.2,9256959,9341717,84758,-,-
BAC206_L11,16,16p13.2,9296284,9385486,89202,-,-
BAC176_C09,16,16p13.2,9306703,9390764,84061,-,-
BAC56_F11,16,16p13.2,9433064,9546642,113578,-,-
BAC1_H01,16,16p13.2,9435826,9532411,96585,-,-
BAC1_G22,16,16p13.2,9457003,9539014,82011,-,-
BAC15_B24,16,16p13.2,9457016,9581431,124415,-,-
BAC200_P14,16,16p13.2,9471258,9546658,75400,-,-
BAC227_C19,16,16p13.2,9603314,9700944,97630,-,-
BAC65_N22,16,16p13.2,9619225,9693148,73923,-,-
BAC224_M24,16,16p13.2,9723828,9807231,83403,-,-
BAC168_B18,16,16p13.2,9784845,9866530,81685,-,-
BAC157_P21,16,16p13.2,9784858,9855053,70195,-,-
BAC129_E07,16,16p13.2,9802026,9913437,111411,-,-
BAC42_A04,16,16p13.2,9802070,9898333,96263,-,-
BAC86_G07,16,16p13.2,9914500,10009773,95273,-,-
BAC142_O09,16,16p13.2,9930139,10035543,105404,-,-
BAC95_F02,16,16p13.2,9937781,10035574,97793,-,-
BAC6_L13,16,16p13.2,9984874,10065890,81016,-,-
BAC95_O12,16,16p13.2,10090756,10168706,77950,-,-
BAC130_B16,16,16p13.2,10100625,10222643,122018,-,-
BAC25_K02,16,16p13.2,10118435,10194123,75688,-,-
BAC120_E05,16,16p13.2,10169991,10253232,83241,-,-
BAC132_K10,16,16p13.2-16p13.13,10169991,10344830,174839,-,-
BAC246_P19,16,16p13.2,10190710,10272398,81688,-,-
BAC244_M19,16,16p13.2-16p13.13,10224010,10344568,120558,-,-
BAC27_F19,16,16p13.2-16p13.13,10229444,10311808,82364,-,-
BAC193_D18,16,16p13.2-16p13.13,10236946,10311808,74862,-,-
BAC75_C20,16,16p13.2-16p13.13,10290460,10399215,108755,-,-
BAC53_C15,16,16p13.13,10454310,10567501,113191,-,-
BAC31_D12,16,16p13.13,10454330,10554070,99740,-,-
BAC65_C21,16,16p13.13,10478711,10558016,79305,-,-
BAC244_C01,16,16p13.13,10493037,10567464,74427,-,-
BAC163_G06,16,16p13.13,10499033,10594929,95896,-,-
BAC116_N18,16,16p13.13,10502614,10577964,75350,-,-
BAC26_D05,16,16p13.13,10567505,10675383,107878,-,-
BAC86_B05,16,16p13.13,10627913,10723489,95576,-,-
BAC208_D02,16,16p13.13,10641525,10747142,105617,-,-
BAC43_A08,16,16p13.13,10652418,10744401,91983,-,-
BAC57_P20,16,16p13.13,10652421,10745776,93355,-,-
BAC115_F10,16,16p13.13,10741864,10861750,119886,-,-
BAC236_B16,16,16p13.13,10761945,10843673,81728,-,-
BAC224_B02,16,16p13.13,10861744,10954837,93093,-,-
BAC228_G08,16,16p13.13,10911985,11017116,105131,-,-
BAC240_C24,16,16p13.13,10936157,11059035,122878,-,-
BAC241_B06,16,16p13.13,10936157,11020106,83949,-,-
BAC101_P11,16,16p13.13,10984904,11080302,95398,-,-
BAC109_J01,16,16p13.13,11007432,11084935,77503,-,-
BAC195_O17,16,16p13.13,11056308,11156922,100614,-,-
BAC18_K04,16,16p13.13,11057812,11209731,151919,-,-
BAC149_I21,16,16p13.13,11068624,11146216,77592,-,-
BAC144_D12,16,16p13.13,11113339,11207017,93678,-,-
BAC20_K17,16,16p13.13,11140625,11277259,136634,-,-
BAC55_M21,16,16p13.13,11277047,11385172,108125,-,-
BAC107_D11,16,16p13.13,11300188,11406297,106109,-,-
BAC59_C20,16,16p13.13,11312567,11433977,121410,-,-
BAC84_I05,16,16p13.13,11360131,11462976,102845,-,-
BAC127_L13,16,16p13.13,11385190,11553956,168766,-,-
BAC16_I22,16,16p13.13,11413226,11508838,95612,-,-
BAC23_C07,16,16p13.13,11433975,11601724,167749,-,-
BAC100_E20,16,16p13.13,11450137,11553956,103819,-,-
BAC37_J16,16,16p13.13,11455444,11583672,128228,-,-
BAC169_I22,16,16p13.13,11455458,11536377,80919,-,-
BAC36_N13,16,16p13.13,11455920,11575361,119441,-,-
BAC224_G07,16,16p13.13,11462971,11552584,89613,-,-
BAC158_J13,16,16p13.13,11470898,11553848,82950,-,-
BAC144_J14,16,16p13.13,11485722,11576060,90338,-,-
BAC147_O12,16,16p13.13,11500107,11575358,75251,-,-
BAC218_G01,16,16p13.13,11553950,11683669,129719,-,-
BAC242_M04,16,16p13.13,11553950,11682192,128242,-,-
BAC237_P18,16,16p13.13,11601718,11703376,101658,-,-
BAC68_I18,16,16p13.13,11601738,11703378,101640,-,-
BAC158_E22,16,16p13.13,11732678,11825536,92858,-,-
BAC221_P02,16,16p13.13,11761511,11847752,86241,-,-
BAC140_F10,16,16p13.13,11769416,11868902,99486,-,-
BAC105_F10,16,16p13.13,11769532,11862654,93122,-,-
BAC127_N21,16,16p13.13,11769892,11902872,132980,-,-
BAC148_L17,16,16p13.13,11769892,11859257,89365,-,-
BAC158_N11,16,16p13.13,11780251,11859259,79008,-,-
BAC219_A07,16,16p13.13,11825893,11919088,93195,-,-
BAC130_G11,16,16p13.13,11919118,12014355,95237,-,-
BAC82_I22,16,16p13.13,11920216,12053952,133736,-,-
BAC8_D15,16,16p13.13,11960800,12078222,117422,-,-
BAC113_P15,16,16p13.13,11998586,12092649,94063,-,-
BAC122_J05,16,16p13.13,12001525,12092653,91128,-,-
BAC129_G17,16,16p13.13,12036583,12129399,92816,-,-
BAC146_D23,16,16p13.13,12036583,12143587,107004,-,-
BAC82_B15,16,16p13.13,12036583,12151318,114735,-,-
BAC96_G11,16,16p13.13,12036583,12143621,107038,-,-
BAC7_O22,16,16p13.13,12078254,12176031,97777,-,-
BAC155_K20,16,16p13.13,12078255,12176031,97776,-,-
BAC173_D07,16,16p13.13,12109899,12223913,114014,-,-
BAC37_F16,16,16p13.13,12169745,12350436,180691,-,-
BAC24_M18,16,16p13.13,12174965,12342851,167886,-,-
BAC152_A04,16,16p13.13,12191791,12294220,102429,-,-
BAC231_O07,16,16p13.13,12196867,12281867,85000,-,-
BAC219_A03,16,16p13.13,12196867,12286509,89642,-,-
BAC163_M13,16,16p13.13,12205643,12281852,76209,-,-
BAC52_P05,16,16p13.13,12304330,12402091,97761,-,-
BAC104_I19,16,16p13.13,12312173,12424320,112147,-,-
BAC24_G03,16,16p13.13-16p13.12,12379076,12622961,243885,-,-
BAC68_B16,16,16p13.13,12398827,12495912,97085,-,-
BAC217_D11,16,16p13.12,12509754,12602709,92955,-,-
BAC20_K01,16,16p13.12,12529560,12636136,106576,-,-
BAC21_P15,16,16p13.12,12562985,12679325,116340,-,-
BAC96_B22,16,16p13.12,12671314,12753168,81854,-,-
BAC234_C08,16,16p13.12,12772902,12864393,91491,-,-
BAC45_A16,16,16p13.12,12783502,12864388,80886,-,-
BAC103_O04,16,16p13.12,12799491,12864393,64902,-,-
BAC71_G07,16,16p13.12,12799491,12869936,70445,-,-
BAC84_M09,16,16p13.12,12918291,13050133,131842,-,-
BAC125_H03,16,16p13.12,12931244,13050154,118910,-,-
BAC48_I14,16,16p13.12,12954679,13108324,153645,-,-
BAC61_J17,16,16p13.12,12972846,13067335,94489,-,-
BAC62_O05,16,16p13.12,12978409,13097548,119139,-,-
BAC156_E05,16,16p13.12,12995418,13067301,71883,-,-
BAC59_A06,16,16p13.12,12995425,13086101,90676,-,-
BAC158_K18,16,16p13.12,13136321,13220874,84553,-,-
BAC226_I16,16,16p13.12,13167246,13251640,84394,-,-
BAC113_O18,16,16p13.12,13220868,13324675,103807,-,-
BAC190_A02,16,16p13.12,13227898,13303747,75849,-,-
BAC196_O02,16,16p13.12,13270531,13385989,115458,-,-
BAC228_B02,16,16p13.12,13324783,13413167,88384,-,-
BAC97_C21,16,16p13.12,13369407,13465245,95838,-,-
BAC168_J11,16,16p13.12,13375538,13475695,100157,-,-
BAC218_A12,16,16p13.12,13477532,13588197,110665,-,-
BAC25_O08,16,16p13.12,13498515,13646945,148430,-,-
BAC241_F18,16,16p13.12,13501612,13583632,82020,-,-
BAC153_H02,16,16p13.12,13541862,13638865,97003,-,-
BAC143_P05,16,16p13.12,13559661,13670959,111298,-,-
BAC27_P22,16,16p13.12,13580404,13752067,171663,-,-
BAC238_A16,16,16p13.12,13599005,13686886,87881,-,-
BAC39_B08,16,16p13.12,13737047,13837810,100763,-,-
BAC140_L11,16,16p13.12,13956238,14021652,65414,-,-
BAC40_P22,16,16p13.12,13984779,14155722,170943,-,-
BAC37_M06,16,16p13.12,13985989,14091713,105724,-,-
BAC194_G19,16,16p13.12,14021002,14111533,90531,-,-
BAC181_M12,16,16p13.12,14021808,14112694,90886,-,-
BAC234_M22,16,16p13.12,14064105,14155730,91625,-,-
BAC110_N14,16,16p13.12,14085605,14186499,100894,-,-
BAC22_H09,16,16p13.12,14089002,14191126,102124,-,-
BAC5_I03,16,16p13.12,14186240,14279821,93581,-,-
BAC86_L07,16,16p13.12,14241177,14341282,100105,-,-
BAC147_K16,16,16p13.12,14279814,14361612,81798,-,-
BAC151_G04,16,16p13.12,14296746,14404313,107567,-,-
BAC194_I03,16,16p13.12,14339161,14437551,98390,-,-
BAC189_A03,16,16p13.12,14404348,14516616,112268,-,-
BAC187_F16,16,16p13.12,14410226,14492035,81809,-,-
BAC176_H03,16,16p13.12,14411321,14486890,75569,-,-
BAC169_F16,16,16p13.12,14437557,14516616,79059,-,-
BAC61_I24,16,16p13.12,14487066,14676854,189788,-,-
BAC127_B13,16,16p13.12,14573558,14663419,89861,-,-
BAC79_H07,16,16p13.12,14573571,14690301,116730,-,-
BAC223_N07,16,16p13.11,14768534,16347579,1579045,-,-
BAC171_I11,16,16p13.11,14776250,14875913,99663,-,-
BAC69_I23,16,16p13.11,14777582,14897721,120139,-,-
BAC197_H03,16,16p13.11,14785063,14875914,90851,-,-
BAC219_A17,16,16p13.11,14795471,14888127,92656,-,-
BAC82_I14,16,16p13.11,14815716,14907874,92158,-,-
BAC66_P05,16,16p13.11,14859150,14957254,98104,yes,-
BAC152_G18,16,16p13.11,14873295,14958745,85450,yes,-
BAC237_D06,16,16p13.11,14876136,14958679,82543,yes,-
BAC193_O01,16,16p13.11,14876136,14957254,81118,yes,-
BAC148_P05,16,16p13.11,14907997,16402341,1494344,-,-
BAC62_L12,16,16p13.11,14950009,15038432,88423,-,-
BAC39_H24,16,16p13.11,14955141,15038693,83552,-,-
BAC190_B14,16,16p13.11,15104161,15196523,92362,-,-
BAC168_L09,16,16p13.11,15221348,15317643,96295,-,-
BAC176_D20,16,16p13.11,15221348,15317611,96263,-,-
BAC37_P06,16,16p13.11,15253734,15352636,98902,-,-
BAC143_N19,16,16p13.11,15297887,15390653,92766,-,-
BAC247_E06,16,16p13.11,15390737,15510186,119449,-,-
BAC237_L06,16,16p13.11,15416738,15489585,72847,-,-
BAC223_I15,16,16p13.11,15458735,15559778,101043,-,-
BAC125_F23,16,16p13.11,15508556,15606106,97550,-,-
BAC109_C05,16,16p13.11,15520467,15598396,77929,-,-
BAC44_B18,16,16p13.11,15524211,15635497,111286,-,-
BAC78_J14,16,16p13.11,15561463,15715151,153688,-,-
BAC52_B22,16,16p13.11,15578324,15688186,109862,-,-
BAC33_G22,16,16p13.11,15601806,15693903,92097,-,-
BAC166_N02,16,16p13.11,15660223,15754379,94156,-,-
BAC197_M23,16,16p13.11,15660228,15785671,125443,-,-
BAC219_F11,16,16p13.11,15672875,15772338,99463,-,-
BAC33_G18,16,16p13.11,15688259,15846553,158294,-,-
BAC125_C13,16,16p13.11,15707571,15805285,97714,-,-
BAC235_O01,16,16p13.11,15715141,15846553,131412,-,-
BAC70_H07,16,16p13.11,15715141,15834086,118945,-,-
BAC162_B01,16,16p13.11,15716158,15846553,130395,-,-
BAC162_J06,16,16p13.11,15785757,15904252,118495,-,-
BAC56_A14,16,16p13.11,15846674,15978749,132075,-,-
BAC220_F11,16,16p13.11,15860684,15960047,99363,-,-
BAC42_E04,16,16p13.11,15880900,15978749,97849,-,-
BAC50_P16,16,16p13.11,15895478,15983700,88222,-,-
BAC91_C03,16,16p13.11,15895478,16001840,106362,-,-
BAC123_A12,16,16p13.11,15978904,16110530,131626,-,-
BAC133_H20,16,16p13.11,15978911,16105554,126643,-,-
BAC8_J03,16,16p13.11,15978921,16121770,142849,-,-
BAC218_L10,16,16p13.11,15995801,16112669,116868,-,-
BAC16_M13,16,16p13.11,16015366,16141638,126272,-,-
BAC58_G10,16,16p13.11,16032685,16110530,77845,-,-
BAC190_F22,16,16p13.11,16032685,16141638,108953,-,-
BAC61_K08,16,16p13.11,16032700,16157699,124999,-,-
BAC149_E01,16,16p13.11,16061376,16164034,102658,-,-
BAC233_F16,16,16p13.11,16095407,16174020,78613,-,-
BAC41_K07,16,16p13.11,16121762,16258578,136816,-,-
BAC204_A17,16,16p13.11,16165411,16274624,109213,-,-
BAC27_D04,16,16p13.11,16177909,16274561,96652,-,-
BAC232_M02,16,16p13.11,16177979,16274790,96811,-,-
BAC42_F14,16,16p13.11,16193297,16390942,197645,yes,-
BAC90_C13,16,16p13.11,16193385,16286771,93386,-,-
BAC214_N17,16,16p13.11,16210980,16294833,83853,-,-
BAC113_F15,16,16p13.11,16210980,16294807,83827,-,-
BAC39_H19,16,16p13.11,16256803,16391842,135039,yes,-
BAC233_I13,16,16p13.11,16274904,16353461,78557,yes,-
BAC169_L10,16,16p13.11,16410356,16495476,85120,-,-
BAC218_L05,16,16p13.11,16442504,16553079,110575,-,-
BAC75_A10,16,16p13.11,16564458,16662154,97696,-,-
BAC143_F20,16,16p13.11,16579354,16664176,84822,-,-
BAC149_L14,16,16p13.11,16592109,16672036,79927,-,-
BAC79_M12,16,16p13.11-16p12.3,16684060,16795508,111448,-,-
BAC246_N02,16,16p12.3,16751417,16876474,125057,-,-
BAC127_B03,16,16p12.3,16756762,16871004,114242,-,-
BAC119_D22,16,16p12.3,16798847,16936926,138079,-,-
BAC234_H23,16,16p12.3,16899507,16986954,87447,-,-
BAC227_J08,16,16p12.3,16913002,16986248,73246,-,-
BAC242_P20,16,16p12.3,17111295,17198777,87482,-,-
BAC92_A04,16,16p12.3,17123045,17231698,108653,-,-
BAC125_J16,16,16p12.3,17164424,17352107,187683,-,-
BAC72_P18,16,16p12.3,17164455,17259065,94610,-,-
BAC14_M15,16,16p12.3,17168554,17259065,90511,-,-
BAC192_M09,16,16p12.3,17190567,17280202,89635,-,-
BAC133_C17,16,16p12.3,17198803,17280186,81383,-,-
BAC48_F06,16,16p12.3,17212679,17324296,111617,-,-
BAC31_G15,16,16p12.3,17219938,17316204,96266,-,-
BAC29_F15,16,16p12.3,17245092,17356085,110993,-,-
BAC125_I16,16,16p12.3,17259059,17365688,106629,-,-
BAC75_O16,16,16p12.3,17277783,17377741,99958,-,-
BAC165_M13,16,16p12.3,17286587,17356085,69498,-,-
BAC152_C14,16,16p12.3,17289311,17378895,89584,-,-
BAC96_J19,16,16p12.3,17301008,17430114,129106,-,-
BAC128_G21,16,16p12.3,17301019,17411603,110584,-,-
BAC81_B20,16,16p12.3,17435282,17657858,222576,-,-
BAC230_N23,16,16p12.3,17463656,17558094,94438,-,-
BAC129_G09,16,16p12.3,17474358,17585807,111449,-,-
BAC90_E20,16,16p12.3,17479309,17600006,120697,-,-
BAC145_H09,16,16p12.3,17479309,17588741,109432,-,-
BAC46_K07,16,16p12.3,17484143,17611496,127353,-,-
BAC171_H05,16,16p12.3,17484689,17588741,104052,-,-
BAC187_D17,16,16p12.3,17540399,17614249,73850,-,-
BAC60_A07,16,16p12.3,17558892,17663273,104381,-,-
BAC78_M15,16,16p12.3,17588776,17669826,81050,-,-
BAC165_P09,16,16p12.3,17606708,17711096,104388,-,-
BAC106_O24,16,16p12.3,17687699,17790973,103274,-,-
BAC72_A07,16,16p12.3,17711089,17814696,103607,-,-
BAC44_C02,16,16p12.3,17723431,17868138,144707,-,-
BAC181_C03,16,16p12.3,17849038,17948096,99058,-,-
BAC53_N01,16,16p12.3,17911541,17999346,87805,-,-
BAC55_O24,16,16p12.3,18172082,18274450,102368,-,-
BAC168_M18,16,16p12.3,18443225,18522317,79092,-,-
BAC37_L05,16,16p12.3,18617203,18706854,89651,-,-
BAC238_P20,16,16p12.3,18809987,18892060,82073,-,-
BAC243_C07,16,16p12.3,18863410,18977203,113793,-,-
BAC124_B14,16,16p12.3,18871244,18980937,109693,-,-
BAC240_E23,16,16p12.3,18871767,18977203,105436,-,-
BAC117_A13,16,16p12.3,18875340,18992893,117553,-,-
BAC247_J19,16,16p12.3,18892419,18992787,100368,-,-
BAC185_N11,16,16p12.3,18926920,19031251,104331,-,-
BAC60_K24,16,16p12.3,18940003,19035022,95019,-,-
BAC227_D18,16,16p12.3,18942628,19036878,94250,-,-
BAC151_M23,16,16p12.3,18992886,19135834,142948,-,-
BAC158_D01,16,16p12.3,19035298,19121714,86416,-,-
BAC42_L09,16,16p12.3,19038923,19158849,119926,-,-
BAC160_K06,16,16p12.3,19093086,19181292,88206,-,-
BAC12_M17,16,16p12.3,19130462,19254415,123953,-,-
BAC195_B19,16,16p12.3,19136891,19244412,107521,-,-
BAC38_J06,16,16p12.3,19316443,19410138,93695,-,-
BAC244_M14,16,16p12.3,19322869,19410134,87265,-,-
BAC40_I04,16,16p12.3,19340589,19424980,84391,-,-
BAC192_P07,16,16p12.3,19347272,19429214,81942,-,-
BAC42_N07,16,16p12.3,19347272,19445273,98001,-,-
BAC51_A24,16,16p12.3,19350791,19436560,85769,-,-
BAC199_H15,16,16p12.3,19350791,19445316,94525,-,-
BAC231_A09,16,16p12.3,19429209,19510586,81377,-,-
BAC20_J09,16,16p12.3,19436728,19613275,176547,-,-
BAC162_I10,16,16p12.3,19438298,19520633,82335,-,-
BAC186_H09,16,16p12.3,19488914,19604653,115739,-,-
BAC170_G24,16,16p12.3,19510639,19642158,131519,-,-
BAC34_L06,16,16p12.3,19523472,19614135,90663,-,-
BAC27_G20,16,16p12.3,19530784,19642158,111374,-,-
BAC1_M06,16,16p12.3,19591810,19709051,117241,-,-
BAC139_G01,16,16p12.3,19682572,19775531,92959,-,-
BAC170_F16,16,16p12.3,19689465,19775531,86066,-,-
BAC157_B21,16,16p12.3,19701523,19801711,100188,-,-
BAC233_J12,16,16p12.3,19709188,19810966,101778,-,-
BAC192_I07,16,16p12.3,19711117,19810966,99849,-,-
BAC165_K16,16,16p12.3,19734610,19830237,95627,-,-
BAC27_C22,16,16p12.3,19749584,19877790,128206,-,-
BAC246_H18,16,16p12.3,19782003,19865825,83822,-,-
BAC236_L03,16,16p12.3,19810961,19937854,126893,-,-
BAC31_A08,16,16p12.3,19831537,19921612,90075,-,-
BAC33_F19,16,16p12.3,19932442,20053416,120974,-,-
BAC69_J09,16,16p12.3,19938120,20031698,93578,-,-
BAC240_D08,16,16p12.3,19944274,20018120,73846,-,-
BAC196_F02,16,16p12.3,19944275,20061751,117476,-,-
BAC83_B04,16,16p12.3,19957611,20061751,104140,-,-
BAC50_I24,16,16p12.3,19974660,20066505,91845,-,-
BAC60_A02,16,16p12.3,20018262,20119787,101525,-,-
BAC165_F15,16,16p12.3,20031692,20159634,127942,-,-
BAC142_M18,16,16p12.3,20034759,20137028,102269,-,-
BAC60_K09,16,16p12.3,20061744,20137028,75284,-,-
BAC244_L06,16,16p12.3,20061746,20151077,89331,-,-
BAC232_B10,16,16p12.3,20066502,20153375,86873,-,-
BAC150_D18,16,16p12.3,20119782,20238843,119061,-,-
BAC168_F23,16,16p12.3,20326115,20406564,80449,-,-
BAC247_F05,16,16p12.3,20333878,20436291,102413,-,-
BAC151_E03,16,16p12.3-16p12.2,20439203,20524628,85425,-,-
BAC167_N14,16,16p12.2,20505925,20611304,105379,-,-
BAC79_H23,16,16p12.2,20536662,20676811,140149,-,-
BAC84_O03,16,16p12.2,20640872,20739878,99006,-,-
BAC23_M08,16,16p12.2,20682677,20785442,102765,-,-
BAC188_D05,16,16p12.2,20703819,20800287,96468,-,-
BAC179_C17,16,16p12.2,20705895,20790831,84936,-,-
BAC89_I02,16,16p12.2,20745066,20860316,115250,-,-
BAC117_E06,16,16p12.2,20758208,20860331,102123,-,-
BAC53_D21,16,16p12.2,20790823,20907902,117079,-,-
BAC57_C14,16,16p12.2,20813600,20913841,100241,-,-
BAC78_K14,16,16p12.2,20825848,20958575,132727,-,-
BAC189_E17,16,16p12.2,20827588,20913820,86232,-,-
BAC151_J21,16,16p12.2,20856832,20958575,101743,-,-
BAC148_A24,16,16p12.2,20860325,20958575,98250,-,-
BAC46_M07,16,16p12.2,20918213,21050131,131918,-,-
BAC52_K22,16,16p12.2,20953965,21090432,136467,-,-
BAC132_C04,16,16p12.2,20963865,21051412,87547,-,-
BAC78_H09,16,16p12.2,20963865,21090432,126567,-,-
BAC230_B24,16,16p12.2,20963904,21053898,89994,-,-
BAC34_G09,16,16p12.2,20978785,21149696,170911,-,-
BAC197_F06,16,16p12.2,20981394,21083453,102059,-,-
BAC108_C04,16,16p12.2,21113990,21191997,78007,-,-
BAC42_L16,16,16p12.2,21172167,21291254,119087,-,-
BAC45_G15,16,16p12.2,21225281,21345660,120379,-,-
BAC80_B15,16,16p12.2,21228529,21332548,104019,-,-
BAC146_H17,16,16p12.2,21252630,21370213,117583,-,-
BAC89_P17,16,16p12.2,21260987,21354780,93793,-,-
BAC166_L22,16,16p12.2,21308816,21440097,131281,-,-
BAC176_O10,16,16p12.2,21365989,21485549,119560,-,-
BAC117_N02,16,16p12.2,21369845,21459430,89585,-,-
BAC123_K21,16,16p12.2-16p12.1,21375065,21980469,605404,-,-
BAC162_F01,16,16p12.2,21389950,21515587,125637,-,-
BAC39_M10,16,16p12.2,21426360,21527585,101225,-,-
BAC51_A20,16,16p12.2,21426370,21515492,89122,-,-
BAC127_D15,16,16p12.2,21426372,21515586,89214,-,-
BAC12_J24,16,16p12.2,21583009,21686216,103207,yes,-
BAC146_C10,16,16p12.2,21583022,21686277,103255,-,-
BAC175_G23,16,16p12.2-16p12.1,21625128,21743688,118560,-,-
BAC221_B03,16,16p12.2-16p12.1,21676457,21751659,75202,-,-
BAC39_G07,16,16p12.2-16p12.1,21688647,21802454,113807,-,-
BAC21_M21,16,16p12.2-16p12.1,21689986,21805033,115047,-,-
BAC12_L17,16,16p12.2-16p12.1,21689992,21878254,188262,-,-
BAC103_D06,16,16p12.2-16p12.1,21692577,22638289,945712,-,-
BAC247_B17,16,16p12.2-16p12.1,21692579,22581759,889180,-,-
BAC161_O19,16,16p12.1,21786016,21875422,89406,-,-
BAC34_D18,16,16p12.1,21786020,21877141,91121,-,-
BAC155_H11,16,16p12.1,21857957,21934474,76517,yes,-
BAC135_A12,16,16p12.1,22005115,22091566,86451,yes,-
BAC157_H14,16,16p12.1,22006005,22107403,101398,yes,-
BAC48_K05,16,16p12.1,22035872,22107399,71527,-,-
BAC142_G13,16,16p12.1,22062378,22158923,96545,-,-
BAC172_D07,16,16p12.1,22074459,22158923,84464,-,-
BAC161_M02,16,16p12.1,22091570,22203934,112364,-,-
BAC149_A14,16,16p12.1,22172499,22270733,98234,yes,-
BAC214_D12,16,16p12.1,22469638,22554818,85180,-,-
BAC25_A22,16,16p12.1,22469638,22591832,122194,-,-
BAC251_O08,16,16p12.1,22494451,22629807,135356,-,-
BAC68_B12,16,16p12.1,22502966,22583963,80997,-,-
BAC189_G23,16,16p12.1,22550235,22630517,80282,-,-
BAC105_G13,16,16p12.1,22554928,22655564,100636,-,-
BAC123_A14,16,16p12.1,22574299,22674924,100625,-,-
BAC58_D14,16,16p12.1,22583972,22729101,145129,-,-
BAC178_C08,16,16p12.1,22585105,22674916,89811,-,-
BAC250_E10,16,16p12.1,22591832,22671122,79290,-,-
BAC165_C17,16,16p12.1,22697877,22786592,88715,-,-
BAC103_J01,16,16p12.1,22751262,22866603,115341,-,-
BAC153_J13,16,16p12.1,22765268,22864490,99222,-,-
BAC249_O08,16,16p12.1,22806690,22941399,134709,-,-
BAC88_A02,16,16p12.1,22826179,22941398,115219,-,-
BAC72_I11,16,16p12.1,22852714,22941395,88681,-,-
BAC120_K24,16,16p12.1,22880407,23000700,120293,-,-
BAC219_L09,16,16p12.1,22897738,22987444,89706,-,-
BAC221_B04,16,16p12.1,22943527,23032926,89399,-,-
BAC15_C15,16,16p12.1,23011105,23103508,92403,-,-
BAC173_E05,16,16p12.1,23057339,23140951,83612,-,-
BAC136_L13,16,16p12.1,23138206,23244708,106502,-,-
BAC100_K06,16,16p12.1,23162973,23248488,85515,-,-
BAC137_F08,16,16p12.1,23180993,23287077,106084,-,-
BAC68_D10,16,16p12.1,23214877,23303835,88958,-,-
BAC232_E15,16,16p12.1,23214877,23308673,93796,-,-
BAC183_G20,16,16p12.1,23314251,23391796,77545,-,-
BAC191_F16,16,16p12.1,23327957,23427519,99562,-,-
BAC244_L22,16,16p12.1,23387793,23463128,75335,-,-
BAC51_O20,16,16p12.1,23391960,23610035,218075,-,-
BAC142_N05,16,16p12.1,23437398,23535639,98241,-,-
BAC181_H11,16,16p12.1,23449418,23535633,86215,-,-
BAC201_E12,16,16p12.1,23463525,23532841,69316,-,-
BAC96_K01,16,16p12.1,23601528,23722424,120896,-,-
BAC239_I10,16,16p12.1,23601539,23698873,97334,-,-
BAC161_H15,16,16p12.1,23628383,23726986,98603,-,-
BAC126_J05,16,16p12.1,23708190,23799388,91198,-,-
BAC39_G24,16,16p12.1,23803018,23894049,91031,-,-
BAC119_J12,16,16p12.1,23920619,24056953,136334,-,-
BAC62_C07,16,16p12.1,23968749,24056920,88171,-,-
BAC192_D07,16,16p12.1,23979799,24066912,87113,-,-
BAC167_H09,16,16p12.1,24057144,24143578,86434,-,-
BAC39_N14,16,16p12.1,24062677,24168389,105712,-,-
BAC84_G09,16,16p12.1,24083261,24165409,82148,-,-
BAC232_B19,16,16p12.1,24089623,24188008,98385,-,-
BAC246_D22,16,16p12.1,24176868,24321179,144311,-,-
BAC198_C05,16,16p12.1,24176868,24271096,94228,-,-
BAC185_E20,16,16p12.1,24176868,24244889,68021,-,-
BAC57_L04,16,16p12.1,24278800,24397270,118470,-,-
BAC148_H18,16,16p12.1,24306487,24414306,107819,-,-
BAC181_H18,16,16p12.1,24336309,24414306,77997,-,-
BAC154_F20,16,16p12.1,24343200,24414306,71106,-,-
BAC250_P03,16,16p12.1,24343202,24442686,99484,-,-
BAC181_K21,16,16p12.1,24354262,24433918,79656,-,-
BAC117_B09,16,16p12.1,24358372,24482664,124292,-,-
BAC108_P04,16,16p12.1,24358376,24450287,91911,-,-
BAC176_H14,16,16p12.1,24371046,24442686,71640,-,-
BAC33_H19,16,16p12.1,24427715,24589508,161793,-,-
BAC37_L10,16,16p12.1,24499110,24579267,80157,-,-
BAC199_F21,16,16p12.1,24505233,24606607,101374,-,-
BAC157_C15,16,16p12.1,24723981,24768055,44074,-,-
BAC155_C20,16,16p12.1,24765401,24846244,80843,-,-
BAC200_E18,16,16p12.1,24918653,25013351,94698,-,-
BAC18_B11,16,16p12.1,24971410,25082986,111576,-,-
BAC24_F06,16,16p12.1,24987009,25105204,118195,-,-
BAC15_O13,16,16p12.1,25028495,25083000,54505,-,-
BAC59_O01,16,16p12.1,25065174,25185111,119937,-,-
BAC60_I07,16,16p12.1,25067951,25191959,124008,-,-
BAC195_L13,16,16p12.1,25068077,25144683,76606,-,-
BAC243_D14,16,16p12.1,25096092,25223776,127684,-,-
BAC223_M17,16,16p12.1,25111105,25191607,80502,-,-
BAC41_L23,16,16p12.1,25144673,25352103,207430,-,-
BAC56_H04,16,16p12.1,25144677,25242445,97768,-,-
BAC75_H24,16,16p12.1,25197355,25292133,94778,-,-
BAC234_I02,16,16p12.1,25474282,25583297,109015,-,-
BAC35_F09,16,16p12.1,25474337,25562440,88103,-,-
BAC151_M07,16,16p12.1,25562594,25664219,101625,-,-
BAC233_E07,16,16p12.1,25593869,25717333,123464,-,-
BAC89_G16,16,16p12.1,25686893,25779268,92375,-,-
BAC54_O06,16,16p12.1,25703744,25803895,100151,-,-
BAC102_P17,16,16p12.1,25803893,25902365,98472,-,-
BAC96_E10,16,16p12.1,25838764,26011915,173151,-,-
BAC10_I15,16,16p12.1,25887656,25979034,91378,-,-
BAC55_I18,16,16p12.1,25908108,26017555,109447,-,-
BAC45_N17,16,16p12.1,26167755,26269391,101636,-,-
BAC112_O06,16,16p12.1,26187859,26324205,136346,-,-
BAC80_J05,16,16p12.1,26204652,26329709,125057,-,-
BAC240_O24,16,16p12.1,26239746,26338541,98795,-,-
BAC155_J22,16,16p12.1,26243429,26324609,81180,-,-
BAC53_D05,16,16p12.1,26492376,26589780,97404,-,-
BAC1_E14,16,16p12.1,26617810,26734384,116574,-,-
BAC60_G23,16,16p12.1,26643987,26740987,97000,-,-
BAC223_O06,16,16p12.1,26664660,26783338,118678,-,-
BAC235_H09,16,16p12.1,26668748,26775185,106437,-,-
BAC198_G02,16,16p12.1,26681102,26765508,84406,-,-
BAC196_B14,16,16p12.1,26708198,26793940,85742,-,-
BAC133_P06,16,16p12.1,26734392,26834652,100260,-,-
BAC31_A23,16,16p12.1,26777925,26868454,90529,-,-
BAC200_O05,16,16p12.1,26790085,26884677,94592,-,-
BAC33_P20,16,16p12.1,26849785,26963501,113716,-,-
BAC200_C07,16,16p12.1,26858963,26959940,100977,-,-
BAC190_B18,16,16p12.1,26865627,26969869,104242,-,-
BAC192_M16,16,16p12.1,26868531,26963499,94968,-,-
BAC140_E21,16,16p12.1,26881799,26974590,92791,-,-
BAC153_B05,16,16p12.1,26907483,27021837,114354,-,-
BAC175_B04,16,16p12.1,26959961,27039759,79798,-,-
BAC2_G21,16,16p12.1,26969951,27065322,95371,-,-
BAC186_D10,16,16p12.1,26974194,27086148,111954,-,-
BAC226_B15,16,16p12.1,26974584,27065318,90734,-,-
BAC120_I08,16,16p12.1,26974606,27065322,90716,-,-
BAC242_F02,16,16p12.1,27037215,27136636,99421,-,-
BAC219_G09,16,16p12.1,27049762,27190992,141230,-,-
BAC81_K14,16,16p12.1,27065313,27207311,141998,-,-
BAC64_C06,16,16p12.1,27081660,27172551,90891,-,-
BAC117_K11,16,16p12.1,27086155,27193015,106860,-,-
BAC66_L17,16,16p12.1,27136644,27260170,123526,-,-
BAC21_I01,16,16p12.1,27185175,27304613,119438,-,-
BAC117_N07,16,16p12.1,27190987,27304727,113740,-,-
BAC26_H01,16,16p12.1,27193010,27340760,147750,-,-
BAC116_E09,16,16p12.1,27207739,27322550,114811,-,-
BAC65_M01,16,16p12.1,27227963,27350049,122086,-,-
BAC220_F15,16,16p12.1,27320205,27409470,89265,yes,-
BAC123_A02,16,16p12.1,27361887,27465289,103402,-,-
BAC78_C03,16,16p12.1,27487027,27586525,99498,-,-
BAC217_I24,16,16p12.1,27503020,27586525,83505,-,-
BAC236_M18,16,16p12.1-16p11.2,27554826,27639232,84406,-,-
BAC137_F10,16,16p12.1-16p11.2,27559566,27677727,118161,-,-
BAC116_J18,16,16p12.1-16p11.2,27587899,27699105,111206,-,-
BAC236_F02,16,16p11.2,27617909,27699105,81196,-,-
BAC33_L03,16,16p11.2,27622463,27728984,106521,-,-
BAC41_L03,16,16p11.2,27622728,27728987,106259,-,-
BAC100_K18,16,16p11.2,27622728,27758159,135431,-,-
BAC67_J10,16,16p11.2,27639488,27728992,89504,-,-
BAC2_F05,16,16p11.2,27639674,27728994,89320,-,-
BAC225_N08,16,16p11.2,27643256,27717703,74447,-,-
BAC159_O11,16,16p11.2,27655823,27759773,103950,-,-
BAC76_B19,16,16p11.2,27655823,27750774,94951,-,-
BAC177_P23,16,16p11.2,27677745,27824753,147008,-,-
BAC171_P05,16,16p11.2,27699128,27803606,104478,-,-
BAC83_G04,16,16p11.2,27729885,27835880,105995,-,-
BAC150_N18,16,16p11.2,27734195,27835676,101481,-,-
BAC100_E04,16,16p11.2,27736820,27835676,98856,-,-
BAC171_G16,16,16p11.2,27793443,27870801,77358,-,-
BAC189_D21,16,16p11.2,27821363,27900284,78921,-,-
BAC220_M22,16,16p11.2,27824971,27948912,123941,-,-
BAC151_F10,16,16p11.2,27919499,28047344,127845,-,-
BAC196_M22,16,16p11.2,27945104,28062823,117719,-,-
BAC186_N08,16,16p11.2,27949131,28035118,85987,-,-
BAC175_N15,16,16p11.2,27949131,28033807,84676,-,-
BAC247_C01,16,16p11.2,27949132,28070552,121420,-,-
BAC127_K04,16,16p11.2,28164474,28264983,100509,-,-
BAC188_N23,16,16p11.2,28164474,28249121,84647,-,-
BAC109_O14,16,16p11.2,28181714,28291485,109771,-,-
BAC238_I24,16,16p11.2,28218442,28285976,67534,-,-
BAC59_L05,16,16p11.2,28219471,28319079,99608,-,-
BAC244_G01,16,16p11.2,28259797,28355024,95227,yes,-
BAC224_E12,16,16p11.2,28312228,28439708,127480,-,-
BAC244_O05,16,16p11.2,28319073,28422443,103370,-,-
BAC72_I18,16,16p11.2,28330689,28439420,108731,-,-
BAC240_N12,16,16p11.2,28378816,28515980,137164,-,-
BAC231_O11,16,16p11.2,28663564,28764947,101383,-,-
BAC218_E17,16,16p11.2,28823303,28933808,110505,-,-
BAC226_O07,16,16p11.2,28889172,28967001,77829,-,-
BAC119_D10,16,16p11.2,28933801,29072004,138203,-,-
BAC160_M02,16,16p11.2,29054613,29245983,191370,-,-
BAC136_I18,16,16p11.2,29054613,29136975,82362,-,-
BAC157_L20,16,16p11.2,29092123,29172742,80619,-,-
BAC191_K22,16,16p11.2,29123085,29221225,98140,-,-
BAC142_H21,16,16p11.2,29123085,29210798,87713,-,-
BAC124_O10,16,16p11.2,29134618,29257214,122596,-,-
BAC40_K06,16,16p11.2,29134618,29236573,101955,-,-
BAC49_D04,16,16p11.2,29153833,29258307,104474,-,-
BAC116_F11,16,16p11.2,29206350,29324359,118009,-,-
BAC2_A09,16,16p11.2,29229835,29333464,103629,-,-
BAC157_D16,16,16p11.2,29245724,29332424,86700,-,-
BAC223_N14,16,16p11.2,29260780,29324356,63576,-,-
BAC221_F24,16,16p11.2,29260780,29355241,94461,-,-
BAC153_N07,16,16p11.2,29352963,29545454,192491,yes,-
BAC57_G06,16,16p11.2,29378586,30196858,818272,-,-
BAC239_P06,16,16p11.2,29450686,29533362,82676,-,-
BAC57_L18,16,16p11.2,29471385,30307138,835753,-,-
BAC78_L07,16,16p11.2,29471398,30323116,851718,-,-
BAC116_I19,16,16p11.2,29553190,29692717,139527,yes,-
BAC194_J05,16,16p11.2,29638447,29720925,82478,-,-
BAC123_H11,16,16p11.2,29720692,29817545,96853,yes,-
BAC68_M20,16,16p11.2,29832493,29997997,165504,yes,-
BAC78_N13,16,16p11.2,29852954,29973097,120143,yes,-
BAC145_J01,16,16p11.2,29859713,29970765,111052,yes,-
BAC88_G03,16,16p11.2,29915735,30021975,106240,yes,-
BAC157_J05,16,16p11.2,29985330,30090916,105586,-,-
BAC146_N14,16,16p11.2,29995581,30090916,95335,yes,-
BAC145_N10,16,16p11.2,30196986,30285324,88338,-,-
BAC237_N13,16,16p11.2,30315534,30397459,81925,-,-
BAC83_P16,16,16p11.2,30370905,30506373,135468,-,-
BAC149_I08,16,16p11.2,30397539,30549383,151844,-,-
BAC32_C05,16,16p11.2,30414706,30545456,130750,-,-
BAC176_J01,16,16p11.2,30506566,30604710,98144,-,-
BAC31_I03,16,16p11.2,30506566,30586160,79594,-,-
BAC180_D06,16,16p11.2,30536445,30648506,112061,-,-
BAC39_A07,16,16p11.2,30549408,30660366,110958,-,-
BAC55_C19,16,16p11.2,30678843,30777734,98891,-,-
BAC170_M08,16,16p11.2,30712013,30795638,83625,-,-
BAC130_F10,16,16p11.2,30736409,30823824,87415,-,-
BAC152_I10,16,16p11.2,30866076,30955557,89481,-,-
BAC131_B03,16,16p11.2,30866076,30993215,127139,-,-
BAC146_H02,16,16p11.2,30883016,30990632,107616,-,-
BAC2_F03,16,16p11.2,30963652,31066356,102704,-,-
BAC246_C01,16,16p11.2,30969065,31105592,136527,-,-
BAC208_F16,16,16p11.2,30993409,31090260,96851,-,-
BAC190_C17,16,16p11.2,30994887,31075801,80914,-,-
BAC234_C05,16,16p11.2,31090269,31177105,86836,-,-
BAC96_P23,16,16p11.2,31090270,31177103,86833,-,-
BAC72_A19,16,16p11.2,31115220,31202238,87018,-,-
BAC62_O17,16,16p11.2,31115221,31199904,84683,-,-
BAC188_P13,16,16p11.2,31302490,31384619,82129,-,-
BAC236_I24,16,16p11.2,31373953,31458152,84199,-,-
BAC239_E05,16,16p11.2,31449506,31567007,117501,-,-
BAC90_C10,16,16p11.2,31466922,31587289,120367,-,-
BAC42_G09,16,16p11.2,31508435,31614435,106000,-,-
BAC102_J20,16,16p11.2,31510095,31596649,86554,-,-
BAC65_J07,16,16p11.2,31510782,31614402,103620,-,-
BAC82_J03,16,16p11.2,31551057,31659086,108029,-,-
BAC49_K20,16,16p11.2,31659180,31772848,113668,yes,-
BAC191_C16,16,16p11.2,31689988,31771948,81960,yes,-
BAC238_E18,16,16p11.2,31723498,31804886,81388,yes,-
BAC234_K10,16,16p11.2,31773339,31858265,84926,-,-
BAC69_C08,16,16p11.2,31787303,31872620,85317,-,-
BAC240_M03,16,16p11.2,31843385,31921170,77785,-,-
BAC45_K05,16,16p11.2,31882027,31953874,71847,-,-
BAC85_J01,16,16p11.2,31896382,32922559,1026177,-,-
BAC106_H18,16,16p11.2,31921163,32022318,101155,-,-
BAC114_K07,16,16p11.2,32011261,32743206,731945,-,-
BAC144_P23,16,16p11.2,32022312,32124885,102573,-,-
BAC160_K22,16,16p11.2,32078893,32158026,79133,-,-
BAC36_L08,16,16p11.2,32088380,32172022,83642,-,-
BAC193_M09,16,16p11.2,32092176,32172027,79851,-,-
BAC167_A10,16,16p11.2,32186314,32275540,89226,-,-
BAC103_F03,16,16p11.2,32197842,32275521,77679,-,-
BAC147_L11,16,16p11.2,32242385,32332962,90577,-,-
BAC119_F14,16,16p11.2,32275533,32390999,115466,-,-
BAC5_I12,16,16p11.2,32338756,32374547,35791,-,-
BAC227_F16,16,16p11.2,32587203,32707309,120106,yes,-
BAC78_L18,16,16p11.2,32595068,32686369,91301,-,-
BAC50_C19,16,16p11.2,32659197,32753956,94759,-,-
BAC42_N17,16,16p11.2,32732360,32821826,89466,-,-
BAC195_M10,16,16p11.2,32806783,32912463,105680,-,-
BAC26_G09,16,16p11.2,32827119,32919648,92529,-,-
BAC184_F18,16,16p11.2,32827138,32912463,85325,-,-
BAC213_J06,16,16p11.2,32864716,32954233,89517,-,-
BAC20_H04,16,16p11.2,33138457,33309764,171307,-,-
BAC185_N07,16,16p11.2,33239818,33328330,88512,-,-
BAC127_O02,16,16p11.2,33252222,33354840,102618,-,-
BAC166_M05,16,16p11.2,33270767,33358367,87600,-,-
BAC200_J18,16,16p11.2,33281161,33368488,87327,-,-
BAC110_H03,16,16p11.2,33294003,33444108,150105,-,-
BAC134_P03,16,16p11.2,33305410,33402830,97420,-,-
BAC169_L16,16,16p11.2,33396659,33472649,75990,-,-
BAC189_M06,16,16p11.2,33402825,33506712,103887,-,-
BAC14_G13,16,16p11.2,33552927,33741551,188624,-,-
BAC49_E03,16,16p11.2,33835433,33927070,91637,-,-
BAC107_E09,16,16p11.2,34036650,34159234,122584,-,-
BAC249_E06,16,16p11.2,34134782,34258414,123632,-,-
BAC226_B19,16,16p11.2,34163340,34220819,57479,-,-
BAC93_A07,16,16p11.2,34259071,34334102,75031,-,-
BAC184_B13,16,16p11.2,34269589,34375900,106311,-,-
BAC143_N09,16,16p11.1,34456900,34540615,83715,-,-
BAC147_B09,16,16p11.1,34478870,34564689,85819,-,-
BAC203_H07,16,16p11.1,34523634,34615597,91963,-,-
BAC124_E14,16,16p11.1,34622704,34733392,110688,-,-
BAC233_L08,16,16p11.1,34622715,34714121,91406,-,-
BAC181_A02,16,16p11.1,34774848,34879353,104505,-,-
BAC175_N21,16,16p11.1,34812498,34891421,78923,-,-
BAC149_D11,16,16p11.1,34842500,34998450,155950,-,-
BAC69_E15,16,16p11.1,34863625,34940861,77236,-,-
BAC151_N18,16,16p11.1,34941221,35027075,85854,-,-
BAC71_I14,16,16q11.2,45058483,45162342,103859,-,-
BAC125_P21,16,16q11.2,45058525,45273580,215055,-,-
BAC57_A24,16,16q11.2,45074154,45203878,129724,-,-
BAC249_J23,16,16q11.2,45125997,45231887,105890,-,-
BAC100_I12,16,16q11.2,45142833,45265254,122421,-,-
BAC71_D10,16,16q11.2,45193892,45340825,146933,-,-
BAC51_J16,16,16q11.2,45198069,45361195,163126,-,-
BAC154_F07,16,16q11.2,45273817,45366835,93018,-,-
BAC46_O13,16,16q11.2,45273826,45406709,132883,-,-
BAC90_M17,16,16q11.2,45292701,45398173,105472,-,-
BAC73_O07,16,16q11.2,45295091,45364969,69878,-,-
BAC143_K17,16,16q11.2,45364847,45454206,89359,-,-
BAC185_H05,16,16q11.2-16q12.1,45423985,45531977,107992,-,-
BAC224_N09,16,16q11.2-16q12.1,45431504,45543319,111815,-,-
BAC144_K15,16,16q12.1,45569232,45664061,94829,-,-
BAC36_J19,16,16q12.1,45664060,45889429,225369,-,-
BAC187_D08,16,16q12.1,45680645,45781522,100877,-,-
BAC171_K17,16,16q12.1,45742881,45841520,98639,-,-
BAC175_J20,16,16q12.1,45795123,45889005,93882,-,-
BAC5_G03,16,16q12.1,45839964,46023450,183486,-,-
BAC133_J04,16,16q12.1,45844119,45926333,82214,-,-
BAC50_G06,16,16q12.1,45917547,46006221,88674,-,-
BAC10_L12,16,16q12.1,46111479,46250597,139118,-,-
BAC218_K12,16,16q12.1,46170542,46276014,105472,-,-
BAC178_F13,16,16q12.1,46184997,46268296,83299,-,-
BAC116_E03,16,16q12.1,46339352,46425561,86209,-,-
BAC132_O10,16,16q12.1,46460792,46532218,71426,-,-
BAC224_C12,16,16q12.1,46466045,46577535,111490,-,-
BAC26_B16,16,16q12.1,46476035,46575547,99512,-,-
BAC247_B03,16,16q12.1,46582236,46708479,126243,-,-
BAC243_B05,16,16q12.1,46609246,46713278,104032,-,-
BAC244_H05,16,16q12.1,46639392,46776628,137236,-,-
BAC37_H24,16,16q12.1,46671628,46764288,92660,-,-
BAC237_G01,16,16q12.1,46672441,46758275,85834,-,-
BAC22_O18,16,16q12.1,46672441,46797986,125545,-,-
BAC234_B08,16,16q12.1,46672450,46758275,85825,-,-
BAC169_K19,16,16q12.1,46784389,46863642,79253,-,-
BAC171_H04,16,16q12.1,46798003,46876623,78620,-,-
BAC249_E11,16,16q12.1,46803107,46874820,71713,-,-
BAC27_B03,16,16q12.1,46851994,47038672,186678,-,-
BAC153_P09,16,16q12.1,46873356,46963278,89922,-,-
BAC48_J17,16,16q12.1,46917433,47042622,125189,-,-
BAC29_J12,16,16q12.1,46977433,47056318,78885,-,-
BAC128_A08,16,16q12.1,47059251,47221367,162116,-,-
BAC14_G03,16,16q12.1,47087189,47190523,103334,-,-
BAC143_D09,16,16q12.1,47097206,47182537,85331,-,-
BAC142_B08,16,16q12.1,47145024,47258323,113299,-,-
BAC240_F18,16,16q12.1,47191533,47262639,71106,-,-
BAC125_E05,16,16q12.1,47250364,47371784,121420,-,-
BAC233_N23,16,16q12.1,47317571,47452940,135369,-,-
BAC231_L19,16,16q12.1,47362357,47462796,100439,-,-
BAC97_G18,16,16q12.1,47405917,47529706,123789,-,-
BAC233_O16,16,16q12.1,47438061,47529706,91645,-,-
BAC151_N06,16,16q12.1,47439705,47532234,92529,-,-
BAC147_A20,16,16q12.1,47452934,47529706,76772,-,-
BAC141_H09,16,16q12.1,47508148,47610093,101945,-,-
BAC134_F19,16,16q12.1,47529701,47649528,119827,-,-
BAC40_L15,16,16q12.1,47554806,47646269,91463,-,-
BAC226_L08,16,16q12.1,47563543,47646320,82777,-,-
BAC26_E07,16,16q12.1,47569266,47649528,80262,-,-
BAC158_J06,16,16q12.1,47596475,47684635,88160,-,-
BAC236_N18,16,16q12.1,47649521,47740298,90777,-,-
BAC30_M15,16,16q12.1,47659251,47773363,114112,-,-
BAC197_E06,16,16q12.1,47680937,47761518,80581,-,-
BAC124_J22,16,16q12.1,47773375,47881131,107756,-,-
BAC237_C06,16,16q12.1,47820838,47927649,106811,-,-
BAC248_B18,16,16q12.1,47820861,47930341,109480,-,-
BAC202_K18,16,16q12.1,47823710,47904402,80692,-,-
BAC60_P04,16,16q12.1,47910702,48134564,223862,-,-
BAC249_P04,16,16q12.1,47994138,48113745,119607,-,-
BAC126_C18,16,16q12.1,48017348,48124982,107634,-,-
BAC176_B20,16,16q12.1,48087928,48244266,156338,-,-
BAC118_B13,16,16q12.1,48134558,48221809,87251,-,-
BAC76_H02,16,16q12.1,48203112,48284320,81208,-,-
BAC59_P06,16,16q12.1,48244291,48347059,102768,-,-
BAC186_K04,16,16q12.1,48360275,48511519,151244,-,-
BAC65_C17,16,16q12.1,48361167,48483792,122625,-,-
BAC248_G02,16,16q12.1,48424559,48533641,109082,-,-
BAC149_O05,16,16q12.1,48528917,48617560,88643,-,-
BAC228_P01,16,16q12.1,48529212,48617560,88348,-,-
BAC103_O13,16,16q12.1,48541121,48647970,106849,-,-
BAC236_N24,16,16q12.1,48545927,48624118,78191,-,-
BAC33_H21,16,16q12.1,48545931,48649427,103496,-,-
BAC120_O22,16,16q12.1,48579802,48677277,97475,-,-
BAC220_D14,16,16q12.1,48588800,48699615,110815,-,-
BAC149_M23,16,16q12.1,48622203,48706022,83819,-,-
BAC249_K03,16,16q12.1,48624113,48705997,81884,-,-
BAC70_H06,16,16q12.1,48732956,48820909,87953,-,-
BAC135_E08,16,16q12.1,48733100,48820909,87809,-,-
BAC117_J12,16,16q12.1,48769056,48854426,85370,-,-
BAC150_H10,16,16q12.1,48769132,48872370,103238,-,-
BAC69_B15,16,16q12.1,48774131,48878358,104227,-,-
BAC153_M14,16,16q12.1,48780559,48859464,78905,-,-
BAC192_C01,16,16q12.1,48826130,48915570,89440,-,-
BAC95_D16,16,16q12.1,48919993,49099944,179951,-,-
BAC142_E07,16,16q12.1,48919994,49014298,94304,-,-
BAC100_G06,16,16q12.1,48932744,49044968,112224,-,-
BAC140_N07,16,16q12.1,48932744,49014302,81558,-,-
BAC23_F19,16,16q12.1,48938462,49036297,97835,-,-
BAC39_C12,16,16q12.1,49032276,49147508,115232,-,-
BAC36_N04,16,16q12.1,49033721,49185510,151789,-,-
BAC139_E18,16,16q12.1,49071663,49162140,90477,-,-
BAC227_C21,16,16q12.1,49085908,49208886,122978,-,-
BAC89_B06,16,16q12.1,49158436,49250505,92069,-,-
BAC76_F13,16,16q12.1,49158436,49250505,92069,-,-
BAC78_A08,16,16q12.1,49201256,49314963,113707,-,-
BAC24_C03,16,16q12.1,49203431,49338191,134760,-,-
BAC69_M09,16,16q12.1,49260724,49357557,96833,-,-
BAC78_F15,16,16q12.1,49311725,49460415,148690,-,-
BAC83_F13,16,16q12.1,49362415,49460415,98000,-,-
BAC64_B14,16,16q12.1,49391436,49494376,102940,-,-
BAC139_I12,16,16q12.1,49401525,49496950,95425,-,-
BAC226_M18,16,16q12.1,49426217,49547193,120976,-,-
BAC125_B08,16,16q12.1,49452961,49639560,186599,-,-
BAC71_K07,16,16q12.1,49461024,49607987,146963,-,-
BAC41_F15,16,16q12.1,49467910,49547182,79272,-,-
BAC45_G02,16,16q12.1,49496505,49664653,168148,-,-
BAC231_L17,16,16q12.1,49496945,49578041,81096,-,-
BAC174_O13,16,16q12.1,49496981,49595947,98966,-,-
BAC52_O05,16,16q12.1,49536580,49643139,106559,-,-
BAC179_N18,16,16q12.1,49543943,49641055,97112,-,-
BAC29_E11,16,16q12.1,49578246,49696968,118722,-,-
BAC36_A09,16,16q12.1,49578257,49674118,95861,-,-
BAC21_K23,16,16q12.1,49654071,49741017,86946,-,-
BAC41_J18,16,16q12.1,49928220,50036819,108599,-,-
BAC1_K12,16,16q12.1,49928801,50051365,122564,-,-
BAC144_D08,16,16q12.1,49928804,50088577,159773,-,-
BAC184_I10,16,16q12.1,50208148,50300197,92049,-,-
BAC220_D12,16,16q12.1,50208148,50283124,74976,-,-
BAC77_C24,16,16q12.1,50218219,50298901,80682,-,-
BAC106_P06,16,16q12.1,50231099,50325633,94534,-,-
BAC176_G09,16,16q12.1,50435527,50551850,116323,-,-
BAC184_J10,16,16q12.1,50531242,50650925,119683,-,-
BAC199_K24,16,16q12.1,50555356,50691662,136306,-,-
BAC78_H11,16,16q12.1,50687510,50778444,90934,-,-
BAC172_N05,16,16q12.1,50757216,50838611,81395,-,-
BAC123_B03,16,16q12.1,50984725,51071150,86425,-,-
BAC165_F17,16,16q12.1,51016013,51098040,82027,-,-
BAC33_G24,16,16q12.1,51026427,51124144,97717,-,-
BAC101_C02,16,16q12.1,51088364,51176590,88226,-,-
BAC116_F15,16,16q12.1-16q12.2,51098034,51239202,141168,-,-
BAC124_M20,16,16q12.1-16q12.2,51191741,51299036,107295,-,-
BAC210_L04,16,16q12.2,51222050,51298878,76828,-,-
BAC55_O10,16,16q12.2,51239274,51348615,109341,-,-
BAC240_M17,16,16q12.2,51348858,51428393,79535,-,-
BAC45_M06,16,16q12.2,51366086,51471088,105002,-,-
BAC116_C11,16,16q12.2,51374489,51547769,173280,-,-
BAC239_N07,16,16q12.2,51431282,51547767,116485,-,-
BAC105_B01,16,16q12.2,51457476,51547764,90288,-,-
BAC78_E16,16,16q12.2,51465587,51558873,93286,-,-
BAC18_H09,16,16q12.2,51485751,51574992,89241,-,-
BAC235_E03,16,16q12.2,51557633,51660170,102537,-,-
BAC38_I14,16,16q12.2,51565250,51687331,122081,-,-
BAC70_P01,16,16q12.2,51582443,51660171,77728,-,-
BAC54_N02,16,16q12.2,51633313,51726084,92771,-,-
BAC71_H04,16,16q12.2,51649552,51747966,98414,-,-
BAC142_E14,16,16q12.2,51684760,51780443,95683,-,-
BAC129_L11,16,16q12.2,51684760,51781827,97067,-,-
BAC29_K01,16,16q12.2,51725458,51823170,97712,-,-
BAC242_M19,16,16q12.2,51735577,51829173,93596,-,-
BAC144_E13,16,16q12.2,51762037,51862284,100247,-,-
BAC234_O18,16,16q12.2,51762037,51823174,61137,-,-
BAC158_N21,16,16q12.2,51767113,51856222,89109,-,-
BAC113_K11,16,16q12.2,51806960,51899740,92780,-,-
BAC252_J09,16,16q12.2,51882208,52000944,118736,-,-
BAC36_D11,16,16q12.2,51888237,52006231,117994,-,-
BAC36_B18,16,16q12.2,51964004,52048388,84384,-,-
BAC180_O20,16,16q12.2,51984694,52073312,88618,-,-
BAC236_F17,16,16q12.2,51997312,52078440,81128,-,-
BAC43_J02,16,16q12.2,52023281,52154975,131694,-,-
BAC153_F16,16,16q12.2,52045636,52124505,78869,-,-
BAC24_D09,16,16q12.2,52045636,52154975,109339,-,-
BAC213_J15,16,16q12.2,52070754,52151987,81233,-,-
BAC196_J19,16,16q12.2,52121161,52203885,82724,-,-
BAC131_D20,16,16q12.2,52139204,52262777,123573,-,-
BAC88_O21,16,16q12.2,52154969,52245580,90611,-,-
BAC140_N22,16,16q12.2,52339068,52422669,83601,-,-
BAC232_O11,16,16q12.2,52366445,52442155,75710,-,-
BAC149_E14,16,16q12.2,52368850,52458289,89439,-,-
BAC20_N01,16,16q12.2,52448888,52549799,100911,-,-
BAC144_L14,16,16q12.2,52498022,52597042,99020,-,-
BAC232_K11,16,16q12.2,52503984,52597038,93054,-,-
BAC198_J21,16,16q12.2,52604258,52701133,96875,-,-
BAC154_C12,16,16q12.2,52630192,52717864,87672,-,-
BAC221_G08,16,16q12.2,52637177,52718156,80979,-,-
BAC127_H03,16,16q12.2,52653046,52753163,100117,-,-
BAC59_D12,16,16q12.2,52653046,52742959,89913,-,-
BAC157_O11,16,16q12.2,52742954,52831935,88981,-,-
BAC124_F16,16,16q12.2,52791950,52929590,137640,-,-
BAC169_L13,16,16q12.2,52800388,52881248,80860,-,-
BAC97_J12,16,16q12.2,52860228,52983627,123399,-,-
BAC183_G22,16,16q12.2,52880711,52990899,110188,-,-
BAC106_F09,16,16q12.2,52912466,53030543,118077,-,-
BAC144_N05,16,16q12.2,52914427,53030543,116116,-,-
BAC58_O14,16,16q12.2,52969148,53084835,115687,-,-
BAC228_N21,16,16q12.2,53077463,53168932,91469,-,-
BAC184_N15,16,16q12.2,53108298,53248196,139898,-,-
BAC64_P06,16,16q12.2,53203263,53292149,88886,-,-
BAC88_M06,16,16q12.2,53226346,53326663,100317,-,-
BAC97_L08,16,16q12.2,53327285,53419114,91829,-,-
BAC148_H19,16,16q12.2,53372084,53451701,79617,-,-
BAC59_J15,16,16q12.2,53383244,53507036,123792,-,-
BAC15_O03,16,16q12.2,53401304,53545061,143757,-,-
BAC189_O09,16,16q12.2,53405481,53483148,77667,-,-
BAC116_A19,16,16q12.2,53417655,53527275,109620,-,-
BAC179_E24,16,16q12.2,53440732,53545070,104338,-,-
BAC69_P20,16,16q12.2,53507197,53629047,121850,-,-
BAC117_D18,16,16q12.2,53512607,53636632,124025,-,-
BAC209_E19,16,16q12.2,53527270,53626500,99230,-,-
BAC92_M17,16,16q12.2,53529780,53629047,99267,-,-
BAC53_N22,16,16q12.2,53549840,53642764,92924,-,-
BAC84_P20,16,16q12.2,53601979,53725045,123066,-,-
BAC231_C15,16,16q12.2,53638726,53722428,83702,-,-
BAC167_O09,16,16q12.2,53781243,53864092,82849,-,-
BAC148_N16,16,16q12.2,53828064,53953997,125933,-,-
BAC186_N18,16,16q12.2,53858813,53945032,86219,-,-
BAC144_D17,16,16q12.2,53912717,54007360,94643,-,-
BAC63_H22,16,16q12.2,53912719,53995787,83068,-,-
BAC180_I18,16,16q12.2,53945033,54029013,83980,-,-
BAC207_B15,16,16q12.2,53976009,54079264,103255,-,-
BAC80_C18,16,16q12.2,54105593,54222889,117296,-,-
BAC240_C03,16,16q12.2,54156173,54253512,97339,-,-
BAC57_P17,16,16q12.2,54206003,54345592,139589,-,-
BAC184_H14,16,16q12.2,54217926,54301105,83179,-,-
BAC159_F02,16,16q12.2,54262949,54345582,82633,-,-
BAC200_B10,16,16q12.2,54301102,54424986,123884,-,-
BAC144_P24,16,16q12.2-16q13,54452988,54535307,82319,-,-
BAC42_M10,16,16q13,54597670,54699924,102254,-,-
BAC38_J21,16,16q13,54813187,54905557,92370,-,-
BAC175_B03,16,16q13,54832888,54920640,87752,-,-
BAC117_H14,16,16q13,54857795,54968957,111162,-,-
BAC97_D22,16,16q13,54917862,54997190,79328,-,-
BAC66_E13,16,16q13,54953543,55033963,80420,-,-
BAC101_H21,16,16q13,54957375,55077187,119812,-,-
BAC88_A01,16,16q13,54957375,55059662,102287,-,-
BAC127_N06,16,16q13,55024624,55138989,114365,-,-
BAC50_C21,16,16q13,55052036,55142416,90380,-,-
BAC178_F15,16,16q13,55056432,55152191,95759,-,-
BAC183_D18,16,16q13,55077196,55160690,83494,-,-
BAC101_K23,16,16q13,55213462,55357059,143597,-,-
BAC202_P04,16,16q13,55228663,55310008,81345,-,-
BAC246_H06,16,16q13,55234366,55328734,94368,-,-
BAC90_I01,16,16q13,55240394,55360755,120361,-,-
BAC149_F22,16,16q13,55244090,55335994,91904,-,-
BAC179_F01,16,16q13,55244090,55328738,84648,-,-
BAC49_L16,16,16q13,55252670,55340533,87863,-,-
BAC37_D17,16,16q13,55256180,55383326,127146,-,-
BAC247_G07,16,16q13,55343321,55466583,123262,-,-
BAC30_G08,16,16q13,55362417,55454837,92420,-,-
BAC249_I24,16,16q13,55364451,55450088,85637,-,-
BAC1_G18,16,16q13,55391805,55546414,154609,-,-
BAC188_G20,16,16q13,55409030,55497371,88341,-,-
BAC83_H24,16,16q13,55421162,55517522,96360,-,-
BAC42_N13,16,16q13,55450100,55543800,93700,-,-
BAC193_C09,16,16q13,55466577,55552966,86389,-,-
BAC115_B13,16,16q13,55541780,55646729,104949,-,-
BAC141_G15,16,16q13,55546474,55646939,100465,-,-
BAC124_P06,16,16q13,55546474,55667924,121450,-,-
BAC178_O08,16,16q13,55552849,55646939,94090,-,-
BAC84_E20,16,16q13,55575371,55668467,93096,-,-
BAC80_P22,16,16q13,55586995,55716945,129950,-,-
BAC233_F19,16,16q13,55644958,55730577,85619,-,-
BAC217_M12,16,16q13,55660884,55755003,94119,-,-
BAC168_D21,16,16q13,55660884,55751015,90131,-,-
BAC103_B12,16,16q13,55660969,55797101,136132,-,-
BAC20_D17,16,16q13,55669539,55761171,91632,-,-
BAC43_O07,16,16q13,55754159,55929839,175680,-,-
BAC199_L22,16,16q13,55787917,55863820,75903,-,-
BAC121_A01,16,16q13,55790964,55900239,109275,-,-
BAC105_M15,16,16q13,55805819,55896616,90797,-,-
BAC31_L03,16,16q13,55823428,55928460,105032,-,-
BAC107_H15,16,16q13,55832105,55934373,102268,-,-
BAC221_H15,16,16q13,55832109,55918557,86448,-,-
BAC62_F12,16,16q13,55847159,55934573,87414,-,-
BAC22_A22,16,16q13,55886676,55985784,99108,-,-
BAC235_J17,16,16q13,55929942,56025468,95526,-,-
BAC226_C18,16,16q13,55934699,56021990,87291,-,-
BAC154_O02,16,16q13,55934699,56021990,87291,-,-
BAC189_C09,16,16q13,55934699,56021989,87290,-,-
BAC15_A22,16,16q13,55941401,56032190,90789,-,-
BAC145_A14,16,16q13,56049826,56169294,119468,-,-
BAC153_E19,16,16q13,56159515,56269341,109826,-,-
BAC236_I20,16,16q13,56169287,56266107,96820,-,-
BAC90_N10,16,16q13,56176032,56269341,93309,-,-
BAC66_A08,16,16q13,56222536,56339453,116917,-,-
BAC176_B11,16,16q13,56269340,56357951,88611,-,-
BAC244_O18,16,16q13,56269347,56361459,92112,-,-
BAC76_P13,16,16q13,56409437,56534467,125030,-,-
BAC76_N11,16,16q13,56464645,56574772,110127,-,-
BAC183_J21,16,16q13,56475210,56565511,90301,-,-
BAC141_K22,16,16q13,56507825,56576067,68242,-,-
BAC101_B16,16,16q13,56565746,56688617,122871,-,-
BAC56_P11,16,16q13-16q21,56575387,56717809,142422,-,-
BAC22_I08,16,16q13,56580892,56691762,110870,-,-
BAC147_M03,16,16q13,56616363,56697577,81214,-,-
BAC191_I19,16,16q13-16q21,56626121,56704503,78382,-,-
BAC114_F21,16,16q13-16q21,56639536,56766388,126852,-,-
BAC36_O03,16,16q21,56708474,56788042,79568,-,-
BAC120_K23,16,16q21,56736504,56846725,110221,-,-
BAC215_J12,16,16q21,56790867,56890155,99288,-,-
BAC228_J01,16,16q21,56790973,56886578,95605,-,-
BAC217_N20,16,16q21,56846719,56936523,89804,-,-
BAC17_C17,16,16q21,56853100,56943334,90234,-,-
BAC117_E14,16,16q21,56875770,56984709,108939,-,-
BAC160_P21,16,16q21,56899022,56994516,95494,-,-
BAC88_P04,16,16q21,56903554,56991714,88160,-,-
BAC78_G16,16,16q21,56921266,57131364,210098,-,-
BAC244_D08,16,16q21,56991678,57096753,105075,-,-
BAC183_I11,16,16q21,56991811,57096753,104942,-,-
BAC195_E23,16,16q21,56994508,57096753,102245,-,-
BAC64_E01,16,16q21,56994607,57096682,102075,-,-
BAC223_K10,16,16q21,57006611,57096753,90142,-,-
BAC230_C16,16,16q21,57046547,57131334,84787,-,-
BAC117_L04,16,16q21,57048927,57131364,82437,-,-
BAC78_D11,16,16q21,57166020,57270401,104381,-,-
BAC190_H01,16,16q21,57220228,57311881,91653,-,-
BAC36_M03,16,16q21,57240004,57367792,127788,-,-
BAC89_O18,16,16q21,57249528,57345943,96415,-,-
BAC59_O14,16,16q21,57270394,57383539,113145,-,-
BAC167_C11,16,16q21,57320612,57445668,125056,-,-
BAC72_D08,16,16q21,57346020,57433788,87768,-,-
BAC167_I09,16,16q21,57368593,57469221,100628,-,-
BAC80_L21,16,16q21,57376073,57542394,166321,-,-
BAC79_C24,16,16q21,57443294,57541938,98644,-,-
BAC247_J15,16,16q21,57658997,57744213,85216,-,-
BAC154_A12,16,16q21,57718895,57810760,91865,-,-
BAC88_J05,16,16q21,57816949,57914424,97475,-,-
BAC119_K20,16,16q21,57909698,58002090,92392,-,-
BAC42_O23,16,16q21,58101049,58206074,105025,-,-
BAC2_N15,16,16q21,58106401,58206809,100408,-,-
BAC238_E15,16,16q21,58116309,58202466,86157,-,-
BAC33_N05,16,16q21,58132505,58253593,121088,-,-
BAC169_O03,16,16q21,58132507,58211850,79343,-,-
BAC95_N12,16,16q21,58175390,58276848,101458,-,-
BAC182_G23,16,16q21,58200509,58303467,102958,-,-
BAC182_J07,16,16q21,58230126,58303467,73341,-,-
BAC199_D05,16,16q21,58275078,58370008,94930,-,-
BAC84_N06,16,16q21,58395745,58489355,93610,-,-
BAC158_A04,16,16q21,58427261,58510218,82957,-,-
BAC130_D08,16,16q21,58450543,58526312,75769,-,-
BAC25_D24,16,16q21,58496369,58510219,13850,-,-
BAC76_O15,16,16q21,58584835,58691503,106668,-,-
BAC72_A11,16,16q21,58681492,58779986,98494,-,-
BAC12_O08,16,16q21,58713442,58793364,79922,-,-
BAC127_C07,16,16q21,58728695,58814657,85962,-,-
BAC67_N10,16,16q21,58809478,58906867,97389,-,-
BAC136_C22,16,16q21,58812163,58935473,123310,-,-
BAC82_J14,16,16q21,59063503,59156658,93155,-,-
BAC101_K03,16,16q21,59385177,59505864,120687,-,-
BAC234_N22,16,16q21,59430716,59513902,83186,-,-
BAC13_G06,16,16q21,59575929,59650301,74372,-,-
BAC46_A02,16,16q21,59714007,59821018,107011,-,-
BAC247_D19,16,16q21,59738340,59808745,70405,-,-
BAC162_E01,16,16q21,59782327,59893306,110979,-,-
BAC75_N01,16,16q21,60041209,60149725,108516,-,-
BAC132_M06,16,16q21,60102880,60185103,82223,-,-
BAC219_L03,16,16q21,60150200,60221544,71344,-,-
BAC204_L13,16,16q21,60221644,60305426,83782,-,-
BAC143_O06,16,16q21,60326265,60416130,89865,-,-
BAC221_J14,16,16q21,60326265,60406657,80392,-,-
BAC153_A20,16,16q21,60499555,60579390,79835,-,-
BAC191_B14,16,16q21,60611663,60698650,86987,-,-
BAC117_N10,16,16q21,60907740,61041535,133795,-,-
BAC96_C09,16,16q21,60962630,61055149,92519,-,-
BAC83_C13,16,16q21,60965196,61070604,105408,-,-
BAC218_K06,16,16q21,60981905,61062982,81077,-,-
BAC8_M17,16,16q21,61011115,61092970,81855,-,-
BAC22_I11,16,16q21,61091705,61194449,102744,-,-
BAC83_F20,16,16q21,61092980,61167127,74147,-,-
BAC219_E20,16,16q21,61181867,61267511,85644,-,-
BAC184_M05,16,16q21,61181884,61271125,89241,-,-
BAC145_N11,16,16q21,61259674,61345717,86043,-,-
BAC155_G04,16,16q21,61554306,61643838,89532,-,-
BAC159_H03,16,16q21,61847213,61929002,81789,-,-
BAC52_B17,16,16q21,62130114,62243503,113389,-,-
BAC232_O01,16,16q21,62170934,62265495,94561,-,-
BAC11_N02,16,16q21,62170936,62270082,99146,-,-
BAC18_H22,16,16q21,62198693,62304832,106139,-,-
BAC129_N15,16,16q21,62254961,62352126,97165,-,-
BAC248_C05,16,16q21,62334005,62412431,78426,-,-
BAC50_A19,16,16q21,62505305,62609505,104200,-,-
BAC120_A18,16,16q21,62539826,62688215,148389,-,-
BAC60_P07,16,16q21,62955984,63074069,118085,-,-
BAC186_A18,16,16q21,62963414,63065192,101778,-,-
BAC224_I21,16,16q21,62969477,63065192,95715,-,-
BAC128_J09,16,16q21,62989043,63073805,84762,-,-
BAC63_J16,16,16q21,62998543,63121342,122799,-,-
BAC52_L05,16,16q21,63239274,63372904,133630,-,-
BAC226_F07,16,16q21,63326818,63411935,85117,-,-
BAC153_A17,16,16q21,63411764,63507375,95611,-,-
BAC83_M06,16,16q21,63436662,63510222,73560,-,-
BAC7_G22,16,16q21,63523013,63636215,113202,-,-
BAC183_O10,16,16q21,63586263,63678029,91766,-,-
BAC15_I20,16,16q21,63762842,63849191,86349,-,-
BAC244_J07,16,16q21,63766221,63847776,81555,-,-
BAC178_O04,16,16q21,63766221,63854801,88580,-,-
BAC96_G02,16,16q21,63766221,63897034,130813,-,-
BAC189_N16,16,16q21,63823596,63900412,76816,-,-
BAC110_F02,16,16q21,63830685,63924470,93785,-,-
BAC196_E01,16,16q21,64020274,64115029,94755,-,-
BAC41_E07,16,16q21,64137645,64241407,103762,-,-
BAC181_N09,16,16q21,64168300,64241407,73107,-,-
BAC237_F21,16,16q21,64215669,64324512,108843,-,-
BAC237_N21,16,16q21,64218849,64335668,116819,-,-
BAC184_E17,16,16q21,64224178,64333539,109361,-,-
BAC66_J08,16,16q21,64244010,64337974,93964,-,-
BAC232_J14,16,16q21,64256926,64335244,78318,-,-
BAC231_I23,16,16q21,64324554,64427283,102729,-,-
BAC153_H16,16,16q21,64428183,64535667,107484,-,-
BAC231_O15,16,16q21,64481928,64577859,95931,-,-
BAC241_J21,16,16q21,64523962,64605599,81637,-,-
BAC123_K04,16,16q21,64530459,64621035,90576,-,-
BAC151_P07,16,16q21,64629161,64722983,93822,-,-
BAC219_J24,16,16q21,64634051,64731997,97946,-,-
BAC144_L04,16,16q21,64708513,64826744,118231,-,-
BAC171_N14,16,16q21,64732080,64816524,84444,-,-
BAC84_K08,16,16q21,64746236,64850958,104722,-,-
BAC162_A11,16,16q21,64832443,64928196,95753,-,-
BAC56_P13,16,16q21,64927289,64939006,11717,-,-
BAC230_F13,16,16q21,64928192,65062479,134287,-,-
BAC205_K17,16,16q21,64939244,65032889,93645,-,-
BAC223_K04,16,16q21,64949813,65006511,56698,-,-
BAC191_F13,16,16q21,65006508,65102050,95542,-,-
BAC186_F12,16,16q21,65009160,65089267,80107,-,-
BAC179_E17,16,16q21,65009161,65111789,102628,-,-
BAC137_J20,16,16q21,65053675,65163954,110279,-,-
BAC39_M02,16,16q21-16q22.1,65131106,65252637,121531,-,-
BAC44_M13,16,16q21-16q22.1,65133255,65252634,119379,-,-
BAC149_F13,16,16q21-16q22.1,65140323,65220328,80005,-,-
BAC53_J17,16,16q21-16q22.1,65157347,65234878,77531,-,-
BAC213_K13,16,16q21-16q22.1,65173493,65254283,80790,-,-
BAC16_K08,16,16q22.1,65207036,65328679,121643,-,-
BAC252_F10,16,16q22.1,65208073,65271227,63154,-,-
BAC52_F10,16,16q22.1,65220423,65314086,93663,-,-
BAC171_I12,16,16q22.1,65244662,65328674,84012,-,-
BAC186_I20,16,16q22.1,65271437,65347936,76499,-,-
BAC152_D15,16,16q22.1,65347933,65428981,81048,-,-
BAC65_I17,16,16q22.1,65372535,65485605,113070,-,-
BAC143_L03,16,16q22.1,65406338,65485609,79271,-,-
BAC110_M04,16,16q22.1,65508053,65636500,128447,-,-
BAC207_N06,16,16q22.1,65508157,65608252,100095,-,-
BAC246_H16,16,16q22.1,65645264,65729788,84524,-,-
BAC1_F03,16,16q22.1,65645264,65740550,95286,-,-
BAC196_I19,16,16q22.1,65693934,65795821,101887,-,-
BAC56_C02,16,16q22.1,65697421,65788142,90721,-,-
BAC222_G12,16,16q22.1,65722152,65827844,105692,-,-
BAC68_N13,16,16q22.1,65931255,66038676,107421,-,-
BAC204_O10,16,16q22.1,65945865,66036286,90421,-,-
BAC152_B23,16,16q22.1,66046747,66135630,88883,-,-
BAC176_K22,16,16q22.1,66190031,66274642,84611,-,-
BAC193_M15,16,16q22.1,66191065,66274642,83577,-,-
BAC227_J20,16,16q22.1,66229821,66323924,94103,yes,-
BAC126_B03,16,16q22.1,66269991,66369877,99886,-,-
BAC217_N16,16,16q22.1,66326622,66416037,89415,-,-
BAC127_O09,16,16q22.1,66345600,66444044,98444,-,-
BAC248_N24,16,16q22.1,66416030,66506199,90169,-,-
BAC10_C14,16,16q22.1,66416030,66506201,90171,-,-
BAC224_M16,16,16q22.1,66416030,66519562,103532,-,-
BAC36_N16,16,16q22.1,66468520,66597425,128905,yes,-
BAC30_L10,16,16q22.1,66473624,66590488,116864,yes,-
BAC61_H22,16,16q22.1,66485255,66605526,120271,-,-
BAC105_H03,16,16q22.1,66575458,66654555,79097,-,-
BAC230_A03,16,16q22.1,66599956,66680670,80714,-,-
BAC130_A20,16,16q22.1,66667925,66803611,135686,-,-
BAC120_F18,16,16q22.1,66806870,66890906,84036,-,-
BAC146_P11,16,16q22.1,66838045,66932312,94267,-,-
BAC161_I15,16,16q22.1,66838045,66923537,85492,-,-
BAC23_H05,16,16q22.1,66838047,66926190,88143,-,-
BAC189_A17,16,16q22.1,66890900,66964580,73680,-,-
BAC194_G04,16,16q22.1,66890900,66989443,98543,-,-
BAC137_M14,16,16q22.1,66932315,66999367,67052,-,-
BAC43_C19,16,16q22.1,67034145,67165378,131233,-,-
BAC249_B22,16,16q22.1,67165375,67290608,125233,-,-
BAC116_B08,16,16q22.1,67219780,67352789,133009,-,-
BAC38_E16,16,16q22.1,67403389,67510572,107183,-,-
BAC121_D13,16,16q22.1,67415419,67507226,91807,-,-
BAC41_L08,16,16q22.1,67507495,67603660,96165,-,-
BAC45_G09,16,16q22.1,67510647,67603213,92566,-,-
BAC144_L21,16,16q22.1,67525464,67603271,77807,-,-
BAC42_F08,16,16q22.1,67554539,67678742,124203,-,-
BAC84_P18,16,16q22.1,67554539,67663955,109416,-,-
BAC128_G11,16,16q22.1,67678736,67813389,134653,-,-
BAC100_E24,16,16q22.1,67716198,67800812,84614,-,-
BAC95_E15,16,16q22.1,67716212,67813386,97174,-,-
BAC161_K17,16,16q22.1,67725081,67820319,95238,-,-
BAC45_C01,16,16q22.1,67809296,67959348,150052,-,-
BAC105_C10,16,16q22.1,67813380,67924953,111573,-,-
BAC24_N06,16,16q22.1,67813396,67900285,86889,-,-
BAC66_G12,16,16q22.1,67818295,67927840,109545,-,-
BAC238_C11,16,16q22.1,67832891,67959406,126515,-,-
BAC31_I10,16,16q22.1,67837837,67959416,121579,-,-
BAC154_K07,16,16q22.1,67838960,67927840,88880,-,-
BAC223_M14,16,16q22.1,67838960,67924953,85993,-,-
BAC145_D08,16,16q22.1,67908770,68034753,125983,-,-
BAC17_F02,16,16q22.1,67927859,68038422,110563,-,-
BAC144_N12,16,16q22.1,67959410,68054856,95446,-,-
BAC178_J03,16,16q22.1,68073376,68171483,98107,-,-
BAC165_F19,16,16q22.1,68099915,68183919,84004,-,-
BAC4_O06,16,16q22.1,68124342,68209910,85568,-,-
BAC252_P10,16,16q22.1,68209901,68369778,159877,-,-
BAC53_H20,16,16q22.1,68209902,68310735,100833,-,-
BAC106_K17,16,16q22.1,68240186,68344936,104750,-,-
BAC213_K02,16,16q22.1,68261664,68344935,83271,-,-
BAC217_P15,16,16q22.1,68294500,68381179,86679,-,-
BAC148_B16,16,16q22.1,68347629,68474789,127160,-,-
BAC142_E20,16,16q22.1,68347629,68447595,99966,-,-
BAC243_C17,16,16q22.1,68369921,68468478,98557,-,-
BAC39_F13,16,16q22.1,68394188,68502446,108258,-,-
BAC154_I24,16,16q22.1,68400887,68493939,93052,-,-
BAC48_A05,16,16q22.1,68405235,68492600,87365,-,-
BAC41_E22,16,16q22.1,68405237,68589331,184094,-,-
BAC119_N23,16,16q22.1,68451288,68597441,146153,-,-
BAC103_J18,16,16q22.1,68485664,68570966,85302,-,-
BAC49_D18,16,16q22.1,68508620,68641444,132824,-,-
BAC124_H18,16,16q22.1,68607306,68731103,123797,-,-
BAC96_A04,16,16q22.1,68700990,68799082,98092,yes,-
BAC103_E21,16,16q22.1,68723308,68815571,92263,-,-
BAC144_L12,16,16q22.1,68738663,68811370,72707,-,-
BAC131_K05,16,16q22.1,68787960,68911293,123333,-,-
BAC38_N19,16,16q22.1,68787960,68906387,118427,-,-
BAC175_E18,16,16q22.1,68823299,68910841,87542,-,-
BAC4_J10,16,16q22.1,68845700,68940674,94974,-,-
BAC63_M23,16,16q22.1,68853518,68956138,102620,-,-
BAC41_D02,16,16q22.1,68910995,69002781,91786,-,-
BAC79_J08,16,16q22.1,68940683,69037748,97065,-,-
BAC5_N09,16,16q22.1,68940683,69028901,88218,-,-
BAC51_B05,16,16q22.1,68940686,69028505,87819,-,-
BAC44_J08,16,16q22.1,68956227,69071167,114940,-,-
BAC165_M20,16,16q22.1,68986180,69069481,83301,-,-
BAC88_F02,16,16q22.1,69157006,69239956,82950,-,-
BAC120_I17,16,16q22.1,69173736,69302634,128898,-,-
BAC162_J08,16,16q22.1,69184077,69265003,80926,-,-
BAC51_G14,16,16q22.1,69207409,69351625,144216,-,-
BAC64_E07,16,16q22.1,69210237,69356625,146388,-,-
BAC147_P14,16,16q22.1,69287360,69370434,83074,-,-
BAC161_A01,16,16q22.1-16q22.2,69376160,69478989,102829,-,-
BAC224_B08,16,16q22.2,69420656,69534063,113407,-,-
BAC80_N16,16,16q22.2,69431383,69525253,93870,-,-
BAC158_E16,16,16q22.2,69457209,69551220,94011,-,-
BAC63_P11,16,16q22.2,69465122,69592668,127546,-,-
BAC133_N18,16,16q22.2,69465145,69551207,86062,-,-
BAC176_B13,16,16q22.2,69498071,69589174,91103,-,-
BAC56_M04,16,16q22.2,69526375,69602361,75986,-,-
BAC103_F23,16,16q22.2,69551216,69692310,141094,-,-
BAC100_C07,16,16q22.2,69564367,69629853,65486,-,-
BAC39_H03,16,16q22.2,69572089,69589174,17085,-,-
BAC95_E19,16,16q22.2,69620049,69739996,119947,-,-
BAC29_G05,16,16q22.2,69628083,69763666,135583,-,-
BAC250_N18,16,16q22.2,69665729,69762845,97116,-,-
BAC8_O14,16,16q22.2,69692321,69788421,96100,-,-
BAC141_M16,16,16q22.2-16q22.3,69794925,69888544,93619,-,-
BAC235_E08,16,16q22.3,69803436,69884028,80592,-,-
BAC128_B12,16,16q22.3,69832603,69934767,102164,-,-
BAC178_G06,16,16q22.3,69884804,69964722,79918,-,-
BAC18_J05,16,16q22.3,69977578,70084433,106855,-,-
BAC36_F11,16,16q22.3,69979142,70078964,99822,-,-
BAC64_E09,16,16q22.3,69982857,70080504,97647,-,-
BAC167_N10,16,16q22.3,70058079,70156955,98876,-,-
BAC139_B04,16,16q22.3,70065799,70147874,82075,-,-
BAC118_F14,16,16q22.3,70084480,70165985,81505,-,-
BAC40_O06,16,16q22.3,70136702,70251424,114722,-,-
BAC238_G18,16,16q22.3,70183930,70265786,81856,-,-
BAC250_N17,16,16q22.3,70184471,70321621,137150,-,-
BAC39_B21,16,16q22.3,70184471,70282694,98223,-,-
BAC59_G02,16,16q22.3,70184474,70325753,141279,-,-
BAC101_O16,16,16q22.3,70193287,70282694,89407,-,-
BAC65_D11,16,16q22.3,70193287,70274207,80920,-,-
BAC232_N03,16,16q22.3,70266883,70361854,94971,-,-
BAC36_A11,16,16q22.3,70282932,70380050,97118,-,-
BAC197_J02,16,16q22.3,70287584,70379172,91588,-,-
BAC251_J10,16,16q22.3,70498703,70575497,76794,-,-
BAC175_K03,16,16q22.3,70524554,70623657,99103,-,-
BAC161_M18,16,16q22.3,70542859,70627358,84499,-,-
BAC48_G01,16,16q22.3,70558446,70710345,151899,yes,-
BAC229_M05,16,16q22.3,70558488,70653331,94843,yes,-
BAC129_J15,16,16q22.3,70583715,70678102,94387,yes,-
BAC78_E24,16,16q22.3,70716761,70798370,81609,-,-
BAC92_G04,16,16q22.3,70737563,70838148,100585,-,-
BAC134_L22,16,16q22.3,70755913,70879205,123292,-,-
BAC161_F11,16,16q22.3,70887658,70980340,92682,-,-
BAC62_O23,16,16q22.3,70897964,71009077,111113,-,-
BAC45_G10,16,16q22.3,70982960,71110641,127681,-,-
BAC196_F06,16,16q22.3,71194490,71288670,94180,-,-
BAC107_L10,16,16q22.3,71235684,71316446,80762,-,-
BAC44_F06,16,16q22.3,71346485,71467782,121297,-,-
BAC12_F18,16,16q22.3,71364165,71455979,91814,-,-
BAC229_M11,16,16q22.3,71392858,71520897,128039,-,-
BAC24_D17,16,16q22.3,71392858,71500676,107818,-,-
BAC171_F20,16,16q22.3,71443523,71536228,92705,-,-
BAC131_C18,16,16q22.3,71467802,71571222,103420,-,-
BAC31_H08,16,16q22.3,71467802,71563911,96109,-,-
BAC144_F07,16,16q22.3,71472684,71538387,65703,-,-
BAC82_P23,16,16q22.3,71506424,71603125,96701,-,-
BAC223_K15,16,16q22.3,71506426,71594013,87587,-,-
BAC38_D07,16,16q22.3,71520946,71702936,181990,-,-
BAC61_N20,16,16q22.3,71538391,71634483,96092,-,-
BAC244_O07,16,16q22.3,71573884,71653359,79475,-,-
BAC60_P15,16,16q22.3,71579637,71714606,134969,-,-
BAC8_M09,16,16q22.3,71594006,71714606,120600,-,-
BAC178_L21,16,16q22.3,71628999,71714606,85607,-,-
BAC50_H06,16,16q22.3,71688220,71787550,99330,-,-
BAC182_N03,16,16q22.3,71714731,71813788,99057,-,-
BAC40_L07,16,16q22.3,71862197,72039272,177075,-,-
BAC81_C05,16,16q22.3,71869955,71944211,74256,-,-
BAC184_H11,16,16q22.3,71871074,71972839,101765,-,-
BAC66_D11,16,16q22.3,71956822,72057949,101127,-,-
BAC168_N21,16,16q22.3,71973298,72067529,94231,-,-
BAC41_A21,16,16q22.3,71989580,72088620,99040,-,-
BAC207_D13,16,16q22.3,72044121,72149566,105445,-,-
BAC238_H22,16,16q22.3,72061346,72157438,96092,-,-
BAC158_O18,16,16q22.3,72063841,72152467,88626,-,-
BAC158_J24,16,16q22.3,72152473,72243668,91195,-,-
BAC187_A02,16,16q22.3,72170645,72260908,90263,-,-
BAC193_C17,16,16q22.3,72260902,72347262,86360,-,-
BAC64_L14,16,16q22.3,72288633,72316834,28201,-,-
BAC170_B15,16,16q22.3,72347257,72418177,70920,-,-
BAC146_D14,16,16q22.3,72397941,72522373,124432,-,-
BAC190_J19,16,16q22.3,72400057,72485250,85193,-,-
BAC103_M03,16,16q22.3,72454681,72545407,90726,-,-
BAC204_P13,16,16q22.3,72518596,72656567,137971,-,-
BAC51_D23,16,16q22.3,72562664,72647955,85291,-,-
BAC90_C06,16,16q22.3,72741875,72841648,99773,-,-
BAC65_F12,16,16q22.3,72784624,72861100,76476,-,-
BAC51_F14,16,16q22.3,72798392,72896772,98380,-,-
BAC57_I23,16,16q22.3,72801866,72925258,123392,-,-
BAC168_A01,16,16q22.3,72841650,72953966,112316,-,-
BAC218_L19,16,16q22.3,72958964,73061302,102338,-,-
BAC7_C11,16,16q22.3,72958964,73071315,112351,-,-
BAC58_J23,16,16q22.3,72985290,73092449,107159,-,-
BAC225_J11,16,16q22.3,73035711,73141969,106258,-,-
BAC225_N09,16,16q22.3,73035780,73142119,106339,-,-
BAC198_I04,16,16q22.3,73077377,73168921,91544,-,-
BAC69_K07,16,16q22.3,73142144,73251512,109368,-,-
BAC160_N07,16,16q22.3,73184150,73276861,92711,-,-
BAC133_A07,16,16q22.3-16q23.1,73210605,73322424,111819,-,-
BAC108_P06,16,16q22.3-16q23.1,73211296,73322425,111129,-,-
BAC166_N24,16,16q22.3,73220347,73288305,67958,-,-
BAC118_L15,16,16q22.3,73255656,73276860,21204,-,-
BAC59_F14,16,16q22.3-16q23.1,73276945,73487044,210099,-,-
BAC143_O09,16,16q22.3-16q23.1,73291189,73389108,97919,-,-
BAC43_D24,16,16q23.1,73302956,73499143,196187,-,-
BAC183_G05,16,16q23.1,73302956,73384688,81732,-,-
BAC24_B02,16,16q23.1,73355460,73454546,99086,-,-
BAC145_J09,16,16q23.1,73422137,73507931,85794,-,-
BAC81_O13,16,16q23.1,73454540,73567063,112523,-,-
BAC107_E18,16,16q23.1,73463451,73598194,134743,-,-
BAC161_A23,16,16q23.1,73502134,73611033,108899,-,-
BAC167_K13,16,16q23.1,73567114,73653395,86281,-,-
BAC135_K14,16,16q23.1,73634728,73729270,94542,-,-
BAC70_O17,16,16q23.1,73700090,73822422,122332,-,-
BAC10_C09,16,16q23.1,73711265,73832390,121125,-,-
BAC157_K04,16,16q23.1,73728296,73831866,103570,-,-
BAC218_H06,16,16q23.1,73763445,73881877,118432,-,-
BAC237_B15,16,16q23.1,73773038,73859639,86601,-,-
BAC80_K16,16,16q23.1,73773146,73897971,124825,-,-
BAC163_I18,16,16q23.1,73777523,73901692,124169,-,-
BAC219_I11,16,16q23.1,73822519,73972013,149494,-,-
BAC12_D23,16,16q23.1,73831250,74006173,174923,-,-
BAC54_N08,16,16q23.1,73903398,74005599,102201,-,-
BAC58_M14,16,16q23.1,73935586,74012693,77107,-,-
BAC22_F14,16,16q23.1,73989334,74088850,99516,-,-
BAC109_B15,16,16q23.1,74003785,74149469,145684,-,-
BAC191_N15,16,16q23.1,74059419,74194376,134957,-,-
BAC81_M17,16,16q23.1,74085548,74193369,107821,-,-
BAC120_K08,16,16q23.1,74085548,74194411,108863,-,-
BAC148_H13,16,16q23.1,74151917,74250627,98710,-,-
BAC161_A17,16,16q23.1,74167627,74251011,83384,-,-
BAC148_E07,16,16q23.1,74189399,74269979,80580,-,-
BAC63_P07,16,16q23.1,74246876,74348344,101468,-,-
BAC147_E23,16,16q23.1,74270020,74343933,73913,-,-
BAC186_G04,16,16q23.1,74270021,74374510,104489,-,-
BAC106_M08,16,16q23.1,74302929,74413123,110194,-,-
BAC179_P19,16,16q23.1,74363213,74463965,100752,-,-
BAC217_N01,16,16q23.1,74435502,74501002,65500,-,-
BAC16_O16,16,16q23.1,74651214,74757984,106770,-,-
BAC105_E10,16,16q23.1,74703306,74801202,97896,-,-
BAC177_B03,16,16q23.1,74739580,74850715,111135,-,-
BAC208_O09,16,16q23.1,74983706,75117653,133947,-,-
BAC39_J05,16,16q23.1,75016181,75170857,154676,-,-
BAC60_I18,16,16q23.1,75024604,75167128,142524,-,-
BAC217_P23,16,16q23.1,75129673,75244941,115268,-,-
BAC192_G19,16,16q23.1,75136710,75239605,102895,-,-
BAC182_L11,16,16q23.1,75248072,75345884,97812,-,-
BAC235_D10,16,16q23.1,75277900,75362553,84653,-,-
BAC63_B16,16,16q23.1,75386983,75499103,112120,-,-
BAC121_O21,16,16q23.1,75411375,75502432,91057,-,-
BAC185_J16,16,16q23.1,75447707,75537720,90013,-,-
BAC124_K12,16,16q23.1,75486799,75573732,86933,-,-
BAC139_N17,16,16q23.1,75547565,75659745,112180,-,-
BAC222_C17,16,16q23.1,75593614,75693863,100249,-,-
BAC199_G08,16,16q23.1,75693512,75773469,79957,-,-
BAC33_N19,16,16q23.1,75693857,75812343,118486,-,-
BAC177_N10,16,16q23.1,75693857,75777370,83513,-,-
BAC64_H14,16,16q23.1,75703610,75808685,105075,-,-
BAC200_M06,16,16q23.1,75719509,75830082,110573,-,-
BAC219_A08,16,16q23.1,75731065,75812352,81287,-,-
BAC181_C02,16,16q23.1,75816855,75912036,95181,-,-
BAC153_C14,16,16q23.1,75858200,75932887,74687,-,-
BAC143_O11,16,16q23.1,75924982,76018069,93087,-,-
BAC86_D13,16,16q23.1,75942596,76033373,90777,-,-
BAC109_N15,16,16q23.1,75987296,76092608,105312,-,-
BAC141_P17,16,16q23.1,76164878,76176436,11558,-,-
BAC105_J01,16,16q23.1,76213296,76294254,80958,-,-
BAC25_G20,16,16q23.1,76402909,76514122,111213,-,-
BAC36_G24,16,16q23.1,76425705,76565742,140037,-,-
BAC131_N17,16,16q23.1,76479365,76587163,107798,-,-
BAC195_F02,16,16q23.1,76594498,76676388,81890,-,-
BAC120_G12,16,16q23.1,76594498,76658571,64073,-,-
BAC69_I12,16,16q23.1,76603091,76693799,90708,-,-
BAC126_G19,16,16q23.1,76622867,76718418,95551,-,-
BAC132_B18,16,16q23.1,76704115,76795332,91217,-,-
BAC148_L08,16,16q23.1,76788711,76879665,90954,-,-
BAC184_O06,16,16q23.1,76812319,76902744,90425,-,-
BAC19_H15,16,16q23.1,76852885,76926192,73307,-,-
BAC178_K15,16,16q23.1,76877259,76973021,95762,-,-
BAC10_E19,16,16q23.1,76923722,77059149,135427,-,-
BAC64_A22,16,16q23.1,76932886,77041075,108189,-,-
BAC117_C22,16,16q23.1,76985259,77100556,115297,-,-
BAC222_A23,16,16q23.1,77029883,77124809,94926,-,-
BAC83_N04,16,16q23.1,77070817,77161873,91056,-,-
BAC135_H15,16,16q23.1,77084804,77175409,90605,-,-
BAC191_E01,16,16q23.1,77104158,77248843,144685,-,-
BAC8_K04,16,16q23.1,77148589,77268550,119961,-,-
BAC56_G12,16,16q23.1,77175404,77268558,93154,-,-
BAC123_G16,16,16q23.1,77175404,77255933,80529,-,-
BAC83_K14,16,16q23.1,77214603,77286866,72263,-,-
BAC172_C10,16,16q23.1,77255926,77339854,83928,-,-
BAC107_C15,16,16q23.1,77255926,77336288,80362,-,-
BAC100_I17,16,16q23.1,77255926,77467054,211128,-,-
BAC14_K03,16,16q23.1,77272361,77369950,97589,-,-
BAC240_D15,16,16q23.1,77336293,77418096,81803,-,-
BAC165_I14,16,16q23.1,77336667,77434629,97962,-,-
BAC186_F10,16,16q23.1,77358533,77442497,83964,-,-
BAC165_G16,16,16q23.1,77358533,77450644,92111,-,-
BAC12_A23,16,16q23.1,77408687,77535149,126462,-,-
BAC84_E07,16,16q23.1,77442493,77557486,114993,-,-
BAC179_F10,16,16q23.1,77511363,77612432,101069,-,-
BAC226_F21,16,16q23.1,77531430,77612432,81002,-,-
BAC140_A24,16,16q23.1,77535146,77639556,104410,-,-
BAC56_P19,16,16q23.1,77565095,77678924,113829,-,-
BAC170_H03,16,16q23.1,77577446,77678926,101480,-,-
BAC103_I11,16,16q23.1,77677764,77763170,85406,-,-
BAC113_O07,16,16q23.1,77680264,77774064,93800,-,-
BAC106_E07,16,16q23.1,77741525,77880037,138512,-,-
BAC58_C01,16,16q23.1,77765584,77815552,49968,-,-
BAC124_O05,16,16q23.1,77771715,77874375,102660,-,-
BAC191_C21,16,16q23.1,77774839,77875365,100526,-,-
BAC246_J05,16,16q23.1,77801899,77887660,85761,-,-
BAC176_P04,16,16q23.1,77875556,77987408,111852,-,-
BAC227_B01,16,16q23.1,77879225,77971294,92069,-,-
BAC97_K19,16,16q23.1,77951563,78041305,89742,-,-
BAC215_E15,16,16q23.1,77971608,78075156,103548,-,-
BAC100_M13,16,16q23.1,78011414,78123835,112421,-,-
BAC166_L11,16,16q23.1,78075149,78142836,67687,-,-
BAC223_D19,16,16q23.1-16q23.2,78124140,78223124,98984,-,-
BAC97_F04,16,16q23.1-16q23.2,78156387,78239372,82985,-,-
BAC241_O15,16,16q23.1-16q23.2,78158260,78255551,97291,-,-
BAC134_D07,16,16q23.2,78222691,78317574,94883,-,-
BAC21_H14,16,16q23.2,78269534,78370724,101190,-,-
BAC63_P02,16,16q23.2,78299186,78392962,93776,-,-
BAC139_N18,16,16q23.2,78324328,78413749,89421,-,-
BAC208_N20,16,16q23.2,78395883,78479370,83487,-,-
BAC131_P04,16,16q23.2,78486918,78577650,90732,-,-
BAC143_K12,16,16q23.2,78583318,78665219,81901,-,-
BAC135_M10,16,16q23.2,78584730,78659126,74396,-,-
BAC193_J16,16,16q23.2,78614550,78708112,93562,-,-
BAC133_L01,16,16q23.2,78614566,78693907,79341,-,-
BAC34_K13,16,16q23.2,78621882,78709536,87654,-,-
BAC48_F10,16,16q23.2,78709590,78784061,74471,-,-
BAC213_E08,16,16q23.2,78743327,78815534,72207,-,-
BAC114_A22,16,16q23.2,78782557,78873859,91302,-,-
BAC186_E16,16,16q23.2,78841967,78933801,91834,-,-
BAC172_F17,16,16q23.2,78842129,78932021,89892,-,-
BAC74_J04,16,16q23.2,78926761,79015277,88516,-,-
BAC234_D02,16,16q23.2,78926766,79069982,143216,-,-
BAC238_J04,16,16q23.2,78942704,79043174,100470,-,-
BAC160_O05,16,16q23.2,78949835,79043329,93494,-,-
BAC217_D24,16,16q23.2,78953116,79035665,82549,-,-
BAC52_I07,16,16q23.2,79064948,79172023,107075,-,-
BAC107_J17,16,16q23.2,79084649,79244863,160214,-,-
BAC116_J17,16,16q23.2,79087389,79191410,104021,-,-
BAC146_L16,16,16q23.2,79133657,79218053,84396,-,-
BAC119_P15,16,16q23.2,79163997,79264717,100720,-,-
BAC168_B07,16,16q23.2,79397806,79500997,103191,-,-
BAC200_K17,16,16q23.2,79397806,79504271,106465,-,-
BAC234_A17,16,16q23.2,79442319,79525812,83493,-,-
BAC63_M07,16,16q23.2,79483993,79590799,106806,-,-
BAC92_N10,16,16q23.2,79524383,79623660,99277,-,-
BAC33_G01,16,16q23.2,79525806,79624206,98400,-,-
BAC125_E07,16,16q23.2,79623972,79737662,113690,-,-
BAC55_M11,16,16q23.2,79628267,79757233,128966,-,-
BAC62_C15,16,16q23.2,79634386,79752191,117805,-,-
BAC173_C15,16,16q23.2,79681107,79763197,82090,-,-
BAC184_M17,16,16q23.2,79851633,79934517,82884,-,-
BAC52_D15,16,16q23.2,79937993,80114617,176624,-,-
BAC55_J20,16,16q23.2,79946133,80085466,139333,-,-
BAC75_L05,16,16q23.2,79968246,80064117,95871,-,-
BAC51_F11,16,16q23.2,80045218,80159002,113784,-,-
BAC137_M10,16,16q23.2,80064112,80167980,103868,-,-
BAC186_G14,16,16q23.2,80069315,80154363,85048,-,-
BAC181_A08,16,16q23.2,80072508,80154363,81855,-,-
BAC161_E09,16,16q23.2,80072516,80179291,106775,-,-
BAC246_B19,16,16q23.2,80114628,80212704,98076,-,-
BAC31_E19,16,16q23.2,80136498,80356727,220229,-,-
BAC185_C15,16,16q23.2,80154356,80249640,95284,-,-
BAC240_I03,16,16q23.2,80258325,80338166,79841,-,-
BAC222_E09,16,16q23.2,80258381,80363955,105574,-,-
BAC184_E20,16,16q23.2,80284675,80392151,107476,-,-
BAC153_D14,16,16q23.2,80300854,80392151,91297,-,-
BAC199_P19,16,16q23.2,80352588,80427511,74923,-,-
BAC187_A10,16,16q23.2,80356394,80497068,140674,-,-
BAC120_D10,16,16q23.2,80356394,80477563,121169,-,-
BAC198_O04,16,16q23.2,80356409,80464299,107890,-,-
BAC50_F20,16,16q23.2,80356412,80447043,90631,-,-
BAC25_H03,16,16q23.2,80356462,80477563,121101,-,-
BAC227_B11,16,16q23.2,80410790,80490695,79905,-,-
BAC120_O08,16,16q23.2-16q23.3,80436408,80535396,98988,-,-
BAC61_K03,16,16q23.2-16q23.3,80447038,80537999,90961,-,-
BAC67_J05,16,16q23.2-16q23.3,80464460,80571172,106712,-,-
BAC105_F21,16,16q23.3,80546513,80631884,85371,-,-
BAC137_G01,16,16q23.3,80580619,80658596,77977,-,-
BAC219_E15,16,16q23.3,80631175,80742127,110952,-,-
BAC8_F18,16,16q23.3,80695635,80854945,159310,-,-
BAC88_B23,16,16q23.3,80700889,80799675,98786,-,-
BAC209_P11,16,16q23.3,80800520,80899598,99078,-,-
BAC237_I06,16,16q23.3,80836916,80917024,80108,-,-
BAC48_F14,16,16q23.3,80896894,81039458,142564,-,-
BAC221_F04,16,16q23.3,80979049,81105742,126693,-,-
BAC64_L09,16,16q23.3,81011274,81100807,89533,-,-
BAC169_P10,16,16q23.3,81037208,81105780,68572,-,-
BAC247_F07,16,16q23.3,81094171,81203499,109328,-,-
BAC57_P10,16,16q23.3,81101274,81201909,100635,-,-
BAC66_B22,16,16q23.3,81128626,81237246,108620,-,-
BAC34_I19,16,16q23.3,81130103,81237254,107151,-,-
BAC19_G24,16,16q23.3,81176035,81298222,122187,-,-
BAC142_B17,16,16q23.3,81237262,81353457,116195,-,-
BAC178_G10,16,16q23.3,81306331,81403439,97108,-,-
BAC225_L08,16,16q23.3,81343729,81425646,81917,-,-
BAC165_P22,16,16q23.3,81353450,81435243,81793,-,-
BAC163_D03,16,16q23.3,81448297,81531969,83672,-,-
BAC185_I24,16,16q23.3,81448297,81538796,90499,-,-
BAC62_L08,16,16q23.3,81464007,81544582,80575,-,-
BAC134_M15,16,16q23.3,81625571,81715604,90033,-,-
BAC162_E15,16,16q23.3,81630944,81732494,101550,-,-
BAC5_E07,16,16q23.3,81657118,81747229,90111,-,-
BAC160_K21,16,16q23.3,81663781,81747229,83448,-,-
BAC57_A06,16,16q23.3,81720584,81837846,117262,-,-
BAC149_H21,16,16q23.3,81726512,81846995,120483,-,-
BAC189_D07,16,16q23.3,81790111,81923027,132916,-,-
BAC241_H03,16,16q23.3,81791247,81899421,108174,-,-
BAC103_F12,16,16q23.3,81838423,81910040,71617,-,-
BAC30_C06,16,16q23.3,81926515,82036357,109842,-,-
BAC162_E03,16,16q23.3,81964550,82085949,121399,-,-
BAC179_I14,16,16q23.3,81966865,82075096,108231,-,-
BAC167_O19,16,16q23.3,82089901,82199590,109689,-,-
BAC135_I18,16,16q23.3,82104325,82188981,84656,-,-
BAC237_C07,16,16q23.3,82115263,82208006,92743,-,-
BAC238_P17,16,16q23.3,82116456,82208006,91550,-,-
BAC73_G20,16,16q23.3,82189004,82277340,88336,-,-
BAC123_I18,16,16q23.3,82199865,82347558,147693,-,-
BAC76_B06,16,16q23.3,82208000,82310337,102337,-,-
BAC191_J18,16,16q23.3,82211727,82310321,98594,-,-
BAC62_F08,16,16q23.3,82295510,82373429,77919,-,-
BAC90_L09,16,16q23.3,82301478,82411512,110034,-,-
BAC134_N19,16,16q23.3,82301670,82442150,140480,-,-
BAC246_E05,16,16q23.3,82308870,82410734,101864,-,-
BAC52_B21,16,16q23.3,82333329,82464340,131011,-,-
BAC185_J10,16,16q23.3,82347551,82435399,87848,-,-
BAC186_A06,16,16q23.3,82347569,82450206,102637,-,-
BAC46_P05,16,16q23.3,82347598,82525145,177547,-,-
BAC42_G11,16,16q23.3,82350590,82519414,168824,-,-
BAC139_J17,16,16q23.3,82396537,82471446,74909,-,-
BAC31_P02,16,16q23.3,82435632,82626909,191277,-,-
BAC83_I20,16,16q23.3,82471439,82570400,98961,-,-
BAC151_O08,16,16q23.3,82497031,82568501,71470,-,-
BAC196_G04,16,16q23.3,82503254,82567415,64161,-,-
BAC124_F05,16,16q23.3,82545793,82667977,122184,-,-
BAC155_A24,16,16q23.3,82567409,82673601,106192,-,-
BAC33_D23,16,16q23.3,82568521,82692886,124365,-,-
BAC224_N03,16,16q23.3,82568522,82683452,114930,-,-
BAC180_B13,16,16q23.3,82594504,82691899,97395,-,-
BAC182_K13,16,16q23.3,82611589,82692405,80816,-,-
BAC151_J22,16,16q23.3-16q24.1,82650289,82744502,94213,-,-
BAC81_E04,16,16q24.1,82711277,82818639,107362,-,-
BAC1_K03,16,16q24.1,82723499,82823573,100074,-,-
BAC119_G17,16,16q24.1,82725979,82834185,108206,-,-
BAC151_I07,16,16q24.1,82732775,82839958,107183,-,-
BAC208_L20,16,16q24.1,82732822,82818635,85813,-,-
BAC145_N07,16,16q24.1,82744991,82830446,85455,-,-
BAC32_J12,16,16q24.1,82761079,82885567,124488,-,-
BAC205_A15,16,16q24.1,82823131,82933638,110507,-,-
BAC248_P17,16,16q24.1,82842475,82961319,118844,-,-
BAC118_B05,16,16q24.1,82844926,82985790,140864,-,-
BAC80_G22,16,16q24.1,82844926,82965669,120743,-,-
BAC168_I08,16,16q24.1,82860188,82965414,105226,-,-
BAC200_G15,16,16q24.1,82918287,83039831,121544,-,-
BAC235_N05,16,16q24.1,82933781,83013331,79550,-,-
BAC37_P14,16,16q24.1,82933786,83057005,123219,-,-
BAC156_G11,16,16q24.1,83026654,83108864,82210,-,-
BAC94_N19,16,16q24.1,83039015,83182291,143276,-,-
BAC204_D21,16,16q24.1,83080299,83169176,88877,-,-
BAC50_J22,16,16q24.1,83129148,83235201,106053,-,-
BAC1_H23,16,16q24.1,83151308,83281476,130168,-,-
BAC213_M08,16,16q24.1,83158652,83254810,96158,-,-
BAC117_H18,16,16q24.1,83169255,83276450,107195,-,-
BAC165_C11,16,16q24.1,83169255,83276522,107267,-,-
BAC240_P05,16,16q24.1,83182367,83253572,71205,-,-
BAC140_B24,16,16q24.1,83183987,83274934,90947,-,-
BAC171_J16,16,16q24.1,83214250,83325665,111415,-,-
BAC96_F15,16,16q24.1,83229619,83332436,102817,-,-
BAC236_N07,16,16q24.1,83275328,83373590,98262,-,-
BAC179_C21,16,16q24.1,83275328,83379879,104551,-,-
BAC76_N23,16,16q24.1,83275328,83363749,88421,-,-
BAC179_H17,16,16q24.1,83292378,83373590,81212,-,-
BAC8_P16,16,16q24.1,83332430,83450012,117582,-,-
BAC130_J07,16,16q24.1,83333389,83402004,68615,-,-
BAC115_F14,16,16q24.1,83368258,83548673,180415,-,-
BAC233_P04,16,16q24.1,83401306,83568509,167203,-,-
BAC34_O10,16,16q24.1,83401998,83517409,115411,-,-
BAC220_N04,16,16q24.1,83419670,83548521,128851,-,-
BAC170_D16,16,16q24.1,83468312,83568149,99837,-,-
BAC146_C21,16,16q24.1,83478347,83570983,92636,-,-
BAC178_M04,16,16q24.1,83620960,83702956,81996,-,-
BAC223_P07,16,16q24.1,83621248,83736710,115462,-,-
BAC250_M10,16,16q24.1,83621282,83732922,111640,-,-
BAC238_K15,16,16q24.1,83622442,83716440,93998,-,-
BAC158_E10,16,16q24.1,83622442,83717090,94648,-,-
BAC217_D16,16,16q24.1,83766685,83853904,87219,-,-
BAC223_N06,16,16q24.1,83780193,83870134,89941,-,-
BAC85_E21,16,16q24.1,83853897,83941711,87814,-,-
BAC26_F13,16,16q24.1,83853902,83941714,87812,-,-
BAC60_C23,16,16q24.1,83873153,83943452,70299,-,-
BAC233_P06,16,16q24.1,83956952,84046867,89915,-,-
BAC242_M14,16,16q24.1,83990735,84090081,99346,-,-
BAC219_B03,16,16q24.1,84027156,84105253,78097,-,-
BAC155_I18,16,16q24.1,84134679,84221917,87238,-,-
BAC123_G11,16,16q24.1,84134688,84237496,102808,-,-
BAC19_O09,16,16q24.1,84237485,84328933,91448,-,-
BAC235_H02,16,16q24.1,84325590,84433486,107896,-,-
BAC235_H10,16,16q24.1,84388878,84485705,96827,-,-
BAC25_O12,16,16q24.1,84491140,84583390,92250,-,-
BAC89_G02,16,16q24.1,84499353,84584956,85603,-,-
BAC193_M23,16,16q24.1,84520791,84601032,80241,-,-
BAC66_E06,16,16q24.1,84525915,84635384,109469,-,-
BAC126_E02,16,16q24.1,84529651,84649880,120229,-,-
BAC122_L21,16,16q24.1,84529667,84649758,120091,-,-
BAC88_J21,16,16q24.1,84546458,84678567,132109,-,-
BAC86_J09,16,16q24.1,84554626,84667868,113242,-,-
BAC60_E18,16,16q24.1,84590434,84747802,157368,-,-
BAC127_J09,16,16q24.1,84698396,84806695,108299,-,-
BAC252_O21,16,16q24.1,84708463,84794695,86232,-,-
BAC243_H03,16,16q24.1,84711638,84806606,94968,-,-
BAC129_B22,16,16q24.1,84843105,84927324,84219,-,-
BAC56_B24,16,16q24.1,84871022,84981385,110363,-,-
BAC71_H12,16,16q24.1,84883744,84978166,94422,-,-
BAC224_D24,16,16q24.1,84894888,84994666,99778,-,-
BAC178_P09,16,16q24.1,84894888,84978166,83278,-,-
BAC80_D19,16,16q24.1,84963815,85052110,88295,-,-
BAC217_J19,16,16q24.1,84963815,85052138,88323,-,-
BAC119_K09,16,16q24.1,85066171,85209983,143812,-,-
BAC168_D16,16,16q24.1,85068672,85173517,104845,-,-
BAC27_J13,16,16q24.1,85161907,85315539,153632,-,-
BAC75_K21,16,16q24.1,85184510,85280988,96478,-,-
BAC110_C04,16,16q24.1,85205842,85308488,102646,-,-
BAC141_F10,16,16q24.1,85209975,85308675,98700,-,-
BAC36_K06,16,16q24.1,85209975,85318000,108025,-,-
BAC86_I20,16,16q24.1,85209975,85344854,134879,-,-
BAC70_D05,16,16q24.1,85244981,85344095,99114,-,-
BAC129_O14,16,16q24.1,85251003,85344854,93851,-,-
BAC219_O05,16,16q24.1,85252087,85354740,102653,-,-
BAC46_J22,16,16q24.1,85281064,85408932,127868,-,-
BAC31_F10,16,16q24.1,85321355,85420651,99296,-,-
BAC195_G12,16,16q24.1,85344847,85442048,97201,-,-
BAC50_M21,16,16q24.1,85412039,85502143,90104,-,-
BAC193_L10,16,16q24.1,85442396,85543552,101156,-,-
BAC81_E16,16,16q24.2,85714745,85823767,109022,-,-
BAC78_G18,16,16q24.2,85769306,85881323,112017,-,-
BAC64_P01,16,16q24.2,85823759,85913599,89840,-,-
BAC161_P13,16,16q24.2,85834331,85920717,86386,-,-
BAC37_F04,16,16q24.2,85836813,85982033,145220,-,-
BAC69_P14,16,16q24.2,86112907,86214987,102080,-,-
BAC162_D02,16,16q24.2,86124446,86214655,90209,-,-
BAC154_J02,16,16q24.2,86190516,86259592,69076,-,-
BAC228_B09,16,16q24.2,86214980,86304991,90011,-,-
BAC110_G14,16,16q24.2,86214980,86317223,102243,-,-
BAC120_O24,16,16q24.2,86238191,86412896,174705,-,-
BAC141_P15,16,16q24.2,86424980,86547441,122461,-,-
BAC126_M01,16,16q24.2,86475977,86574663,98686,-,-
BAC162_M18,16,16q24.2,86486782,86571898,85116,-,-
BAC165_I13,16,16q24.2,86486782,86569468,82686,-,-
BAC16_D10,16,16q24.2,86519024,86637205,118181,-,-
BAC166_L05,16,16q24.2,86561437,86682717,121280,-,-
BAC170_C10,16,16q24.2,86607783,86710304,102521,-,-
BAC121_H21,16,16q24.2,86615367,86646207,30840,-,-
BAC105_G04,16,16q24.2,86636205,86720973,84768,-,-
BAC24_A04,16,16q24.2,86719882,86817430,97548,-,-
BAC188_D02,16,16q24.2,86775170,86852647,77477,-,-
BAC208_G18,16,16q24.2,87042168,87147621,105453,-,-
BAC249_N19,16,16q24.2-16q24.3,87109433,87246836,137403,-,-
BAC183_F22,16,16q24.2-16q24.3,87109435,87246836,137401,-,-
BAC54_O09,16,16q24.2-16q24.3,87109435,87214227,104792,-,-
BAC72_F02,16,16q24.2-16q24.3,87118637,87214239,95602,-,-
BAC36_A14,16,16q24.3,87236355,87320176,83821,-,-
BAC185_A20,16,16q24.3,87373901,87446657,72756,-,-
BAC25_N24,16,16q24.3,87473666,87567737,94071,-,-
BAC126_N21,16,16q24.3,87538812,87614538,75726,-,-
BAC65_J09,16,16q24.3,87582436,87693355,110919,-,-
BAC218_L18,16,16q24.3,87705473,87801380,95907,-,-
BAC36_K13,16,16q24.3,87705473,87865821,160348,-,-
BAC226_C13,16,16q24.3,87711742,87810435,98693,-,-
BAC66_C15,16,16q24.3,87734409,87820657,86248,-,-
BAC173_M22,16,16q24.3,87734440,87829132,94692,-,-
BAC70_M06,16,16q24.3,87749393,87881203,131810,-,-
BAC168_K07,16,16q24.3,87810543,87896914,86371,-,-
BAC175_O14,16,16q24.3,87811532,87896503,84971,-,-
BAC92_N07,16,16q24.3,87829129,87923300,94171,-,-
BAC238_J10,16,16q24.3,87881195,87955642,74447,-,-
BAC96_I21,16,16q24.3,87896494,88032011,135517,-,-
BAC131_P11,16,16q24.3,87929702,88040898,111196,-,-
BAC18_L03,16,16q24.3,87958836,88066030,107194,-,-
BAC83_P21,16,16q24.3,87974040,88075829,101789,-,-
BAC193_N17,16,16q24.3,87995349,88080356,85007,-,-
BAC240_D14,16,16q24.3,88004779,88080356,75577,-,-
BAC148_J22,16,16q24.3,88110845,88205164,94319,yes,-
BAC20_J19,16,16q24.3,88123184,88205136,81952,-,-
BAC72_M12,16,16q24.3,88157706,88238319,80613,-,-
BAC206_C22,16,16q24.3,88238348,88314719,76371,-,-
BAC179_I22,16,16q24.3,88327305,88481502,154197,yes,-
BAC235_K16,16,16q24.3,88335689,88417638,81949,-,-
BAC101_G17,16,16q24.3,88335689,88417595,81906,-,-
BAC94_H05,16,16q24.3,88341278,88443558,102280,-,-
BAC229_H15,16,16q24.3,88404513,88490937,86424,-,-
BAC81_A11,16,16q24.3,88527227,88608575,81348,-,-
BAC156_A11,17,17p13.3,26910,131898,104988,-,-
BAC95_J10,17,17p13.3,26911,101177,74266,-,-
BAC25_B05,17,17p13.3,101176,264216,163040,-,-
BAC197_A20,17,17p13.3,116756,217901,101145,-,-
BAC66_O11,17,17p13.3,117610,225797,108187,-,-
BAC219_G17,17,17p13.3,131891,204467,72576,-,-
BAC152_F14,17,17p13.3,137137,217905,80768,-,-
BAC82_D02,17,17p13.3,141773,233845,92072,-,-
BAC110_O13,17,17p13.3,157851,293897,136046,-,-
BAC199_F13,17,17p13.3,157861,233765,75904,-,-
BAC226_F20,17,17p13.3,403054,503791,100737,-,-
BAC84_C19,17,17p13.3,410092,517277,107185,-,-
BAC49_N19,17,17p13.3,410116,544833,134717,-,-
BAC220_M24,17,17p13.3,517657,603564,85907,-,-
BAC34_H06,17,17p13.3,517657,603533,85876,-,-
BAC119_A07,17,17p13.3,550614,647698,97084,-,-
BAC132_D18,17,17p13.3,668423,778426,110003,-,-
BAC39_L09,17,17p13.3,668423,778415,109992,-,-
BAC141_P05,17,17p13.3,675233,749664,74431,-,-
BAC32_G05,17,17p13.3,778469,906402,127933,-,-
BAC160_I09,17,17p13.3,814500,906997,92497,-,-
BAC71_H10,17,17p13.3,878540,1022422,143882,-,-
BAC55_J01,17,17p13.3,907028,1041325,134297,-,-
BAC31_I23,17,17p13.3,907028,991647,84619,-,-
BAC104_O02,17,17p13.3,907029,1022421,115392,-,-
BAC159_N11,17,17p13.3,927360,1052807,125447,-,-
BAC184_G24,17,17p13.3,969716,1068276,98560,-,-
BAC38_B05,17,17p13.3,997956,1110912,112956,-,-
BAC142_M22,17,17p13.3,1007313,1071979,64666,-,-
BAC217_L13,17,17p13.3,1041420,1120339,78919,-,-
BAC97_J24,17,17p13.3,1043628,1149210,105582,-,-
BAC210_O09,17,17p13.3,1044057,1186567,142510,-,-
BAC83_M10,17,17p13.3,1080356,1229977,149621,-,-
BAC184_P01,17,17p13.3,1107050,1204791,97741,-,-
BAC163_F14,17,17p13.3,1149201,1261315,112114,-,-
BAC184_G09,17,17p13.3,1149203,1247831,98628,-,-
BAC171_F06,17,17p13.3,1149208,1228412,79204,-,-
BAC80_A10,17,17p13.3,1177519,1289221,111702,-,-
BAC180_C17,17,17p13.3,1221521,1372927,151406,-,-
BAC78_F20,17,17p13.3,1342456,1511236,168780,-,-
BAC217_H14,17,17p13.3,1359371,1468144,108773,-,-
BAC163_D12,17,17p13.3,1359533,1482497,122964,-,-
BAC65_K23,17,17p13.3,1402505,1568710,166205,-,-
BAC101_E22,17,17p13.3,1458880,1613388,154508,yes,-
BAC150_P22,17,17p13.3,1458899,1568693,109794,-,-
BAC12_I17,17,17p13.3,1500310,1613127,112817,yes,-
BAC40_H23,17,17p13.3,1509610,1604509,94899,-,-
BAC19_O21,17,17p13.3,1568894,1711101,142207,yes,-
BAC95_G19,17,17p13.3,1613122,1716057,102935,-,-
BAC106_M10,17,17p13.3,1616644,1696352,79708,-,-
BAC69_C07,17,17p13.3,1616696,1711100,94404,-,-
BAC84_M16,17,17p13.3,1622621,1730357,107736,-,-
BAC237_F04,17,17p13.3,1632257,1716057,83800,-,-
BAC112_N05,17,17p13.3,1632257,1735188,102931,-,-
BAC84_D10,17,17p13.3,1632257,1731362,99105,-,-
BAC209_C22,17,17p13.3,1677914,1790784,112870,-,-
BAC80_M08,17,17p13.3,1730363,1824483,94120,-,-
BAC59_L21,17,17p13.3,1734262,1890626,156364,-,-
BAC224_E13,17,17p13.3,1743623,1824480,80857,-,-
BAC39_H21,17,17p13.3,1760066,1912046,151980,-,-
BAC162_C13,17,17p13.3,1769389,1830505,61116,-,-
BAC8_D13,17,17p13.3,1787485,1918533,131048,-,-
BAC34_O15,17,17p13.3,1792417,1882741,90324,-,-
BAC219_B09,17,17p13.3,1794152,1937686,143534,-,-
BAC160_N09,17,17p13.3,1819636,1912046,92410,-,-
BAC91_M16,17,17p13.3,1819636,1918540,98904,-,-
BAC50_H10,17,17p13.3,1882806,1977548,94742,-,-
BAC153_G02,17,17p13.3,1890682,1976759,86077,-,-
BAC126_D23,17,17p13.3,1890694,1971138,80444,-,-
BAC109_H09,17,17p13.3,1922909,2112208,189299,-,-
BAC122_J08,17,17p13.3,2053519,2147401,93882,-,-
BAC40_D11,17,17p13.3,2060847,2196931,136084,-,-
BAC176_L20,17,17p13.3,2115130,2208260,93130,-,-
BAC188_G13,17,17p13.3,2133782,2208260,74478,-,-
BAC183_G10,17,17p13.3,2184167,2285943,101776,-,-
BAC82_M13,17,17p13.3,2208254,2334180,125926,-,-
BAC125_I23,17,17p13.3,2222759,2317145,94386,-,-
BAC226_F05,17,17p13.3,2226521,2316833,90312,-,-
BAC175_K10,17,17p13.3,2226521,2316833,90312,-,-
BAC89_M06,17,17p13.3,2233917,2328531,94614,-,-
BAC46_G14,17,17p13.3,2256887,2334175,77288,-,-
BAC157_B02,17,17p13.3,2320364,2431047,110683,-,-
BAC234_G19,17,17p13.3,2328526,2442195,113669,-,-
BAC237_P03,17,17p13.3,2340899,2431047,90148,-,-
BAC63_J08,17,17p13.3,2340899,2445465,104566,-,-
BAC10_A05,17,17p13.3,2374448,2474911,100463,-,-
BAC190_F10,17,17p13.3,2388499,2488318,99819,-,-
BAC186_M15,17,17p13.3,2460766,2633700,172934,-,-
BAC195_P05,17,17p13.3,2493343,2574271,80928,-,-
BAC135_N07,17,17p13.3,2510283,2624227,113944,-,-
BAC148_F06,17,17p13.3,2517812,2603600,85788,-,-
BAC31_H03,17,17p13.3,2517823,2603600,85777,-,-
BAC40_E12,17,17p13.3,2717362,2820750,103388,-,-
BAC194_G14,17,17p13.3,2741560,2830385,88825,-,-
BAC26_P17,17,17p13.3,2765241,2865457,100216,-,-
BAC247_D10,17,17p13.3,2812258,2891554,79296,-,-
BAC36_N06,17,17p13.3,2812737,2920705,107968,-,-
BAC122_O10,17,17p13.3,2954121,3114740,160619,-,-
BAC106_K05,17,17p13.3,3008444,3195977,187533,-,-
BAC53_A19,17,17p13.3,3044116,3171798,127682,-,-
BAC154_K10,17,17p13.3,3064157,3158608,94451,-,-
BAC43_H08,17,17p13.3,3081395,3156624,75229,-,-
BAC232_E03,17,17p13.3,3118666,3195977,77311,-,-
BAC41_O19,17,17p13.3,3123943,3240240,116297,-,-
BAC35_K08,17,17p13.3,3252030,3371403,119373,-,-
BAC73_C22,17,17p13.3,3294644,3380432,85788,-,-
BAC200_I19,17,17p13.3,3350730,3434697,83967,-,-
BAC187_H23,17,17p13.3,3380426,3415025,34599,-,-
BAC217_A05,17,17p13.3,3414677,3495507,80830,-,-
BAC186_H22,17,17p13.3,3433163,3553138,119975,-,-
BAC33_O16,17,17p13.3-17p13.2,3510713,3617937,107224,-,-
BAC192_G13,17,17p13.3-17p13.2,3517428,3610796,93368,-,-
BAC220_J10,17,17p13.3-17p13.2,3548798,3640019,91221,-,-
BAC182_H21,17,17p13.3-17p13.2,3550932,3687776,136844,-,-
BAC213_P02,17,17p13.3-17p13.2,3551292,3629807,78515,-,-
BAC195_B08,17,17p13.2,3611108,3709743,98635,-,-
BAC151_J24,17,17p13.2,3712452,3808110,95658,-,-
BAC145_N20,17,17p13.2,3712452,3811623,99171,-,-
BAC246_O19,17,17p13.2,3712532,3789323,76791,-,-
BAC237_H14,17,17p13.2,3818327,3907150,88823,-,-
BAC24_P06,17,17p13.2,3845154,3928631,83477,-,-
BAC118_M12,17,17p13.2,3922343,4034022,111679,-,-
BAC177_A22,17,17p13.2,3922362,4016138,93776,-,-
BAC8_J04,17,17p13.2,3922376,4099758,177382,-,-
BAC73_A18,17,17p13.2,3928656,4007717,79061,-,-
BAC144_E16,17,17p13.2,3955924,4063240,107316,-,-
BAC250_F14,17,17p13.2,3960461,4063237,102776,-,-
BAC6_J05,17,17p13.2,3976541,4117910,141369,-,-
BAC142_D02,17,17p13.2,4016149,4110376,94227,-,-
BAC52_H24,17,17p13.2,4034012,4126849,92837,-,-
BAC221_D21,17,17p13.2,4114295,4214163,99868,-,-
BAC236_B12,17,17p13.2,4174223,4270947,96724,-,-
BAC197_G12,17,17p13.2,4197928,4367078,169150,-,-
BAC51_I06,17,17p13.2,4252312,4348180,95868,-,-
BAC165_K05,17,17p13.2,4274498,4360372,85874,-,-
BAC39_E15,17,17p13.2,4409690,4573039,163349,-,-
BAC1_A10,17,17p13.2,4472779,4571202,98423,-,-
BAC219_K06,17,17p13.2,4496424,4575443,79019,-,-
BAC27_B12,17,17p13.2,4800266,4938806,138540,-,-
BAC189_A24,17,17p13.2,4882789,4895770,12981,-,-
BAC163_I08,17,17p13.2,4921821,5063966,142145,-,-
BAC17_D10,17,17p13.2,4992594,5109255,116661,-,-
BAC19_L13,17,17p13.2,4992944,5103959,111015,-,-
BAC140_E06,17,17p13.2,4998742,5072364,73622,-,-
BAC58_D19,17,17p13.2,4998742,5099505,100763,-,-
BAC50_B02,17,17p13.2,5005052,5098896,93844,-,-
BAC134_O19,17,17p13.2,5047148,5132011,84863,-,-
BAC38_J10,17,17p13.2,5098904,5216177,117273,-,-
BAC124_A19,17,17p13.2,5132006,5283768,151762,-,-
BAC61_E13,17,17p13.2,5132050,5255139,123089,-,-
BAC233_J22,17,17p13.2,5134530,5218421,83891,-,-
BAC11_M16,17,17p13.2,5144211,5250663,106452,-,-
BAC112_B03,17,17p13.2,5146630,5255163,108533,-,-
BAC152_P06,17,17p13.2,5146634,5234561,87927,-,-
BAC50_C23,17,17p13.2,5152600,5293759,141159,-,-
BAC76_P20,17,17p13.2,5216485,5311806,95321,-,-
BAC86_E11,17,17p13.2,5256107,5357071,100964,-,-
BAC244_C15,17,17p13.2,5293770,5418118,124348,-,-
BAC93_O20,17,17p13.2,5302468,5402443,99975,-,-
BAC22_O01,17,17p13.2,5334776,5439215,104439,-,-
BAC221_K09,17,17p13.2,5364373,5439171,74798,-,-
BAC196_C21,17,17p13.2,5364373,5456945,92572,-,-
BAC59_H08,17,17p13.2,5384529,5499156,114627,-,-
BAC249_D04,17,17p13.2,5417363,5499156,81793,-,-
BAC186_L02,17,17p13.2,5417365,5511826,94461,-,-
BAC227_E10,17,17p13.2,5418328,5519313,100985,-,-
BAC238_L13,17,17p13.2,5456939,5530718,73779,-,-
BAC177_P17,17,17p13.2,5516808,5643934,127126,-,-
BAC116_C16,17,17p13.2,5530721,5634400,103679,-,-
BAC27_M06,17,17p13.2,5539290,5647717,108427,-,-
BAC29_P19,17,17p13.2,5581404,5670211,88807,-,-
BAC177_D18,17,17p13.2,5581404,5671483,90079,-,-
BAC235_J06,17,17p13.2,5608583,5697909,89326,-,-
BAC244_P17,17,17p13.2,5649100,5736977,87877,-,-
BAC155_O16,17,17p13.2,5670212,5788325,118113,-,-
BAC244_A05,17,17p13.2,5697922,5787448,89526,-,-
BAC202_I14,17,17p13.2,5787287,5869699,82412,-,-
BAC8_H18,17,17p13.2,5795825,5888919,93094,-,-
BAC96_J24,17,17p13.2,5830607,5969091,138484,-,-
BAC56_O24,17,17p13.2,5875771,5959606,83835,-,-
BAC175_C01,17,17p13.2,5917320,6016341,99021,-,-
BAC23_A12,17,17p13.2,5954874,6063277,108403,-,-
BAC222_P03,17,17p13.2,5955070,6055472,100402,-,-
BAC52_N09,17,17p13.2,5960732,6125654,164922,-,-
BAC39_P08,17,17p13.2,5961153,6066312,105159,-,-
BAC51_L21,17,17p13.2,5969086,6080720,111634,-,-
BAC66_D12,17,17p13.2,5972576,6063277,90701,-,-
BAC101_L07,17,17p13.2,6036028,6159952,123924,-,-
BAC246_H20,17,17p13.2,6095814,6189996,94182,-,-
BAC247_D09,17,17p13.2,6128158,6289752,161594,-,-
BAC6_L11,17,17p13.2,6190181,6286165,95984,-,-
BAC217_J12,17,17p13.2,6220964,6324737,103773,-,-
BAC78_J08,17,17p13.2,6223254,6370502,147248,-,-
BAC48_L15,17,17p13.2,6244577,6370073,125496,-,-
BAC240_H18,17,17p13.2,6270416,6408746,138330,-,-
BAC84_F22,17,17p13.2,6286160,6383245,97085,-,-
BAC157_M23,17,17p13.2,6289743,6349967,60224,-,-
BAC149_M14,17,17p13.2,6289746,6366918,77172,-,-
BAC156_C19,17,17p13.2,6461750,6544518,82768,-,-
BAC82_N22,17,17p13.2,6474193,6576335,102142,-,-
BAC147_G23,17,17p13.2,6480192,6563535,83343,-,-
BAC134_C20,17,17p13.2,6544584,6692610,148026,-,-
BAC184_G11,17,17p13.2,6602249,6684648,82399,-,-
BAC77_K20,17,17p13.2,6684928,6782590,97662,-,-
BAC106_L03,17,17p13.2,6699110,6798714,99604,-,-
BAC102_E07,17,17p13.2-17p13.1,6760307,6846669,86362,-,-
BAC23_L04,17,17p13.2-17p13.1,6782623,6930484,147861,-,-
BAC194_B17,17,17p13.1,6810597,6910073,99476,-,-
BAC26_B22,17,17p13.1,6819256,6946803,127547,-,-
BAC105_J05,17,17p13.1,6864990,6996756,131766,-,-
BAC69_B12,17,17p13.1,6864990,6942060,77070,-,-
BAC129_P06,17,17p13.1,6883520,6975849,92329,-,-
BAC55_G19,17,17p13.1,7069957,7193789,123832,-,-
BAC86_F21,17,17p13.1,7098428,7193789,95361,-,-
BAC135_O22,17,17p13.1,7178940,7254172,75232,-,-
BAC167_N13,17,17p13.1,7178942,7254172,75230,-,-
BAC195_A24,17,17p13.1,7193842,7288194,94352,-,-
BAC187_L17,17,17p13.1,7242582,7331930,89348,-,-
BAC185_O03,17,17p13.1,7297649,7427694,130045,-,-
BAC88_C08,17,17p13.1,7435948,7531283,95335,-,-
BAC70_B10,17,17p13.1,7459912,7604402,144490,-,-
BAC162_I14,17,17p13.1,7538977,7682983,144006,-,-
BAC75_B21,17,17p13.1,7604524,7692190,87666,-,-
BAC106_M24,17,17p13.1,7619080,7707083,88003,-,-
BAC68_E01,17,17p13.1,7627998,7717045,89047,-,-
BAC235_H04,17,17p13.1,7662576,7805359,142783,-,-
BAC249_B13,17,17p13.1,7662586,7747716,85130,-,-
BAC235_N12,17,17p13.1,7717039,7805359,88320,-,-
BAC230_C18,17,17p13.1,7719266,7810343,91077,-,-
BAC65_D12,17,17p13.1,7730648,7828621,97973,-,-
BAC232_L02,17,17p13.1,7801618,7862879,61261,-,-
BAC114_J19,17,17p13.1,7853041,7948709,95668,-,-
BAC77_F14,17,17p13.1,7971262,8079723,108461,-,-
BAC120_J09,17,17p13.1,8062196,8149655,87459,-,-
BAC238_B02,17,17p13.1,8101874,8188969,87095,-,-
BAC101_F10,17,17p13.1,8179754,8276921,97167,-,-
BAC1_L24,17,17p13.1,8252600,8365421,112821,-,-
BAC233_E01,17,17p13.1,8270681,8365421,94740,-,-
BAC20_F16,17,17p13.1,8288926,8373533,84607,-,-
BAC109_D11,17,17p13.1,8408325,8495048,86723,-,-
BAC156_I14,17,17p13.1,8618356,8694342,75986,-,-
BAC158_I12,17,17p13.1,8633351,8739545,106194,-,-
BAC182_G20,17,17p13.1,8655844,8739505,83661,-,-
BAC50_E11,17,17p13.1,8665403,8765884,100481,-,-
BAC103_N10,17,17p13.1,8792308,8916290,123982,-,-
BAC66_D07,17,17p13.1,8795770,8902675,106905,-,-
BAC157_D04,17,17p13.1,8807699,8907459,99760,-,-
BAC198_N21,17,17p13.1,8958361,9096651,138290,-,-
BAC196_A17,17,17p13.1,8961503,9096651,135148,-,-
BAC240_L21,17,17p13.1,8961830,9098082,136252,-,-
BAC200_M05,17,17p13.1,9003380,9112032,108652,-,-
BAC174_A05,17,17p13.1,9036031,9135148,99117,-,-
BAC178_G21,17,17p13.1,9061918,9187853,125935,-,-
BAC129_H08,17,17p13.1,9061919,9192842,130923,-,-
BAC132_K08,17,17p13.1,9061923,9162307,100384,-,-
BAC166_K23,17,17p13.1,9096696,9187845,91149,-,-
BAC34_H14,17,17p13.1,9096697,9192842,96145,-,-
BAC119_J03,17,17p13.1,9096919,9191425,94506,-,-
BAC190_L04,17,17p13.1,9098076,9192842,94766,-,-
BAC221_O03,17,17p13.1,9098088,9192842,94754,-,-
BAC142_A02,17,17p13.1,9141452,9222243,80791,-,-
BAC37_A16,17,17p13.1,9154776,9257130,102354,-,-
BAC223_K07,17,17p13.1,9162595,9257133,94538,-,-
BAC184_L06,17,17p13.1,9257150,9332367,75217,-,-
BAC110_N17,17,17p13.1,9276841,9357094,80253,-,-
BAC68_C02,17,17p13.1,9333752,9529450,195698,-,-
BAC230_M07,17,17p13.1,9364780,9511726,146946,-,-
BAC172_C03,17,17p13.1,9411299,9485440,74141,-,-
BAC87_O24,17,17p13.1,9413594,9502150,88556,-,-
BAC20_G21,17,17p13.1,9502328,9614265,111937,-,-
BAC77_M22,17,17p13.1,9511905,9607967,96062,-,-
BAC236_D04,17,17p13.1,9603377,9681419,78042,-,-
BAC19_G22,17,17p13.1,9614363,9732287,117924,-,-
BAC119_B20,17,17p13.1,9654276,9736484,82208,-,-
BAC177_M24,17,17p13.1,9654347,9736477,82130,-,-
BAC150_A15,17,17p13.1,9674933,9785738,110805,-,-
BAC24_E11,17,17p13.1,9674936,9814988,140052,-,-
BAC205_A20,17,17p13.1,9709379,9783267,73888,-,-
BAC183_J05,17,17p13.1,9727546,9816170,88624,-,-
BAC118_I10,17,17p13.1,9756629,9937594,180965,-,-
BAC115_D09,17,17p13.1,9783670,9865386,81716,-,-
BAC160_P15,17,17p13.1,9804999,9892606,87607,-,-
BAC117_E05,17,17p13.1,9847709,9979762,132053,-,-
BAC61_K23,17,17p13.1,9865394,9991800,126406,-,-
BAC191_C24,17,17p13.1,9897959,10028967,131008,-,-
BAC99_C14,17,17p13.1,9898142,10009595,111453,-,-
BAC80_B12,17,17p13.1,9939348,10111420,172072,-,-
BAC167_N02,17,17p13.1,9943321,10016030,72709,-,-
BAC158_P05,17,17p13.1,9995388,10096058,100670,-,-
BAC175_L09,17,17p13.1,10029294,10118324,89030,-,-
BAC25_K23,17,17p13.1,10072853,10165598,92745,-,-
BAC232_P06,17,17p13.1,10145877,10265699,119822,-,-
BAC183_E23,17,17p13.1,10179948,10265766,85818,-,-
BAC196_P17,17,17p13.1,10190990,10290706,99716,-,-
BAC117_F01,17,17p13.1,10232163,10336750,104587,-,-
BAC243_O10,17,17p13.1,10240163,10325682,85519,-,-
BAC189_G08,17,17p13.1,10249411,10355838,106427,-,-
BAC241_O18,17,17p13.1,10401784,10483547,81763,-,-
BAC59_B19,17,17p13.1,10455580,10585533,129953,-,-
BAC63_G19,17,17p13.1,10500074,10585533,85459,-,-
BAC126_H01,17,17p13.1,10555545,10641950,86405,-,-
BAC33_O19,17,17p13.1,10600489,10724338,123849,-,-
BAC199_E20,17,17p13.1,10801644,10937032,135388,-,-
BAC87_M12,17,17p13.1,10801874,10920573,118699,-,-
BAC179_J04,17,17p13.1,10833776,10957476,123700,-,-
BAC243_J03,17,17p13.1,10872757,10957415,84658,-,-
BAC191_N19,17,17p13.1,10947150,11034033,86883,-,-
BAC41_K23,17,17p13.1,10955851,11064010,108159,-,-
BAC21_N19,17,17p13.1,10989298,11155602,166304,-,-
BAC142_A21,17,17p13.1,11029088,11122780,93692,-,-
BAC103_L04,17,17p13.1-17p12,11165849,11305370,139521,-,-
BAC107_P18,17,17p12,11203499,11286543,83044,-,-
BAC184_E12,17,17p12,11206784,11286543,79759,-,-
BAC170_J20,17,17p12,11210731,11290366,79635,-,-
BAC244_P11,17,17p12,11210732,11305380,94648,-,-
BAC8_K12,17,17p12,11291790,11400654,108864,-,-
BAC140_N23,17,17p12,11295882,11375797,79915,-,-
BAC146_B18,17,17p12,11295885,11392434,96549,-,-
BAC135_B22,17,17p12,11333730,11413041,79311,-,-
BAC132_M20,17,17p12,11340444,11455770,115326,-,-
BAC55_K14,17,17p12,11340452,11482283,141831,-,-
BAC88_C04,17,17p12,11353063,11476710,123647,-,-
BAC102_K14,17,17p12,11400649,11509404,108755,-,-
BAC14_K07,17,17p12,11476704,11596391,119687,-,-
BAC232_H07,17,17p12,11556913,11627143,70230,-,-
BAC140_D17,17,17p12,11562595,11688802,126207,-,-
BAC83_N02,17,17p12,11565761,11678019,112258,-,-
BAC242_M01,17,17p12,11581742,11666728,84986,-,-
BAC22_A20,17,17p12,11596385,11688797,92412,-,-
BAC32_E15,17,17p12,11659916,11745737,85821,-,-
BAC73_J03,17,17p12,11688827,11800102,111275,-,-
BAC59_M14,17,17p12,11694056,11817241,123185,-,-
BAC80_D06,17,17p12,11745908,11836521,90613,-,-
BAC244_J05,17,17p12,11746430,11851319,104889,-,-
BAC70_M12,17,17p12,11822909,11926242,103333,-,-
BAC148_O20,17,17p12,11854090,11950098,96008,-,-
BAC51_B20,17,17p12,11867283,11958191,90908,-,-
BAC233_L11,17,17p12,11907575,11981837,74262,-,-
BAC195_G15,17,17p12,11944591,12024557,79966,-,-
BAC154_C22,17,17p12,11979148,12054994,75846,-,-
BAC195_F23,17,17p12,12002929,12104773,101844,-,-
BAC116_C19,17,17p12,12010131,12101356,91225,-,-
BAC26_H06,17,17p12,12017885,12114527,96642,-,-
BAC168_E04,17,17p12,12032413,12150991,118578,-,-
BAC200_M22,17,17p12,12035372,12114514,79142,-,-
BAC36_P09,17,17p12,12075711,12206789,131078,-,-
BAC76_M23,17,17p12,12117088,12215959,98871,-,-
BAC218_N09,17,17p12,12118312,12210203,91891,-,-
BAC52_M10,17,17p12,12118384,12206751,88367,-,-
BAC150_P01,17,17p12,12418175,12526995,108820,-,-
BAC79_B09,17,17p12,12418701,12524121,105420,-,-
BAC22_K11,17,17p12,12524168,12629872,105704,-,-
BAC176_C19,17,17p12,12561156,12660627,99471,-,-
BAC15_A10,17,17p12,12608111,12703933,95822,-,-
BAC106_P16,17,17p12,12620816,12700042,79226,-,-
BAC249_K10,17,17p12,12658584,12769627,111043,-,-
BAC184_L01,17,17p12,12756487,12840310,83823,-,-
BAC189_J07,17,17p12,12769664,12867384,97720,-,-
BAC61_D08,17,17p12,12800643,12955248,154605,-,-
BAC244_L09,17,17p12,12934598,13027292,92694,-,-
BAC109_M13,17,17p12,13004726,13128423,123697,-,-
BAC114_G12,17,17p12,13009733,13113647,103914,-,-
BAC95_C03,17,17p12,13027323,13120026,92703,-,-
BAC197_M12,17,17p12,13065882,13164840,98958,-,-
BAC52_F06,17,17p12,13069877,13217824,147947,-,-
BAC194_H24,17,17p12,13188879,13277115,88236,-,-
BAC50_A03,17,17p12,13241293,13370269,128976,-,-
BAC70_B18,17,17p12,13275125,13362267,87142,-,-
BAC226_F13,17,17p12,13292633,13397095,104462,-,-
BAC50_K13,17,17p12,13305228,13394749,89521,-,-
BAC30_K11,17,17p12,13465620,13552939,87319,-,-
BAC175_C21,17,17p12,13484871,13582508,97637,-,-
BAC39_N11,17,17p12,13517133,13631265,114132,-,-
BAC77_I01,17,17p12,13517141,13598498,81357,-,-
BAC189_P23,17,17p12,13525078,13599962,74884,-,-
BAC88_G20,17,17p12,13631897,13762746,130849,-,-
BAC108_M02,17,17p12,13694634,13809039,114405,-,-
BAC159_G08,17,17p12,13728487,13810253,81766,-,-
BAC171_P01,17,17p12,13810522,13886729,76207,-,-
BAC153_J07,17,17p12,13861208,13940716,79508,-,-
BAC89_P08,17,17p12,13914984,14023865,108881,-,-
BAC102_C20,17,17p12,13936179,14088899,152720,-,-
BAC127_A05,17,17p12,13936858,14037044,100186,-,-
BAC140_D03,17,17p12,13990700,14077112,86412,-,-
BAC42_K14,17,17p12,13998964,14186226,187262,-,-
BAC235_I13,17,17p12,14077105,14161877,84772,-,-
BAC38_I19,17,17p12,14077140,14195132,117992,-,-
BAC118_C17,17,17p12,14133020,14216943,83923,-,-
BAC132_H11,17,17p12,14195124,14286601,91477,-,-
BAC38_O21,17,17p12,14254589,14344162,89573,-,-
BAC156_I11,17,17p12,14271879,14353523,81644,-,-
BAC168_M23,17,17p12,14277305,14356616,79311,-,-
BAC68_C10,17,17p12,14286692,14399746,113054,-,-
BAC170_M14,17,17p12,14451355,14548328,96973,-,-
BAC33_L21,17,17p12,14544696,14653899,109203,-,-
BAC185_D08,17,17p12,14624681,14721770,97089,-,-
BAC65_C19,17,17p12,14700769,14799004,98235,-,-
BAC219_K23,17,17p12,14716374,14796339,79965,-,-
BAC125_E03,17,17p12,14808565,14925450,116885,-,-
BAC157_G01,17,17p12,14833775,14948982,115207,-,-
BAC193_J12,17,17p12,14851061,14967334,116273,-,-
BAC140_P21,17,17p12,14857907,14951357,93450,-,-
BAC69_D20,17,17p12,14872343,14974709,102366,-,-
BAC152_J10,17,17p12,14887550,14967334,79784,-,-
BAC184_G14,17,17p12,14887550,14999445,111895,-,-
BAC135_G10,17,17p12,14887550,14991655,104105,-,-
BAC163_B05,17,17p12,14887581,14991655,104074,-,-
BAC127_A13,17,17p12,15007948,15137643,129695,-,-
BAC59_O13,17,17p12,15031515,15140805,109290,-,-
BAC171_I03,17,17p12,15033759,15127992,94233,-,-
BAC103_H17,17,17p12,15033759,15124853,91094,-,-
BAC240_L04,17,17p12,15045898,15103827,57929,-,-
BAC180_E05,17,17p12,15055076,15144106,89030,-,-
BAC113_L01,17,17p12,15061109,15166305,105196,-,-
BAC193_F10,17,17p12,15084579,15160269,75690,-,-
BAC80_J24,17,17p12,15127990,15212727,84737,-,-
BAC227_C12,17,17p12,15146957,15234184,87227,-,-
BAC232_P15,17,17p12,15173256,15292777,119521,-,-
BAC154_G20,17,17p12,15207618,15290012,82394,-,-
BAC100_A02,17,17p12,15212721,15295674,82953,-,-
BAC64_B16,17,17p12,15361245,15495492,134247,-,-
BAC120_H23,17,17p12,15397248,15522199,124951,-,-
BAC198_H06,17,17p12,15397579,15495501,97922,-,-
BAC182_G04,17,17p12,15479870,15559175,79305,-,-
BAC97_H12,17,17p12,15524779,15681979,157200,-,-
BAC41_E16,17,17p12,15587690,15667014,79324,-,-
BAC150_L13,17,17p12,15595256,15703151,107895,-,-
BAC124_J04,17,17p12,15637521,15732860,95339,-,-
BAC96_G24,17,17p12,15678528,15768500,89972,-,-
BAC66_G13,17,17p12,15682012,15784421,102409,-,-
BAC60_L08,17,17p12,15703163,15800404,97241,-,-
BAC184_B05,17,17p12,15703163,15784421,81258,-,-
BAC189_J17,17,17p12-17p11.2,15883603,15968000,84397,-,-
BAC88_H17,17,17p12-17p11.2,15883613,15976668,93055,-,-
BAC125_B22,17,17p11.2,16030194,16135047,104853,-,-
BAC16_C09,17,17p11.2,16030523,16143482,112959,-,-
BAC42_K11,17,17p11.2,16030528,16134876,104348,-,-
BAC240_E14,17,17p11.2,16135054,16229097,94043,-,-
BAC71_M13,17,17p11.2,16157960,16254166,96206,-,-
BAC148_O18,17,17p11.2,16160456,16271034,110578,-,-
BAC83_N17,17,17p11.2,16240915,16254159,13244,-,-
BAC149_L21,17,17p11.2,16294515,16389108,94593,-,-
BAC175_H10,17,17p11.2,16298101,16376550,78449,-,-
BAC125_N20,17,17p11.2,16298101,16452036,153935,-,-
BAC146_D01,17,17p11.2,16298101,16376550,78449,-,-
BAC120_H08,17,17p11.2,16388679,16491127,102448,-,-
BAC62_D24,17,17p11.2,16394729,16491039,96310,-,-
BAC186_K22,17,17p11.2,16464420,16536858,72438,-,-
BAC33_P23,17,17p11.2,16520193,16606904,86711,-,-
BAC14_G14,17,17p11.2,16536853,16653725,116872,-,-
BAC1_H11,17,17p11.2,16546396,16651553,105157,-,-
BAC72_P14,17,17p11.2,16606899,16728660,121761,-,-
BAC50_J15,17,17p11.2,16628319,16723315,94996,-,-
BAC131_K12,17,17p11.2,16649885,16730278,80393,-,-
BAC197_O11,17,17p11.2,16765536,16905322,139786,-,-
BAC26_I07,17,17p11.2,16765541,16831111,65570,-,-
BAC36_F12,17,17p11.2,16814281,16905150,90869,-,-
BAC129_D23,17,17p11.2,16899118,16985429,86311,-,-
BAC101_K17,17,17p11.2,16985468,17073907,88439,-,-
BAC123_D23,17,17p11.2,16985468,17097262,111794,-,-
BAC89_C18,17,17p11.2,17016420,17131794,115374,-,-
BAC198_N13,17,17p11.2,17023950,17130505,106555,-,-
BAC90_H16,17,17p11.2,17023950,17123431,99481,-,-
BAC154_C08,17,17p11.2,17035864,17159168,123304,-,-
BAC179_F21,17,17p11.2,17064875,17159168,94293,-,-
BAC189_N01,17,17p11.2,17130498,17205249,74751,-,-
BAC167_A18,17,17p11.2,17159455,17312714,153259,-,-
BAC20_P07,17,17p11.2,17159455,17270834,111379,-,-
BAC176_I19,17,17p11.2,17159455,17246412,86957,-,-
BAC95_I12,17,17p11.2,17223012,17312714,89702,-,-
BAC155_B06,17,17p11.2,17224283,17312714,88431,-,-
BAC56_J17,17,17p11.2,17292030,17405361,113331,-,-
BAC36_C18,17,17p11.2,17319807,17416798,96991,-,-
BAC170_M10,17,17p11.2,17329239,17418240,89001,-,-
BAC36_P15,17,17p11.2,17331390,17438344,106954,-,-
BAC236_B14,17,17p11.2,17438634,17516340,77706,-,-
BAC76_J10,17,17p11.2,17450083,17546372,96289,-,-
BAC23_C16,17,17p11.2,17463832,17613561,149729,-,-
BAC165_E09,17,17p11.2,17463835,17546372,82537,-,-
BAC249_G12,17,17p11.2,17516703,17630050,113347,-,-
BAC41_D18,17,17p11.2,17630085,17765348,135263,-,-
BAC131_M11,17,17p11.2,17656584,17732446,75862,-,-
BAC103_D11,17,17p11.2,17675642,17773047,97405,-,-
BAC180_E16,17,17p11.2,17745241,17834811,89570,-,-
BAC57_N06,17,17p11.2,17771139,17905306,134167,-,-
BAC197_E01,17,17p11.2,17784849,17869092,84243,-,-
BAC20_D12,17,17p11.2,17869121,17959297,90176,-,-
BAC238_N13,17,17p11.2,17905310,18000093,94783,-,-
BAC57_C22,17,17p11.2,17942726,18094980,152254,-,-
BAC184_A04,17,17p11.2,17946998,18035543,88545,-,-
BAC70_D14,17,17p11.2,17947038,18035539,88501,-,-
BAC186_E14,17,17p11.2,18072869,18192554,119685,-,-
BAC97_I20,17,17p11.2,18134041,18253141,119100,yes,-
BAC199_D08,17,17p11.2,18143433,18253137,109704,yes,-
BAC154_P06,17,17p11.2,18162460,18248416,85956,yes,-
BAC189_H21,17,17p11.2,18162460,18257052,94592,yes,-
BAC39_C07,17,17p11.2,18247431,18353910,106479,yes,-
BAC230_J18,17,17p11.2,18259833,18334313,74480,-,-
BAC228_C10,17,17p11.2,18334305,18452134,117829,yes,-
BAC81_H03,17,17p11.2,18334314,18466773,132459,yes,-
BAC58_P21,17,17p11.2,18375816,18495486,119670,-,-
BAC233_A12,17,17p11.2,18477926,18590054,112128,-,-
BAC153_J19,17,17p11.2,18486367,18572002,85635,-,-
BAC132_A14,17,17p11.2,18545601,18659036,113435,-,-
BAC191_B21,17,17p11.2,18548807,18625069,76262,-,-
BAC132_L20,17,17p11.2,18551994,18642158,90164,-,-
BAC232_D17,17,17p11.2,18552702,18643970,91268,-,-
BAC77_C07,17,17p11.2,18572002,18667062,95060,-,-
BAC61_M05,17,17p11.2,18585570,18790554,204984,yes,-
BAC57_D11,17,17p11.2,18637785,18740310,102525,-,-
BAC77_B01,17,17p11.2,18692820,18812898,120078,yes,-
BAC223_F08,17,17p11.2,18706298,18812826,106528,-,-
BAC112_G03,17,17p11.2,18706511,18877925,171414,-,-
BAC42_C13,17,17p11.2,18890115,18949541,59426,-,-
BAC160_J02,17,17p11.2,18895959,18934771,38812,yes,-
BAC97_K11,17,17p11.2,19092309,19166207,73898,-,-
BAC148_B12,17,17p11.2,19181422,19270584,89162,-,-
BAC132_O07,17,17p11.2,19205924,19293764,87840,-,-
BAC26_B11,17,17p11.2,19305355,19418955,113600,-,-
BAC92_D22,17,17p11.2,19312997,19430431,117434,-,-
BAC12_C18,17,17p11.2,19312997,19419219,106222,-,-
BAC69_L23,17,17p11.2,19324108,19430431,106323,-,-
BAC175_P18,17,17p11.2,19342369,19426842,84473,-,-
BAC181_A20,17,17p11.2,19365160,19475861,110701,-,-
BAC146_B24,17,17p11.2,19429942,19525289,95347,-,-
BAC27_K06,17,17p11.2,19430424,19527676,97252,-,-
BAC70_N14,17,17p11.2,19444561,19564358,119797,-,-
BAC171_D20,17,17p11.2,19459092,19567317,108225,-,-
BAC116_O21,17,17p11.2,19497650,19564652,67002,-,-
BAC10_I20,17,17p11.2,19518107,19594933,76826,-,-
BAC65_P13,17,17p11.2,19539646,19669891,130245,-,-
BAC96_I07,17,17p11.2,19594928,19681918,86990,-,-
BAC101_A12,17,17p11.2,19608634,19705391,96757,-,-
BAC249_G09,17,17p11.2,19646334,19768227,121893,-,-
BAC44_J06,17,17p11.2,19670305,19750258,79953,-,-
BAC193_P10,17,17p11.2,19705463,19818096,112633,-,-
BAC36_G17,17,17p11.2,19862108,19997262,135154,-,-
BAC156_C17,17,17p11.2,19862112,19993501,131389,-,-
BAC151_L20,17,17p11.2,19963166,20053829,90663,-,-
BAC11_J06,17,17p11.2,19972070,20060246,88176,-,-
BAC124_E01,17,17p11.2,20007104,20110777,103673,-,-
BAC117_D16,17,17p11.2,20048801,20157067,108266,-,-
BAC162_G03,17,17p11.2,20055949,20173464,117515,-,-
BAC188_P16,17,17p11.2,20118916,20215396,96480,-,-
BAC20_M05,17,17p11.2,20236104,20304535,68431,-,-
BAC233_L09,17,17p11.2,20236104,20328140,92036,-,-
BAC162_M06,17,17p11.2,20255057,20372550,117493,yes,-
BAC237_C22,17,17p11.2,20278330,20378881,100551,yes,-
BAC60_H06,17,17p11.2,20282173,20377821,95648,yes,-
BAC141_A08,17,17p11.2,20290368,20374862,84494,yes,-
BAC40_H06,17,17p11.2,20304566,20408992,104426,yes,-
BAC126_C05,17,17p11.2,20375090,20444251,69161,-,-
BAC48_M08,17,17p11.2,20484792,20574468,89676,-,-
BAC223_H04,17,17p11.2,20513213,20630155,116942,-,-
BAC195_E10,17,17p11.2,20548487,20625429,76942,-,-
BAC200_J14,17,17p11.2,20590249,20674244,83995,-,-
BAC223_I12,17,17p11.2,20590264,20683829,93565,-,-
BAC28_P01,17,17p11.2,20630150,20767840,137690,-,-
BAC119_A16,17,17p11.2,20734338,20883501,149163,-,-
BAC4_G22,17,17p11.2,20783335,20878435,95100,-,-
BAC118_H17,17,17p11.2,20795817,20899866,104049,-,-
BAC40_J07,17,17p11.2,20806750,20899866,93116,-,-
BAC239_L05,17,17p11.2,20814951,20954011,139060,-,-
BAC32_C06,17,17p11.2,20913557,21092245,178688,-,-
BAC248_A23,17,17p11.2,20992803,21074535,81732,-,-
BAC142_A03,17,17p11.2,20992818,21093786,100968,-,-
BAC61_I13,17,17p11.2,21056634,21164340,107706,yes,-
BAC236_B19,17,17p11.2,21093798,21203781,109983,yes,-
BAC32_I03,17,17p11.2,21122115,21224985,102870,yes,-
BAC100_J04,17,17p11.2,21172151,21326351,154200,yes,-
BAC130_E22,17,17p11.2,21203776,21272142,68366,yes,-
BAC68_G08,17,17p11.2,21237061,21330883,93822,-,-
BAC26_L13,17,17p11.2,21621793,21749182,127389,-,-
BAC52_D13,17,17p11.2,21632014,21739891,107877,-,-
BAC38_N23,17,17p11.2,21632241,21718881,86640,-,-
BAC118_E14,17,17p11.2,21732500,21829336,96836,-,-
BAC96_P12,17,17p11.2,21806914,21829334,22420,-,-
BAC236_B22,17,17p11.2,21810046,21829336,19290,-,-
BAC168_D15,17,17p11.2,21826617,21867030,40413,-,-
BAC171_F08,17,17p11.2,21826617,21917926,91309,-,-
BAC149_L03,17,17p11.2,21826617,21901799,75182,-,-
BAC81_F21,17,17p11.2,21826617,21866339,39722,-,-
BAC171_P11,17,17p11.2,21845528,21925091,79563,-,-
BAC199_H24,17,17p11.2,21869111,21951988,82877,-,-
BAC124_N17,17,17p11.2,21951982,22098156,146174,-,-
BAC65_N19,17,17p11.2,21951982,22049298,97316,-,-
BAC162_D22,17,17q11.1,22303054,22387703,84649,-,-
BAC109_N05,17,17q11.1,22354695,22459839,105144,-,-
BAC181_M18,17,17q11.1,22395077,22501342,106265,-,-
BAC181_L03,17,17q11.1,22514366,22595064,80698,-,-
BAC108_B07,17,17q11.1,22539740,22622227,82487,-,-
BAC61_H10,17,17q11.1,22554289,22713712,159423,-,-
BAC33_E14,17,17q11.1,22569894,22742043,172149,-,-
BAC179_K16,17,17q11.1,22598350,22681034,82684,-,-
BAC153_A04,17,17q11.1,22598350,22687537,89187,-,-
BAC185_O05,17,17q11.1,22604154,22681026,76872,-,-
BAC124_E05,17,17q11.1,22663578,22748022,84444,-,-
BAC127_K24,17,17q11.1,22678826,22795460,116634,-,-
BAC26_K22,17,17q11.1,22687531,22823650,136119,-,-
BAC232_N15,17,17q11.1,22716813,22818153,101340,-,-
BAC123_P01,17,17q11.1,22742310,22873255,130945,-,-
BAC147_O14,17,17q11.1,22861269,22956061,94792,-,-
BAC148_N17,17,17q11.1,22880966,22947344,66378,-,-
BAC199_K14,17,17q11.1,22969254,23071781,102527,yes,-
BAC90_D06,17,17q11.1,23061298,23183681,122383,-,-
BAC21_K21,17,17q11.1-17q11.2,23116555,23212016,95461,-,-
BAC14_F15,17,17q11.1-17q11.2,23120679,23233958,113279,-,-
BAC233_A07,17,17q11.1-17q11.2,23129796,23235425,105629,-,-
BAC227_H01,17,17q11.1-17q11.2,23175431,23284901,109470,-,-
BAC49_N07,17,17q11.1-17q11.2,23175431,23278643,103212,-,-
BAC63_F04,17,17q11.2,23233951,23425203,191252,-,-
BAC218_O02,17,17q11.2,23233954,23332968,99014,-,-
BAC180_L12,17,17q11.2,23326373,23408578,82205,-,-
BAC244_L03,17,17q11.2,23326374,23427379,101005,-,-
BAC233_B12,17,17q11.2,23340670,23425203,84533,-,-
BAC1_J12,17,17q11.2,23360128,23484815,124687,-,-
BAC159_J06,17,17q11.2,23433939,23563488,129549,-,-
BAC219_C23,17,17q11.2,23442339,23522336,79997,-,-
BAC116_E13,17,17q11.2,23449084,23535186,86102,-,-
BAC143_M19,17,17q11.2,23484810,23589472,104662,-,-
BAC140_N17,17,17q11.2,23510663,23624714,114051,-,-
BAC211_B03,17,17q11.2,23624941,23724492,99551,-,-
BAC190_O06,17,17q11.2,23724528,23805347,80819,-,-
BAC185_C22,17,17q11.2,23724732,23863867,139135,-,-
BAC26_F18,17,17q11.2,23774098,23863867,89769,-,-
BAC149_H11,17,17q11.2,23828734,23932422,103688,-,-
BAC182_I09,17,17q11.2,23863291,23968261,104970,-,-
BAC12_P23,17,17q11.2,23863859,23970872,107013,-,-
BAC18_M10,17,17q11.2,23863937,23991101,127164,-,-
BAC153_F07,17,17q11.2,23883212,24003814,120602,-,-
BAC51_K01,17,17q11.2,23928308,24022566,94258,-,-
BAC148_O11,17,17q11.2,23932418,24057754,125336,-,-
BAC168_J13,17,17q11.2,23945170,24022584,77414,-,-
BAC247_B18,17,17q11.2,23974331,24072499,98168,-,-
BAC34_D22,17,17q11.2,24003815,24178787,174972,-,-
BAC244_N11,17,17q11.2,24070954,24183570,112616,-,-
BAC176_M08,17,17q11.2,24096975,24184756,87781,-,-
BAC181_P04,17,17q11.2,24159999,24268409,108410,-,-
BAC36_C02,17,17q11.2,24216217,24302847,86630,-,-
BAC50_C14,17,17q11.2,24217148,24302845,85697,-,-
BAC218_I13,17,17q11.2,24218775,24302847,84072,-,-
BAC27_D11,17,17q11.2,24268444,24368544,100100,-,-
BAC154_L19,17,17q11.2,24273634,24356053,82419,-,-
BAC42_B18,17,17q11.2,24273638,24356053,82415,-,-
BAC187_M13,17,17q11.2,24278517,24377138,98621,-,-
BAC144_D10,17,17q11.2,24321495,24429777,108282,-,-
BAC97_C05,17,17q11.2,24429768,24521049,91281,-,-
BAC68_J18,17,17q11.2,24433172,24521049,87877,-,-
BAC151_E22,17,17q11.2,24454132,24546660,92528,-,-
BAC34_O08,17,17q11.2,24510679,24621346,110667,-,-
BAC66_P08,17,17q11.2,24519666,24621349,101683,-,-
BAC187_M11,17,17q11.2,24519666,24602557,82891,-,-
BAC213_C12,17,17q11.2,24519669,24621952,102283,-,-
BAC180_F06,17,17q11.2,24519672,24620184,100512,-,-
BAC222_N23,17,17q11.2,24519688,24628743,109055,-,-
BAC33_F20,17,17q11.2,24546690,24676612,129922,-,-
BAC194_I10,17,17q11.2,24628120,24733128,105008,-,-
BAC6_O16,17,17q11.2,24646964,24796979,150015,-,-
BAC117_B12,17,17q11.2,24673362,24785871,112509,-,-
BAC50_H22,17,17q11.2,24688637,24802791,114154,-,-
BAC149_J18,17,17q11.2,24803000,24893958,90958,-,-
BAC11_A04,17,17q11.2,24896865,24990204,93339,-,-
BAC132_G10,17,17q11.2,24919004,24978555,59551,-,-
BAC22_D10,17,17q11.2,25024272,25160868,136596,-,-
BAC241_M16,17,17q11.2,25026068,25162994,136926,-,-
BAC50_K11,17,17q11.2,25041228,25120195,78967,-,-
BAC14_I18,17,17q11.2,25045181,25158976,113795,-,-
BAC42_G19,17,17q11.2,25064642,25243109,178467,-,-
BAC152_I01,17,17q11.2,25078133,25160868,82735,-,-
BAC119_J20,17,17q11.2,25163008,25284877,121869,-,-
BAC106_F14,17,17q11.2,25261767,25359801,98034,-,-
BAC66_C14,17,17q11.2,25380721,25465592,84871,-,-
BAC106_L10,17,17q11.2,25408442,25494893,86451,-,-
BAC70_M04,17,17q11.2,25409789,25494896,85107,-,-
BAC186_G18,17,17q11.2,25465969,25549038,83069,-,-
BAC88_D12,17,17q11.2,25469235,25579877,110642,-,-
BAC188_J10,17,17q11.2,25494891,25589953,95062,-,-
BAC252_A13,17,17q11.2,25579928,25622282,42354,-,-
BAC119_A20,17,17q11.2,25626206,25738526,112320,-,-
BAC226_I02,17,17q11.2,25762802,25845336,82534,-,-
BAC184_C20,17,17q11.2,25782850,25869344,86494,-,-
BAC60_D19,17,17q11.2,25845571,26048755,203184,-,-
BAC57_D07,17,17q11.2,25869336,25982020,112684,-,-
BAC193_E11,17,17q11.2,25886063,25967743,81680,-,-
BAC81_D10,17,17q11.2,25898131,26048755,150624,-,-
BAC142_F18,17,17q11.2,26031503,26135448,103945,-,-
BAC118_M22,17,17q11.2,26068433,26186947,118514,-,-
BAC247_O15,17,17q11.2,26068442,26191059,122617,-,-
BAC135_B18,17,17q11.2,26105930,26191821,85891,-,-
BAC244_C02,17,17q11.2,26135458,26216826,81368,-,-
BAC186_A03,17,17q11.2,26208903,26291929,83026,-,-
BAC233_C09,17,17q11.2,26304699,26396791,92092,-,-
BAC176_D18,17,17q11.2,26310122,26385310,75188,-,-
BAC110_C12,17,17q11.2,26365120,26454868,89748,-,-
BAC146_P21,17,17q11.2,26371835,26472942,101107,-,-
BAC48_B08,17,17q11.2,26396786,26515425,118639,-,-
BAC7_N05,17,17q11.2,26396878,26474153,77275,-,-
BAC151_I23,17,17q11.2,26407504,26517801,110297,-,-
BAC221_C05,17,17q11.2,26576213,26663199,86986,-,-
BAC20_B17,17,17q11.2,26581685,26667045,85360,-,-
BAC162_H13,17,17q11.2,26605490,26700889,95399,-,-
BAC36_P16,17,17q11.2,26646646,26725297,78651,-,-
BAC137_H11,17,17q11.2,26658553,26758166,99613,-,-
BAC238_P03,17,17q11.2,26683095,26818054,134959,-,-
BAC96_A09,17,17q11.2,26718366,26847885,129519,-,-
BAC71_O04,17,17q11.2,26718373,26847818,129445,-,-
BAC23_J05,17,17q11.2,26749753,26847885,98132,-,-
BAC92_O16,17,17q11.2,26827062,26992692,165630,-,-
BAC88_I09,17,17q11.2,26830975,27014398,183423,-,-
BAC63_L14,17,17q11.2,26831101,26998078,166977,-,-
BAC70_L06,17,17q11.2,26943807,27032580,88773,-,-
BAC22_E20,17,17q11.2,26987241,27100812,113571,-,-
BAC217_K02,17,17q11.2,27046393,27135312,88919,-,-
BAC180_K05,17,17q11.2,27048399,27135312,86913,-,-
BAC69_O03,17,17q11.2,27138965,27239093,100128,-,-
BAC55_F24,17,17q11.2,27145480,27263730,118250,-,-
BAC248_N07,17,17q11.2,27242774,27354541,111767,-,-
BAC107_E15,17,17q11.2,27246337,27409341,163004,-,-
BAC90_C19,17,17q11.2,27246684,27354544,107860,-,-
BAC21_A07,17,17q11.2,27273343,27367303,93960,-,-
BAC200_K02,17,17q11.2,27286388,27426164,139776,-,-
BAC1_F09,17,17q11.2,27322898,27450602,127704,-,-
BAC88_C01,17,17q11.2,27381494,27480676,99182,-,-
BAC168_G23,17,17q11.2,27450609,27572502,121893,-,-
BAC88_E18,17,17q11.2,27450614,27557324,106710,-,-
BAC199_N13,17,17q11.2,27481322,27578298,96976,-,-
BAC147_P10,17,17q11.2,27491016,27572502,81486,-,-
BAC177_C18,17,17q11.2,27491049,27578298,87249,-,-
BAC63_M13,17,17q11.2,27527388,27621725,94337,-,-
BAC130_J13,17,17q11.2,27558773,27638559,79786,-,-
BAC37_E23,17,17q11.2,27558774,27689808,131034,-,-
BAC52_C12,17,17q11.2,27572551,27707128,134577,-,-
BAC206_L08,17,17q11.2,27613607,27689812,76205,-,-
BAC28_P02,17,17q11.2,27621754,27732620,110866,-,-
BAC125_N18,17,17q11.2,27638553,27723570,85017,-,-
BAC170_G09,17,17q11.2,27638608,27724840,86232,-,-
BAC140_C11,17,17q11.2,27813835,27906092,92257,-,-
BAC229_B07,17,17q11.2,27900053,27983191,83138,-,-
BAC211_H19,17,17q11.2,27906122,28013806,107684,-,-
BAC101_D20,17,17q11.2,27910323,28013639,103316,-,-
BAC61_L24,17,17q11.2,27946938,28110245,163307,-,-
BAC85_C08,17,17q11.2,27983205,28085123,101918,-,-
BAC18_G22,17,17q11.2,27983205,28101248,118043,-,-
BAC151_B23,17,17q11.2,28044532,28163241,118709,-,-
BAC150_H20,17,17q11.2,28085117,28168449,83332,-,-
BAC50_D07,17,17q11.2,28107800,28215453,107653,-,-
BAC219_J13,17,17q11.2,28147636,28282334,134698,-,-
BAC61_P14,17,17q11.2,28189208,28302895,113687,-,-
BAC176_K19,17,17q11.2,28199144,28285161,86017,-,-
BAC37_L19,17,17q11.2,28199144,28302895,103751,-,-
BAC106_K10,17,17q11.2,28226912,28335814,108902,-,-
BAC53_M02,17,17q11.2,28241921,28335821,93900,-,-
BAC178_B17,17,17q11.2,28276893,28380504,103611,-,-
BAC105_P01,17,17q11.2,28282600,28405763,123163,-,-
BAC57_O05,17,17q11.2,28291645,28409303,117658,-,-
BAC218_K03,17,17q11.2,28313506,28414966,101460,-,-
BAC233_E23,17,17q11.2,28335860,28414986,79126,-,-
BAC218_E20,17,17q11.2,28380508,28458150,77642,-,-
BAC175_I20,17,17q11.2,28409312,28488261,78949,-,-
BAC22_N08,17,17q11.2,28409657,28511909,102252,-,-
BAC51_J20,17,17q11.2,28490931,28641270,150339,-,-
BAC153_J02,17,17q11.2,28533513,28636853,103340,-,-
BAC187_F07,17,17q11.2,28550763,28631906,81143,-,-
BAC243_B19,17,17q11.2,28575329,28651595,76266,-,-
BAC199_E02,17,17q11.2,28641264,28785834,144570,-,-
BAC191_G13,17,17q11.2,28663375,28764472,101097,-,-
BAC42_N12,17,17q11.2-17q12,28712736,28803615,90879,-,-
BAC229_C13,17,17q11.2-17q12,28767446,28844725,77279,-,-
BAC183_I19,17,17q11.2-17q12,28767448,28866829,99381,-,-
BAC33_D07,17,17q11.2-17q12,28788974,28866815,77841,-,-
BAC221_D17,17,17q11.2-17q12,28795401,28866822,71421,-,-
BAC192_G12,17,17q12,28900468,28995833,95365,-,-
BAC52_K04,17,17q12,28976702,29090706,114004,-,-
BAC119_G03,17,17q12,28987085,29080328,93243,-,-
BAC55_D08,17,17q12,29120825,29202356,81531,-,-
BAC29_O03,17,17q12,29199646,29290302,90656,-,-
BAC244_H08,17,17q12,29377106,29467839,90733,-,-
BAC118_M10,17,17q12,29519521,29651470,131949,-,-
BAC146_H10,17,17q12,29563244,29651471,88227,-,-
BAC120_I20,17,17q12,29572856,29707570,134714,-,-
BAC78_P22,17,17q12,29683933,29784842,100909,-,-
BAC8_J15,17,17q12,29707564,29795669,88105,-,-
BAC16_K23,17,17q12,29738864,29880529,141665,-,-
BAC59_C18,17,17q12,29751389,29854498,103109,-,-
BAC8_A15,17,17q12,29781508,29887862,106354,-,-
BAC24_M03,17,17q12,29790154,29904808,114654,-,-
BAC161_O14,17,17q12,29795670,29887860,92190,-,-
BAC157_N23,17,17q12,29798539,29880772,82233,-,-
BAC50_H17,17,17q12,29863593,29981485,117892,-,-
BAC187_O02,17,17q12,29880766,30025965,145199,-,-
BAC187_D19,17,17q12,29887894,30008539,120645,-,-
BAC231_E15,17,17q12,29904990,29984177,79187,-,-
BAC86_N19,17,17q12,29910817,30026292,115475,-,-
BAC30_L05,17,17q12,29928713,30023562,94849,-,-
BAC199_I02,17,17q12,30038712,30118564,79852,-,-
BAC218_E08,17,17q12,30039259,30137172,97913,-,-
BAC8_G16,17,17q12,30047177,30169093,121916,-,-
BAC105_J07,17,17q12,30047188,30142585,95397,-,-
BAC82_D13,17,17q12,30090510,30223155,132645,-,-
BAC37_F24,17,17q12,30094181,30173161,78980,-,-
BAC57_B10,17,17q12,30139563,30238189,98626,-,-
BAC36_F07,17,17q12,30142584,30262788,120204,-,-
BAC224_D14,17,17q12,30163427,30248210,84783,-,-
BAC233_M12,17,17q12,30187427,30262789,75362,-,-
BAC60_D01,17,17q12,30303065,30454744,151679,-,-
BAC96_A10,17,17q12,30363576,30457204,93628,-,-
BAC241_P14,17,17q12,30404919,30495061,90142,-,-
BAC5_I11,17,17q12,30578773,30664893,86120,-,-
BAC210_N10,17,17q12,30659116,30738998,79882,-,-
BAC19_D08,17,17q12,30665134,30765767,100633,-,-
BAC100_I20,17,17q12,30675743,30777356,101613,-,-
BAC199_N06,17,17q12,30675743,30782294,106551,-,-
BAC156_K01,17,17q12,30756198,30885950,129752,-,-
BAC91_A19,17,17q12,30760368,30878536,118168,-,-
BAC36_E06,17,17q12,30782301,30878536,96235,-,-
BAC116_G06,17,17q12,30795667,30926982,131315,-,-
BAC91_E18,17,17q12,30874306,31010388,136082,-,-
BAC126_O09,17,17q12,30906116,30994159,88043,-,-
BAC1_K14,17,17q12,30913588,31099492,185904,-,-
BAC21_A08,17,17q12,30913593,31007311,93718,-,-
BAC141_F19,17,17q12,30927635,31039526,111891,-,-
BAC199_G20,17,17q12,30991066,31082092,91026,-,-
BAC179_I16,17,17q12,30994397,31077390,82993,-,-
BAC252_A08,17,17q12,30994426,31149528,155102,-,-
BAC181_E10,17,17q12,31007407,31084230,76823,-,-
BAC73_H21,17,17q12,31027858,31184815,156957,-,-
BAC40_K20,17,17q12,31052958,31149500,96542,-,-
BAC12_E18,17,17q12,31077583,31168935,91352,-,-
BAC184_K09,17,17q12,31081231,31171045,89814,-,-
BAC63_P21,17,17q12,31133251,31229943,96692,-,-
BAC157_E20,17,17q12,31205922,31289385,83463,-,-
BAC92_D19,17,17q12,31206726,31289374,82648,-,-
BAC26_G10,17,17q12,31208998,31309093,100095,-,-
BAC82_D09,17,17q12,31312443,31457363,144920,yes,-
BAC117_E02,17,17q12,31336537,31425478,88941,-,-
BAC213_D12,17,17q12,31338811,31428164,89353,yes,-
BAC131_G05,17,17q12,31468746,31865457,396711,-,-
BAC250_N21,17,17q12,31482247,31578366,96119,yes,-
BAC162_F13,17,17q12,31497027,33425796,1928769,-,-
BAC187_C22,17,17q12,31532461,33425796,1893335,-,-
BAC160_C21,17,17q12,31605450,33425796,1820346,-,-
BAC155_N01,17,17q12,31852200,31931276,79076,yes,-
BAC241_L17,17,17q12,31862507,31938476,75969,yes,-
BAC40_N09,17,17q12,31862507,31966817,104310,yes,-
BAC139_J19,17,17q12,31862507,31966828,104321,yes,-
BAC163_D14,17,17q12,31862507,31938317,75810,yes,-
BAC42_I19,17,17q12,31925202,32006790,81588,yes,-
BAC238_G20,17,17q12,32014577,32100380,85803,-,-
BAC150_J24,17,17q12,32017546,32099279,81733,-,-
BAC147_K13,17,17q12,32017546,32099279,81733,-,-
BAC197_O23,17,17q12,32017903,32115536,97633,-,-
BAC150_I12,17,17q12,32075536,32163269,87733,-,-
BAC40_I15,17,17q12,32078109,32203357,125248,-,-
BAC105_A15,17,17q12,32131711,32312702,180991,-,-
BAC146_P04,17,17q12,32163473,32252751,89278,-,-
BAC235_H07,17,17q12,32216454,32307498,91044,-,-
BAC149_G11,17,17q12,32281205,32370056,88851,-,-
BAC187_A22,17,17q12,32321009,32417738,96729,-,-
BAC224_G10,17,17q12,32333025,32414068,81043,-,-
BAC97_B09,17,17q12,32414138,32532621,118483,-,-
BAC54_K23,17,17q12,32417733,32578192,160459,-,-
BAC86_M13,17,17q12,32438157,32526230,88073,-,-
BAC38_H05,17,17q12,32438157,32521019,82862,-,-
BAC90_F05,17,17q12,32455754,32589358,133604,-,-
BAC84_N23,17,17q12,32536174,32625655,89481,-,-
BAC56_L17,17,17q12,32589363,32739327,149964,-,-
BAC249_L03,17,17q12,32614256,32731132,116876,-,-
BAC194_I12,17,17q12,32646677,32725575,78898,-,-
BAC108_H18,17,17q12,32655705,32749234,93529,-,-
BAC84_O09,17,17q12,32677163,32774497,97334,-,-
BAC193_P17,17,17q12,32690933,32779210,88277,-,-
BAC22_L12,17,17q12,32690933,32775627,84694,-,-
BAC162_N06,17,17q12,32741094,32854289,113195,-,-
BAC84_F05,17,17q12,32761096,32861742,100646,-,-
BAC81_G22,17,17q12,32774491,32881826,107335,-,-
BAC82_F09,17,17q12,32774491,32884499,110008,-,-
BAC72_B09,17,17q12,32779559,32902628,123069,-,-
BAC26_F11,17,17q12,32881862,33010545,128683,-,-
BAC117_I13,17,17q12,32884493,32991291,106798,-,-
BAC95_C07,17,17q12,32947463,33038400,90937,-,-
BAC26_P18,17,17q12,32949107,33051623,102516,-,-
BAC190_K09,17,17q12,32963964,33056247,92283,-,-
BAC221_I08,17,17q12,32969500,33106292,136792,-,-
BAC195_N09,17,17q12,32991389,33122791,131402,-,-
BAC150_J13,17,17q12,33007200,33129517,122317,-,-
BAC56_I11,17,17q12,33107723,33208982,101259,-,-
BAC4_D04,17,17q12,33142460,33226655,84195,-,-
BAC43_F08,17,17q12,33180104,33296987,116883,-,-
BAC202_H10,17,17q12,33180111,33296733,116622,-,-
BAC176_E23,17,17q12,33226651,33346012,119361,-,-
BAC34_K20,17,17q12,33299908,33620714,320806,-,-
BAC232_O03,17,17q12,33353749,33613486,259737,yes,-
BAC236_G04,17,17q12,33660623,33751125,90502,-,-
BAC189_D23,17,17q12,33660623,33760109,99486,-,-
BAC31_P12,17,17q12,33780274,33889244,108970,-,-
BAC176_M03,17,17q12,33847788,33902604,54816,-,-
BAC233_D12,17,17q12,33925594,34023229,97635,-,-
BAC193_D24,17,17q12,33992473,34079261,86788,-,-
BAC106_G05,17,17q12,34027290,34206838,179548,-,-
BAC80_O16,17,17q12,34122951,34251519,128568,-,-
BAC129_N03,17,17q12,34161960,34251610,89650,-,-
BAC132_B08,17,17q12,34206833,34292030,85197,-,-
BAC250_H02,17,17q12,34455210,34573848,118638,-,-
BAC71_K10,17,17q12,34455210,34594143,138933,-,-
BAC230_N20,17,17q12,34455210,34536825,81615,-,-
BAC185_A19,17,17q12,34471860,34604839,132979,-,-
BAC178_D11,17,17q12,34474619,34584843,110224,-,-
BAC86_L03,17,17q12,34474622,34613771,139149,-,-
BAC235_F21,17,17q12,34474632,34578852,104220,-,-
BAC50_D04,17,17q12,34604836,34680640,75804,-,-
BAC155_E12,17,17q12,34652534,34767827,115293,-,-
BAC148_P12,17,17q12,34668167,34781218,113051,-,-
BAC57_H23,17,17q12,34668167,34799730,131563,-,-
BAC223_N13,17,17q12,34674792,34753281,78489,-,-
BAC46_G06,17,17q12,34818388,34936281,117893,-,-
BAC170_J19,17,17q12,34818411,34922641,104230,-,-
BAC176_C20,17,17q12,34857591,34936284,78693,-,-
BAC166_E04,17,17q12,34857591,34987710,130119,-,-
BAC120_J07,17,17q12,34889419,34986698,97279,-,-
BAC29_G13,17,17q12,34946421,35061427,115006,-,-
BAC68_N12,17,17q12,34986886,35081287,94401,-,-
BAC234_C11,17,17q12,34989498,35092255,102757,-,-
BAC217_J07,17,17q12,34989617,35061427,71810,-,-
BAC78_B16,17,17q12,35016018,35105225,89207,-,-
BAC70_K20,17,17q12,35096952,35191048,94096,-,-
BAC80_A22,17,17q12,35107813,35196390,88577,-,-
BAC76_F11,17,17q12,35107813,35211131,103318,-,-
BAC46_L23,17,17q12,35191042,35335489,144447,-,-
BAC84_G20,17,17q12-17q21.1,35255470,35404744,149274,yes,-
BAC160_F22,17,17q12,35298253,35387440,89187,-,-
BAC201_H18,17,17q12,35304834,35399251,94417,yes,-
BAC102_B20,17,17q12-17q21.1,35310243,35404715,94472,yes,-
BAC46_N21,17,17q21.1,35466176,35565593,99417,-,-
BAC208_G05,17,17q21.1,35491053,35565445,74392,-,-
BAC106_K24,17,17q21.1,35510756,35585790,75034,-,-
BAC200_I14,17,17q21.1-17q21.2,35520260,35635720,115460,-,-
BAC115_E22,17,17q21.1-17q21.2,35533825,35635720,101895,-,-
BAC208_A12,17,17q21.1-17q21.2,35534877,35608480,73603,-,-
BAC197_I01,17,17q21.1-17q21.2,35573727,35675305,101578,-,-
BAC73_I02,17,17q21.2,35635328,35719714,84386,-,-
BAC147_N17,17,17q21.2,35719758,35802247,82489,-,-
BAC83_A01,17,17q21.2,35727272,35836806,109534,-,-
BAC60_F21,17,17q21.2,35771112,35891501,120389,-,-
BAC229_F07,17,17q21.2,35871531,35948909,77378,-,-
BAC239_C17,17,17q21.2,35891494,35999592,108098,-,-
BAC211_O08,17,17q21.2,35970425,36051168,80743,-,-
BAC65_F13,17,17q21.2,35990637,36087612,96975,-,-
BAC66_O21,17,17q21.2,36264459,36356854,92395,-,-
BAC182_B02,17,17q21.2,36282016,36374451,92435,-,-
BAC57_B20,17,17q21.2,36282016,36404167,122151,-,-
BAC153_H01,17,17q21.2,36282016,36407435,125419,-,-
BAC198_B05,17,17q21.2,36282301,36374451,92150,-,-
BAC20_M20,17,17q21.2,36404161,36489600,85439,-,-
BAC84_H10,17,17q21.2,36438623,36509436,70813,-,-
BAC153_F08,17,17q21.2,36465451,36556010,90559,-,-
BAC5_O19,17,17q21.2,36529648,36621923,92275,-,-
BAC67_L01,17,17q21.2,36529649,36612955,83306,-,-
BAC42_I24,17,17q21.2,36544551,36631007,86456,-,-
BAC238_M02,17,17q21.2,36550746,36639622,88876,yes,-
BAC97_A21,17,17q21.2,36552593,36651024,98431,-,-
BAC99_J24,17,17q21.2,36651134,36739458,88324,yes,-
BAC163_P05,17,17q21.2,36698148,36838804,140656,-,-
BAC95_L06,17,17q21.2,36800158,36915080,114922,-,-
BAC247_O05,17,17q21.2,36813178,36913649,100471,-,-
BAC148_L05,17,17q21.2,36820514,36968160,147646,-,-
BAC48_C05,17,17q21.2,36827603,36917792,90189,-,-
BAC189_F07,17,17q21.2,36864013,36963060,99047,-,-
BAC78_C14,17,17q21.2,36915677,37016758,101081,-,-
BAC81_G11,17,17q21.2,37029232,37128635,99403,-,-
BAC36_I08,17,17q21.2,37117578,37215482,97904,-,-
BAC64_F09,17,17q21.2,37204033,37311838,107805,-,-
BAC190_O02,17,17q21.2,37210493,37306160,95667,-,-
BAC27_A20,17,17q21.2,37230171,37360661,130490,-,-
BAC61_C08,17,17q21.2,37230171,37342772,112601,-,-
BAC180_F14,17,17q21.2,37263873,37378020,114147,-,-
BAC233_O08,17,17q21.2,37342767,37408885,66118,-,-
BAC22_E17,17,17q21.2,37360991,37443241,82250,-,-
BAC10_J06,17,17q21.2,37409044,37524466,115422,-,-
BAC140_C19,17,17q21.2,37432748,37524466,91718,-,-
BAC239_N06,17,17q21.2,37442968,37525157,82189,-,-
BAC157_A08,17,17q21.2,37456791,37538227,81436,-,-
BAC161_M03,17,17q21.2,37509086,37600259,91173,-,-
BAC57_G05,17,17q21.2,37600275,37681285,81010,-,-
BAC65_O11,17,17q21.2,37613070,37740584,127514,-,-
BAC191_C20,17,17q21.2,37617401,37707424,90023,-,-
BAC21_P13,17,17q21.2,37617401,37707395,89994,-,-
BAC161_H06,17,17q21.2,37617434,37740584,123150,-,-
BAC106_D08,17,17q21.2,37669252,37779428,110176,-,-
BAC161_J02,17,17q21.2,37715567,37797176,81609,-,-
BAC150_F07,17,17q21.2-17q21.31,37716673,37837692,121019,-,-
BAC39_J12,17,17q21.2-17q21.31,37716673,37895253,178580,-,-
BAC66_C16,17,17q21.2-17q21.31,37753386,37880975,127589,-,-
BAC67_N21,17,17q21.31,37881081,37984223,103142,yes,-
BAC159_H12,17,17q21.31,37895252,38011766,116514,yes,-
BAC76_K24,17,17q21.31,37929355,38025674,96319,yes,-
BAC108_J17,17,17q21.31,37942211,38072538,130327,yes,-
BAC211_I10,17,17q21.31,38021439,38160740,139301,-,-
BAC197_D15,17,17q21.31,38025669,38107386,81717,-,-
BAC179_E15,17,17q21.31,38078899,38183059,104160,-,-
BAC163_I15,17,17q21.31,38080902,38179907,99005,-,-
BAC56_L05,17,17q21.31,38080902,38208231,127329,-,-
BAC182_P18,17,17q21.31,38133236,38228030,94794,-,-
BAC242_A13,17,17q21.31,38191898,38268469,76571,-,-
BAC77_A06,17,17q21.31,38327707,38436011,108304,-,-
BAC6_B13,17,17q21.31,38381031,38522700,141669,-,-
BAC34_J03,17,17q21.31,38415956,38581356,165400,-,-
BAC193_O02,17,17q21.31,38440394,38518180,77786,-,-
BAC140_I06,17,17q21.31,38440394,38545606,105212,-,-
BAC176_D01,17,17q21.31,38502214,38584311,82097,-,-
BAC210_A01,17,17q21.31,38540806,38725501,184695,-,-
BAC44_O13,17,17q21.31,38861910,38958090,96180,-,-
BAC145_D05,17,17q21.31,38894604,38969699,75095,-,-
BAC153_M10,17,17q21.31,38902082,39003677,101595,-,-
BAC171_K07,17,17q21.31,38909681,39002242,92561,-,-
BAC59_C23,17,17q21.31,38953272,39103402,150130,-,-
BAC187_L03,17,17q21.31,38992624,39065772,73148,-,-
BAC154_M22,17,17q21.31,38993465,39070919,77454,-,-
BAC57_N23,17,17q21.31,39002236,39095033,92797,-,-
BAC148_I17,17,17q21.31,39043189,39129363,86174,-,-
BAC160_I20,17,17q21.31,39065766,39181068,115302,-,-
BAC200_N06,17,17q21.31,39095238,39183046,87808,-,-
BAC128_H01,17,17q21.31,39103424,39230073,126649,-,-
BAC123_I12,17,17q21.31,39103445,39210553,107108,-,-
BAC27_G10,17,17q21.31,39106218,39242772,136554,-,-
BAC143_K16,17,17q21.31,39106305,39227761,121456,-,-
BAC50_E19,17,17q21.31,39133290,39273024,139734,-,-
BAC4_B24,17,17q21.31,39186233,39279405,93172,-,-
BAC39_N04,17,17q21.31,39206040,39333025,126985,-,-
BAC32_O16,17,17q21.31,39233444,39333039,99595,-,-
BAC84_D23,17,17q21.31,39273988,39384770,110782,-,-
BAC57_J04,17,17q21.31,39279398,39458111,178713,-,-
BAC103_A07,17,17q21.31,39305184,39397252,92068,-,-
BAC234_N15,17,17q21.31,39333051,39458077,125026,-,-
BAC55_O20,17,17q21.31,39347376,39491728,144352,-,-
BAC43_I03,17,17q21.31,39361369,39458114,96745,-,-
BAC248_B17,17,17q21.31,39373739,39447483,73744,-,-
BAC66_N01,17,17q21.31,39458111,39554959,96848,-,-
BAC183_N20,17,17q21.31,39492102,39591210,99108,-,-
BAC222_J11,17,17q21.31,39492488,39583676,91188,-,-
BAC101_E18,17,17q21.31,39508256,39639696,131440,-,-
BAC24_L18,17,17q21.31,39530519,39654510,123991,-,-
BAC203_N05,17,17q21.31,39547603,39627050,79447,-,-
BAC215_F07,17,17q21.31,39692026,39824448,132422,-,-
BAC26_F19,17,17q21.31,39744252,39880404,136152,-,-
BAC31_F18,17,17q21.31,39824615,39915467,90852,-,-
BAC197_K12,17,17q21.31,39903916,39997904,93988,-,-
BAC63_K17,17,17q21.31,39915729,40005445,89716,-,-
BAC221_I15,17,17q21.31,39963931,40058889,94958,-,-
BAC153_N08,17,17q21.31,40065916,40185593,119677,-,-
BAC252_O11,17,17q21.31,40121582,40204777,83195,-,-
BAC149_E06,17,17q21.31,40149248,40279629,130381,-,-
BAC243_H14,17,17q21.31,40187734,40277636,89902,-,-
BAC240_D03,17,17q21.31,40215472,40295024,79552,-,-
BAC242_J06,17,17q21.31,40218131,40312713,94582,-,-
BAC244_D06,17,17q21.31,40251418,40334598,83180,-,-
BAC152_P24,17,17q21.31,40295018,40386329,91311,-,-
BAC249_P23,17,17q21.31,40311697,40434493,122796,-,-
BAC96_M03,17,17q21.31,40326681,40436425,109744,-,-
BAC230_N08,17,17q21.31,40470369,40581578,111209,-,-
BAC206_H13,17,17q21.31,40470679,40584494,113815,-,-
BAC111_A03,17,17q21.31,40496522,40592560,96038,-,-
BAC38_K06,17,17q21.31,40592754,40689084,96330,-,-
BAC68_K04,17,17q21.31,40636452,40746252,109800,-,-
BAC168_F15,17,17q21.31,40679941,40763423,83482,-,-
BAC20_D02,17,17q21.31,40739882,40771698,31816,-,-
BAC113_O05,17,17q21.31,40744816,40846431,101615,-,-
BAC26_O19,17,17q21.31,40757501,40899435,141934,yes,-
BAC240_P23,17,17q21.31,40772517,40910878,138361,yes,-
BAC57_P18,17,17q21.31,40947140,41077933,130793,-,-
BAC142_H09,17,17q21.31,40968259,41087146,118887,-,-
BAC220_B06,17,17q21.31,40979466,41062625,83159,-,-
BAC163_G13,17,17q21.31,40985018,41068834,83816,-,-
BAC37_L13,17,17q21.31,40985018,41087028,102010,-,-
BAC151_C11,17,17q21.31,40985018,41096406,111388,-,-
BAC89_I09,17,17q21.31,40992493,41081871,89378,-,-
BAC151_J04,17,17q21.31,41000968,41096423,95455,-,-
BAC103_C19,17,17q21.31,41077931,41167148,89217,-,-
BAC160_C13,17,17q21.31,41119375,41231665,112290,-,-
BAC192_G06,17,17q21.31,41162912,41272565,109653,-,-
BAC147_E13,17,17q21.31,41165895,41281859,115964,-,-
BAC77_G22,17,17q21.31,41167150,41274995,107845,-,-
BAC79_P08,17,17q21.31,41173998,41272558,98560,-,-
BAC43_B12,17,17q21.31,41179632,41294763,115131,-,-
BAC195_A23,17,17q21.31,41198141,41274995,76854,-,-
BAC250_L09,17,17q21.31,41198178,41298351,100173,-,-
BAC235_J03,17,17q21.31,41231720,41326186,94466,-,-
BAC158_J04,17,17q21.31,41291579,41373299,81720,-,-
BAC158_F04,17,17q21.31,41291579,41373310,81731,-,-
BAC37_M11,17,17q21.31,41294782,41467919,173137,yes,-
BAC217_I19,17,17q21.31,41315408,41431444,116036,-,-
BAC41_K16,17,17q21.31,41379060,41477784,98724,-,-
BAC57_C07,17,17q21.31,41501424,41605688,104264,-,-
BAC84_F24,17,17q21.31,41557146,41644370,87224,-,-
BAC140_I19,17,17q21.31,41558954,41644532,85578,-,-
BAC41_C07,17,17q21.31,41599927,41743504,143577,-,-
BAC70_E04,17,17q21.31-17q21.32,41644648,41932903,288255,yes,-
BAC40_E03,17,17q21.31,41644653,41717748,73095,-,-
BAC106_J16,17,17q21.31,41739902,41867768,127866,-,-
BAC10_L01,17,17q21.31-17q21.32,41813882,42125859,311977,-,-
BAC186_P16,17,17q21.31-17q21.32,41845003,42148423,303420,-,-
BAC197_L11,17,17q21.32,42058614,42147592,88978,-,-
BAC170_A15,17,17q21.32,42188275,42291718,103443,yes,-
BAC131_L04,17,17q21.32,42199757,42291718,91961,-,-
BAC226_L15,17,17q21.32,42199835,42291718,91883,-,-
BAC59_P23,17,17q21.32,42199900,42291718,91818,-,-
BAC127_E23,17,17q21.32,42239186,42370562,131376,yes,-
BAC227_K17,17,17q21.32,42345326,42418938,73612,-,-
BAC60_F19,17,17q21.32,42352940,42442564,89624,-,-
BAC60_P21,17,17q21.32,42374302,42480412,106110,-,-
BAC144_M06,17,17q21.32,42396196,42464812,68616,-,-
BAC181_I18,17,17q21.32,42418932,42520177,101245,-,-
BAC50_C20,17,17q21.32,42437534,42570073,132539,-,-
BAC52_K02,17,17q21.32,42450427,42570636,120209,-,-
BAC165_F12,17,17q21.32,42521007,42607628,86621,-,-
BAC26_J01,17,17q21.32,42631202,42789116,157914,-,-
BAC52_H08,17,17q21.32,42636797,42789122,152325,-,-
BAC137_C23,17,17q21.32,42720365,42807190,86825,-,-
BAC2_N13,17,17q21.32,42837379,42945360,107981,-,-
BAC180_E10,17,17q21.32,42858075,42971465,113390,-,-
BAC86_N21,17,17q21.32,43050926,43166794,115868,-,-
BAC18_B10,17,17q21.32,43142644,43239366,96722,-,-
BAC115_J06,17,17q21.32,43151697,43259465,107768,-,-
BAC61_L10,17,17q21.32,43167016,43259468,92452,-,-
BAC175_K02,17,17q21.32,43168851,43261207,92356,-,-
BAC95_E11,17,17q21.32,43168851,43259468,90617,-,-
BAC165_D03,17,17q21.32,43176404,43259468,83064,-,-
BAC237_D08,17,17q21.32,43239360,43351335,111975,-,-
BAC5_D22,17,17q21.32,43259462,43372772,113310,-,-
BAC34_O14,17,17q21.32,43288743,43427584,138841,-,-
BAC209_A10,17,17q21.32,43313612,43412872,99260,-,-
BAC67_I16,17,17q21.32,43432758,43513672,80914,-,-
BAC124_H19,17,17q21.32,43464000,43556390,92390,-,-
BAC149_C06,17,17q21.32,43513689,43601470,87781,-,-
BAC192_D23,17,17q21.32,43516871,43597622,80751,-,-
BAC197_H01,17,17q21.32,43518662,43606194,87532,-,-
BAC236_G20,17,17q21.32,43518662,43621347,102685,-,-
BAC117_B11,17,17q21.32,43527974,43629887,101913,-,-
BAC158_P03,17,17q21.32,43545109,43613044,67935,-,-
BAC111_L15,17,17q21.32,43545109,43661471,116362,-,-
BAC166_F24,17,17q21.32,43551826,43638120,86294,-,-
BAC233_M18,17,17q21.32,43556385,43629618,73233,-,-
BAC72_I06,17,17q21.32,43565911,43659036,93125,-,-
BAC119_P17,17,17q21.32,43613097,43798140,185043,-,-
BAC150_E04,17,17q21.32,43639468,43725669,86201,-,-
BAC167_J14,17,17q21.32,43829302,43936117,106815,-,-
BAC231_G19,17,17q21.32,43860976,43936116,75140,-,-
BAC149_F06,17,17q21.32,43860976,43940056,79080,-,-
BAC83_I02,17,17q21.32,43879745,43978258,98513,-,-
BAC123_L15,17,17q21.32,43891590,43978258,86668,-,-
BAC226_B18,17,17q21.32,44002524,44096258,93734,-,-
BAC96_K04,17,17q21.32,44047376,44221477,174101,-,-
BAC96_P08,17,17q21.32,44056018,44158745,102727,-,-
BAC200_O06,17,17q21.32,44082394,44162451,80057,-,-
BAC19_J19,17,17q21.32,44096509,44221477,124968,-,-
BAC10_M15,17,17q21.32,44111732,44199972,88240,-,-
BAC176_M10,17,17q21.32,44162449,44289000,126551,-,-
BAC63_M16,17,17q21.32,44169531,44289000,119469,-,-
BAC148_I14,17,17q21.32,44169549,44291119,121570,-,-
BAC80_P20,17,17q21.32,44170528,44284906,114378,-,-
BAC60_A17,17,17q21.32,44170937,44302214,131277,-,-
BAC61_J16,17,17q21.32,44202159,44289000,86841,-,-
BAC41_N09,17,17q21.32,44234710,44328201,93491,-,-
BAC8_N12,17,17q21.32,44251194,44327930,76736,-,-
BAC227_O19,17,17q21.32,44284900,44386533,101633,-,-
BAC8_P15,17,17q21.32,44302218,44393919,91701,-,-
BAC25_K18,17,17q21.32,44343784,44430115,86331,-,-
BAC233_A23,17,17q21.32,44360119,44451017,90898,-,-
BAC238_F21,17,17q21.32,44430112,44510747,80635,-,-
BAC199_L15,17,17q21.32,44438912,44514881,75969,-,-
BAC219_E16,17,17q21.32,44459717,44544326,84609,-,-
BAC231_H15,17,17q21.32,44476972,44557507,80535,-,-
BAC50_B14,17,17q21.32,44590228,44723185,132957,-,-
BAC166_O19,17,17q21.32,44605784,44720908,115124,-,-
BAC184_G16,17,17q21.32,44626855,44723185,96330,-,-
BAC61_J24,17,17q21.32,44626855,44714800,87945,-,-
BAC226_N10,17,17q21.32,44641825,44729773,87948,-,-
BAC69_H19,17,17q21.32,44680406,44770192,89786,-,-
BAC110_M17,17,17q21.32-17q21.33,44719474,44818568,99094,-,-
BAC59_B22,17,17q21.32-17q21.33,44729763,44870486,140723,-,-
BAC43_E09,17,17q21.32-17q21.33,44729765,44818568,88803,-,-
BAC150_P19,17,17q21.32-17q21.33,44762046,44878833,116787,-,-
BAC38_J07,17,17q21.32-17q21.33,44770523,44910642,140119,-,-
BAC244_A21,17,17q21.33,44810305,44910796,100491,-,-
BAC239_I20,17,17q21.33,44816034,44940438,124404,-,-
BAC38_G07,17,17q21.33,44821059,44923823,102764,-,-
BAC168_E06,17,17q21.33,44832751,44955052,122301,-,-
BAC227_C01,17,17q21.33,44859402,44959834,100432,-,-
BAC81_D11,17,17q21.33,44936846,45044081,107235,-,-
BAC81_K18,17,17q21.33,45062570,45141017,78447,-,-
BAC52_K11,17,17q21.33,45062570,45141017,78447,-,-
BAC248_J18,17,17q21.33,45071013,45180725,109712,-,-
BAC42_N09,17,17q21.33,45094656,45180736,86080,-,-
BAC195_N15,17,17q21.33,45118243,45203743,85500,-,-
BAC248_K24,17,17q21.33,45141009,45265837,124828,-,-
BAC175_O01,17,17q21.33,45156113,45243790,87677,-,-
BAC233_N22,17,17q21.33,45251118,45262881,11763,-,-
BAC141_E10,17,17q21.33,45265956,45389679,123723,-,-
BAC40_C13,17,17q21.33,45318708,45490167,171459,-,-
BAC160_F14,17,17q21.33,45318896,45412612,93716,-,-
BAC243_F20,17,17q21.33,45372372,45445921,73549,-,-
BAC81_E05,17,17q21.33,45446202,45557678,111476,-,-
BAC217_B21,17,17q21.33,45486482,45565521,79039,-,-
BAC238_E06,17,17q21.33,45499528,45605085,105557,-,-
BAC125_F06,17,17q21.33,45505484,45609994,104510,-,-
BAC165_P13,17,17q21.33,45531791,45609970,78179,-,-
BAC133_A01,17,17q21.33,45661467,45748951,87484,-,-
BAC160_E18,17,17q21.33,45706868,45812048,105180,-,-
BAC142_C04,17,17q21.33,45780091,45880254,100163,-,-
BAC247_M10,17,17q21.33,45780091,45885560,105469,-,-
BAC124_H12,17,17q21.33,45780977,45948839,167862,-,-
BAC161_F02,17,17q21.33,45861620,45985373,123753,-,-
BAC48_M06,17,17q21.33,45861642,45985370,123728,-,-
BAC139_C01,17,17q21.33,45890171,46024678,134507,-,-
BAC158_H22,17,17q21.33,45944831,46022731,77900,-,-
BAC158_K22,17,17q21.33,45944833,46022726,77893,-,-
BAC25_E14,17,17q21.33,45948368,46085220,136852,-,-
BAC200_M15,17,17q21.33,46062260,46135353,73093,-,-
BAC217_H06,17,17q21.33,46062266,46135353,73087,-,-
BAC142_A09,17,17q21.33,46135020,46216594,81574,-,-
BAC80_C08,17,17q21.33,46135056,46281581,146525,-,-
BAC105_D19,17,17q21.33,46135440,46235901,100461,-,-
BAC145_D11,17,17q21.33,46222845,46337791,114946,-,-
BAC186_O05,17,17q21.33,46238869,46358347,119478,-,-
BAC105_H11,17,17q21.33,46255460,46344608,89148,-,-
BAC33_M24,17,17q21.33,46349074,46436084,87010,-,-
BAC101_H20,17,17q21.33,46391274,46506896,115622,-,-
BAC80_K03,17,17q21.33,46397023,46481007,83984,-,-
BAC11_G15,17,17q21.33,46423824,46538226,114402,-,-
BAC102_C14,17,17q21.33,46423828,46524175,100347,-,-
BAC73_L14,17,17q21.33,46467867,46568798,100931,-,-
BAC38_B16,17,17q21.33,46490105,46618606,128501,-,-
BAC49_N04,17,17q21.33,46490401,46605912,115511,-,-
BAC237_O07,17,17q21.33,46506051,46605915,99864,-,-
BAC33_O15,17,17q21.33,46619452,46705517,86065,-,-
BAC83_H04,17,17q21.33,46630839,46730019,99180,-,-
BAC63_C14,17,17q21.33,46781664,46879576,97912,-,-
BAC133_J19,17,17q21.33,46782212,46869106,86894,-,-
BAC31_E18,17,17q21.33,46784425,46879640,95215,-,-
BAC188_D13,17,17q21.33,46801489,46908387,106898,-,-
BAC72_H14,17,17q21.33,46879631,46968400,88769,-,-
BAC240_F24,17,17q21.33,46879635,46957719,78084,-,-
BAC191_G05,17,17q21.33,46886307,46968420,82113,-,-
BAC179_L18,17,17q21.33,46905345,47021937,116592,-,-
BAC60_I13,17,17q21.33,46909313,46996211,86898,-,-
BAC109_L05,17,17q21.33,46952000,47051564,99564,-,-
BAC241_H04,17,17q21.33,47010831,47096916,86085,-,-
BAC59_L07,17,17q21.33,47072994,47163097,90103,-,-
BAC226_L04,17,17q21.33,47075934,47166007,90073,-,-
BAC156_K13,17,17q21.33,47115953,47210746,94793,-,-
BAC102_I18,17,17q21.33,47117006,47256275,139269,-,-
BAC135_P17,17,17q21.33,47120837,47214909,94072,-,-
BAC51_D24,17,17q21.33,47121544,47256278,134734,-,-
BAC124_A06,17,17q21.33,47121576,47214904,93328,-,-
BAC23_K10,17,17q21.33,47214902,47291240,76338,-,-
BAC83_N05,17,17q21.33,47309516,47395535,86019,-,-
BAC65_H21,17,17q21.33-17q22,47452641,47620337,167696,-,-
BAC34_M20,17,17q22,47637134,47769060,131926,-,-
BAC30_B16,17,17q22,47856640,47929661,73021,-,-
BAC89_L13,17,17q22,48096851,48205439,108588,-,-
BAC101_F18,17,17q22,48285203,48371310,86107,-,-
BAC86_N10,17,17q22,48371304,48475751,104447,-,-
BAC71_P08,17,17q22,48619837,48729074,109237,-,-
BAC62_K11,17,17q22,48655106,48748851,93745,-,-
BAC66_B19,17,17q22,48802847,48893120,90273,-,-
BAC10_A22,17,17q22,48990385,49092911,102526,-,-
BAC91_F18,17,17q22,49130230,49236700,106470,-,-
BAC146_M13,17,17q22,49138303,49263179,124876,-,-
BAC199_M22,17,17q22,49155333,49236816,81483,-,-
BAC131_L17,17,17q22,49338418,49556063,217645,-,-
BAC49_P04,17,17q22,49387489,49478891,91402,-,-
BAC187_G11,17,17q22,49478892,49564335,85443,-,-
BAC15_G07,17,17q22,49687089,49780596,93507,-,-
BAC160_D14,17,17q22,49813633,49896944,83311,-,-
BAC168_O07,17,17q22,49923952,50012638,88686,-,-
BAC81_M19,17,17q22,49962381,50072918,110537,-,-
BAC70_O05,17,17q22,49991450,50099169,107719,-,-
BAC66_M01,17,17q22,50103046,50305797,202751,-,-
BAC110_E08,17,17q22,50228227,50310856,82629,-,-
BAC40_M12,17,17q22,50288058,50418205,130147,-,-
BAC230_M18,17,17q22,50288058,50404615,116557,-,-
BAC12_F21,17,17q22,50313190,50418116,104926,-,-
BAC72_C10,17,17q22,50319151,50404615,85464,-,-
BAC161_B17,17,17q22,50322159,50437960,115801,-,-
BAC165_C18,17,17q22,50327515,50401281,73766,-,-
BAC109_C14,17,17q22,50333753,50462953,129200,-,-
BAC8_O17,17,17q22,50359926,50438132,78206,-,-
BAC85_F22,17,17q22,50401311,50536860,135549,-,-
BAC182_K14,17,17q22,50445651,50525202,79551,-,-
BAC188_F24,17,17q22,50522677,50616237,93560,-,-
BAC97_E22,17,17q22,50644367,50765823,121456,-,-
BAC42_E17,17,17q22,50663534,50789022,125488,-,-
BAC242_O13,17,17q22,50671441,50754473,83032,-,-
BAC110_E13,17,17q22,50695601,50809980,114379,-,-
BAC131_P23,17,17q22,50765831,50869419,103588,-,-
BAC191_P11,17,17q22,50776186,50869397,93211,-,-
BAC117_I22,17,17q22,50925568,51017900,92332,-,-
BAC184_K21,17,17q22,50987652,51073393,85741,-,-
BAC78_O14,17,17q22,51064470,51174713,110243,-,-
BAC153_B15,17,17q22,51121699,51215045,93346,-,-
BAC48_J09,17,17q22,51179786,51292291,112505,-,-
BAC102_F04,17,17q22,51229146,51324734,95588,-,-
BAC240_I13,17,17q22,51292449,51392294,99845,-,-
BAC119_E17,17,17q22,51353656,51449156,95500,-,-
BAC222_P02,17,17q22,51353891,51449156,95265,-,-
BAC248_C11,17,17q22,51372124,51469441,97317,-,-
BAC173_M02,17,17q22,51375122,51503472,128350,-,-
BAC66_D16,17,17q22,51385499,51470964,85465,-,-
BAC96_N07,17,17q22,51761314,51899079,137765,-,-
BAC226_E22,17,17q22,51820517,51854010,33493,-,-
BAC160_M17,17,17q22,51903361,51993330,89969,-,-
BAC92_E17,17,17q22,51914605,52010681,96076,-,-
BAC36_E02,17,17q22,51943518,52141725,198207,-,-
BAC120_F11,17,17q22,52100465,52217326,116861,-,-
BAC244_I08,17,17q22,52122652,52206838,84186,-,-
BAC108_I14,17,17q22,52183803,52278038,94235,-,-
BAC88_F15,17,17q22,52259619,52374690,115071,-,-
BAC155_O06,17,17q22,52280923,52365089,84166,-,-
BAC24_O15,17,17q22,52280923,52408295,127372,-,-
BAC15_E15,17,17q22,52287563,52450585,163022,-,-
BAC218_C03,17,17q22,52288818,52411183,122365,-,-
BAC92_I11,17,17q22,52288843,52381044,92201,-,-
BAC236_P20,17,17q22,52323377,52408295,84918,-,-
BAC73_M17,17,17q22,52335482,52453038,117556,-,-
BAC192_C03,17,17q22,52423390,52505393,82003,-,-
BAC205_I13,17,17q22,52453043,52555528,102485,-,-
BAC162_H04,17,17q22,52500930,52596976,96046,-,-
BAC127_L24,17,17q22,52500930,52582924,81994,-,-
BAC247_H17,17,17q22,52528699,52614403,85704,-,-
BAC48_F01,17,17q22,52542267,52640440,98173,-,-
BAC162_L05,17,17q22,52582923,52695389,112466,-,-
BAC187_F18,17,17q22,52635488,52718412,82924,-,-
BAC181_I04,17,17q22,52643283,52782153,138870,-,-
BAC84_B23,17,17q22,52648727,52763914,115187,-,-
BAC189_H11,17,17q22,52659856,52749521,89665,-,-
BAC191_D16,17,17q22,52695661,52790453,94792,-,-
BAC115_O01,17,17q22,52706374,52781004,74630,-,-
BAC152_D05,17,17q22,52731750,52801987,70237,-,-
BAC238_A14,17,17q22,52780999,52877587,96588,-,-
BAC186_M19,17,17q22,52785105,52883392,98287,-,-
BAC236_G21,17,17q22,52883436,52986410,102974,-,-
BAC217_E16,17,17q22,52916728,53007511,90783,-,-
BAC25_P23,17,17q22,52988420,53069580,81160,-,-
BAC205_O10,17,17q22,53001171,53087047,85876,-,-
BAC150_O15,17,17q22,53010880,53111488,100608,-,-
BAC235_E23,17,17q22,53024107,53105129,81022,-,-
BAC109_I02,17,17q22,53042070,53154187,112117,-,-
BAC233_L12,17,17q22,53078093,53198966,120873,-,-
BAC132_J21,17,17q22,53093672,53199172,105500,-,-
BAC192_H03,17,17q22,53119671,53194071,74400,-,-
BAC246_P01,17,17q22,53193755,53276419,82664,-,-
BAC233_M11,17,17q22,53251946,53406862,154916,-,-
BAC121_C07,17,17q22,53251946,53355577,103631,-,-
BAC148_K16,17,17q22,53251946,53340147,88201,-,-
BAC243_D20,17,17q22,53263054,53355698,92644,-,-
BAC122_C19,17,17q22,53292362,53392796,100434,-,-
BAC179_E22,17,17q22,53404418,53484950,80532,-,-
BAC50_N10,17,17q22,53469366,53631593,162227,-,-
BAC177_E24,17,17q22,53469407,53562187,92780,-,-
BAC43_O16,17,17q22,53477525,53557539,80014,-,-
BAC9_L08,17,17q22,53477582,53557630,80048,-,-
BAC157_K16,17,17q22,53484960,53535432,50472,-,-
BAC24_J21,17,17q22,53488931,53602826,113895,-,-
BAC13_B12,17,17q22,53492181,53602826,110645,-,-
BAC133_G08,17,17q22,53662098,53758544,96446,-,-
BAC110_A01,17,17q22,53690420,53788478,98058,-,-
BAC235_M05,17,17q22,53690491,53786705,96214,-,-
BAC90_A13,17,17q22,53693654,53784022,90368,-,-
BAC82_C11,17,17q22,53717085,53806210,89125,-,-
BAC220_D18,17,17q22,53722211,53813385,91174,-,-
BAC199_L06,17,17q22,53784017,53858664,74647,-,-
BAC103_G05,17,17q22,53788735,53888817,100082,-,-
BAC127_I05,17,17q22,53801603,53932465,130862,-,-
BAC54_H12,17,17q22,53858658,53948724,90066,-,-
BAC53_N10,17,17q22,53953124,53965740,12616,-,-
BAC116_M07,17,17q22,53965185,54057925,92740,-,-
BAC243_M08,17,17q22,53966132,54057902,91770,-,-
BAC155_L20,17,17q22,53997380,54126031,128651,-,-
BAC134_A09,17,17q22,53997532,54110564,113032,-,-
BAC210_G06,17,17q22,54018207,54148465,130258,-,-
BAC63_L18,17,17q22,54047798,54144367,96569,-,-
BAC95_N13,17,17q22,54053476,54162275,108799,-,-
BAC39_B10,17,17q22,54060581,54144355,83774,-,-
BAC34_K05,17,17q22,54060581,54202576,141995,-,-
BAC128_M02,17,17q22,54061267,54168365,107098,-,-
BAC241_D05,17,17q22,54069934,54139172,69238,-,-
BAC24_L17,17,17q22,54108063,54215553,107490,-,-
BAC220_B14,17,17q22,54126145,54222955,96810,-,-
BAC25_C24,17,17q22,54150122,54283119,132997,-,-
BAC86_M03,17,17q22,54168600,54250930,82330,-,-
BAC115_N02,17,17q22,54196113,54380542,184429,-,-
BAC131_K14,17,17q22,54222955,54302257,79302,-,-
BAC81_B01,17,17q22,54335583,54465369,129786,-,-
BAC148_K12,17,17q22,54379826,54474452,94626,-,-
BAC205_L05,17,17q22,54379897,54474457,94560,-,-
BAC34_D20,17,17q22,54396055,54477779,81724,-,-
BAC163_O22,17,17q22,54420863,54526493,105630,-,-
BAC222_M22,17,17q22,54474619,54584380,109761,-,-
BAC233_E17,17,17q22,54483892,54529618,45726,-,-
BAC248_L08,17,17q22,54495596,54606506,110910,-,-
BAC197_K10,17,17q22,54544586,54622622,78036,-,-
BAC181_B14,17,17q22,54566523,54668261,101738,-,-
BAC92_I19,17,17q22,54584376,54703221,118845,-,-
BAC247_P02,17,17q22,54730952,54812886,81934,-,-
BAC104_C04,17,17q22,54765565,54781316,15751,-,-
BAC82_I12,17,17q22-17q23.1,54803373,54923118,119745,-,-
BAC24_H14,17,17q22-17q23.1,54829883,54957335,127452,-,-
BAC134_L15,17,17q22-17q23.1,54872111,54950779,78668,-,-
BAC140_L19,17,17q22-17q23.1,54880196,54972993,92797,-,-
BAC118_H16,17,17q23.1,54926041,55055040,128999,-,-
BAC101_C16,17,17q23.1,54980110,55078888,98778,-,-
BAC140_G21,17,17q23.1,55015564,55112645,97081,-,-
BAC105_E06,17,17q23.1,55122936,55217002,94066,-,-
BAC69_E05,17,17q23.1,55147326,55254349,107023,-,-
BAC17_D22,17,17q23.1,55159363,55253066,93703,-,-
BAC196_A04,17,17q23.1,55212013,55289917,77904,-,-
BAC117_M18,17,17q23.1,55212132,55331026,118894,-,-
BAC236_C23,17,17q23.1,55263955,55349907,85952,-,-
BAC23_P03,17,17q23.1,55270505,55379358,108853,-,-
BAC91_M15,17,17q23.1,55280313,55379353,99040,-,-
BAC237_I07,17,17q23.1,55331021,55413151,82130,-,-
BAC51_J15,17,17q23.1,55349902,55523171,173269,yes,-
BAC55_A20,17,17q23.1,55387881,55482745,94864,-,-
BAC14_G07,17,17q23.1,55387881,55488850,100969,yes,-
BAC241_L02,17,17q23.1-17q23.2,55441769,57791844,2350075,-,-
BAC228_B01,17,17q23.1-17q23.2,55523174,55620658,97484,-,-
BAC187_M20,17,17q23.2,55620655,55707208,86553,-,-
BAC244_A16,17,17q23.2,55631471,55722369,90898,-,-
BAC45_J03,17,17q23.2,55637896,55774635,136739,-,-
BAC59_J03,17,17q23.2,55642472,55746765,104293,-,-
BAC100_P18,17,17q23.2,55667859,55808183,140324,-,-
BAC29_D22,17,17q23.2,55715868,55808183,92315,-,-
BAC53_D04,17,17q23.2,55746759,55856145,109386,-,-
BAC92_P23,17,17q23.2,55760885,55856139,95254,-,-
BAC66_F09,17,17q23.2,55773574,55896175,122601,-,-
BAC46_I01,17,17q23.2,55842192,55945655,103463,-,-
BAC181_B11,17,17q23.2,55847617,55947635,100018,-,-
BAC162_J10,17,17q23.2,55912100,56004322,92222,-,-
BAC246_I13,17,17q23.2,55957747,56046737,88990,-,-
BAC50_I22,17,17q23.2,55991405,56119015,127610,-,-
BAC78_I17,17,17q23.2,56017074,56137264,120190,-,-
BAC159_J08,17,17q23.2,56038803,56119006,80203,-,-
BAC10_I02,17,17q23.2,56038803,56195707,156904,-,-
BAC165_N11,17,17q23.2,56092997,56179963,86966,-,-
BAC24_O02,17,17q23.2,56121139,56277491,156352,-,-
BAC31_B19,17,17q23.2,56144592,56257308,112716,-,-
BAC38_B14,17,17q23.2,56150420,56283656,133236,-,-
BAC135_C15,17,17q23.2,56176999,56254981,77982,-,-
BAC81_E18,17,17q23.2,56241662,56338593,96931,-,-
BAC190_I22,17,17q23.2,56350854,56452200,101346,-,-
BAC101_L01,17,17q23.2,56477258,56567520,90262,-,-
BAC231_G09,17,17q23.2,56497003,56579813,82810,-,-
BAC195_I04,17,17q23.2,56523896,56637891,113995,-,-
BAC114_E08,17,17q23.2,56647099,56749349,102250,-,-
BAC46_L05,17,17q23.2,56665676,56793307,127631,-,-
BAC235_I20,17,17q23.2,56666371,56761950,95579,-,-
BAC184_N02,17,17q23.2,56695317,56794319,99002,-,-
BAC91_M23,17,17q23.2,56717047,56824388,107341,-,-
BAC182_N22,17,17q23.2,56717047,56794354,77307,-,-
BAC10_I01,17,17q23.2,56793442,56905189,111747,-,-
BAC90_D17,17,17q23.2,56794347,56892821,98474,-,-
BAC66_I09,17,17q23.2,56821354,56903562,82208,-,-
BAC221_C11,17,17q23.2,56917786,57028639,110853,-,-
BAC35_K17,17,17q23.2,56980994,57061528,80534,-,-
BAC185_O04,17,17q23.2,57020880,57100495,79615,-,-
BAC96_B23,17,17q23.2,57020880,57122698,101818,-,-
BAC29_B23,17,17q23.2,57075034,57174051,99017,-,-
BAC37_O14,17,17q23.2,57114412,57224502,110090,-,-
BAC31_B21,17,17q23.2,57174612,57291982,117370,-,-
BAC61_I15,17,17q23.2,57237957,57351620,113663,-,-
BAC151_D16,17,17q23.2,57293619,57392766,99147,-,-
BAC38_J17,17,17q23.2,57301891,57392750,90859,-,-
BAC84_P24,17,17q23.2,57301891,57392766,90875,-,-
BAC154_H19,17,17q23.2,57301901,57405567,103666,-,-
BAC126_C23,17,17q23.2,57313788,57398642,84854,-,-
BAC39_L07,17,17q23.2,57313791,57399107,85316,-,-
BAC96_N02,17,17q23.2,57313839,57398601,84762,-,-
BAC130_J16,17,17q23.2,57398633,57486442,87809,-,-
BAC75_B16,17,17q23.2,57461718,57545531,83813,-,-
BAC100_G13,17,17q23.2,57463961,57528383,64422,-,-
BAC242_G08,17,17q23.2,57580035,57657051,77016,yes,-
BAC101_E19,17,17q23.2,57630036,57715093,85057,yes,-
BAC237_H18,17,17q23.2,57630036,57733612,103576,yes,-
BAC227_A19,17,17q23.2,57630110,57715093,84983,yes,-
BAC179_E03,17,17q23.2,57638611,57715093,76482,yes,-
BAC218_G18,17,17q23.2,57697097,57781957,84860,-,-
BAC89_M17,17,17q23.2,57741040,57833757,92717,-,-
BAC189_M24,17,17q23.2,57885729,57962598,76869,-,-
BAC226_H16,17,17q23.2,57904620,58017392,112772,-,-
BAC148_A04,17,17q23.2,57919458,58017392,97934,-,-
BAC33_J20,17,17q23.2,57949208,58050291,101083,-,-
BAC42_L15,17,17q23.2,57951180,58043928,92748,-,-
BAC193_I08,17,17q23.2,57966551,58068142,101591,-,-
BAC238_L03,17,17q23.2,57969915,58124629,154714,-,-
BAC96_K22,17,17q23.2,58037395,58125822,88427,-,-
BAC71_O15,17,17q23.2,58038861,58126799,87938,-,-
BAC69_P23,17,17q23.2,58061632,58182105,120473,-,-
BAC196_O11,17,17q23.2,58088076,58177537,89461,-,-
BAC199_F06,17,17q23.2,58126172,58217852,91680,-,-
BAC170_B07,17,17q23.2,58126172,58206150,79978,-,-
BAC229_O10,17,17q23.2,58153942,58249328,95386,-,-
BAC238_I03,17,17q23.2,58193337,58342110,148773,-,-
BAC123_H16,17,17q23.2,58227655,58325019,97364,-,-
BAC181_L10,17,17q23.2,58247577,58368640,121063,-,-
BAC104_F08,17,17q23.2-17q23.3,58325539,58437323,111784,-,-
BAC92_K20,17,17q23.2-17q23.3,58350436,58431658,81222,-,-
BAC187_E18,17,17q23.2-17q23.3,58355333,58439009,83676,-,-
BAC143_P07,17,17q23.3,58528686,58629058,100372,-,-
BAC11_C05,17,17q23.3,58548486,58629034,80548,-,-
BAC96_A16,17,17q23.3,58569332,58688167,118835,-,-
BAC82_N19,17,17q23.3,58569871,58723991,154120,-,-
BAC57_G11,17,17q23.3,58569871,58673352,103481,-,-
BAC118_G16,17,17q23.3,58615764,58720987,105223,-,-
BAC250_J05,17,17q23.3,58632732,58761299,128567,-,-
BAC107_H19,17,17q23.3,58723983,58822463,98480,-,-
BAC208_E15,17,17q23.3,58748113,58839624,91511,-,-
BAC69_P09,17,17q23.3,58786952,58912525,125573,-,-
BAC126_I22,17,17q23.3,58792667,58931286,138619,-,-
BAC151_J02,17,17q23.3,58845544,58921912,76368,-,-
BAC132_P20,17,17q23.3,58849519,58972833,123314,-,-
BAC148_A17,17,17q23.3,58902353,59010872,108519,-,-
BAC38_C03,17,17q23.3,58972869,59067165,94296,-,-
BAC10_M10,17,17q23.3,58974392,59110175,135783,-,-
BAC204_N16,17,17q23.3,58982376,59065396,83020,-,-
BAC30_P08,17,17q23.3,58989571,59092717,103146,-,-
BAC88_D15,17,17q23.3,59067300,59150930,83630,-,-
BAC135_D17,17,17q23.3,59089037,59188289,99252,-,-
BAC249_J22,17,17q23.3,59101208,59222140,120932,-,-
BAC59_A05,17,17q23.3,59150925,59294953,144028,-,-
BAC78_M01,17,17q23.3,59222138,59359288,137150,yes,-
BAC84_M12,17,17q23.3,59297090,59423954,126864,yes,-
BAC97_D15,17,17q23.3,59318804,59437298,118494,-,-
BAC50_H03,17,17q23.3,59357568,59485995,128427,-,-
BAC243_K09,17,17q23.3,59359257,59470366,111109,-,-
BAC25_F19,17,17q23.3,59374876,59457331,82455,-,-
BAC142_E18,17,17q23.3,59381691,59508244,126553,-,-
BAC8_J16,17,17q23.3,59499071,59611537,112466,-,-
BAC32_N16,17,17q23.3,59507874,59648795,140921,-,-
BAC67_K17,17,17q23.3,59550033,59682500,132467,-,-
BAC42_P08,17,17q23.3,59561523,59668544,107021,-,-
BAC81_J15,17,17q23.3,59562942,59640222,77280,-,-
BAC39_L05,17,17q23.3,59599607,59684417,84810,-,-
BAC157_B15,17,17q23.3,59639349,59714094,74745,-,-
BAC28_F01,17,17q23.3,59642069,59765035,122966,-,-
BAC184_E10,17,17q23.3,59661832,59758494,96662,-,-
BAC37_D19,17,17q23.3,59758490,59868919,110429,-,-
BAC218_O18,17,17q23.3-17q24.1,59858133,59976344,118211,-,-
BAC12_K03,17,17q24.1,59972431,60070892,98461,-,-
BAC51_H18,17,17q24.1,59977463,60070856,93393,-,-
BAC83_O07,17,17q24.1,60031783,60139100,107317,-,-
BAC53_G16,17,17q24.1,60039450,60171129,131679,-,-
BAC199_D16,17,17q24.1,60046870,60139100,92230,-,-
BAC40_E17,17,17q24.1,60046870,60176336,129466,-,-
BAC143_L19,17,17q24.1,60071202,60162474,91272,-,-
BAC184_J23,17,17q24.1,60073930,60162451,88521,-,-
BAC235_A12,17,17q24.1,60083460,60180939,97479,-,-
BAC153_L13,17,17q24.1,60102028,60176340,74312,-,-
BAC197_K06,17,17q24.1,60135128,60264316,129188,-,-
BAC236_P22,17,17q24.1,60260102,60399073,138971,-,-
BAC249_H15,17,17q24.1,60264391,60386110,121719,-,-
BAC81_K10,17,17q24.1,60399081,60528917,129836,-,-
BAC40_F15,17,17q24.1,60412941,60541554,128613,-,-
BAC193_C15,17,17q24.1,60448009,60529232,81223,-,-
BAC61_G10,17,17q24.1,60485583,60614905,129322,-,-
BAC81_D05,17,17q24.1,60491071,60591798,100727,-,-
BAC238_P08,17,17q24.1,60529660,60551325,21665,-,-
BAC196_G05,17,17q24.1,60533324,60612587,79263,-,-
BAC46_D03,17,17q24.1,60544450,60669535,125085,-,-
BAC149_P09,17,17q24.1,60604202,60622009,17807,-,-
BAC233_A01,17,17q24.1,60622288,60741185,118897,-,-
BAC190_J03,17,17q24.1,60643590,60764990,121400,-,-
BAC8_A08,17,17q24.1,60667159,60818007,150848,-,-
BAC153_D07,17,17q24.1,60668696,60749261,80565,-,-
BAC44_O18,17,17q24.1,60670691,60800584,129893,-,-
BAC160_M07,17,17q24.1,60732986,60812933,79947,-,-
BAC67_B07,17,17q24.1,60741191,60881589,140398,-,-
BAC241_P07,17,17q24.1,60741251,60844576,103325,-,-
BAC133_O17,17,17q24.1,60874072,60965755,91683,-,-
BAC176_N09,17,17q24.1,60881596,60966072,84476,-,-
BAC37_G09,17,17q24.1,60926244,61126638,200394,-,-
BAC126_C14,17,17q24.1,60926244,61041306,115062,-,-
BAC36_I20,17,17q24.1,60932692,61041302,108610,-,-
BAC104_D03,17,17q24.1,60970297,61086664,116367,-,-
BAC36_M11,17,17q24.1,61014330,61121400,107070,-,-
BAC132_G07,17,17q24.1,61014963,61097277,82314,-,-
BAC173_M23,17,17q24.1,61014989,61093890,78901,-,-
BAC150_K19,17,17q24.1,61019941,61106341,86400,-,-
BAC142_B04,17,17q24.1,61019941,61100308,80367,-,-
BAC184_E15,17,17q24.1,61041307,61126898,85591,-,-
BAC1_D03,17,17q24.1,61093899,61174999,81100,-,-
BAC236_H17,17,17q24.1,61197661,61280606,82945,-,-
BAC148_K01,17,17q24.1,61197661,61317613,119952,-,-
BAC82_N15,17,17q24.1,61206876,61390120,183244,-,-
BAC160_B15,17,17q24.1,61283876,61410253,126377,-,-
BAC42_O05,17,17q24.1,61362872,61456666,93794,-,-
BAC137_B12,17,17q24.1,61377321,61449291,71970,-,-
BAC101_F21,17,17q24.1,61449618,61589442,139824,-,-
BAC230_C06,17,17q24.1,61460357,61551567,91210,-,-
BAC128_H03,17,17q24.1,61460367,61555636,95269,-,-
BAC123_F21,17,17q24.1,61481355,61581095,99740,-,-
BAC5_I15,17,17q24.1,61487535,61574189,86654,-,-
BAC29_A07,17,17q24.1,61500001,61589433,89432,-,-
BAC142_C23,17,17q24.1-17q24.2,61589452,61710679,121227,-,-
BAC243_O21,17,17q24.1-17q24.2,61598606,61629595,30989,-,-
BAC148_I04,17,17q24.2,61629778,61719955,90177,-,-
BAC197_N18,17,17q24.2,61644456,61743008,98552,-,-
BAC105_P16,17,17q24.2,61658120,61795953,137833,-,-
BAC65_L23,17,17q24.2,61660296,61741250,80954,-,-
BAC203_G04,17,17q24.2,61660302,61752295,91993,-,-
BAC226_D22,17,17q24.2,61730222,61820824,90602,-,-
BAC153_K03,17,17q24.2,61773062,61869290,96228,-,-
BAC198_A01,17,17q24.2,61792702,61879735,87033,-,-
BAC187_E13,17,17q24.2,61820819,61921681,100862,-,-
BAC70_P11,17,17q24.2,61859026,61963885,104859,-,-
BAC107_B12,17,17q24.2,61869282,61960990,91708,-,-
BAC31_O15,17,17q24.2,61912618,62011940,99322,-,-
BAC82_L11,17,17q24.2,61921323,62054668,133345,-,-
BAC37_E14,17,17q24.2,61936036,62054685,118649,-,-
BAC188_M08,17,17q24.2,61937764,62030809,93045,-,-
BAC26_K17,17,17q24.2,61937870,62037034,99164,-,-
BAC146_K07,17,17q24.2,61961268,62121896,160628,-,-
BAC103_H01,17,17q24.2,61965159,62122514,157355,-,-
BAC143_A22,17,17q24.2,61968468,62054663,86195,-,-
BAC153_M16,17,17q24.2,62002936,62121896,118960,-,-
BAC77_A10,17,17q24.2,62080399,62171384,90985,-,-
BAC25_I01,17,17q24.2,62106409,62205675,99266,-,-
BAC195_N16,17,17q24.2,62121496,62195935,74439,-,-
BAC109_B01,17,17q24.2,62121723,62205678,83955,-,-
BAC156_F16,17,17q24.2,62159973,62245290,85317,-,-
BAC186_E24,17,17q24.2,62202414,62300516,98102,-,-
BAC186_C01,17,17q24.2,62286701,62379046,92345,-,-
BAC233_E04,17,17q24.2,62331336,62426088,94752,-,-
BAC51_J11,17,17q24.2,62506313,62594327,88014,-,-
BAC56_P20,17,17q24.2,62559674,62723776,164102,-,-
BAC61_K09,17,17q24.2,62594336,62729856,135520,-,-
BAC76_P08,17,17q24.2,62651739,62748503,96764,-,-
BAC159_C11,17,17q24.2,62736947,62823942,86995,-,-
BAC217_M03,17,17q24.2,62739157,62831301,92144,-,-
BAC133_A17,17,17q24.2,62788569,62910901,122332,-,-
BAC97_D10,17,17q24.2,62788569,62875940,87371,-,-
BAC210_E18,17,17q24.2,62788717,62880829,92112,-,-
BAC84_H06,17,17q24.2,62794188,62899229,105041,-,-
BAC119_H14,17,17q24.2,62812098,62910917,98819,-,-
BAC53_C17,17,17q24.2,62823950,62949780,125830,-,-
BAC139_I23,17,17q24.2,62880437,62997357,116920,-,-
BAC31_O19,17,17q24.2,62910514,63010165,99651,-,-
BAC228_P07,17,17q24.2,62957500,63075843,118343,-,-
BAC80_C17,17,17q24.2,62997442,63170153,172711,-,-
BAC154_I23,17,17q24.2,62997442,63093020,95578,-,-
BAC50_A11,17,17q24.2,62997447,63092349,94902,-,-
BAC12_C13,17,17q24.2,63100080,63217679,117599,-,-
BAC116_D18,17,17q24.2,63100080,63193521,93441,-,-
BAC233_F23,17,17q24.2,63107308,63193524,86216,-,-
BAC125_A16,17,17q24.2,63170146,63275470,105324,-,-
BAC21_L20,17,17q24.2,63170178,63340190,170012,-,-
BAC140_A02,17,17q24.2,63203465,63339367,135902,-,-
BAC34_I05,17,17q24.2,63203466,63277504,74038,-,-
BAC55_H24,17,17q24.2,63231327,63340189,108862,-,-
BAC27_N10,17,17q24.2,63235991,63317454,81463,-,-
BAC41_C19,17,17q24.2,63277498,63388549,111051,-,-
BAC234_C23,17,17q24.2,63277869,63392922,115053,-,-
BAC149_J01,17,17q24.2,63380966,63472333,91367,-,-
BAC41_L19,17,17q24.2,63421371,63614980,193609,-,-
BAC167_C03,17,17q24.2,63434690,63661424,226734,-,-
BAC198_D13,17,17q24.2,63470711,63642610,171899,-,-
BAC119_K10,17,17q24.2,63669717,63769572,99855,-,-
BAC82_C13,17,17q24.2,63675639,63831803,156164,-,-
BAC194_A21,17,17q24.2,63681463,63790683,109220,-,-
BAC194_A14,17,17q24.2,63693219,63775262,82043,-,-
BAC40_H13,17,17q24.2,63720762,63827711,106949,-,-
BAC177_N14,17,17q24.2,63730832,63811907,81075,-,-
BAC177_D12,17,17q24.2,63730832,63811907,81075,-,-
BAC244_J22,17,17q24.2,63758942,63845920,86978,-,-
BAC134_M20,17,17q24.2,63772557,63833643,61086,-,-
BAC68_B18,17,17q24.2,63772557,63845920,73363,-,-
BAC38_O07,17,17q24.2,64024772,64136269,111497,-,-
BAC136_D03,17,17q24.2,64059463,64188261,128798,-,-
BAC74_O10,17,17q24.2,64187151,64280348,93197,-,-
BAC92_M21,17,17q24.2,64284494,64403181,118687,-,-
BAC156_I05,17,17q24.2,64303416,64419249,115833,-,-
BAC23_L13,17,17q24.2,64336120,64440552,104432,-,-
BAC134_P06,17,17q24.2-17q24.3,64598363,64691993,93630,-,-
BAC88_C24,17,17q24.3,64681251,64692093,10842,-,-
BAC175_L21,17,17q24.3,64701102,64783817,82715,-,-
BAC114_O08,17,17q24.3,64731219,64821900,90681,-,-
BAC120_M22,17,17q24.3,64894279,64996505,102226,-,-
BAC194_K02,17,17q24.3,64942822,65017253,74431,-,-
BAC24_L12,17,17q24.3,64951132,65043615,92483,-,-
BAC171_M03,17,17q24.3,64952674,65068501,115827,-,-
BAC185_K20,17,17q24.3,64953611,65045368,91757,-,-
BAC161_J08,17,17q24.3,64996501,65116626,120125,-,-
BAC78_C05,17,17q24.3,65097817,65214095,116278,-,-
BAC246_D06,17,17q24.3,65122049,65200362,78313,-,-
BAC42_M02,17,17q24.3,65146528,65229916,83388,-,-
BAC240_A05,17,17q24.3,65263088,65332729,69641,-,-
BAC146_E13,17,17q24.3,65330983,65410394,79411,-,-
BAC1_J06,17,17q24.3,65332723,65456842,124119,-,-
BAC181_D09,17,17q24.3,65602085,65670116,68031,-,-
BAC119_G13,17,17q24.3,65627208,65769094,141886,yes,-
BAC219_H07,17,17q24.3,65677914,65769094,91180,-,-
BAC242_H17,17,17q24.3,65773662,65889553,115891,-,-
BAC70_L10,17,17q24.3,65773662,65845359,71697,-,-
BAC246_L19,17,17q24.3,65776575,65860810,84235,-,-
BAC145_D09,17,17q24.3,65895795,65917928,22133,-,-
BAC37_J08,17,17q24.3,66022683,66105640,82957,-,-
BAC79_O23,17,17q24.3,66290457,66418085,127628,-,-
BAC175_D04,17,17q24.3,66292332,66437829,145497,-,-
BAC246_D09,17,17q24.3,66294134,66383946,89812,-,-
BAC116_I18,17,17q24.3,66437827,66557455,119628,-,-
BAC132_I11,17,17q24.3,66862052,66928573,66521,-,-
BAC70_N11,17,17q24.3,66884538,66990764,106226,-,-
BAC101_F05,17,17q24.3,67142457,67231345,88888,-,-
BAC135_B17,17,17q24.3,67288599,67384663,96064,-,-
BAC60_H19,17,17q24.3,67294659,67378577,83918,-,-
BAC198_M15,17,17q24.3,67384838,67469342,84504,-,-
BAC48_H06,17,17q24.3,67534967,67641788,106821,-,-
BAC162_M11,17,17q24.3,67535083,67643737,108654,-,-
BAC158_H21,17,17q24.3,67571190,67643732,72542,-,-
BAC240_A17,17,17q24.3,67589895,67719351,129456,-,-
BAC142_D23,17,17q24.3,67720648,67847378,126730,-,-
BAC66_B13,17,17q24.3,67770977,67920524,149547,-,-
BAC66_H01,17,17q24.3,67816254,67920771,104517,-,-
BAC62_D10,17,17q24.3,67916581,67996108,79527,-,-
BAC219_A15,17,17q24.3,67919352,68044244,124892,-,-
BAC82_I01,17,17q24.3,67930661,68044244,113583,-,-
BAC172_A14,17,17q24.3,67949977,68026823,76846,-,-
BAC42_M15,17,17q24.3,68035956,68207131,171175,-,-
BAC83_A09,17,17q24.3,68046924,68155230,108306,-,-
BAC127_F11,17,17q24.3,68046925,68147994,101069,-,-
BAC151_F18,17,17q24.3,68108807,68185989,77182,-,-
BAC150_D16,17,17q24.3,68137832,68219026,81194,-,-
BAC150_N10,17,17q24.3,68147988,68257000,109012,-,-
BAC196_A21,17,17q24.3,68147988,68207131,59143,-,-
BAC189_P17,17,17q24.3,68185983,68263492,77509,-,-
BAC69_J03,17,17q24.3,68207123,68301725,94602,-,-
BAC61_J10,17,17q24.3,68214261,68343919,129658,-,-
BAC144_F11,17,17q24.3,68220395,68301818,81423,-,-
BAC176_H23,17,17q24.3,68234834,68351544,116710,-,-
BAC70_P05,17,17q24.3,68267207,68350178,82971,-,-
BAC39_P21,17,17q24.3-17q25.1,68324565,68453152,128587,-,-
BAC184_G12,17,17q24.3-17q25.1,68343912,68406771,62859,-,-
BAC159_L12,17,17q24.3-17q25.1,68375698,68452777,77079,-,-
BAC168_A21,17,17q24.3-17q25.1,68392983,68479040,86057,-,-
BAC123_I07,17,17q25.1,68426531,68518403,91872,-,-
BAC39_M15,17,17q25.1,68437872,68548718,110846,-,-
BAC175_G09,17,17q25.1,68576380,68681574,105194,-,-
BAC115_A02,17,17q25.1,68577292,68689814,112522,-,-
BAC83_F22,17,17q25.1,68663377,68759251,95874,-,-
BAC20_J18,17,17q25.1,68690167,68806020,115853,-,-
BAC209_F05,17,17q25.1,68690712,68775893,85181,-,-
BAC186_D04,17,17q25.1,68748256,68845909,97653,-,-
BAC84_L22,17,17q25.1,68755954,68872215,116261,-,-
BAC151_D09,17,17q25.1,68759244,68830167,70923,-,-
BAC136_G10,17,17q25.1,68759244,68868580,109336,-,-
BAC204_G24,17,17q25.1,68759519,68857092,97573,-,-
BAC108_B05,17,17q25.1,68872374,68958821,86447,-,-
BAC11_N01,17,17q25.1,68931893,69028460,96567,-,-
BAC147_M12,17,17q25.1,68931893,69028476,96583,-,-
BAC48_G10,17,17q25.1,68931923,69095775,163852,-,-
BAC11_K11,17,17q25.1,68932108,69036527,104419,-,-
BAC183_O19,17,17q25.1,68958416,69038738,80322,-,-
BAC22_M10,17,17q25.1,68958447,69100817,142370,-,-
BAC185_J06,17,17q25.1,68958823,69039007,80184,-,-
BAC168_M22,17,17q25.1,69070557,69172083,101526,-,-
BAC42_I09,17,17q25.1,69115595,69198521,82926,-,-
BAC69_I13,17,17q25.1,69142741,69304965,162224,-,-
BAC193_P22,17,17q25.1,69168737,69250501,81764,-,-
BAC200_G18,17,17q25.1,69198528,69289578,91050,-,-
BAC74_M10,17,17q25.1,69198529,69290091,91562,-,-
BAC23_L03,17,17q25.1,69305978,69426109,120131,-,-
BAC217_G20,17,17q25.1,69306575,69391744,85169,-,-
BAC51_D18,17,17q25.1,69398090,69512267,114177,-,-
BAC118_F23,17,17q25.1,69414734,69512277,97543,-,-
BAC162_P21,17,17q25.1,69416096,69513625,97529,-,-
BAC74_J12,17,17q25.1,69425419,69548539,123120,-,-
BAC232_L13,17,17q25.1,69467773,69548550,80777,-,-
BAC88_G05,17,17q25.1,69474083,69586310,112227,-,-
BAC67_L09,17,17q25.1,69548545,69738377,189832,-,-
BAC119_N16,17,17q25.1,69603066,69753611,150545,-,-
BAC57_B04,17,17q25.1,69622790,69730453,107663,-,-
BAC140_G13,17,17q25.1,69627964,69723561,95597,-,-
BAC97_E19,17,17q25.1,69627966,69723560,95594,-,-
BAC193_B04,17,17q25.1,69634640,69730501,95861,-,-
BAC52_P22,17,17q25.1,69672435,69886755,214320,-,-
BAC225_C03,17,17q25.1,69681869,69814010,132141,-,-
BAC104_N04,17,17q25.1,69681894,69808567,126673,-,-
BAC176_H05,17,17q25.1,69684457,69807261,122804,-,-
BAC150_I11,17,17q25.1,69690845,69753611,62766,-,-
BAC105_L18,17,17q25.1,69814005,69900054,86049,-,-
BAC203_E19,17,17q25.1,69814059,69908898,94839,-,-
BAC172_G06,17,17q25.1,69846065,69942648,96583,-,-
BAC149_K02,17,17q25.1,69873679,69995899,122220,-,-
BAC198_J11,17,17q25.1,69903132,69969147,66015,-,-
BAC64_I06,17,17q25.1,69903135,70021411,118276,-,-
BAC57_O20,17,17q25.1,69908973,69995899,86926,-,-
BAC58_L10,17,17q25.1,69945788,70065341,119553,-,-
BAC106_N17,17,17q25.1,69969145,70080824,111679,-,-
BAC59_B09,17,17q25.1,69979423,70139356,159933,-,-
BAC239_D02,17,17q25.1,70004785,70106270,101485,-,-
BAC42_A23,17,17q25.1,70004785,70098984,94199,-,-
BAC105_G07,17,17q25.1,70171971,70315337,143366,-,-
BAC11_C04,17,17q25.1,70183908,70316461,132553,-,-
BAC53_I13,17,17q25.1,70188977,70273752,84775,-,-
BAC169_P12,17,17q25.1,70200073,70311211,111138,-,-
BAC132_B19,17,17q25.1,70220522,70296742,76220,-,-
BAC116_E10,17,17q25.1,70287026,70396381,109355,-,-
BAC150_K04,17,17q25.1,70315331,70396528,81197,-,-
BAC4_N22,17,17q25.1,70316494,70403777,87283,-,-
BAC235_G20,17,17q25.1,70377631,70519236,141605,-,-
BAC34_G01,17,17q25.1,70377635,70552494,174859,-,-
BAC130_D06,17,17q25.1,70437895,70521200,83305,-,-
BAC64_N01,17,17q25.1,70437895,70562208,124313,-,-
BAC107_G14,17,17q25.1,70437900,70628916,191016,-,-
BAC239_O11,17,17q25.1,70482087,70628916,146829,-,-
BAC238_J16,17,17q25.1,70527052,70637511,110459,-,-
BAC118_B06,17,17q25.1,70549801,70696052,146251,-,-
BAC79_L22,17,17q25.1,70629121,70717875,88754,-,-
BAC105_P12,17,17q25.1,70683642,70764436,80794,-,-
BAC162_O02,17,17q25.1,70718313,70807750,89437,-,-
BAC156_E16,17,17q25.1,70718313,70853627,135314,-,-
BAC252_P03,17,17q25.1,70723973,70881187,157214,-,-
BAC26_E05,17,17q25.1,70730883,70853626,122743,-,-
BAC185_G21,17,17q25.1,70767469,70894522,127053,-,-
BAC84_G05,17,17q25.1,70904850,70992997,88147,-,-
BAC66_I21,17,17q25.1,70939971,71035031,95060,-,-
BAC58_I05,17,17q25.1,70941140,70961829,20689,-,-
BAC145_I08,17,17q25.1,70967700,71067566,99866,-,-
BAC194_N04,17,17q25.1,71041573,71159273,117700,-,-
BAC32_A01,17,17q25.1,71048951,71124556,75605,-,-
BAC159_G06,17,17q25.1,71052810,71173716,120906,-,-
BAC10_M20,17,17q25.1,71089072,71173812,84740,-,-
BAC162_G01,17,17q25.1,71089072,71173966,84894,-,-
BAC235_O07,17,17q25.1,71155694,71245818,90124,-,-
BAC195_A22,17,17q25.1,71179459,71257611,78152,-,-
BAC71_I11,17,17q25.1,71181735,71294533,112798,-,-
BAC27_P18,17,17q25.1,71189889,71294533,104644,-,-
BAC67_I18,17,17q25.1,71210854,71304754,93900,-,-
BAC80_O09,17,17q25.1,71238554,71365843,127289,-,-
BAC223_M20,17,17q25.1,71250661,71348474,97813,-,-
BAC181_P18,17,17q25.1,71250661,71330204,79543,-,-
BAC161_N07,17,17q25.1,71284908,71365660,80752,-,-
BAC58_G18,17,17q25.1,71366562,71453420,86858,-,-
BAC248_D14,17,17q25.1,71372871,71453435,80564,-,-
BAC81_D13,17,17q25.1,71427875,71556942,129067,-,-
BAC172_E19,17,17q25.1,71453606,71556942,103336,-,-
BAC115_I11,17,17q25.1,71454014,71574045,120031,-,-
BAC105_C07,17,17q25.1,71473257,71594490,121233,yes,-
BAC120_G14,17,17q25.1,71565244,71683496,118252,yes,-
BAC68_E15,17,17q25.1,71668484,71801364,132880,-,-
BAC143_L08,17,17q25.1,71689748,71774783,85035,-,-
BAC89_P18,17,17q25.1,71696189,71801814,105625,-,-
BAC227_L07,17,17q25.1,71732427,71821877,89450,-,-
BAC39_L17,17,17q25.1,71822181,71950217,128036,-,-
BAC193_D16,17,17q25.1,71829413,71924660,95247,-,-
BAC61_I06,17,17q25.1,71833885,71953845,119960,-,-
BAC196_N14,17,17q25.1,71851226,71940122,88896,-,-
BAC182_B18,17,17q25.1,71968159,72068110,99951,-,-
BAC219_D17,17,17q25.1,72078790,72157883,79093,-,-
BAC59_E12,17,17q25.1-17q25.2,72107527,72221624,114097,-,-
BAC121_J08,17,17q25.1-17q25.2,72109548,72221411,111863,-,-
BAC40_N23,17,17q25.1,72118185,72189907,71722,-,-
BAC238_L21,17,17q25.1-17q25.2,72189906,72316321,126415,-,-
BAC144_M04,17,17q25.2,72256616,72342642,86026,-,-
BAC33_E10,17,17q25.2,72277077,72386901,109824,-,-
BAC197_C03,17,17q25.2,72280665,72393662,112997,-,-
BAC135_O14,17,17q25.2,72342635,72415036,72401,-,-
BAC240_D17,17,17q25.2,72342637,72459289,116652,-,-
BAC140_J05,17,17q25.2,72436063,72547572,111509,-,-
BAC205_H09,17,17q25.2,72459292,72547344,88052,-,-
BAC235_P20,17,17q25.2,72487177,72583195,96018,-,-
BAC23_B07,17,17q25.2,72500306,72583195,82889,-,-
BAC82_L16,17,17q25.2,72500323,72625036,124713,-,-
BAC246_H09,17,17q25.2,72520282,72625036,104754,-,-
BAC158_J17,17,17q25.2,72520282,72636914,116632,-,-
BAC179_A20,17,17q25.2,72547566,72632580,85014,-,-
BAC62_H22,17,17q25.2,72583352,72673991,90639,-,-
BAC222_D13,17,17q25.2,72584159,72698345,114186,-,-
BAC128_H19,17,17q25.2,72615466,72742517,127051,-,-
BAC187_I20,17,17q25.2,72663592,72805959,142367,-,-
BAC220_E20,17,17q25.2,72670632,72759382,88750,-,-
BAC55_P11,17,17q25.2-17q25.3,72805644,72948206,142562,-,-
BAC171_H17,17,17q25.2-17q25.3,72826864,72943500,116636,-,-
BAC238_N15,17,17q25.2-17q25.3,72832908,72912515,79607,-,-
BAC90_C02,17,17q25.2-17q25.3,72848324,72948215,99891,-,-
BAC193_G04,17,17q25.2-17q25.3,72861791,72948215,86424,-,-
BAC200_G03,17,17q25.3,72948840,73048569,99729,-,-
BAC147_C08,17,17q25.3,72955320,73118573,163253,-,-
BAC247_K20,17,17q25.3,73065808,73183334,117526,-,-
BAC57_D09,17,17q25.3,73106883,73254246,147363,-,-
BAC171_D05,17,17q25.3,73106936,73182172,75236,-,-
BAC38_D09,17,17q25.3,73147685,73246274,98589,-,-
BAC97_N08,17,17q25.3,73170710,73293320,122610,-,-
BAC193_H06,17,17q25.3,73202277,73318332,116055,-,-
BAC252_I23,17,17q25.3,73272422,73381895,109473,-,-
BAC76_B08,17,17q25.3,73318498,73445992,127494,-,-
BAC182_C18,17,17q25.3,73320053,73406589,86536,-,-
BAC188_F07,17,17q25.3,73384910,73479544,94634,-,-
BAC39_O10,17,17q25.3,73398036,73489534,91498,-,-
BAC31_L16,17,17q25.3,73412095,73522903,110808,-,-
BAC10_D09,17,17q25.3,73433674,73528117,94443,-,-
BAC89_A11,17,17q25.3,73433692,73532022,98330,-,-
BAC141_N07,17,17q25.3,73501499,73621509,120010,-,-
BAC197_A16,17,17q25.3,73528770,73559018,30248,-,-
BAC30_J07,17,17q25.3,73551945,73650451,98506,-,-
BAC42_D15,17,17q25.3,73733069,73824142,91073,-,-
BAC25_K07,17,17q25.3,73764714,73871050,106336,-,-
BAC193_P19,17,17q25.3,73833838,73988517,154679,yes,-
BAC147_A19,17,17q25.3,73864142,73949222,85080,yes,-
BAC190_M10,17,17q25.3,73900491,73988632,88141,-,-
BAC29_F19,17,17q25.3,73949255,74059383,110128,-,-
BAC232_L09,17,17q25.3,73968945,74059383,90438,-,-
BAC36_L05,17,17q25.3,73968952,74068301,99349,-,-
BAC91_P20,17,17q25.3,73984807,74089304,104497,-,-
BAC120_J08,17,17q25.3,73990562,74102226,111664,-,-
BAC240_F10,17,17q25.3,74006893,74101047,94154,-,-
BAC240_H21,17,17q25.3,74006893,74146653,139760,-,-
BAC125_O01,17,17q25.3,74006893,74102226,95333,-,-
BAC13_N18,17,17q25.3,74028546,74115010,86464,-,-
BAC33_B17,17,17q25.3,74038470,74146493,108023,-,-
BAC139_D11,17,17q25.3,74059374,74155228,95854,-,-
BAC231_O05,17,17q25.3,74089558,74187385,97827,-,-
BAC170_E04,17,17q25.3,74118655,74216747,98092,-,-
BAC64_A13,17,17q25.3,74118732,74216712,97980,-,-
BAC44_N06,17,17q25.3,74211753,74342658,130905,-,-
BAC217_A01,17,17q25.3,74259505,74382107,122602,-,-
BAC101_K24,17,17q25.3,74259505,74361860,102355,-,-
BAC192_E02,17,17q25.3,74307982,74407917,99935,-,-
BAC244_C22,17,17q25.3,74392309,74493658,101349,-,-
BAC131_P15,17,17q25.3,74467796,74617807,150011,yes,-
BAC155_H10,17,17q25.3,74467799,74550338,82539,-,-
BAC129_F07,17,17q25.3,74493673,74592276,98603,-,-
BAC69_D22,17,17q25.3,74528730,74661285,132555,yes,-
BAC229_O02,17,17q25.3,74530298,74611442,81144,yes,-
BAC242_D20,17,17q25.3,74653859,74738948,85089,-,-
BAC146_O01,17,17q25.3,74655486,74738948,83462,-,-
BAC69_B22,17,17q25.3,74655528,74741147,85619,-,-
BAC31_N23,17,17q25.3,74673425,74792522,119097,-,-
BAC72_H12,17,17q25.3,74699929,74796932,97003,-,-
BAC148_N07,17,17q25.3,74750901,74861122,110221,-,-
BAC117_A05,17,17q25.3,74750901,74846740,95839,-,-
BAC37_C24,17,17q25.3,74775281,74880779,105498,-,-
BAC48_K14,17,17q25.3,74796956,74899041,102085,-,-
BAC80_A15,17,17q25.3,74825642,74954770,129128,-,-
BAC5_O03,17,17q25.3,74889896,74998009,108113,-,-
BAC219_C20,17,17q25.3,74899062,75021400,122338,-,-
BAC141_B05,17,17q25.3,74940751,75021400,80649,-,-
BAC80_G15,17,17q25.3,75249971,75462044,212073,-,-
BAC154_L20,17,17q25.3,75292636,75375976,83340,-,-
BAC159_P02,17,17q25.3,75351933,75467563,115630,-,-
BAC157_B10,17,17q25.3,75388348,75497239,108891,-,-
BAC116_A18,17,17q25.3,75396341,75481633,85292,-,-
BAC57_H18,17,17q25.3,75396357,75536331,139974,-,-
BAC24_B21,17,17q25.3,75462208,75564566,102358,-,-
BAC149_J05,17,17q25.3,75467698,75541317,73619,-,-
BAC228_K06,17,17q25.3,75481635,75564847,83212,-,-
BAC250_P07,17,17q25.3,75614895,75729763,114868,-,-
BAC25_O18,17,17q25.3,75620270,75715424,95154,-,-
BAC45_P11,17,17q25.3,75652683,75745581,92898,-,-
BAC95_L19,17,17q25.3,75657702,75745938,88236,-,-
BAC180_L02,17,17q25.3,75657707,75738346,80639,-,-
BAC199_P07,17,17q25.3,75657721,75806201,148480,-,-
BAC238_H16,17,17q25.3,75682658,75806449,123791,-,-
BAC137_M01,17,17q25.3,75756960,75881757,124797,-,-
BAC66_K01,17,17q25.3,75756961,75890392,133431,-,-
BAC103_G07,17,17q25.3,75789859,75889737,99878,-,-
BAC49_E07,17,17q25.3,75798209,75915243,117034,-,-
BAC244_E18,17,17q25.3,75806241,75907463,101222,-,-
BAC31_A10,17,17q25.3,75824225,75943634,119409,-,-
BAC90_N12,17,17q25.3,75828465,75951483,123018,-,-
BAC177_I24,17,17q25.3,75843796,75915242,71446,-,-
BAC184_K12,17,17q25.3,75999084,76114387,115303,-,-
BAC230_O07,17,17q25.3,76039410,76183226,143816,-,-
BAC167_M01,17,17q25.3,76090140,76194338,104198,-,-
BAC68_F14,17,17q25.3,76114378,76194338,79960,-,-
BAC188_L12,17,17q25.3,76197798,76289489,91691,-,-
BAC152_J23,17,17q25.3,76225557,76335105,109548,-,-
BAC171_H16,17,17q25.3,76226545,76308206,81661,-,-
BAC238_N02,17,17q25.3,76238357,76326732,88375,-,-
BAC37_C22,17,17q25.3,76308717,76410468,101751,-,-
BAC145_L21,17,17q25.3,76324781,76445219,120438,-,-
BAC57_G22,17,17q25.3,76324781,76402142,77361,-,-
BAC217_F07,17,17q25.3,76336281,76442092,105811,-,-
BAC188_P04,17,17q25.3,76351135,76431815,80680,-,-
BAC159_D10,17,17q25.3,76371411,76468752,97341,-,-
BAC181_J11,17,17q25.3,76371675,76484411,112736,-,-
BAC100_K23,17,17q25.3,76409521,76504567,95046,-,-
BAC78_E04,17,17q25.3,76410462,76515652,105190,-,-
BAC30_I13,17,17q25.3,76442390,76544948,102558,-,-
BAC193_N15,17,17q25.3,76468749,76544617,75868,-,-
BAC39_J09,17,17q25.3,76504696,76631206,126510,-,-
BAC28_B10,17,17q25.3,76504701,76595527,90826,-,-
BAC112_E06,17,17q25.3,76514700,76612513,97813,-,-
BAC218_E12,17,17q25.3,76514714,76612535,97821,-,-
BAC197_P14,17,17q25.3,76596007,76669763,73756,-,-
BAC248_C23,17,17q25.3,76624969,76710506,85537,-,-
BAC65_K19,17,17q25.3,76732495,76860146,127651,-,-
BAC249_L16,17,17q25.3,76733067,76821012,87945,-,-
BAC182_O15,17,17q25.3,76821003,76932244,111241,-,-
BAC10_L05,17,17q25.3,76871695,76989752,118057,-,-
BAC195_C03,17,17q25.3,76989894,77158137,168243,-,-
BAC160_H20,17,17q25.3,77030460,77096052,65592,-,-
BAC69_N02,17,17q25.3,77158131,77248565,90434,-,-
BAC152_G12,17,17q25.3,77158131,77262231,104100,-,-
BAC127_C10,17,17q25.3,77161259,77245333,84074,-,-
BAC86_L22,17,17q25.3,77175579,77262183,86604,-,-
BAC131_P06,17,17q25.3,77437629,77523348,85719,-,-
BAC181_A09,17,17q25.3,77610866,77685947,75081,-,-
BAC115_J11,17,17q25.3,77713182,77816927,103745,-,-
BAC59_J11,17,17q25.3,77729484,77826219,96735,-,-
BAC81_F05,17,17q25.3,77729522,77826222,96700,-,-
BAC29_K17,17,17q25.3,77737367,77816921,79554,-,-
BAC186_K10,17,17q25.3,77737440,77816904,79464,-,-
BAC197_D16,17,17q25.3,77755903,77882681,126778,-,-
BAC156_B05,17,17q25.3,77755915,77849251,93336,-,-
BAC97_I24,17,17q25.3,77882675,77979594,96919,-,-
BAC203_M03,17,17q25.3,77882679,77970506,87827,-,-
BAC35_K04,17,17q25.3,77913858,78058702,144844,-,-
BAC141_F12,17,17q25.3,77982261,78058702,76441,-,-
BAC140_G10,17,17q25.3,78098637,78219532,120895,-,-
BAC107_M01,17,17q25.3,78098637,78173887,75250,-,-
BAC78_C18,17,17q25.3,78098637,78188976,90339,-,-
BAC64_L04,17,17q25.3,78098690,78194042,95352,-,-
BAC139_B07,17,17q25.3,78142718,78229272,86554,-,-
BAC46_L10,17,17q25.3,78142735,78270463,127728,-,-
BAC190_F12,17,17q25.3,78179880,78270238,90358,-,-
BAC193_N11,17,17q25.3,78182994,78247945,64951,-,-
BAC108_P17,17,17q25.3,78229509,78316525,87016,-,-
BAC196_P01,17,17q25.3,78299681,78316611,16930,-,-
BAC220_E16,17,17q25.3,78316397,78408668,92271,-,-
BAC185_M18,17,17q25.3,78389462,78475875,86413,-,-
BAC219_J05,17,17q25.3,78390868,78483684,92816,-,-
BAC128_I23,17,17q25.3,78432676,78562785,130109,-,-
BAC172_N23,18,18p11.32,60304,157012,96708,-,-
BAC106_I11,18,18p11.32,157069,256485,99416,-,-
BAC229_E10,18,18p11.32,219297,359244,139947,-,-
BAC67_G06,18,18p11.32,245252,322730,77478,-,-
BAC9_P02,18,18p11.32,307395,427803,120408,-,-
BAC182_K20,18,18p11.32,355581,496733,141152,-,-
BAC40_C12,18,18p11.32,359462,467063,107601,-,-
BAC119_C21,18,18p11.32,359462,457096,97634,-,-
BAC77_M14,18,18p11.32,367409,466363,98954,-,-
BAC168_K16,18,18p11.32,467056,545154,78098,-,-
BAC59_D24,18,18p11.32,575879,672460,96581,-,-
BAC125_J19,18,18p11.32,642065,804253,162188,-,-
BAC126_M07,18,18p11.32,642271,729609,87338,-,-
BAC237_O03,18,18p11.32,650472,729609,79137,-,-
BAC109_C08,18,18p11.32,672455,769906,97451,-,-
BAC115_P12,18,18p11.32,690106,769909,79803,-,-
BAC238_C08,18,18p11.32,770058,846236,76178,-,-
BAC73_M22,18,18p11.32,811124,902997,91873,-,-
BAC147_J05,18,18p11.32,969978,1054807,84829,-,-
BAC66_H14,18,18p11.32,972371,1114958,142587,-,-
BAC58_H11,18,18p11.32,1010447,1106297,95850,-,-
BAC2_C24,18,18p11.32,1178593,1382650,204057,-,-
BAC36_C07,18,18p11.32,1208996,1288674,79678,-,-
BAC242_H11,18,18p11.32,1231907,1319323,87416,-,-
BAC43_M02,18,18p11.32,1480596,1589453,108857,-,-
BAC234_I17,18,18p11.32,1499909,1613641,113732,-,-
BAC31_H05,18,18p11.32,1693433,1831655,138222,-,-
BAC82_G04,18,18p11.32,1693490,1821882,128392,-,-
BAC17_J22,18,18p11.32,1740178,1832440,92262,-,-
BAC142_P03,18,18p11.32,1832435,1937071,104636,-,-
BAC72_K17,18,18p11.32,1832435,1937019,104584,-,-
BAC137_P20,18,18p11.32,1837627,1915605,77978,-,-
BAC61_L03,18,18p11.32,1855564,1936803,81239,-,-
BAC247_P15,18,18p11.32,1955655,2037816,82161,-,-
BAC8_K06,18,18p11.32,1975666,2072172,96506,-,-
BAC153_O01,18,18p11.32,2132415,2213505,81090,-,-
BAC26_J21,18,18p11.32,2146535,2249555,103020,-,-
BAC20_G03,18,18p11.32,2181886,2266674,84788,-,-
BAC66_F24,18,18p11.32,2250845,2341023,90178,-,-
BAC48_E16,18,18p11.32,2250877,2354376,103499,-,-
BAC63_F21,18,18p11.32,2291000,2390541,99541,-,-
BAC147_E19,18,18p11.32,2401050,2498737,97687,-,-
BAC6_L15,18,18p11.32,2409469,2498737,89268,-,-
BAC230_D05,18,18p11.32,2464118,2543957,79839,-,-
BAC42_L19,18,18p11.32,2592954,2691935,98981,-,-
BAC155_H14,18,18p11.32,2596160,2680956,84796,-,-
BAC160_F11,18,18p11.32,2598152,2690734,92582,-,-
BAC120_B03,18,18p11.32,2599165,2691937,92772,-,-
BAC81_B11,18,18p11.32,2736485,2828551,92066,-,-
BAC217_D15,18,18p11.31,2960787,3063463,102676,-,-
BAC109_B04,18,18p11.31,2961540,3075058,113518,-,-
BAC66_D15,18,18p11.31,2976579,3065672,89093,-,-
BAC158_G04,18,18p11.31,2983859,3071556,87697,-,-
BAC4_P18,18,18p11.31,2985030,3065672,80642,-,-
BAC247_J06,18,18p11.31,2985961,3063463,77502,-,-
BAC176_H04,18,18p11.31,3303814,3441294,137480,-,-
BAC45_I08,18,18p11.31,3322508,3436144,113636,-,-
BAC155_O20,18,18p11.31,3353693,3441294,87601,-,-
BAC136_E13,18,18p11.31,3406201,3483799,77598,-,-
BAC58_M22,18,18p11.31,3406201,3524279,118078,-,-
BAC159_K09,18,18p11.31,3529348,3609165,79817,-,-
BAC50_B20,18,18p11.31,3529351,3658638,129287,-,-
BAC128_H12,18,18p11.31,3565126,3689512,124386,-,-
BAC211_M08,18,18p11.31,3574278,3727239,152961,-,-
BAC246_A20,18,18p11.31,3579220,3654107,74887,-,-
BAC83_C07,18,18p11.31,3609160,3727417,118257,-,-
BAC81_I01,18,18p11.31,3615515,3738273,122758,-,-
BAC67_C07,18,18p11.31,3677600,3840638,163038,-,-
BAC102_M17,18,18p11.31,3756965,3859066,102101,-,-
BAC179_E06,18,18p11.31,3775181,3888234,113053,-,-
BAC65_A17,18,18p11.31,3775193,3876681,101488,-,-
BAC223_B23,18,18p11.31,3775214,3867442,92228,-,-
BAC239_D14,18,18p11.31,3803612,3886057,82445,-,-
BAC143_H16,18,18p11.31,3812598,3919922,107324,-,-
BAC109_E09,18,18p11.31,3983884,4070821,86937,-,-
BAC10_B03,18,18p11.31,4023283,4116077,92794,-,-
BAC161_K14,18,18p11.31,4072900,4151928,79028,-,-
BAC111_P01,18,18p11.31,4138326,4274979,136653,-,-
BAC177_P19,18,18p11.31,4145916,4235164,89248,-,-
BAC33_D17,18,18p11.31,4146289,4303179,156890,-,-
BAC60_G04,18,18p11.31,4161587,4235164,73577,-,-
BAC25_N03,18,18p11.31,4222302,4325670,103368,-,-
BAC192_C10,18,18p11.31,4223666,4325673,102007,-,-
BAC191_N20,18,18p11.31,4325718,4399568,73850,-,-
BAC242_D15,18,18p11.31,4589175,4695957,106782,-,-
BAC27_J18,18,18p11.31,4617221,4807987,190766,-,-
BAC249_L11,18,18p11.31,4804194,4896600,92406,-,-
BAC79_K14,18,18p11.31,4819739,4945274,125535,-,-
BAC129_J21,18,18p11.31,4836751,4944507,107756,-,-
BAC193_F16,18,18p11.31,4846734,4951369,104635,-,-
BAC144_H16,18,18p11.31,4846734,4953394,106660,-,-
BAC41_K18,18,18p11.31,4942628,5032905,90277,-,-
BAC31_H13,18,18p11.31,4953397,5086093,132696,-,-
BAC246_B04,18,18p11.31,5054209,5161357,107148,-,-
BAC157_F21,18,18p11.31,5490051,5581053,91002,-,-
BAC123_A06,18,18p11.31,5509109,5592308,83199,-,-
BAC227_M10,18,18p11.31,5550403,5639341,88938,-,-
BAC149_C09,18,18p11.31,5654912,5748394,93482,-,-
BAC179_L17,18,18p11.31,5667769,5744387,76618,-,-
BAC20_J17,18,18p11.31,5746368,5838009,91641,-,-
BAC28_C03,18,18p11.31,5908360,6002666,94306,-,-
BAC121_D11,18,18p11.31,5914315,6026076,111761,-,-
BAC196_P11,18,18p11.31,5928368,6033902,105534,-,-
BAC237_L01,18,18p11.31,5975044,6104064,129020,-,-
BAC128_L08,18,18p11.31,5975044,6108041,132997,-,-
BAC89_C03,18,18p11.31,6002987,6122561,119574,-,-
BAC194_B07,18,18p11.31,6067431,6187878,120447,-,-
BAC106_H08,18,18p11.31,6097554,6188212,90658,-,-
BAC116_C10,18,18p11.31,6168126,6271400,103274,-,-
BAC20_L10,18,18p11.31,6238955,6321065,82110,-,-
BAC223_I17,18,18p11.31,6264490,6349055,84565,-,-
BAC35_F10,18,18p11.31,6264573,6355932,91359,-,-
BAC76_L14,18,18p11.31,6272369,6361850,89481,-,-
BAC117_I12,18,18p11.31,6400189,6518434,118245,-,-
BAC83_J11,18,18p11.31,6411869,6494277,82408,-,-
BAC222_C11,18,18p11.31,6700624,6781027,80403,-,-
BAC110_D11,18,18p11.31,6714425,6830832,116407,-,-
BAC86_K13,18,18p11.31,6813146,6898506,85360,-,-
BAC124_M09,18,18p11.31,6813147,6925762,112615,-,-
BAC250_O01,18,18p11.31,6825329,6913317,87988,-,-
BAC134_A05,18,18p11.31,6926012,7080565,154553,-,-
BAC141_C01,18,18p11.31,6965630,7053318,87688,-,-
BAC57_H08,18,18p11.31,6965630,7083991,118361,-,-
BAC183_D20,18,18p11.31,6977465,7083773,106308,-,-
BAC67_D01,18,18p11.31,6977489,7114079,136590,-,-
BAC137_O06,18,18p11.31,7021009,7104711,83702,-,-
BAC145_D12,18,18p11.31,7037848,7137624,99776,-,-
BAC122_M15,18,18p11.31-18p11.23,7155660,7240390,84730,-,-
BAC241_A18,18,18p11.31-18p11.23,7156726,7249510,92784,-,-
BAC229_A18,18,18p11.31-18p11.23,7156726,7271740,115014,-,-
BAC105_M06,18,18p11.23,7226780,7319370,92590,-,-
BAC244_I20,18,18p11.23,7353930,7448299,94369,-,-
BAC190_B03,18,18p11.23,7355142,7456127,100985,-,-
BAC148_P22,18,18p11.23,7407651,7478378,70727,-,-
BAC147_C17,18,18p11.23,7473358,7595179,121821,-,-
BAC34_E05,18,18p11.23,7496950,7595179,98229,-,-
BAC95_H16,18,18p11.23,7507910,7606757,98847,-,-
BAC176_B07,18,18p11.23,7621464,7744850,123386,-,-
BAC169_N16,18,18p11.23,7631113,7731657,100544,-,-
BAC195_G20,18,18p11.23,7664319,7743310,78991,-,-
BAC20_P18,18,18p11.23,7676860,7837615,160755,-,-
BAC67_D16,18,18p11.23,7901872,8012901,111029,-,-
BAC78_G08,18,18p11.23,7907177,8017291,110114,-,-
BAC222_C14,18,18p11.23,8017321,8108395,91074,-,-
BAC132_N16,18,18p11.23,8155789,8239700,83911,-,-
BAC76_E10,18,18p11.23,8155792,8306386,150594,-,-
BAC109_P23,18,18p11.23,8195184,8351276,156092,-,-
BAC228_C23,18,18p11.23,8240639,8333597,92958,-,-
BAC151_L13,18,18p11.23,8245139,8346211,101072,-,-
BAC130_C14,18,18p11.23,8306381,8396584,90203,-,-
BAC96_H01,18,18p11.23,8306384,8435527,129143,-,-
BAC4_P07,18,18p11.23,8340749,8437899,97150,-,-
BAC115_H13,18,18p11.23,8370208,8492457,122249,-,-
BAC39_L11,18,18p11.23,8371700,8457428,85728,-,-
BAC218_A15,18,18p11.23,8381295,8470657,89362,-,-
BAC102_F07,18,18p11.23-18p11.22,8438184,8537496,99312,-,-
BAC38_G20,18,18p11.22,8536959,8629119,92160,-,-
BAC218_P13,18,18p11.22,8553990,8704238,150248,-,-
BAC232_F19,18,18p11.22,8565587,8677473,111886,-,-
BAC43_E17,18,18p11.22,8567487,8693171,125684,-,-
BAC237_E08,18,18p11.22,8627293,8729046,101753,-,-
BAC113_I08,18,18p11.22,8650029,8751054,101025,-,-
BAC123_F10,18,18p11.22,8678269,8799084,120815,-,-
BAC252_O03,18,18p11.22,8686648,8770634,83986,-,-
BAC177_B11,18,18p11.22,8702331,8784607,82276,-,-
BAC32_L06,18,18p11.22,8702342,8820682,118340,-,-
BAC160_B08,18,18p11.22,8747315,8844048,96733,-,-
BAC123_C19,18,18p11.22,8755035,8842158,87123,-,-
BAC34_J05,18,18p11.22,8755039,8876438,121399,-,-
BAC30_M13,18,18p11.22,8770645,8922364,151719,-,-
BAC115_C15,18,18p11.22,8820676,8917477,96801,-,-
BAC167_F06,18,18p11.22,8845741,8926334,80593,-,-
BAC66_A23,18,18p11.22,8926327,9026857,100530,-,-
BAC20_E03,18,18p11.22,9015746,9105504,89758,-,-
BAC104_L03,18,18p11.22,9089212,9178806,89594,-,-
BAC184_N19,18,18p11.22,9160621,9255670,95049,-,-
BAC200_K14,18,18p11.22,9170541,9258413,87872,-,-
BAC19_I18,18,18p11.22,9192838,9294320,101482,-,-
BAC8_K03,18,18p11.22,9274573,9362348,87775,-,-
BAC49_G12,18,18p11.22,9296553,9449233,152680,-,-
BAC80_F07,18,18p11.22,9296882,9417313,120431,-,-
BAC59_G09,18,18p11.22,9390156,9475151,84995,-,-
BAC90_L15,18,18p11.22,9475173,9583414,108241,-,-
BAC101_L08,18,18p11.22,9664565,9754057,89492,-,-
BAC182_E13,18,18p11.22,9690065,9792091,102026,-,-
BAC235_E10,18,18p11.22,9690066,9792091,102025,-,-
BAC79_G11,18,18p11.22,9690109,9826380,136271,-,-
BAC139_H12,18,18p11.22,9741825,9845087,103262,-,-
BAC222_C12,18,18p11.22,9746333,9845044,98711,-,-
BAC69_N18,18,18p11.22,9754050,9858923,104873,-,-
BAC224_D05,18,18p11.22,9760371,9838141,77770,-,-
BAC30_E07,18,18p11.22,9880471,9984650,104179,-,-
BAC197_G17,18,18p11.22,9939262,10025221,85959,-,-
BAC26_K09,18,18p11.22,9987489,10095146,107657,-,-
BAC41_G06,18,18p11.22,10025228,10128802,103574,-,-
BAC224_L13,18,18p11.22,10038379,10142362,103983,-,-
BAC65_H10,18,18p11.22,10044814,10151208,106394,-,-
BAC14_I19,18,18p11.22,10049893,10138546,88653,-,-
BAC65_I24,18,18p11.22,10049894,10131070,81176,-,-
BAC77_A03,18,18p11.22,10131068,10254759,123691,-,-
BAC189_D03,18,18p11.22,10134809,10235147,100338,-,-
BAC204_M12,18,18p11.22,10138710,10274755,136045,-,-
BAC59_G22,18,18p11.22,10139653,10256345,116692,-,-
BAC38_K21,18,18p11.22,10245025,10274745,29720,-,-
BAC237_J14,18,18p11.22,10258255,10360059,101804,-,-
BAC102_P03,18,18p11.22,10318865,10406805,87940,-,-
BAC114_P11,18,18p11.22,10325257,10425264,100007,-,-
BAC15_F10,18,18p11.22,10325373,10429646,104273,-,-
BAC23_N19,18,18p11.22,10345563,10429611,84048,-,-
BAC35_I02,18,18p11.22,10347617,10439747,92130,-,-
BAC66_E14,18,18p11.22,10360129,10462785,102656,-,-
BAC106_J04,18,18p11.22,10441434,10530892,89458,-,-
BAC136_F21,18,18p11.22,10536876,10648613,111737,-,-
BAC238_F24,18,18p11.22,10537635,10641305,103670,-,-
BAC220_I06,18,18p11.22,10550667,10641305,90638,-,-
BAC38_D11,18,18p11.22,10561511,10651568,90057,-,-
BAC44_D01,18,18p11.22,10561515,10772065,210550,-,-
BAC60_P12,18,18p11.22,10623341,10738493,115152,-,-
BAC110_A17,18,18p11.22,10648962,10758458,109496,-,-
BAC140_M06,18,18p11.22,10671672,10763420,91748,-,-
BAC165_D17,18,18p11.22,10688390,10789970,101580,-,-
BAC167_F11,18,18p11.22,10702532,10799980,97448,-,-
BAC71_G02,18,18p11.22,10702537,10789970,87433,-,-
BAC56_H13,18,18p11.22-18p11.21,10839931,10938319,98388,-,-
BAC100_L09,18,18p11.22-18p11.21,10860632,10957905,97273,-,-
BAC118_D16,18,18p11.22-18p11.21,10878028,10960288,82260,-,-
BAC36_K21,18,18p11.22-18p11.21,10878029,11013148,135119,-,-
BAC136_N19,18,18p11.21,10905917,11037545,131628,-,-
BAC133_B21,18,18p11.21,10961129,11054139,93010,-,-
BAC176_D19,18,18p11.21,10962376,11039955,77579,-,-
BAC28_P10,18,18p11.21,11038799,11195840,157041,-,-
BAC246_M01,18,18p11.21,11104268,11204941,100673,-,-
BAC81_N22,18,18p11.21,11178144,11266883,88739,-,-
BAC101_O10,18,18p11.21,11357501,11459675,102174,-,-
BAC23_H03,18,18p11.21,11468817,11568526,99709,-,-
BAC65_H22,18,18p11.21,11476091,11574323,98232,-,-
BAC233_B18,18,18p11.21,11631189,11710548,79359,-,-
BAC193_E08,18,18p11.21,11643947,11710548,66601,-,-
BAC159_A09,18,18p11.21,11764796,11855460,90664,-,-
BAC44_F12,18,18p11.21,11764818,11907164,142346,-,-
BAC130_A18,18,18p11.21,11802069,11865653,63584,-,-
BAC123_B15,18,18p11.21,11893438,11990156,96718,-,-
BAC226_C03,18,18p11.21,11893909,12013211,119302,-,-
BAC176_L23,18,18p11.21,11906520,12020974,114454,-,-
BAC178_F20,18,18p11.21,11907324,12013199,105875,-,-
BAC52_L06,18,18p11.21,11987129,12100661,113532,-,-
BAC80_B04,18,18p11.21,12105085,12234710,129625,-,-
BAC84_P16,18,18p11.21,12161934,12282152,120218,-,-
BAC188_J01,18,18p11.21,12161934,12246629,84695,-,-
BAC233_K04,18,18p11.21,12320945,12418148,97203,-,-
BAC2_C12,18,18p11.21,12380276,12472824,92548,-,-
BAC142_N24,18,18p11.21,12413563,12539908,126345,-,-
BAC143_N16,18,18p11.21,12446089,12539903,93814,-,-
BAC56_C07,18,18p11.21,12593916,12693725,99809,-,-
BAC182_F21,18,18p11.21,12684729,12770154,85425,-,-
BAC97_D14,18,18p11.21,12693727,12800741,107014,-,-
BAC31_F12,18,18p11.21,12700277,12795455,95178,-,-
BAC162_C11,18,18p11.21,12740547,12826629,86082,-,-
BAC71_H18,18,18p11.21,12740547,12846519,105972,-,-
BAC67_N02,18,18p11.21,12790208,12889168,98960,-,-
BAC145_I07,18,18p11.21,12800735,12890936,90201,-,-
BAC59_H18,18,18p11.21,12800735,12936931,136196,-,-
BAC86_A18,18,18p11.21,12912351,13026865,114514,-,-
BAC210_D05,18,18p11.21,13027051,13116654,89603,-,-
BAC238_M08,18,18p11.21,13071006,13170225,99219,-,-
BAC41_E10,18,18p11.21,13076808,13168234,91426,-,-
BAC33_N06,18,18p11.21,13076819,13204633,127814,-,-
BAC180_J14,18,18p11.21,13082038,13168221,86183,-,-
BAC199_L17,18,18p11.21,13123428,13217248,93820,-,-
BAC177_K13,18,18p11.21,13170619,13325166,154547,-,-
BAC141_I04,18,18p11.21,13204635,13303487,98852,-,-
BAC157_B17,18,18p11.21,13217240,13298197,80957,-,-
BAC156_E12,18,18p11.21,13217241,13302883,85642,-,-
BAC167_N03,18,18p11.21,13303479,13383254,79775,-,-
BAC195_C04,18,18p11.21,13343721,13428205,84484,-,-
BAC165_M08,18,18p11.21,13345221,13428208,82987,-,-
BAC218_B03,18,18p11.21,13363755,13441861,78106,-,-
BAC27_H07,18,18p11.21,13370391,13517880,147489,-,-
BAC234_G23,18,18p11.21,13481845,13588607,106762,-,-
BAC103_C22,18,18p11.21,13498472,13586484,88012,-,-
BAC192_K06,18,18p11.21,13588601,13655824,67223,-,-
BAC35_F05,18,18p11.21,13588736,13686710,97974,-,-
BAC211_J20,18,18p11.21,13602194,13695839,93645,-,-
BAC39_P20,18,18p11.21,13638997,13748256,109259,-,-
BAC143_O17,18,18p11.21,13655838,13748806,92968,-,-
BAC233_K11,18,18p11.21,13695829,13782752,86923,-,-
BAC237_I15,18,18p11.21,13740373,13822663,82290,-,-
BAC34_M13,18,18p11.21,13851531,13977818,126287,-,-
BAC157_D23,18,18p11.21,13852609,13925677,73068,-,-
BAC29_E05,18,18p11.21,13921082,14056323,135241,-,-
BAC166_K05,18,18p11.21,13937918,14025604,87686,-,-
BAC53_E10,18,18p11.21,13958226,14046858,88632,-,-
BAC227_M08,18,18p11.21,14046855,14139057,92202,-,-
BAC127_E20,18,18p11.21,14322230,14447521,125291,-,-
BAC241_I03,18,18p11.21,14342547,14417713,75166,-,-
BAC45_E01,18,18p11.21,14416478,14510403,93925,-,-
BAC250_O21,18,18p11.21,14433977,14525010,91033,-,-
BAC179_D17,18,18p11.21,14433989,14538041,104052,-,-
BAC145_A12,18,18p11.21,14435762,14519169,83407,-,-
BAC71_F07,18,18p11.21,14454026,14480783,26757,-,-
BAC206_G05,18,18p11.21,14676190,14780507,104317,-,-
BAC61_I04,18,18p11.21,14701380,14800907,99527,-,-
BAC147_K11,18,18p11.21,14789057,14882207,93150,-,-
BAC6_B23,18,18p11.21,14908282,15044711,136429,-,-
BAC250_N02,18,18p11.21,14912308,15028157,115849,-,-
BAC249_C02,18,18p11.21,14912310,14992697,80387,-,-
BAC25_E06,18,18p11.21,14924506,15008209,83703,-,-
BAC56_H18,18,18p11.21,14955082,15048717,93635,-,-
BAC120_M23,18,18p11.21,14962144,15061003,98859,-,-
BAC244_L10,18,18p11.21,14970353,15061001,90648,-,-
BAC236_M06,18,18p11.21,15008030,15117773,109743,-,-
BAC83_H16,18,18p11.21,15083559,15179287,95728,-,-
BAC143_J12,18,18q11.1,16788220,16863043,74823,-,-
BAC52_E02,18,18q11.1,16912723,17015028,102305,-,-
BAC59_I08,18,18q11.1,16912723,17015028,102305,-,-
BAC39_A16,18,18q11.1,16956698,17086516,129818,-,-
BAC105_A11,18,18q11.1,16967221,17086516,119295,-,-
BAC199_H09,18,18q11.1,17095272,17175358,80086,-,-
BAC86_F03,18,18q11.1,17120192,17195455,75263,-,-
BAC106_P11,18,18q11.1,17197480,17283132,85652,-,-
BAC107_B16,18,18q11.1,17198527,17276430,77903,-,-
BAC4_H13,18,18q11.1,17201494,17286662,85168,-,-
BAC82_M17,18,18q11.1-18q11.2,17226747,17311206,84459,-,-
BAC162_K24,18,18q11.1-18q11.2,17248922,17323620,74698,-,-
BAC189_M17,18,18q11.1-18q11.2,17269193,17375056,105863,-,-
BAC38_J22,18,18q11.1-18q11.2,17281276,17368255,86979,-,-
BAC7_J19,18,18q11.1-18q11.2,17291247,17321395,30148,-,-
BAC51_H07,18,18q11.2,17332458,17435643,103185,-,-
BAC106_C23,18,18q11.2,17401473,17514663,113190,-,-
BAC198_M23,18,18q11.2,17464394,17564104,99710,-,-
BAC208_G08,18,18q11.2,17484654,17569432,84778,-,-
BAC5_L05,18,18q11.2,17525455,17620421,94966,-,-
BAC149_A12,18,18q11.2,17613277,17690675,77398,-,-
BAC233_G06,18,18q11.2,17704495,17824146,119651,-,-
BAC161_D21,18,18q11.2,17704495,17824114,119619,-,-
BAC240_O16,18,18q11.2,17704521,17794180,89659,-,-
BAC45_H08,18,18q11.2,17719279,17881182,161903,-,-
BAC154_D22,18,18q11.2,17724067,17814282,90215,-,-
BAC34_L17,18,18q11.2,17766538,17975461,208923,-,-
BAC90_G08,18,18q11.2,17814529,17903548,89019,-,-
BAC176_F05,18,18q11.2,17873527,17965206,91679,-,-
BAC5_B17,18,18q11.2,17874370,17978201,103831,-,-
BAC123_D08,18,18q11.2,17902440,18033334,130894,-,-
BAC211_O05,18,18q11.2,18019329,18122052,102723,-,-
BAC196_H18,18,18q11.2,18047475,18125709,78234,-,-
BAC224_F19,18,18q11.2,18047475,18143613,96138,-,-
BAC196_G18,18,18q11.2,18047475,18125412,77937,-,-
BAC217_A22,18,18q11.2,18047482,18124768,77286,-,-
BAC150_M07,18,18q11.2,18076509,18156962,80453,-,-
BAC123_G02,18,18q11.2,18125702,18243213,117511,-,-
BAC196_D06,18,18q11.2,18125702,18231705,106003,-,-
BAC196_C06,18,18q11.2,18125702,18231705,106003,-,-
BAC233_P08,18,18q11.2,18145878,18231705,85827,-,-
BAC147_M07,18,18q11.2,18154405,18237730,83325,-,-
BAC146_G22,18,18q11.2,18154405,18243996,89591,-,-
BAC96_M12,18,18q11.2,18154405,18243213,88808,-,-
BAC136_C19,18,18q11.2,18207277,18286734,79457,-,-
BAC183_C01,18,18q11.2,18234987,18324537,89550,-,-
BAC210_B02,18,18q11.2,18326768,18407694,80926,-,-
BAC110_H17,18,18q11.2,18412020,18527926,115906,-,-
BAC152_M14,18,18q11.2,18782385,18854966,72581,-,-
BAC127_L04,18,18q11.2,18835507,18964347,128840,-,-
BAC96_F19,18,18q11.2,18844805,19005489,160684,-,-
BAC144_J16,18,18q11.2,18863481,18964623,101142,-,-
BAC92_N16,18,18q11.2,18863481,18964347,100866,-,-
BAC90_N06,18,18q11.2,18876568,18965778,89210,-,-
BAC100_B16,18,18q11.2,18925679,19025543,99864,-,-
BAC135_N08,18,18q11.2,18961488,19096455,134967,-,-
BAC224_I05,18,18q11.2,19006580,19106968,100388,-,-
BAC41_F06,18,18q11.2,19007996,19106968,98972,-,-
BAC184_G04,18,18q11.2,19017247,19128399,111152,-,-
BAC137_H23,18,18q11.2,19017247,19087095,69848,-,-
BAC122_E18,18,18q11.2,19059585,19189790,130205,-,-
BAC118_J11,18,18q11.2,19143779,19232572,88793,-,-
BAC22_A11,18,18q11.2,19143779,19303854,160075,-,-
BAC91_N24,18,18q11.2,19159269,19266056,106787,-,-
BAC24_A05,18,18q11.2,19174786,19356915,182129,-,-
BAC128_G04,18,18q11.2,19189786,19372788,183002,-,-
BAC187_I08,18,18q11.2,19237355,19319167,81812,-,-
BAC143_N14,18,18q11.2,19249323,19354588,105265,-,-
BAC56_E07,18,18q11.2,19250161,19406359,156198,-,-
BAC233_E05,18,18q11.2,19278055,19366509,88454,-,-
BAC129_N02,18,18q11.2,19315138,19404250,89112,-,-
BAC193_D07,18,18q11.2,19413013,19530328,117315,-,-
BAC155_H12,18,18q11.2,19425036,19563578,138542,-,-
BAC189_J21,18,18q11.2,19425038,19528881,103843,-,-
BAC122_N07,18,18q11.2,19425038,19528881,103843,-,-
BAC126_E05,18,18q11.2,19425043,19528881,103838,-,-
BAC147_I05,18,18q11.2,19431373,19553930,122557,-,-
BAC60_A18,18,18q11.2,19448394,19544770,96376,-,-
BAC188_C18,18,18q11.2,19448418,19543977,95559,-,-
BAC37_G08,18,18q11.2,19659353,19791656,132303,-,-
BAC226_O04,18,18q11.2,19715234,19799951,84717,-,-
BAC156_O23,18,18q11.2,19749008,19827957,78949,-,-
BAC150_O20,18,18q11.2,19752486,19857726,105240,-,-
BAC81_G01,18,18q11.2,19799946,19923647,123701,-,-
BAC5_G07,18,18q11.2,19803488,19920254,116766,-,-
BAC116_D21,18,18q11.2,19809712,19911181,101469,-,-
BAC55_K21,18,18q11.2,19880385,20024097,143712,-,-
BAC210_C17,18,18q11.2,19880440,19968643,88203,-,-
BAC131_F03,18,18q11.2,19911863,19992207,80344,-,-
BAC50_F16,18,18q11.2,19916766,20022954,106188,-,-
BAC130_F16,18,18q11.2,20032122,20114868,82746,-,-
BAC63_M19,18,18q11.2,20078106,20175124,97018,-,-
BAC238_D23,18,18q11.2,20148884,20227841,78957,-,-
BAC31_K18,18,18q11.2,20153962,20335208,181246,-,-
BAC31_C10,18,18q11.2,20154073,20255915,101842,-,-
BAC224_A03,18,18q11.2,20196565,20278604,82039,-,-
BAC151_M01,18,18q11.2,20207157,20296330,89173,-,-
BAC172_O11,18,18q11.2,20228317,20331368,103051,-,-
BAC206_D08,18,18q11.2,20335206,20441590,106384,-,-
BAC193_L19,18,18q11.2,20395719,20488378,92659,-,-
BAC125_N19,18,18q11.2,20442000,20537169,95169,-,-
BAC12_K05,18,18q11.2,20448811,20538404,89593,-,-
BAC125_D11,18,18q11.2,20585098,20700078,114980,-,-
BAC170_I12,18,18q11.2,20590357,20675352,84995,-,-
BAC147_E18,18,18q11.2,20590808,20699187,108379,-,-
BAC2_A12,18,18q11.2,20619406,20736442,117036,-,-
BAC229_I02,18,18q11.2,20623120,20699189,76069,-,-
BAC153_H10,18,18q11.2,20638870,20735887,97017,-,-
BAC132_F17,18,18q11.2,20642334,20764587,122253,-,-
BAC21_M18,18,18q11.2,20711007,20820509,109502,-,-
BAC125_I24,18,18q11.2,20820606,20902454,81848,-,-
BAC124_D04,18,18q11.2,20892696,21008524,115828,-,-
BAC160_M23,18,18q11.2,20906429,20971367,64938,-,-
BAC246_H19,18,18q11.2,21018847,21104532,85685,-,-
BAC213_D23,18,18q11.2,21095874,21202793,106919,-,-
BAC75_N22,18,18q11.2,21107976,21193714,85738,-,-
BAC72_O03,18,18q11.2,21217270,21322396,105126,-,-
BAC57_H19,18,18q11.2,21219282,21303778,84496,-,-
BAC113_L03,18,18q11.2,21327782,21425442,97660,-,-
BAC64_C10,18,18q11.2,21619551,21713808,94257,-,-
BAC64_J10,18,18q11.2,21623878,21705177,81299,-,-
BAC161_M08,18,18q11.2,21632437,21719319,86882,-,-
BAC97_D24,18,18q11.2,21673169,21754528,81359,-,-
BAC163_D08,18,18q11.2,21705344,21798279,92935,-,-
BAC72_M06,18,18q11.2,21719316,21848761,129445,-,-
BAC21_P19,18,18q11.2,21867501,22008413,140912,-,-
BAC118_L11,18,18q11.2,21886574,21972516,85942,-,-
BAC231_O01,18,18q11.2,21927078,22018289,91211,-,-
BAC143_E12,18,18q11.2,21927078,22010901,83823,-,-
BAC117_K04,18,18q11.2,22045500,22148605,103105,-,-
BAC84_J22,18,18q11.2,22104814,22198229,93415,-,-
BAC165_N07,18,18q11.2,22148633,22263095,114462,-,-
BAC144_F10,18,18q11.2,22174862,22263095,88233,-,-
BAC41_B15,18,18q11.2,22203042,22298476,95434,-,-
BAC108_D19,18,18q11.2,22222438,22360703,138265,-,-
BAC36_H03,18,18q11.2,22241796,22348894,107098,-,-
BAC162_D13,18,18q11.2,22255849,22340559,84710,-,-
BAC86_C20,18,18q11.2,22294350,22405544,111194,-,-
BAC232_H06,18,18q11.2,22312547,22405063,92516,-,-
BAC198_L19,18,18q11.2,22406040,22482629,76589,-,-
BAC88_B18,18,18q11.2,22496957,22661345,164388,-,-
BAC83_B23,18,18q11.2,22520889,22605283,84394,-,-
BAC19_O10,18,18q11.2,22543529,22673112,129583,-,-
BAC32_I10,18,18q11.2,22554016,22673100,119084,-,-
BAC40_H16,18,18q11.2,22567247,22658892,91645,-,-
BAC127_P19,18,18q11.2,22664715,22777273,112558,-,-
BAC176_I11,18,18q11.2,22691872,22829579,137707,-,-
BAC48_H10,18,18q11.2,22696164,22845268,149104,-,-
BAC161_D02,18,18q11.2,22767455,22845019,77564,-,-
BAC222_K20,18,18q11.2,22858680,22940429,81749,-,-
BAC30_N12,18,18q11.2,23031389,23154688,123299,-,-
BAC236_N01,18,18q11.2-18q12.1,23215569,23329659,114090,-,-
BAC106_K23,18,18q11.2-18q12.1,23238261,23329659,91398,-,-
BAC80_L24,18,18q12.1,23320062,23419743,99681,-,-
BAC168_P08,18,18q12.1,23389736,23499148,109412,-,-
BAC25_I03,18,18q12.1,23419762,23507383,87621,-,-
BAC66_A10,18,18q12.1,23453065,23548509,95444,-,-
BAC123_B18,18,18q12.1,23480724,23582896,102172,-,-
BAC225_N14,18,18q12.1,23517029,23630039,113010,-,-
BAC44_F11,18,18q12.1,23548818,23687281,138463,-,-
BAC83_D02,18,18q12.1,23552989,23643188,90199,-,-
BAC124_C19,18,18q12.1,23600520,23681488,80968,-,-
BAC198_G09,18,18q12.1,23659911,23750373,90462,-,-
BAC50_B18,18,18q12.1,23661769,23750055,88286,-,-
BAC109_F21,18,18q12.1,23759035,23844355,85320,-,-
BAC61_A02,18,18q12.1,23767714,23886024,118310,-,-
BAC86_N24,18,18q12.1,23802994,23904348,101354,-,-
BAC60_D14,18,18q12.1,23814796,23918412,103616,-,-
BAC243_N15,18,18q12.1,23886080,23995009,108929,-,-
BAC252_H16,18,18q12.1,23925558,24030666,105108,-,-
BAC186_G19,18,18q12.1,24020613,24106492,85879,-,-
BAC53_K09,18,18q12.1,24030665,24148448,117783,-,-
BAC8_F09,18,18q12.1,24213752,24378568,164816,-,-
BAC38_B02,18,18q12.1,24218611,24309669,91058,-,-
BAC165_B16,18,18q12.1,24301334,24407355,106021,-,-
BAC172_H03,18,18q12.1,24329812,24409639,79827,-,-
BAC104_C03,18,18q12.1,24498934,24583528,84594,-,-
BAC37_L09,18,18q12.1,24665775,24750911,85136,-,-
BAC193_K14,18,18q12.1,24814971,24914154,99183,-,-
BAC57_M15,18,18q12.1,24862744,24949909,87165,-,-
BAC182_G16,18,18q12.1,25125072,25207932,82860,-,-
BAC196_N12,18,18q12.1,25410338,25473852,63514,-,-
BAC151_M13,18,18q12.1,25471973,25558309,86336,-,-
BAC194_I17,18,18q12.1,25509501,25586651,77150,-,-
BAC155_F21,18,18q12.1,25748570,25830959,82389,-,-
BAC29_L18,18,18q12.1,25808002,25903048,95046,-,-
BAC114_N17,18,18q12.1,25918083,26004957,86874,-,-
BAC194_M21,18,18q12.1,26006945,26090320,83375,-,-
BAC30_M17,18,18q12.1,26018520,26090315,71795,-,-
BAC59_I14,18,18q12.1,26140628,26276577,135949,-,-
BAC141_M07,18,18q12.1,26338493,26425936,87443,-,-
BAC247_L03,18,18q12.1,26406944,26499895,92951,-,-
BAC60_A16,18,18q12.1,26425929,26529861,103932,-,-
BAC193_I20,18,18q12.1,26456640,26541966,85326,-,-
BAC42_L17,18,18q12.1,26481257,26598535,117278,-,-
BAC101_L10,18,18q12.1,26598598,26683611,85013,-,-
BAC104_J03,18,18q12.1,26815308,26898153,82845,-,-
BAC149_G23,18,18q12.1,26971383,27064371,92988,-,-
BAC16_G12,18,18q12.1,27190414,27311589,121175,-,-
BAC199_F11,18,18q12.1,27219830,27295895,76065,-,-
BAC163_N04,18,18q12.1,27223098,27308146,85048,-,-
BAC50_G13,18,18q12.1,27228223,27305672,77449,-,-
BAC41_B11,18,18q12.1,27263644,27383860,120216,-,-
BAC25_O07,18,18q12.1,27296052,27391526,95474,-,-
BAC194_N01,18,18q12.1,27378456,27484427,105971,-,-
BAC55_H10,18,18q12.1,27476826,27585243,108417,-,-
BAC150_K16,18,18q12.1,27615418,27712315,96897,-,-
BAC170_H15,18,18q12.1,27627292,27732892,105600,-,-
BAC57_J02,18,18q12.1,27715626,27805031,89405,-,-
BAC115_A22,18,18q12.1,27757463,27858007,100544,-,-
BAC76_H03,18,18q12.1,27775806,27890582,114776,-,-
BAC39_H23,18,18q12.1,27822358,27971076,148718,-,-
BAC4_N07,18,18q12.1,27832561,27890582,58021,-,-
BAC151_I14,18,18q12.1,27868561,27963409,94848,-,-
BAC107_M13,18,18q12.1,27890835,27991631,100796,-,-
BAC182_J01,18,18q12.1,27893572,27999191,105619,-,-
BAC197_P12,18,18q12.1,27906416,27991616,85200,-,-
BAC142_F17,18,18q12.1,27938345,28019766,81421,-,-
BAC57_I06,18,18q12.1,27945288,27957543,12255,-,-
BAC4_B11,18,18q12.1,27974633,28069730,95097,-,-
BAC238_F11,18,18q12.1,27996121,28069718,73597,-,-
BAC54_I12,18,18q12.1,27996123,28069654,73531,-,-
BAC119_D18,18,18q12.1,28011333,28113977,102644,-,-
BAC249_A08,18,18q12.1,28041057,28099914,58857,-,-
BAC191_D23,18,18q12.1,28113288,28193281,79993,-,-
BAC228_N05,18,18q12.1,28123426,28202199,78773,-,-
BAC235_D16,18,18q12.1,28176624,28257646,81022,-,-
BAC19_B03,18,18q12.1,28255906,28344211,88305,-,-
BAC162_A09,18,18q12.1,28257640,28368954,111314,-,-
BAC139_I20,18,18q12.1,28315606,28391170,75564,-,-
BAC150_N01,18,18q12.1,28316996,28407478,90482,-,-
BAC185_D24,18,18q12.1,28319159,28404098,84939,-,-
BAC91_O19,18,18q12.1,28427626,28534173,106547,-,-
BAC108_B13,18,18q12.1,28518520,28639370,120850,-,-
BAC29_L22,18,18q12.1,28541728,28636460,94732,-,-
BAC140_P22,18,18q12.1,28756510,28845729,89219,-,-
BAC96_K20,18,18q12.1,28789071,28890355,101284,-,-
BAC19_N01,18,18q12.1,28792729,28890348,97619,-,-
BAC52_A14,18,18q12.1,28792735,28883555,90820,-,-
BAC53_H23,18,18q12.1,29003684,29138710,135026,-,-
BAC68_A13,18,18q12.1,29035290,29142953,107663,-,-
BAC38_F11,18,18q12.1,29098055,29180273,82218,-,-
BAC192_E13,18,18q12.1,29192259,29306685,114426,-,-
BAC149_G09,18,18q12.1,29286625,29378410,91785,-,-
BAC108_K20,18,18q12.1,29339608,29439351,99743,-,-
BAC5_B06,18,18q12.1,29339608,29425939,86331,-,-
BAC195_G07,18,18q12.1,29563621,29679198,115577,-,-
BAC115_K12,18,18q12.1,29910488,30006090,95602,-,-
BAC73_D15,18,18q12.1,30020863,30122930,102067,-,-
BAC120_I07,18,18q12.1,30024294,30122086,97792,-,-
BAC123_B06,18,18q12.1,30166829,30256674,89845,-,-
BAC161_D08,18,18q12.1,30186754,30268077,81323,-,-
BAC46_O17,18,18q12.1,30256673,30346248,89575,-,-
BAC74_O13,18,18q12.1,30313231,30345043,31812,-,-
BAC116_M13,18,18q12.1,30328677,30443134,114457,-,-
BAC230_F15,18,18q12.1,30348234,30443134,94900,-,-
BAC169_E15,18,18q12.1,30355630,30443134,87504,-,-
BAC217_F16,18,18q12.1,30504202,30602641,98439,-,-
BAC124_E09,18,18q12.1,30554932,30664633,109701,-,-
BAC41_L05,18,18q12.1,30602636,30718981,116345,-,-
BAC218_N05,18,18q12.1,30676066,30785805,109739,-,-
BAC222_H13,18,18q12.1,30837090,30921361,84271,-,-
BAC41_M10,18,18q12.1-18q12.2,30998252,31156404,158152,-,-
BAC76_B03,18,18q12.2,31021090,31136948,115858,-,-
BAC131_H24,18,18q12.2,31250998,31335835,84837,-,-
BAC5_O10,18,18q12.2,31251008,31338909,87901,-,-
BAC18_J06,18,18q12.2,31261086,31271238,10152,-,-
BAC92_H06,18,18q12.2,31275992,31360618,84626,-,-
BAC53_F20,18,18q12.2,31293953,31453692,159739,-,-
BAC171_I13,18,18q12.2,31338903,31443233,104330,-,-
BAC78_D07,18,18q12.2,31360755,31453692,92937,-,-
BAC226_H15,18,18q12.2,31709699,31808148,98449,-,-
BAC141_E05,18,18q12.2,31780476,31873426,92950,-,-
BAC49_E22,18,18q12.2,31780707,31925966,145259,-,-
BAC232_K04,18,18q12.2,31781305,31862403,81098,-,-
BAC159_C07,18,18q12.2,31926199,32007351,81152,-,-
BAC118_O23,18,18q12.2,32007366,32097715,90349,-,-
BAC141_E22,18,18q12.2,32087857,32169454,81597,-,-
BAC118_F19,18,18q12.2,32087857,32169454,81597,-,-
BAC184_G02,18,18q12.2,32169615,32273030,103415,-,-
BAC53_E23,18,18q12.2,32238167,32324672,86505,-,-
BAC130_F17,18,18q12.2,32326405,32410723,84318,-,-
BAC59_N19,18,18q12.2,32326405,32470613,144208,-,-
BAC27_C10,18,18q12.2,32371030,32489369,118339,-,-
BAC65_J11,18,18q12.2,32394223,32489369,95146,-,-
BAC167_B04,18,18q12.2,32470888,32559370,88482,-,-
BAC218_K22,18,18q12.2,32483299,32564426,81127,-,-
BAC58_A16,18,18q12.2,32558711,32642967,84256,-,-
BAC37_I07,18,18q12.2,32567769,32720305,152536,-,-
BAC44_P04,18,18q12.2,32622695,32778864,156169,-,-
BAC103_F11,18,18q12.2,32637392,32754541,117149,-,-
BAC240_A01,18,18q12.2,32679512,32765512,86000,-,-
BAC32_I21,18,18q12.2,32726072,32844955,118883,-,-
BAC217_L07,18,18q12.2,32780416,32877790,97374,-,-
BAC116_B18,18,18q12.2,32795141,32874501,79360,-,-
BAC17_L17,18,18q12.2,32872165,32975057,102892,-,-
BAC9_D20,18,18q12.2,32895819,33009049,113230,-,-
BAC191_K19,18,18q12.2,32977552,33061145,83593,-,-
BAC144_F22,18,18q12.2,33039922,33120152,80230,-,-
BAC62_N10,18,18q12.2,33061456,33163972,102516,-,-
BAC49_N09,18,18q12.2,33089114,33292884,203770,-,-
BAC1_M13,18,18q12.2,33163984,33328626,164642,-,-
BAC130_D10,18,18q12.2,33177089,33292689,115600,-,-
BAC189_G22,18,18q12.2,33220223,33328626,108403,-,-
BAC188_H05,18,18q12.2,33296056,33381776,85720,-,-
BAC34_I07,18,18q12.2,33296056,33425896,129840,-,-
BAC247_E21,18,18q12.2,33321475,33397465,75990,-,-
BAC232_E19,18,18q12.2,33328623,33432257,103634,-,-
BAC143_F01,18,18q12.2,33335862,33450856,114994,-,-
BAC71_B01,18,18q12.2,33360745,33509004,148259,-,-
BAC91_N03,18,18q12.2,33377864,33519950,142086,-,-
BAC230_H03,18,18q12.2,33381772,33490543,108771,-,-
BAC137_O15,18,18q12.2,33417117,33500579,83462,-,-
BAC194_O17,18,18q12.2,33542061,33645509,103448,-,-
BAC225_P11,18,18q12.2,33591747,33702347,110600,-,-
BAC193_O14,18,18q12.2,33694768,33795432,100664,-,-
BAC88_P01,18,18q12.2,33748374,33838433,90059,-,-
BAC162_M04,18,18q12.2,33755171,33881353,126182,-,-
BAC195_N11,18,18q12.2,33854982,33934094,79112,-,-
BAC244_L19,18,18q12.2,33987211,34072621,85410,-,-
BAC60_N10,18,18q12.2,34203418,34331044,127626,-,-
BAC191_E05,18,18q12.2,34393445,34476194,82749,-,-
BAC150_E06,18,18q12.2,34466072,34558769,92697,-,-
BAC115_N16,18,18q12.2,34536425,34632665,96240,-,-
BAC40_D19,18,18q12.2,34614767,34718785,104018,-,-
BAC34_P12,18,18q12.2,34669449,34779342,109893,-,-
BAC176_H18,18,18q12.2,34676352,34785592,109240,-,-
BAC127_K06,18,18q12.2,34676987,34802101,125114,-,-
BAC194_J14,18,18q12.2,34685583,34762993,77410,-,-
BAC64_M04,18,18q12.2,34696631,34764799,68168,-,-
BAC132_E14,18,18q12.2,34718780,34808790,90010,-,-
BAC42_I18,18,18q12.2,34742961,34841466,98505,-,-
BAC35_E03,18,18q12.2,34883848,34974819,90971,-,-
BAC157_K09,18,18q12.2,35023196,35113747,90551,-,-
BAC146_O04,18,18q12.2,35115537,35220733,105196,-,-
BAC70_O16,18,18q12.2,35130571,35211843,81272,-,-
BAC135_N19,18,18q12.2,35260565,35365626,105061,-,-
BAC181_G22,18,18q12.2,35318570,35401323,82753,-,-
BAC8_G01,18,18q12.2,35323162,35472235,149073,-,-
BAC100_H11,18,18q12.2-18q12.3,35472253,35550619,78366,-,-
BAC29_B24,18,18q12.3,35645309,35816482,171173,-,-
BAC22_J01,18,18q12.3,35706059,35816428,110369,-,-
BAC72_F15,18,18q12.3,35836738,35911077,74339,-,-
BAC249_M22,18,18q12.3,35919865,36017714,97849,-,-
BAC176_G03,18,18q12.3,35981943,36076884,94941,-,-
BAC176_P20,18,18q12.3,36015033,36115213,100180,-,-
BAC175_K23,18,18q12.3,36122794,36207578,84784,-,-
BAC166_I22,18,18q12.3,36281621,36365557,83936,-,-
BAC14_H17,18,18q12.3,36355378,36374001,18623,-,-
BAC191_H04,18,18q12.3,36570635,36662367,91732,-,-
BAC91_F19,18,18q12.3,36694165,36800216,106051,-,-
BAC148_M23,18,18q12.3,36927743,37006236,78493,-,-
BAC51_G08,18,18q12.3,37007047,37170253,163206,-,-
BAC239_F13,18,18q12.3,37420651,37534658,114007,-,-
BAC91_O16,18,18q12.3,37533410,37612637,79227,-,-
BAC54_L22,18,18q12.3,37783347,37899933,116586,-,-
BAC39_D04,18,18q12.3,37805264,37899929,94665,-,-
BAC182_B23,18,18q12.3,37899924,37993841,93917,-,-
BAC249_M04,18,18q12.3,37899932,37988186,88254,-,-
BAC115_M16,18,18q12.3,37999326,38096026,96700,-,-
BAC167_L16,18,18q12.3,38014592,38106193,91601,-,-
BAC249_O20,18,18q12.3,38177193,38271890,94697,-,-
BAC129_D10,18,18q12.3,38193050,38271901,78851,-,-
BAC150_N12,18,18q12.3,38238556,38347553,108997,-,-
BAC105_I02,18,18q12.3,38241461,38373937,132476,-,-
BAC25_F09,18,18q12.3,38286523,38410398,123875,-,-
BAC56_F22,18,18q12.3,38525731,38625362,99631,-,-
BAC104_B22,18,18q12.3,38608779,38748281,139502,-,-
BAC27_M11,18,18q12.3,38664455,38749464,85009,-,-
BAC238_N14,18,18q12.3,38903767,38990152,86385,-,-
BAC179_F14,18,18q12.3,38923895,39015168,91273,-,-
BAC239_P12,18,18q12.3,39219126,39308863,89737,-,-
BAC61_C11,18,18q12.3,39257615,39353449,95834,-,-
BAC143_A06,18,18q12.3,39534867,39606827,71960,-,-
BAC241_G13,18,18q12.3,39589211,39692479,103268,-,-
BAC129_D15,18,18q12.3,39738054,39836802,98748,-,-
BAC109_A09,18,18q12.3,39773526,39844119,70593,-,-
BAC41_F01,18,18q12.3,39793152,39894495,101343,-,-
BAC38_E02,18,18q12.3,39878595,39968402,89807,-,-
BAC69_J05,18,18q12.3,39978157,40116739,138582,-,-
BAC187_M14,18,18q12.3,39978157,40071466,93309,-,-
BAC158_P15,18,18q12.3,39978157,40065422,87265,-,-
BAC50_P09,18,18q12.3,40029475,40135186,105711,-,-
BAC168_H07,18,18q12.3,40212859,40288587,75728,-,-
BAC54_B08,18,18q12.3,40398842,40498522,99680,-,-
BAC236_K07,18,18q12.3,40492533,40559933,67400,-,-
BAC149_I18,18,18q12.3,40492533,40595058,102525,-,-
BAC165_L15,18,18q12.3,40562551,40678231,115680,-,-
BAC106_O20,18,18q12.3,40595507,40755972,160465,-,-
BAC141_P10,18,18q12.3,40612371,40694065,81694,-,-
BAC249_O02,18,18q12.3,40639033,40719776,80743,-,-
BAC232_J13,18,18q12.3,40644664,40722940,78276,-,-
BAC155_N16,18,18q12.3,40653459,40796842,143383,-,-
BAC139_D17,18,18q12.3,40657215,40813475,156260,-,-
BAC144_M21,18,18q12.3,40661232,40753310,92078,-,-
BAC117_L05,18,18q12.3,40684352,40813463,129111,-,-
BAC146_N03,18,18q12.3,40685227,40792595,107368,-,-
BAC117_E15,18,18q12.3,40739332,40815972,76640,-,-
BAC60_J14,18,18q12.3,40766700,40871906,105206,-,-
BAC171_F09,18,18q12.3,40796205,40886318,90113,-,-
BAC33_P14,18,18q12.3,41137898,41243570,105672,-,-
BAC156_C01,18,18q12.3,41151352,41241023,89671,-,-
BAC147_I01,18,18q12.3,41245179,41341882,96703,-,-
BAC37_K10,18,18q12.3,41245179,41337516,92337,-,-
BAC133_L18,18,18q12.3,41256730,41396308,139578,-,-
BAC184_P24,18,18q12.3,41293135,41383937,90802,-,-
BAC234_E12,18,18q12.3,41429576,41509648,80072,-,-
BAC66_O04,18,18q12.3,41460265,41575958,115693,-,-
BAC5_L24,18,18q12.3,41471960,41569119,97159,-,-
BAC181_K10,18,18q12.3,41481510,41575960,94450,-,-
BAC154_B12,18,18q12.3,41487456,41575960,88504,-,-
BAC208_P03,18,18q12.3,41490531,41575960,85429,-,-
BAC121_H01,18,18q12.3,41609153,41757073,147920,-,-
BAC240_M02,18,18q12.3,41613917,41715274,101357,-,-
BAC161_C24,18,18q12.3,41642801,41732668,89867,-,-
BAC238_I17,18,18q12.3-18q21.1,41735761,41843900,108139,-,-
BAC74_A13,18,18q12.3-18q21.1,41757306,41873205,115899,-,-
BAC62_C19,18,18q21.1,41816680,41886989,70309,-,-
BAC178_E20,18,18q21.1,41843910,41929158,85248,-,-
BAC68_E18,18,18q21.1,41913646,42043254,129608,-,-
BAC58_A12,18,18q21.1,41938921,42055099,116178,-,-
BAC50_A17,18,18q21.1,42000975,42107586,106611,-,-
BAC46_A22,18,18q21.1,42055197,42186310,131113,-,-
BAC142_P17,18,18q21.1,42055690,42185182,129492,-,-
BAC250_C01,18,18q21.1,42077060,42165540,88480,-,-
BAC249_G06,18,18q21.1,42094346,42196583,102237,-,-
BAC157_H02,18,18q21.1,42107583,42196583,89000,-,-
BAC69_I19,18,18q21.1,42185175,42286579,101404,-,-
BAC145_H23,18,18q21.1,42190247,42283442,93195,-,-
BAC149_N20,18,18q21.1,42202156,42315777,113621,-,-
BAC53_C23,18,18q21.1,42202156,42300991,98835,-,-
BAC81_I02,18,18q21.1,42229033,42316631,87598,-,-
BAC240_N20,18,18q21.1,42230663,42315776,85113,-,-
BAC75_C11,18,18q21.1,42235065,42356522,121457,-,-
BAC153_E15,18,18q21.1,42283436,42378692,95256,-,-
BAC171_C19,18,18q21.1,42283436,42404709,121273,-,-
BAC163_J13,18,18q21.1,42335473,42430634,95161,-,-
BAC63_I11,18,18q21.1,42425463,42591876,166413,-,-
BAC180_C10,18,18q21.1,42493624,42606670,113046,-,-
BAC26_B08,18,18q21.1,42495054,42616558,121504,-,-
BAC50_E17,18,18q21.1,42516279,42606675,90396,-,-
BAC61_D11,18,18q21.1,42516281,42616594,100313,-,-
BAC217_C17,18,18q21.1,42528762,42638560,109798,-,-
BAC67_A02,18,18q21.1,42657965,42749698,91733,-,-
BAC176_P08,18,18q21.1,42681103,42794752,113649,-,-
BAC28_H07,18,18q21.1,42732970,42801438,68468,yes,-
BAC153_N05,18,18q21.1,42752170,42801439,49269,yes,-
BAC125_G06,18,18q21.1,42761961,42841676,79715,yes,-
BAC13_B05,18,18q21.1,42801546,42855617,54071,yes,-
BAC23_C08,18,18q21.1,42841949,42959928,117979,-,-
BAC82_P16,18,18q21.1,42865504,42964262,98758,-,-
BAC162_F11,18,18q21.1,42924259,43023242,98983,-,-
BAC223_L09,18,18q21.1,42924264,43023242,98978,-,-
BAC117_I02,18,18q21.1,42985958,43158733,172775,-,-
BAC92_H14,18,18q21.1,43023237,43143608,120371,-,-
BAC179_C02,18,18q21.1,43037721,43130971,93250,-,-
BAC126_E12,18,18q21.1,43050817,43105603,54786,-,-
BAC122_P23,18,18q21.1,43050817,43105622,54805,-,-
BAC168_E08,18,18q21.1,43053962,43158733,104771,-,-
BAC12_B01,18,18q21.1,43093993,43235360,141367,-,-
BAC229_I17,18,18q21.1,43125546,43266140,140594,-,-
BAC227_C03,18,18q21.1,43152941,43235313,82372,-,-
BAC62_K21,18,18q21.1,43178608,43357647,179039,-,-
BAC136_E08,18,18q21.1,43237437,43341374,103937,-,-
BAC178_G19,18,18q21.1,43269727,43357410,87683,-,-
BAC120_M13,18,18q21.1,43316991,43492045,175054,-,-
BAC141_J18,18,18q21.1,43334092,43433532,99440,-,-
BAC137_E01,18,18q21.1,43365453,43460805,95352,-,-
BAC172_G20,18,18q21.1,43368973,43470473,101500,-,-
BAC35_I12,18,18q21.1,43371516,43470315,98799,-,-
BAC76_F21,18,18q21.1,43450657,43531766,81109,-,-
BAC55_N21,18,18q21.1,43493364,43584875,91511,-,-
BAC167_K11,18,18q21.1,43502293,43598449,96156,-,-
BAC250_G23,18,18q21.1,43551361,43640013,88652,-,-
BAC102_D18,18,18q21.1,43740503,43822712,82209,-,-
BAC106_L14,18,18q21.1,43787144,43933653,146509,-,-
BAC106_J17,18,18q21.1,43807120,43939510,132390,-,-
BAC151_H15,18,18q21.1,43822729,43913517,90788,-,-
BAC170_L16,18,18q21.1,43828503,43933547,105044,-,-
BAC249_C09,18,18q21.1,43831244,43940993,109749,-,-
BAC238_G14,18,18q21.1,43850698,43941023,90325,-,-
BAC26_A02,18,18q21.1,43852949,43941023,88074,-,-
BAC206_H05,18,18q21.1,43915019,44026530,111511,-,-
BAC222_D17,18,18q21.1,43941060,44019707,78647,-,-
BAC45_L01,18,18q21.1,43949132,44059725,110593,-,-
BAC51_H20,18,18q21.1,43960836,44056637,95801,-,-
BAC128_N11,18,18q21.1,44019699,44242403,222704,-,-
BAC130_L13,18,18q21.1,44060094,44162252,102158,-,-
BAC196_A13,18,18q21.1,44063468,44172644,109176,-,-
BAC233_A02,18,18q21.1,44080467,44217833,137366,-,-
BAC125_N13,18,18q21.1,44083398,44229636,146238,-,-
BAC63_J03,18,18q21.1,44093086,44183794,90708,-,-
BAC184_A20,18,18q21.1,44116860,44197914,81054,-,-
BAC139_F05,18,18q21.1,44116860,44197929,81069,-,-
BAC194_O08,18,18q21.1,44190848,44284866,94018,-,-
BAC144_I05,18,18q21.1,44191779,44271428,79649,-,-
BAC91_E14,18,18q21.1,44242465,44401416,158951,-,-
BAC179_K11,18,18q21.1,44261162,44382164,121002,-,-
BAC240_E21,18,18q21.1,44312369,44400406,88037,-,-
BAC126_I24,18,18q21.1,44333324,44447925,114601,-,-
BAC137_G03,18,18q21.1,44333333,44447925,114592,-,-
BAC59_E16,18,18q21.1,44389513,44532304,142791,-,-
BAC106_M20,18,18q21.1,44447917,44540926,93009,-,-
BAC72_B05,18,18q21.1,44459848,44549637,89789,-,-
BAC249_J14,18,18q21.1,44476531,44549635,73104,-,-
BAC171_C10,18,18q21.1,44505549,44608688,103139,-,-
BAC130_B15,18,18q21.1,44536666,44636410,99744,-,-
BAC33_P09,18,18q21.1,44554995,44694936,139941,-,-
BAC51_M23,18,18q21.1,44575522,44665161,89639,-,-
BAC198_O19,18,18q21.1,44608682,44706692,98010,-,-
BAC2_H04,18,18q21.1,44621556,44694927,73371,-,-
BAC68_B17,18,18q21.1,44660316,44769688,109372,-,-
BAC195_H04,18,18q21.1,44675424,44769712,94288,-,-
BAC137_I05,18,18q21.1,44699950,44791566,91616,-,-
BAC67_N19,18,18q21.1,44706685,44832064,125379,-,-
BAC217_O04,18,18q21.1,44809807,44923718,113911,-,-
BAC182_C23,18,18q21.1,44910093,44989706,79613,-,-
BAC6_D17,18,18q21.1,45047431,45148473,101042,-,-
BAC75_N03,18,18q21.1,45064199,45148447,84248,-,-
BAC252_C05,18,18q21.1,45224487,45335510,111023,-,-
BAC66_K10,18,18q21.1,45252408,45372623,120215,-,-
BAC114_C17,18,18q21.1,45259156,45403377,144221,-,-
BAC175_N08,18,18q21.1,45296109,45403385,107276,-,-
BAC83_K16,18,18q21.1,45321589,45452194,130605,-,-
BAC218_F07,18,18q21.1,45350368,45433653,83285,-,-
BAC126_H22,18,18q21.1,45373319,45478732,105413,-,-
BAC21_J23,18,18q21.1,45403379,45535221,131842,-,-
BAC57_C21,18,18q21.1,45459140,45547422,88282,-,-
BAC48_K07,18,18q21.1,45477405,45564483,87078,-,-
BAC106_K12,18,18q21.1,45578479,45680275,101796,-,-
BAC80_M01,18,18q21.1,45609468,45763588,154120,-,-
BAC96_I12,18,18q21.1,45617663,45706355,88692,-,-
BAC231_K09,18,18q21.1,45629090,45725125,96035,-,-
BAC225_C07,18,18q21.1,45644306,45738773,94467,-,-
BAC186_P19,18,18q21.1,45732647,45836159,103512,-,-
BAC141_F09,18,18q21.1,45763583,45879506,115923,-,-
BAC213_D24,18,18q21.1,45785636,45868400,82764,-,-
BAC169_M07,18,18q21.1,45786573,45858616,72043,-,-
BAC199_M20,18,18q21.1,45798878,45883062,84184,-,-
BAC168_K19,18,18q21.1,45805356,45934647,129291,-,-
BAC241_H18,18,18q21.1,45852686,45931204,78518,-,-
BAC244_M21,18,18q21.1,45858623,45955631,97008,-,-
BAC76_I19,18,18q21.1,45955685,46045581,89896,-,-
BAC88_B03,18,18q21.1,45972934,46095377,122443,-,-
BAC111_I02,18,18q21.1,45976912,46075019,98107,-,-
BAC196_A09,18,18q21.1,45988299,46073979,85680,-,-
BAC107_K08,18,18q21.1,45992284,46095375,103091,-,-
BAC36_O07,18,18q21.1,45992284,46074150,81866,-,-
BAC195_G13,18,18q21.1,46040415,46117033,76618,-,-
BAC78_K10,18,18q21.1,46102996,46176520,73524,-,-
BAC141_N21,18,18q21.1,46149560,46273578,124018,-,-
BAC137_A20,18,18q21.1,46308362,46399113,90751,-,-
BAC73_G02,18,18q21.1-18q21.2,46315788,46406081,90293,-,-
BAC197_O18,18,18q21.1-18q21.2,46318092,46406081,87989,-,-
BAC208_D23,18,18q21.1-18q21.2,46319751,46405317,85566,-,-
BAC68_K20,18,18q21.1-18q21.2,46350107,46455011,104904,-,-
BAC39_P12,18,18q21.1-18q21.2,46359058,46463773,104715,-,-
BAC231_D17,18,18q21.1-18q21.2,46361685,46444041,82356,-,-
BAC1_E24,18,18q21.1-18q21.2,46384130,46503427,119297,-,-
BAC250_O14,18,18q21.2,46447345,46605786,158441,-,-
BAC175_E14,18,18q21.2,46463860,46574220,110360,-,-
BAC94_F16,18,18q21.2,46487638,46605786,118148,-,-
BAC136_E01,18,18q21.2,46488961,46554305,65344,-,-
BAC139_M13,18,18q21.2,46578506,46691060,112554,-,-
BAC122_H11,18,18q21.2,46632734,46753368,120634,-,-
BAC162_H09,18,18q21.2,46655519,46746131,90612,-,-
BAC144_H12,18,18q21.2,46768403,46866125,97722,-,-
BAC54_O10,18,18q21.2,46843720,46965539,121819,-,-
BAC155_B08,18,18q21.2,46928121,47002328,74207,-,-
BAC175_I13,18,18q21.2,46942549,47039236,96687,-,-
BAC56_B06,18,18q21.2,46949845,47041838,91993,-,-
BAC223_A07,18,18q21.2,47042855,47148735,105880,-,-
BAC252_I18,18,18q21.2,47043023,47135638,92615,-,-
BAC224_P06,18,18q21.2,47043023,47134353,91330,-,-
BAC25_P06,18,18q21.2,47043039,47185414,142375,-,-
BAC107_P10,18,18q21.2,47058971,47161416,102445,-,-
BAC33_M10,18,18q21.2,47180958,47255520,74562,-,-
BAC24_D21,18,18q21.2,47187580,47286257,98677,-,-
BAC172_B14,18,18q21.2,47250607,47364338,113731,-,-
BAC147_C02,18,18q21.2,47309294,47396663,87369,-,-
BAC181_L06,18,18q21.2,47309313,47396048,86735,-,-
BAC137_D19,18,18q21.2,47396656,47486626,89970,-,-
BAC49_M03,18,18q21.2,47475857,47581707,105850,-,-
BAC230_B11,18,18q21.2,47500510,47609705,109195,-,-
BAC145_I02,18,18q21.2,47550821,47639313,88492,-,-
BAC26_K08,18,18q21.2,47550821,47647116,96295,-,-
BAC234_F17,18,18q21.2,47550856,47660217,109361,-,-
BAC217_N18,18,18q21.2,47644247,47754258,110011,-,-
BAC13_P18,18,18q21.2,47780097,47883619,103522,-,-
BAC224_F20,18,18q21.2,47792663,47883619,90956,-,-
BAC42_D16,18,18q21.2,47825317,47911337,86020,-,-
BAC130_L15,18,18q21.2,47829921,47928046,98125,-,-
BAC163_N13,18,18q21.2,47858882,47947531,88649,-,-
BAC139_A18,18,18q21.2,47947537,48031962,84425,-,-
BAC155_I02,18,18q21.2,48016592,48101696,85104,-,-
BAC179_G23,18,18q21.2,48016592,48102506,85914,-,-
BAC120_C22,18,18q21.2,48101937,48210190,108253,-,-
BAC60_P24,18,18q21.2,48133998,48144832,10834,-,-
BAC156_C16,18,18q21.2,48136387,48210215,73828,-,-
BAC219_N22,18,18q21.2,48263308,48349921,86613,-,-
BAC105_P09,18,18q21.2,48274972,48402038,127066,-,-
BAC102_I23,18,18q21.2,48404752,48514887,110135,-,-
BAC40_G24,18,18q21.2,48519524,48615058,95534,-,-
BAC23_J11,18,18q21.2,48530467,48667506,137039,-,-
BAC179_E18,18,18q21.2,49119358,49217486,98128,-,-
BAC20_L22,18,18q21.2,49119360,49312519,193159,-,-
BAC141_J19,18,18q21.2,49207409,49289450,82041,-,-
BAC71_M09,18,18q21.2,49383818,49484161,100343,-,-
BAC151_L15,18,18q21.2,49418923,49493529,74606,-,-
BAC177_H16,18,18q21.2,49449524,49593365,143841,-,-
BAC42_D05,18,18q21.2,49555263,49663215,107952,-,-
BAC191_I10,18,18q21.2,49602051,49685692,83641,-,-
BAC234_G13,18,18q21.2,49625276,49747064,121788,-,-
BAC73_I05,18,18q21.2,49663214,49747061,83847,-,-
BAC105_G16,18,18q21.2,49774321,49869919,95598,-,-
BAC131_F07,18,18q21.2,49884800,49982172,97372,-,-
BAC236_A05,18,18q21.2,49931176,50014939,83763,-,-
BAC48_H04,18,18q21.2,49938575,49982166,43591,-,-
BAC56_M16,18,18q21.2,49959754,50089135,129381,-,-
BAC248_E22,18,18q21.2,50007395,50090853,83458,-,-
BAC182_B24,18,18q21.2,50117356,50218553,101197,-,-
BAC218_I23,18,18q21.2,50464765,50548696,83931,-,-
BAC127_K13,18,18q21.2,50511826,50588503,76677,-,-
BAC124_K04,18,18q21.2,50514338,50605805,91467,-,-
BAC42_B03,18,18q21.2,50827885,50946926,119041,-,-
BAC132_M24,18,18q21.2,50868782,50946755,77973,-,-
BAC37_I24,18,18q21.2,51006661,51123812,117151,-,-
BAC168_E23,18,18q21.2,51021016,51113975,92959,-,-
BAC139_I08,18,18q21.2,51147440,51259181,111741,-,-
BAC157_G14,18,18q21.2,51166408,51247088,80680,-,-
BAC139_K20,18,18q21.2,51305608,51390645,85037,-,-
BAC105_E08,18,18q21.2,51314651,51430591,115940,-,-
BAC172_E10,18,18q21.2,51414539,51510613,96074,-,-
BAC91_C08,18,18q21.2,51414539,51518354,103815,-,-
BAC70_J12,18,18q21.2,51421242,51520702,99460,-,-
BAC171_M14,18,18q21.2,51421255,51505454,84199,-,-
BAC144_G01,18,18q21.2,51430641,51505178,74537,-,-
BAC86_I23,18,18q21.2,51430641,51546127,115486,-,-
BAC39_D15,18,18q21.2,51448786,51605294,156508,-,-
BAC76_G23,18,18q21.2,51451302,51591243,139941,-,-
BAC105_B15,18,18q21.2,51506702,51611220,104518,-,-
BAC235_M04,18,18q21.2,51525798,51612255,86457,-,-
BAC116_G14,18,18q21.2,51612348,51721862,109514,-,-
BAC222_O07,18,18q21.2,51770366,51869976,99610,-,-
BAC28_P12,18,18q21.2,51786463,51878644,92181,-,-
BAC224_I18,18,18q21.2,51803704,51878644,74940,-,-
BAC54_O12,18,18q21.2,51804217,51901894,97677,-,-
BAC56_L18,18,18q21.2-18q21.31,51939545,52028933,89388,-,-
BAC197_P11,18,18q21.2-18q21.31,51939546,52036089,96543,-,-
BAC46_B24,18,18q21.31,52059253,52146235,86982,-,-
BAC92_N08,18,18q21.31,52188102,52274057,85955,-,-
BAC2_M08,18,18q21.31,52345259,52454951,109692,-,-
BAC188_P18,18,18q21.31,52352656,52434360,81704,-,-
BAC14_O21,18,18q21.31,52381163,52497622,116459,-,-
BAC39_L13,18,18q21.31,52418316,52497622,79306,-,-
BAC71_L11,18,18q21.31,52423869,52568852,144983,-,-
BAC89_B10,18,18q21.31,52511819,52594611,82792,-,-
BAC193_O19,18,18q21.31,52542153,52618669,76516,-,-
BAC109_D23,18,18q21.31,52618702,52740722,122020,-,-
BAC145_L03,18,18q21.31,52661262,52753203,91941,-,-
BAC41_M22,18,18q21.31,52719127,52910061,190934,-,-
BAC151_L02,18,18q21.31,52732610,52834222,101612,-,-
BAC187_L01,18,18q21.31,52761273,52833147,71874,-,-
BAC238_E14,18,18q21.31,52824295,52910061,85766,-,-
BAC182_L23,18,18q21.31,52832988,52932440,99452,-,-
BAC50_A02,18,18q21.31,52833139,52949451,116312,-,-
BAC233_H11,18,18q21.31,52963546,53051962,88416,-,-
BAC191_E08,18,18q21.31,52964044,53053339,89295,-,-
BAC189_K22,18,18q21.31,53143470,53228123,84653,-,-
BAC33_K12,18,18q21.31,53194571,53301007,106436,-,-
BAC193_E14,18,18q21.31,53239502,53329059,89557,-,-
BAC191_D10,18,18q21.31,53262770,53341713,78943,-,-
BAC244_G11,18,18q21.31,53301391,53395299,93908,-,-
BAC23_E05,18,18q21.31,53355443,53460709,105266,-,-
BAC67_F08,18,18q21.31,53475720,53588297,112577,-,-
BAC220_A02,18,18q21.31,53507803,53589729,81926,-,-
BAC43_K05,18,18q21.31,53541202,53631145,89943,-,-
BAC148_N05,18,18q21.31,53578924,53674093,95169,-,-
BAC155_M02,18,18q21.31,53595240,53718590,123350,-,-
BAC189_C19,18,18q21.31,53606427,53696721,90294,-,-
BAC62_I13,18,18q21.31,53611628,53718568,106940,-,-
BAC29_N13,18,18q21.31,53658396,53770034,111638,-,-
BAC73_F03,18,18q21.31,53658560,53783913,125353,-,-
BAC180_F10,18,18q21.31,53717689,53844831,127142,-,-
BAC123_G18,18,18q21.31,53718636,53818149,99513,-,-
BAC82_A15,18,18q21.31,53718637,53831795,113158,-,-
BAC77_N12,18,18q21.31,53727061,53826927,99866,-,-
BAC57_L03,18,18q21.31,53755541,53844831,89290,-,-
BAC236_O20,18,18q21.31,53807954,53906973,99019,-,-
BAC100_C06,18,18q21.31,53826931,53921422,94491,-,-
BAC125_E12,18,18q21.31,53879993,53969750,89757,-,-
BAC71_E16,18,18q21.31,53893194,54040847,147653,-,-
BAC1_O22,18,18q21.31,53896470,53993199,96729,-,-
BAC104_G22,18,18q21.31,53905812,53993156,87344,-,-
BAC168_D14,18,18q21.31,53979265,54086095,106830,-,-
BAC217_D02,18,18q21.31,54010109,54094166,84057,-,-
BAC39_M21,18,18q21.31,54077783,54173429,95646,-,-
BAC165_M09,18,18q21.31,54135206,54270408,135202,-,-
BAC78_F08,18,18q21.31-18q21.32,54241285,54400327,159042,-,-
BAC173_H13,18,18q21.31-18q21.32,54292083,54403330,111247,-,-
BAC141_I23,18,18q21.32,54544361,54631193,86832,-,-
BAC38_H18,18,18q21.32,54588274,54748436,160162,-,-
BAC57_M08,18,18q21.32,54626006,54736975,110969,-,-
BAC238_K12,18,18q21.32,54665750,54701043,35293,-,-
BAC78_M19,18,18q21.32,54736968,54864621,127653,-,-
BAC140_P05,18,18q21.32,54748429,54828250,79821,-,-
BAC83_D12,18,18q21.32,54772067,54919247,147180,-,-
BAC175_D17,18,18q21.32,54792098,54891194,99096,-,-
BAC227_E14,18,18q21.32,54792098,54890750,98652,-,-
BAC115_O11,18,18q21.32,54795123,54890804,95681,-,-
BAC36_O20,18,18q21.32,54842574,54945498,102924,-,-
BAC44_F04,18,18q21.32,54890845,54985092,94247,-,-
BAC177_J23,18,18q21.32,54891252,54980897,89645,-,-
BAC67_M20,18,18q21.32,54903677,55003938,100261,-,-
BAC161_F21,18,18q21.32,54984602,55068714,84112,-,-
BAC79_E23,18,18q21.32,55071674,55162009,90335,-,-
BAC167_H21,18,18q21.32,55114080,55197367,83287,-,-
BAC192_C19,18,18q21.32,55114374,55194981,80607,-,-
BAC82_D23,18,18q21.32,55125404,55197531,72127,-,-
BAC165_A02,18,18q21.32,55158677,55243290,84613,-,-
BAC192_L07,18,18q21.32,55364353,55473661,109308,-,-
BAC144_F14,18,18q21.32,55403976,55507644,103668,-,-
BAC29_N04,18,18q21.32,55403985,55508413,104428,-,-
BAC171_I22,18,18q21.32,55405054,55522657,117603,-,-
BAC20_K04,18,18q21.32,55406397,55525553,119156,-,-
BAC12_E23,18,18q21.32,55524288,55644660,120372,-,-
BAC230_M23,18,18q21.32,55525587,55620364,94777,-,-
BAC121_G13,18,18q21.32,55547373,55693322,145949,-,-
BAC76_G22,18,18q21.32,55586451,55666867,80416,-,-
BAC250_P23,18,18q21.32,55598969,55732093,133124,-,-
BAC20_G17,18,18q21.32,55650366,55743727,93361,-,-
BAC231_L05,18,18q21.32,55691997,55777471,85474,-,-
BAC189_N17,18,18q21.32,55809612,55884096,74484,-,-
BAC157_P15,18,18q21.32,55914300,55985373,71073,-,-
BAC56_P16,18,18q21.32,55941668,56030085,88417,-,-
BAC158_E06,18,18q21.32,56011119,56114026,102907,-,-
BAC175_F18,18,18q21.32,56104657,56195307,90650,-,-
BAC169_H11,18,18q21.32,56143396,56223972,80576,-,-
BAC33_I14,18,18q21.32,56143399,56283311,139912,-,-
BAC66_H19,18,18q21.32,56261904,56357522,95618,-,-
BAC28_J17,18,18q21.32,56460280,56564493,104213,-,-
BAC40_A08,18,18q21.32,56460291,56563319,103028,-,-
BAC167_A07,18,18q21.32,56564495,56672711,108216,-,-
BAC200_L20,18,18q21.32,56564495,56637953,73458,-,-
BAC92_O22,18,18q21.32,56775732,56861836,86104,-,-
BAC179_J08,18,18q21.32,56867915,56977353,109438,-,-
BAC86_M10,18,18q21.32,56976882,57059386,82504,-,-
BAC46_E18,18,18q21.32-18q21.33,57067755,57154665,86910,-,-
BAC81_D12,18,18q21.32-18q21.33,57072565,57164832,92267,-,-
BAC193_L04,18,18q21.32-18q21.33,57072858,57177595,104737,-,-
BAC155_P18,18,18q21.33,57265901,57352994,87093,-,-
BAC250_N05,18,18q21.33,57327233,57426980,99747,-,-
BAC71_G14,18,18q21.33,57426973,57559501,132528,-,-
BAC58_K20,18,18q21.33,57591419,57674337,82918,-,-
BAC217_C08,18,18q21.33,57635473,57724916,89443,-,-
BAC233_M24,18,18q21.33,57688077,57776931,88854,-,-
BAC96_M09,18,18q21.33,57725210,57828818,103608,-,-
BAC124_J02,18,18q21.33,57742892,57843686,100794,-,-
BAC46_L09,18,18q21.33,57821911,57929883,107972,-,-
BAC147_I03,18,18q21.33,57869375,57961719,92344,-,-
BAC167_E01,18,18q21.33,57988923,58073519,84596,-,-
BAC120_A17,18,18q21.33,58020545,58123577,103032,-,-
BAC222_B03,18,18q21.33,58075119,58147802,72683,-,-
BAC148_B19,18,18q21.33,58147805,58240108,92303,-,-
BAC34_F15,18,18q21.33,58147834,58304693,156859,-,-
BAC92_A10,18,18q21.33,58164009,58296441,132432,-,-
BAC63_F23,18,18q21.33,58228397,58314731,86334,-,-
BAC103_O09,18,18q21.33,58232699,58304693,71994,-,-
BAC23_D11,18,18q21.33,58276699,58439102,162403,-,-
BAC78_G21,18,18q21.33,58296450,58394808,98358,-,-
BAC136_E06,18,18q21.33,58377174,58460888,83714,-,-
BAC86_D14,18,18q21.33,58394801,58503409,108608,-,-
BAC201_K03,18,18q21.33,58395074,58481785,86711,-,-
BAC246_L08,18,18q21.33,58402417,58549637,147220,-,-
BAC17_I03,18,18q21.33,58430894,58549656,118762,-,-
BAC187_I22,18,18q21.33,58445117,58549651,104534,-,-
BAC124_F02,18,18q21.33,58550206,58694617,144411,-,-
BAC62_F18,18,18q21.33,58583827,58670085,86258,-,-
BAC186_F06,18,18q21.33,58636420,58721260,84840,-,-
BAC38_I10,18,18q21.33,58664013,58781651,117638,-,-
BAC52_E04,18,18q21.33,58683212,58832133,148921,-,-
BAC54_B24,18,18q21.33,58703555,58832831,129276,-,-
BAC228_N02,18,18q21.33,58930844,59015584,84740,-,-
BAC157_F14,18,18q21.33,59015578,59087045,71467,-,-
BAC51_A05,18,18q21.33,59025184,59144495,119311,-,-
BAC190_E09,18,18q21.33,59048477,59145358,96881,-,-
BAC230_C11,18,18q21.33,59076118,59172880,96762,-,-
BAC37_M18,18,18q21.33,59076118,59207873,131755,-,-
BAC135_L02,18,18q21.33,59158835,59289037,130202,-,-
BAC2_O20,18,18q21.33,59213788,59327091,113303,-,-
BAC244_L15,18,18q21.33,59226186,59329074,102888,-,-
BAC79_D07,18,18q21.33,59233699,59327614,93915,-,-
BAC198_J16,18,18q21.33,59237655,59325739,88084,-,-
BAC153_F21,18,18q21.33,59349463,59401434,51971,-,-
BAC63_E12,18,18q21.33,59411320,59498883,87563,-,-
BAC160_L15,18,18q21.33,59457318,59541602,84284,-,-
BAC20_B11,18,18q21.33,59541594,59680559,138965,-,-
BAC86_F02,18,18q21.33,59549206,59618273,69067,-,-
BAC161_M09,18,18q21.33,59608386,59739218,130832,-,-
BAC39_C18,18,18q21.33-18q22.1,59719104,59830148,111044,-,-
BAC140_E14,18,18q21.33-18q22.1,59719667,59822868,103201,-,-
BAC219_N11,18,18q21.33-18q22.1,59749545,59851950,102405,-,-
BAC19_I07,18,18q21.33-18q22.1,59788943,59864006,75063,-,-
BAC152_J24,18,18q22.1,59814468,59914083,99615,-,-
BAC61_O04,18,18q22.1,59851944,59998357,146413,-,-
BAC45_P05,18,18q22.1,59852020,59998393,146373,-,-
BAC102_F06,18,18q22.1,59946680,60027533,80853,-,-
BAC92_A18,18,18q22.1,60080040,60188262,108222,-,-
BAC131_D09,18,18q22.1,60080040,60221723,141683,-,-
BAC51_E07,18,18q22.1,60128428,60231511,103083,-,-
BAC61_C04,18,18q22.1,60466811,60547637,80826,-,-
BAC141_L02,18,18q22.1,60510873,60588270,77397,-,-
BAC223_F23,18,18q22.1,60517000,60616153,99153,-,-
BAC187_N07,18,18q22.1,60547657,60651106,103449,-,-
BAC188_P19,18,18q22.1,60727549,60804491,76942,-,-
BAC244_F12,18,18q22.1,60729346,60804476,75130,-,-
BAC101_J10,18,18q22.1,60950123,61038333,88210,-,-
BAC69_C14,18,18q22.1,61014422,61106827,92405,-,-
BAC154_B11,18,18q22.1,61056058,61141501,85443,-,-
BAC25_G15,18,18q22.1,61060902,61181737,120835,-,-
BAC38_G14,18,18q22.1,61084054,61188773,104719,-,-
BAC64_F19,18,18q22.1,61362516,61501758,139242,-,-
BAC73_H08,18,18q22.1,61492940,61630758,137818,-,-
BAC69_L02,18,18q22.1,61513959,61635575,121616,-,-
BAC246_I05,18,18q22.1,61513973,61602976,89003,-,-
BAC217_O17,18,18q22.1,61521029,61604356,83327,-,-
BAC150_A10,18,18q22.1,61606678,61692876,86198,-,-
BAC141_P08,18,18q22.1,61622539,61704450,81911,-,-
BAC230_I15,18,18q22.1,61756829,61850444,93615,-,-
BAC88_A13,18,18q22.1,61934648,62027826,93178,-,-
BAC233_G15,18,18q22.1,62240084,62344531,104447,-,-
BAC146_K12,18,18q22.1,62253659,62347546,93887,-,-
BAC43_J22,18,18q22.1,62461153,62567365,106212,-,-
BAC126_P13,18,18q22.1,62505945,62594254,88309,-,-
BAC126_H09,18,18q22.1,62506007,62594254,88247,-,-
BAC169_E18,18,18q22.1,62536967,62631695,94728,-,-
BAC64_H11,18,18q22.1,62578062,62662315,84253,-,-
BAC95_N02,18,18q22.1,62664759,62781956,117197,-,-
BAC156_B16,18,18q22.1,62671390,62781892,110502,-,-
BAC43_G24,18,18q22.1,62693701,62790328,96627,-,-
BAC63_G01,18,18q22.1,62824706,62904609,79903,-,-
BAC39_K15,18,18q22.1,62920569,63040364,119795,-,-
BAC139_B14,18,18q22.1,63119993,63196371,76378,-,-
BAC26_K01,18,18q22.1,63446646,63571509,124863,-,-
BAC170_I17,18,18q22.1,63450800,63518888,68088,-,-
BAC195_H09,18,18q22.1,63531460,63626895,95435,-,-
BAC188_E10,18,18q22.1,63579828,63657677,77849,-,-
BAC56_N10,18,18q22.1,63657671,63749564,91893,-,-
BAC185_M15,18,18q22.1,63981260,64068426,87166,-,-
BAC46_H18,18,18q22.1,64057077,64145702,88625,-,-
BAC148_O08,18,18q22.1,64260187,64357659,97472,-,-
BAC96_D20,18,18q22.1,64377776,64493376,115600,-,-
BAC142_J10,18,18q22.1,64396336,64503000,106664,-,-
BAC237_F15,18,18q22.1,64539762,64623711,83949,-,-
BAC116_H13,18,18q22.1,64721954,64824025,102071,-,-
BAC143_K19,18,18q22.1-18q22.2,64882738,64971460,88722,-,-
BAC226_H22,18,18q22.1-18q22.2,64882742,64969810,87068,-,-
BAC140_M19,18,18q22.2,65008316,65027619,19303,-,-
BAC184_E21,18,18q22.2,65117990,65211158,93168,-,-
BAC123_M14,18,18q22.2,65160437,65248306,87869,-,-
BAC43_I02,18,18q22.2,65176834,65282523,105689,-,-
BAC69_G23,18,18q22.2,65203499,65305926,102427,-,-
BAC7_P17,18,18q22.2,65498190,65575986,77796,-,-
BAC105_A07,18,18q22.2,65701850,65816972,115122,-,-
BAC234_L20,18,18q22.2,65735167,65816972,81805,-,-
BAC249_O17,18,18q22.2,65773327,65872040,98713,-,-
BAC175_P05,18,18q22.2,65907247,66003831,96584,-,-
BAC219_K16,18,18q22.2,65911887,66012500,100613,-,-
BAC211_K16,18,18q22.2,65919261,66003178,83917,-,-
BAC175_B05,18,18q22.2,66003173,66118856,115683,-,-
BAC55_J15,18,18q22.2,66018852,66171572,152720,-,-
BAC119_I20,18,18q22.2,66027993,66125288,97295,-,-
BAC44_O02,18,18q22.2,66052167,66251494,199327,-,-
BAC27_G02,18,18q22.2,66083253,66172290,89037,-,-
BAC72_A17,18,18q22.2,66165452,66251256,85804,-,-
BAC179_M06,18,18q22.2,66286936,66381184,94248,-,-
BAC229_C12,18,18q22.2,66286957,66381184,94227,-,-
BAC163_P02,18,18q22.2,66401347,66477639,76292,-,-
BAC236_B11,18,18q22.2,66449568,66517999,68431,-,-
BAC61_H03,18,18q22.2,66606267,66718845,112578,-,-
BAC58_E20,18,18q22.2,66656427,66770357,113930,-,-
BAC160_C22,18,18q22.2,66723126,66802958,79832,-,-
BAC39_O12,18,18q22.2,66742959,66847714,104755,-,-
BAC67_C17,18,18q22.3,66951254,67069556,118302,-,-
BAC43_A24,18,18q22.3,66979772,67088762,108990,-,-
BAC5_L08,18,18q22.3,67003235,67117757,114522,-,-
BAC195_E17,18,18q22.3,67154790,67272422,117632,-,-
BAC134_G22,18,18q22.3,67165747,67263702,97955,-,-
BAC196_P15,18,18q22.3,67166172,67248919,82747,-,-
BAC41_I20,18,18q22.3,67433236,67524115,90879,-,-
BAC50_P14,18,18q22.3,67442326,67562848,120522,-,-
BAC113_N03,18,18q22.3,67524758,67626627,101869,-,-
BAC151_F02,18,18q22.3,67564215,67644354,80139,-,-
BAC182_I20,18,18q22.3,67668902,67689856,20954,-,-
BAC27_C04,18,18q22.3,67815708,67905018,89310,-,-
BAC141_F04,18,18q22.3,67838832,67932967,94135,-,-
BAC221_O21,18,18q22.3,67999357,68104280,104923,-,-
BAC171_M17,18,18q22.3,68204618,68280908,76290,-,-
BAC231_L01,18,18q22.3,68238082,68324893,86811,-,-
BAC137_B09,18,18q22.3,68320743,68416119,95376,-,-
BAC204_F04,18,18q22.3,68418165,68507495,89330,-,-
BAC39_P22,18,18q22.3,68421712,68520722,99010,-,-
BAC242_C10,18,18q22.3,68431778,68520722,88944,-,-
BAC119_I10,18,18q22.3,68437455,68527731,90276,-,-
BAC196_B11,18,18q22.3,68507948,68591444,83496,-,-
BAC236_M16,18,18q22.3,68521230,68625618,104388,-,-
BAC25_G18,18,18q22.3,68536083,68642058,105975,-,-
BAC238_P04,18,18q22.3,68593519,68655817,62298,-,-
BAC89_L06,18,18q22.3,68871340,68985805,114465,-,-
BAC7_K10,18,18q22.3,68924373,69005451,81078,-,-
BAC244_A12,18,18q22.3,69058111,69180924,122813,-,-
BAC147_M19,18,18q22.3,69061773,69157501,95728,-,-
BAC55_K24,18,18q22.3,69111301,69223304,112003,-,-
BAC240_G20,18,18q22.3,69296809,69376048,79239,-,-
BAC129_F17,18,18q22.3,69311942,69390813,78871,-,-
BAC96_K11,18,18q22.3,69362586,69463085,100499,-,-
BAC96_J09,18,18q22.3,69390822,69537413,146591,-,-
BAC248_O04,18,18q22.3,69503238,69581729,78491,-,-
BAC210_J01,18,18q22.3,69539797,69613257,73460,-,-
BAC242_C01,18,18q22.3,69585080,69700110,115030,-,-
BAC158_F08,18,18q22.3,69621436,69704993,83557,-,-
BAC62_I01,18,18q22.3,69847598,69957819,110221,-,-
BAC235_N01,18,18q22.3,69849501,69956038,106537,-,-
BAC52_F03,18,18q22.3,69881724,69982983,101259,-,-
BAC97_B02,18,18q22.3,70061132,70166576,105444,-,-
BAC186_E08,18,18q22.3,70092971,70219841,126870,-,-
BAC59_P02,18,18q22.3,70193904,70296980,103076,-,-
BAC20_L11,18,18q22.3,70269089,70400880,131791,-,-
BAC57_N01,18,18q22.3,70279234,70336675,57441,-,-
BAC179_H20,18,18q22.3,70286422,70385919,99497,-,-
BAC36_D19,18,18q22.3,70286422,70385914,99492,-,-
BAC109_A05,18,18q22.3,70297080,70398925,101845,-,-
BAC108_J06,18,18q22.3,70474173,70626723,152550,-,-
BAC80_J02,18,18q22.3,70639244,70719125,79881,-,-
BAC160_G15,18,18q22.3,70665944,70755056,89112,-,-
BAC91_O07,18,18q22.3,70676612,70759522,82910,-,-
BAC226_E17,18,18q22.3,70755099,70864989,109890,-,-
BAC18_H05,18,18q22.3,70789925,70891394,101469,-,-
BAC44_D15,18,18q22.3,70789985,70903931,113946,-,-
BAC62_D17,18,18q22.3,70790000,70894464,104464,-,-
BAC43_E05,18,18q22.3,70829622,70981558,151936,-,-
BAC144_A02,18,18q22.3,70945894,71039170,93276,-,-
BAC41_P03,18,18q22.3,70946012,71084907,138895,-,-
BAC157_F11,18,18q22.3,70946259,71030765,84506,-,-
BAC38_O20,18,18q22.3,71028345,71105427,77082,-,-
BAC210_B16,18,18q22.3,71030758,71092176,61418,-,-
BAC96_H23,18,18q22.3,71031091,71148514,117423,-,-
BAC52_A13,18,18q22.3,71039175,71138561,99386,-,-
BAC239_J11,18,18q22.3,71039477,71136927,97450,-,-
BAC242_G10,18,18q22.3,71076950,71182416,105466,-,-
BAC72_L03,18,18q22.3,71077058,71200301,123243,-,-
BAC25_D04,18,18q22.3,71105677,71195820,90143,-,-
BAC238_I22,18,18q22.3-18q23,71200378,71301004,100626,-,-
BAC103_D21,18,18q23,71344509,71422737,78228,-,-
BAC198_L13,18,18q23,71350844,71472168,121324,-,-
BAC90_O01,18,18q23,71365200,71453160,87960,-,-
BAC148_H23,18,18q23,71365202,71522546,157344,-,-
BAC221_D20,18,18q23,71394982,71507273,112291,-,-
BAC204_B02,18,18q23,71410613,71422739,12126,-,-
BAC84_G17,18,18q23,71422736,71494961,72225,-,-
BAC223_B11,18,18q23,71430198,71507285,77087,-,-
BAC193_O08,18,18q23,71433553,71512579,79026,-,-
BAC104_F20,18,18q23,71453157,71561240,108083,-,-
BAC185_I16,18,18q23,71455561,71544579,89018,-,-
BAC51_E18,18,18q23,71507280,71609397,102117,-,-
BAC37_C23,18,18q23,71512579,71594186,81607,-,-
BAC69_J23,18,18q23,71599885,71705152,105267,-,-
BAC181_F15,18,18q23,71599928,71710497,110569,-,-
BAC197_P19,18,18q23,71721154,71838729,117575,-,-
BAC80_N21,18,18q23,71829168,71954587,125419,-,-
BAC12_M11,18,18q23,71838349,71931068,92719,-,-
BAC125_N04,18,18q23,71860558,71944181,83623,-,-
BAC30_N14,18,18q23,71870332,72036897,166565,-,-
BAC178_A11,18,18q23,72053126,72131952,78826,-,-
BAC52_M05,18,18q23,72053126,72137845,84719,-,-
BAC73_G19,18,18q23,72085710,72207075,121365,-,-
BAC52_O06,18,18q23,72145463,72241571,96108,-,-
BAC41_H14,18,18q23,72145468,72268944,123476,-,-
BAC184_J04,18,18q23,72199921,72294263,94342,-,-
BAC128_L09,18,18q23,72205924,72287603,81679,-,-
BAC160_C15,18,18q23,72207081,72328203,121122,-,-
BAC75_H21,18,18q23,72207097,72292723,85626,-,-
BAC146_L03,18,18q23,72298894,72391764,92870,-,-
BAC244_O14,18,18q23,72298895,72391764,92869,-,-
BAC233_B15,18,18q23,72342763,72432296,89533,-,-
BAC60_O21,18,18q23,72373647,72468133,94486,-,-
BAC68_J07,18,18q23,72380130,72521508,141378,-,-
BAC155_D24,18,18q23,72413492,72533029,119537,-,-
BAC226_D14,18,18q23,72440350,72539355,99005,-,-
BAC25_L23,18,18q23,72462919,72571948,109029,-,-
BAC153_G05,18,18q23,72465233,72537402,72169,-,-
BAC70_J19,18,18q23,72468453,72556912,88459,-,-
BAC200_E11,18,18q23,72520774,72607649,86875,-,-
BAC82_H06,18,18q23,72595301,72722144,126843,-,-
BAC97_O10,18,18q23,72603584,72722410,118826,-,-
BAC160_J01,18,18q23,72635928,72758337,122409,-,-
BAC206_P02,18,18q23,72635982,72733856,97874,-,-
BAC233_M16,18,18q23,72678401,72751706,73305,-,-
BAC170_P03,18,18q23,72690220,72782634,92414,-,-
BAC92_P18,18,18q23,72758332,72856209,97877,-,-
BAC143_M10,18,18q23,72818847,72911614,92767,-,-
BAC26_E17,18,18q23,72818860,72902712,83852,-,-
BAC165_K03,18,18q23,72845230,72925195,79965,-,-
BAC21_K02,18,18q23,72865091,72954877,89786,-,-
BAC21_J06,18,18q23,72879577,72987855,108278,-,-
BAC109_C09,18,18q23,72879693,72996567,116874,-,-
BAC65_M07,18,18q23,72880182,72996567,116385,-,-
BAC31_L04,18,18q23,72888654,73002257,113603,-,-
BAC130_P13,18,18q23,72912350,73018416,106066,-,-
BAC199_H19,18,18q23,72925189,73044059,118870,-,-
BAC176_M01,18,18q23,72925417,73013583,88166,-,-
BAC60_I14,18,18q23,72979774,73104266,124492,-,-
BAC231_K11,18,18q23,73013629,73101121,87492,-,-
BAC163_G18,18,18q23,73038984,73145406,106422,-,-
BAC121_F13,18,18q23,73038984,73176626,137642,-,-
BAC106_J23,18,18q23,73061345,73216825,155480,-,-
BAC149_F18,18,18q23,73221286,73334646,113360,-,-
BAC125_G04,18,18q23,73429445,73535280,105835,-,-
BAC149_C11,18,18q23,73432910,73535823,102913,-,-
BAC81_K21,18,18q23,73443705,73559911,116206,-,-
BAC148_G16,18,18q23,73479528,73559911,80383,-,-
BAC221_F23,18,18q23,73535274,73630579,95305,-,-
BAC49_I08,18,18q23,73537322,73619326,82004,-,-
BAC195_F01,18,18q23,73580009,73690331,110322,-,-
BAC171_O03,18,18q23,73613840,73701641,87801,-,-
BAC231_N05,18,18q23,73658425,73754845,96420,-,-
BAC63_N18,18,18q23,73669041,73760234,91193,-,-
BAC195_O20,18,18q23,73969536,74058197,88661,-,-
BAC239_C10,18,18q23,73979291,74077140,97849,-,-
BAC226_G11,18,18q23,73982003,74079852,97849,-,-
BAC141_K23,18,18q23,74151041,74238124,87083,-,-
BAC42_P22,18,18q23,74159192,74269733,110541,-,-
BAC64_P04,18,18q23,74160729,74264288,103559,-,-
BAC35_H12,18,18q23,74161687,74280183,118496,-,-
BAC25_N07,18,18q23,74168445,74286086,117641,-,-
BAC24_A14,18,18q23,74178786,74312654,133868,-,-
BAC32_J22,18,18q23,74178867,74264288,85421,-,-
BAC21_B01,18,18q23,74240705,74320911,80206,-,-
BAC225_L16,18,18q23,74269764,74366399,96635,-,-
BAC106_C01,18,18q23,74293969,74380322,86353,-,-
BAC69_E14,18,18q23,74319739,74423448,103709,-,-
BAC59_B01,18,18q23,74320974,74512794,191820,-,-
BAC53_F07,18,18q23,74321251,74407330,86079,-,-
BAC2_I10,18,18q23,74380314,74407330,27016,-,-
BAC88_C05,18,18q23,74403516,74553070,149554,-,-
BAC36_D05,18,18q23,74423458,74527380,103922,-,-
BAC65_D04,18,18q23,74436626,74550622,113996,-,-
BAC56_D22,18,18q23,74443922,74476059,32137,-,-
BAC42_C21,18,18q23,74443940,74527343,83403,-,-
BAC186_B12,18,18q23,74446185,74543550,97365,-,-
BAC27_I13,18,18q23,74455499,74576928,121429,-,-
BAC189_J23,18,18q23,74554391,74656861,102470,-,-
BAC46_G08,18,18q23,74575331,74718822,143491,-,-
BAC171_L19,18,18q23,74623600,74719892,96292,-,-
BAC238_D04,18,18q23,74669575,74801792,132217,-,-
BAC149_I10,18,18q23,74719958,74804883,84925,-,-
BAC187_I04,18,18q23,74721100,74800159,79059,-,-
BAC129_D11,18,18q23,74721100,74828078,106978,-,-
BAC246_G10,18,18q23,74944278,75027243,82965,-,-
BAC42_H19,18,18q23,74969264,75055917,86653,-,-
BAC144_C07,18,18q23,74981610,75068948,87338,-,-
BAC66_H11,18,18q23,74984350,75114050,129700,-,-
BAC107_K13,18,18q23,74988667,75110826,122159,-,-
BAC78_H13,18,18q23,75001073,75101000,99927,-,-
BAC113_H14,18,18q23,75064249,75173370,109121,-,-
BAC97_P10,18,18q23,75069246,75166325,97079,-,-
BAC210_L22,18,18q23,75088182,75183510,95328,-,-
BAC99_M01,18,18q23,75095848,75221952,126104,-,-
BAC60_L11,18,18q23,75110856,75222028,111172,-,-
BAC68_J20,18,18q23,75138616,75238137,99521,-,-
BAC38_B23,18,18q23,75166320,75276278,109958,-,-
BAC150_B12,18,18q23,75297452,75399283,101831,-,-
BAC248_B03,18,18q23,75297452,75415753,118301,-,-
BAC244_J13,18,18q23,75349325,75445847,96522,-,-
BAC146_D09,18,18q23,75446198,75520504,74306,-,-
BAC118_J02,18,18q23,75474581,75579056,104475,-,-
BAC197_M21,18,18q23,75511317,75607690,96373,-,-
BAC127_D19,18,18q23,75521079,75621190,100111,-,-
BAC16_C10,18,18q23,75559915,75675514,115599,-,-
BAC74_F14,18,18q23,75667724,75687395,19671,-,-
BAC166_K12,18,18q23,75687390,75767952,80562,yes,-
BAC184_C18,18,18q23,75740827,75823022,82195,-,-
BAC95_N19,18,18q23,75852602,75915200,62598,-,-
BAC140_L10,18,18q23,75928638,76039597,110959,-,-
BAC117_A20,18,18q23,75956548,76069267,112719,-,-
BAC149_A20,18,18q23,76026296,76110688,84392,-,-
BAC125_O16,19,19p13.3,228476,353134,124658,-,-
BAC96_L08,19,19p13.3,241168,321991,80823,-,-
BAC163_E08,19,19p13.3,292986,371046,78060,-,-
BAC103_N07,19,19p13.3,502421,609531,107110,-,-
BAC206_D20,19,19p13.3,549268,662576,113308,-,-
BAC183_D24,19,19p13.3,579590,662543,82953,-,-
BAC141_C19,19,19p13.3,662603,815730,153127,-,-
BAC31_J20,19,19p13.3,858930,1016916,157986,yes,-
BAC238_F09,19,19p13.3,889250,973677,84427,yes,-
BAC162_C17,19,19p13.3,889250,1027049,137799,yes,-
BAC220_K10,19,19p13.3,1092489,1217188,124699,yes,-
BAC131_H06,19,19p13.3,1274540,1361184,86644,yes,-
BAC171_A02,19,19p13.3,1275739,1392935,117196,yes,-
BAC125_C05,19,19p13.3,1393093,1493875,100782,-,-
BAC125_K18,19,19p13.3,1490395,1601832,111437,yes,-
BAC59_C15,19,19p13.3,1514743,1601848,87105,yes,-
BAC191_A15,19,19p13.3,1626304,1701419,75115,-,-
BAC189_E13,19,19p13.3,1682732,1758559,75827,-,-
BAC236_P13,19,19p13.3,1693400,1758559,65159,-,-
BAC94_K18,19,19p13.3,1794124,1887334,93210,yes,-
BAC148_D24,19,19p13.3,1794244,1887428,93184,yes,-
BAC178_I12,19,19p13.3,1794246,1888558,94312,yes,-
BAC198_M11,19,19p13.3,1847562,1948803,101241,yes,-
BAC151_A13,19,19p13.3,1907799,2003177,95378,-,-
BAC118_O13,19,19p13.3,2003175,2138053,134878,-,-
BAC177_P10,19,19p13.3,2077205,2162207,85002,-,-
BAC173_A15,19,19p13.3,2174761,2276882,102121,-,-
BAC159_P11,19,19p13.3,2200762,2280597,79835,-,-
BAC188_C21,19,19p13.3,2200773,2316327,115554,-,-
BAC215_C20,19,19p13.3,2316352,2435376,119024,-,-
BAC141_D02,19,19p13.3,2435587,2539219,103632,-,-
BAC32_A11,19,19p13.3,2515161,2595800,80639,-,-
BAC211_G16,19,19p13.3,2516064,2607324,91260,-,-
BAC92_A01,19,19p13.3,2539213,2613641,74428,-,-
BAC71_D14,19,19p13.3,2557057,2657348,100291,-,-
BAC154_N03,19,19p13.3,2557057,2661533,104476,-,-
BAC66_F07,19,19p13.3,2557058,2651463,94405,-,-
BAC62_K10,19,19p13.3,2647483,2784646,137163,-,-
BAC189_N07,19,19p13.3,2661650,2743223,81573,-,-
BAC60_O19,19,19p13.3,2681930,2784770,102840,-,-
BAC155_H18,19,19p13.3,2686926,2784770,97844,-,-
BAC247_A08,19,19p13.3,2689482,2784770,95288,-,-
BAC101_L04,19,19p13.3,2689484,2857653,168169,-,-
BAC168_K24,19,19p13.3,2707468,2830967,123499,-,-
BAC157_A05,19,19p13.3,2784805,2901248,116443,-,-
BAC104_F05,19,19p13.3,2976103,3075879,99776,-,-
BAC90_P22,19,19p13.3,3024524,3128268,103744,-,-
BAC228_F05,19,19p13.3,3031512,3106598,75086,-,-
BAC75_B14,19,19p13.3,3128262,3239497,111235,-,-
BAC166_N04,19,19p13.3,3194245,3272706,78461,-,-
BAC12_I12,19,19p13.3,3224836,3316293,91457,-,-
BAC170_C14,19,19p13.3,3272719,3354221,81502,-,-
BAC168_L10,19,19p13.3,3316333,3415863,99530,-,-
BAC33_L13,19,19p13.3,3363036,3515425,152389,-,-
BAC160_K24,19,19p13.3,3604123,3672419,68296,-,-
BAC38_D20,19,19p13.3,3706826,3801423,94597,-,-
BAC152_G06,19,19p13.3,3744273,3840410,96137,-,-
BAC171_O19,19,19p13.3,3747984,3826644,78660,-,-
BAC162_O12,19,19p13.3,3756120,3840410,84290,-,-
BAC128_H05,19,19p13.3,3784587,3876547,91960,-,-
BAC180_F03,19,19p13.3,3801427,3901594,100167,-,-
BAC11_E02,19,19p13.3,3826683,3929191,102508,-,-
BAC70_H18,19,19p13.3,3844972,3975036,130064,yes,-
BAC208_A09,19,19p13.3,3848596,3948099,99503,yes,-
BAC240_F17,19,19p13.3,3996623,4085819,89196,-,-
BAC43_B02,19,19p13.3,4020793,4137620,116827,-,-
BAC198_H21,19,19p13.3,4035575,4172366,136791,-,-
BAC141_N15,19,19p13.3,4072256,4167595,95339,-,-
BAC214_H11,19,19p13.3,4072317,4153888,81571,-,-
BAC43_H22,19,19p13.3,4102748,4275960,173212,-,-
BAC37_C21,19,19p13.3,4138722,4318982,180260,-,-
BAC244_J01,19,19p13.3,4200523,4298721,98198,-,-
BAC149_B16,19,19p13.3,4234654,4310233,75579,-,-
BAC92_M15,19,19p13.3,4329048,4431245,102197,-,-
BAC214_H19,19,19p13.3,4329307,4418985,89678,-,-
BAC154_H08,19,19p13.3,4364779,4460926,96147,-,-
BAC158_B19,19,19p13.3,4478164,4600391,122227,-,-
BAC135_D23,19,19p13.3,4478218,4599070,120852,-,-
BAC231_E11,19,19p13.3,4478218,4599145,120927,-,-
BAC205_J15,19,19p13.3,4554678,4639957,85279,-,-
BAC142_M11,19,19p13.3,4554702,4641493,86791,-,-
BAC198_M16,19,19p13.3,4555899,4640201,84302,-,-
BAC217_P13,19,19p13.3,4599150,4676029,76879,-,-
BAC243_J05,19,19p13.3,4626801,4699558,72757,-,-
BAC142_J03,19,19p13.3,4640194,4764534,124340,-,-
BAC161_I12,19,19p13.3,4641841,4713843,72002,-,-
BAC34_G24,19,19p13.3,4713841,4807570,93729,-,-
BAC175_B22,19,19p13.3,4718452,4812598,94146,-,-
BAC199_B22,19,19p13.3,4773713,4873672,99959,-,-
BAC163_J14,19,19p13.3,4847987,4938399,90412,-,-
BAC45_N06,19,19p13.3,4966995,5057772,90777,-,-
BAC218_J10,19,19p13.3,4997226,5090904,93678,-,-
BAC58_D17,19,19p13.3,5090899,5186655,95756,-,-
BAC42_K24,19,19p13.3,5092787,5197827,105040,-,-
BAC232_D03,19,19p13.3,5133998,5208246,74248,-,-
BAC141_G23,19,19p13.3,5201423,5316042,114619,-,-
BAC67_J11,19,19p13.3,5206150,5322959,116809,-,-
BAC151_G13,19,19p13.3,5209157,5324154,114997,-,-
BAC90_A09,19,19p13.3,5288774,5406297,117523,-,-
BAC189_N14,19,19p13.3,5295434,5404009,108575,-,-
BAC196_O16,19,19p13.3,5319864,5431374,111510,-,-
BAC206_C15,19,19p13.3,5320098,5435178,115080,-,-
BAC236_C05,19,19p13.3,5324205,5454678,130473,-,-
BAC235_M19,19,19p13.3,5350028,5438582,88554,-,-
BAC171_J13,19,19p13.3,5350320,5438582,88262,-,-
BAC101_D22,19,19p13.3,5404051,5500779,96728,-,-
BAC237_I23,19,19p13.3,5414099,5500725,86626,-,-
BAC175_B14,19,19p13.3,5551646,5668224,116578,-,-
BAC233_A04,19,19p13.3,5575808,5668224,92416,-,-
BAC65_F21,19,19p13.3,5623130,5726326,103196,-,-
BAC131_P08,19,19p13.3,5623130,5726326,103196,-,-
BAC50_C02,19,19p13.3,5623135,5754299,131164,-,-
BAC140_G05,19,19p13.3,5668219,5777145,108926,-,-
BAC57_D10,19,19p13.3,5668219,5790590,122371,-,-
BAC88_C14,19,19p13.3,5907585,6068652,161067,-,-
BAC51_G04,19,19p13.3,5995089,6089391,94302,-,-
BAC35_E10,19,19p13.3,6041861,6188355,146494,-,-
BAC176_E18,19,19p13.3,6077573,6235923,158350,-,-
BAC208_K19,19,19p13.3,6077646,6189596,111950,-,-
BAC107_M17,19,19p13.3,6087285,6241861,154576,-,-
BAC155_P24,19,19p13.3,6134191,6241861,107670,-,-
BAC200_C05,19,19p13.3,6240131,6324604,84473,-,-
BAC28_D11,19,19p13.3,6296318,6450741,154423,-,-
BAC97_C15,19,19p13.3,6339590,6450804,111214,-,-
BAC33_O14,19,19p13.3,6342700,6443279,100579,-,-
BAC1_B24,19,19p13.3,6443307,6520091,76784,-,-
BAC90_A14,19,19p13.3,6473995,6594140,120145,-,-
BAC230_J16,19,19p13.3,6500789,6574735,73946,-,-
BAC172_G04,19,19p13.3,6673463,6783404,109941,-,-
BAC14_G16,19,19p13.3,6694651,6783404,88753,-,-
BAC116_B05,19,19p13.3,6694682,6807307,112625,-,-
BAC31_O01,19,19p13.3,6724201,6870852,146651,-,-
BAC176_F20,19,19p13.3,6759394,6833139,73745,-,-
BAC63_K23,19,19p13.3,6759448,6870867,111419,-,-
BAC240_B10,19,19p13.3,6791709,6892565,100856,-,-
BAC90_F12,19,19p13.2,6931604,6977804,46200,-,-
BAC183_C09,19,19p13.2,7098205,7193164,94959,-,-
BAC169_A13,19,19p13.2,7100480,7193164,92684,-,-
BAC30_P19,19,19p13.2,7131214,7232924,101710,-,-
BAC165_I18,19,19p13.2,7331743,7435392,103649,-,-
BAC247_B08,19,19p13.2,7467815,7558307,90492,-,-
BAC178_L22,19,19p13.2,7576484,7669091,92607,-,-
BAC178_E04,19,19p13.2,7602905,7694843,91938,-,-
BAC247_P10,19,19p13.2,7723387,7822361,98974,-,-
BAC20_L21,19,19p13.2,7784565,7912722,128157,-,-
BAC165_E22,19,19p13.2,7868074,7931857,63783,-,-
BAC248_C01,19,19p13.2,7949095,8031328,82233,-,-
BAC187_E14,19,19p13.2,7949095,8058306,109211,-,-
BAC234_M09,19,19p13.2,7949095,8077145,128050,-,-
BAC165_L20,19,19p13.2,7975201,8058307,83106,-,-
BAC58_H13,19,19p13.2,8002234,8183272,181038,-,-
BAC39_N05,19,19p13.2,8065011,8182235,117224,-,-
BAC119_K04,19,19p13.2,8065057,8162370,97313,-,-
BAC186_D15,19,19p13.2,8174582,8294134,119552,yes,-
BAC50_G16,19,19p13.2,8174640,8293402,118762,yes,-
BAC155_B09,19,19p13.2,8183267,8294116,110849,yes,-
BAC106_O18,19,19p13.2,8436821,8518753,81932,-,-
BAC110_F17,19,19p13.2,8452873,8565415,112542,-,-
BAC122_A23,19,19p13.2,8610088,8724547,114459,yes,-
BAC108_A08,19,19p13.2,8610121,8717162,107041,yes,-
BAC215_A06,19,19p13.2,8625942,8716841,90899,-,-
BAC140_G17,19,19p13.2,8636893,8717169,80276,yes,-
BAC61_N07,19,19p13.2,8657217,8751161,93944,yes,-
BAC37_E20,19,19p13.2,8700354,8724629,24275,yes,-
BAC170_D09,19,19p13.2,8745872,8803080,57208,-,-
BAC77_M04,19,19p13.2,8820551,8840147,19596,-,-
BAC109_D02,19,19p13.2,8921740,9013782,92042,-,-
BAC32_O22,19,19p13.2,8935815,9047008,111193,-,-
BAC165_P07,19,19p13.2,9047011,9161570,114559,yes,-
BAC242_I11,19,19p13.2,9047011,9161563,114552,yes,-
BAC224_L15,19,19p13.2,9047015,9122771,75756,-,-
BAC76_P01,19,19p13.2,9060169,9161568,101399,yes,-
BAC172_A24,19,19p13.2,9078604,9161482,82878,yes,-
BAC230_O04,19,19p13.2,9078905,9197618,118713,yes,-
BAC79_N22,19,19p13.2,9086552,9203800,117248,yes,-
BAC54_H22,19,19p13.2,9109599,9161570,51971,yes,-
BAC247_K01,19,19p13.2,9124103,9197647,73544,yes,-
BAC250_B19,19,19p13.2,9161563,9269163,107600,yes,-
BAC154_G19,19,19p13.2,9169826,9255917,86091,-,-
BAC187_I16,19,19p13.2,9203809,9285438,81629,-,-
BAC64_P21,19,19p13.2,9241041,9341790,100749,-,-
BAC201_M15,19,19p13.2,9241183,9328508,87325,-,-
BAC124_H08,19,19p13.2,9267294,9343623,76329,-,-
BAC167_F08,19,19p13.2,9269191,9350064,80873,-,-
BAC139_A02,19,19p13.2,9427554,9525026,97472,-,-
BAC75_F13,19,19p13.2,9433056,9519780,86724,-,-
BAC152_P20,19,19p13.2,9441562,9525116,83554,-,-
BAC34_P07,19,19p13.2,9441562,9594661,153099,-,-
BAC190_A10,19,19p13.2,9487893,9594661,106768,-,-
BAC125_N09,19,19p13.2,9495658,9609225,113567,-,-
BAC153_H04,19,19p13.2,9495658,9609225,113567,-,-
BAC195_H16,19,19p13.2,9516595,9594656,78061,-,-
BAC192_N15,19,19p13.2,9516595,9609225,92630,-,-
BAC19_O19,19,19p13.2,9516856,9647106,130250,-,-
BAC217_J02,19,19p13.2,9597687,9698235,100548,-,-
BAC140_G04,19,19p13.2,9609220,9700830,91610,-,-
BAC147_C13,19,19p13.2,9698229,9776213,77984,-,-
BAC196_N04,19,19p13.2,9734836,9843740,108904,-,-
BAC165_P03,19,19p13.2,9780567,9930891,150324,-,-
BAC52_L03,19,19p13.2,9843878,9987128,143250,-,-
BAC26_H16,19,19p13.2,9935483,10040802,105319,-,-
BAC79_O13,19,19p13.2,9952941,10040798,87857,-,-
BAC158_B07,19,19p13.2,9953401,10040798,87397,-,-
BAC191_A03,19,19p13.2,9977160,10105934,128774,-,-
BAC243_P18,19,19p13.2,9986860,10105908,119048,-,-
BAC50_G09,19,19p13.2,10040794,10168092,127298,-,-
BAC51_O09,19,19p13.2,10040794,10175611,134817,-,-
BAC104_B19,19,19p13.2,10040973,10157032,116059,-,-
BAC139_P18,19,19p13.2,10043643,10166219,122576,-,-
BAC79_F23,19,19p13.2,10105960,10216276,110316,-,-
BAC18_A22,19,19p13.2,10260833,10504471,243638,-,-
BAC144_D13,19,19p13.2,10338839,10427770,88931,-,-
BAC43_C15,19,19p13.2,10372969,10461182,88213,-,-
BAC27_K21,19,19p13.2,10462034,10581871,119837,-,-
BAC128_G12,19,19p13.2,10504473,10633960,129487,-,-
BAC21_G09,19,19p13.2,10575361,10748720,173359,-,-
BAC105_J21,19,19p13.2,10584068,10670198,86130,-,-
BAC106_G11,19,19p13.2,10699596,10798264,98668,-,-
BAC184_L17,19,19p13.2,10699596,10795436,95840,-,-
BAC77_P18,19,19p13.2,10699621,10849985,150364,-,-
BAC130_D07,19,19p13.2,10721746,10811015,89269,-,-
BAC115_K23,19,19p13.2,10754391,10849988,95597,-,-
BAC236_P14,19,19p13.2,10805109,10884047,78938,-,-
BAC33_P04,19,19p13.2,10849982,10970179,120197,-,-
BAC124_J14,19,19p13.2,10860704,10958736,98032,-,-
BAC146_G12,19,19p13.2,10860711,10958736,98025,-,-
BAC8_N01,19,19p13.2,10868624,11031735,163111,-,-
BAC192_H09,19,19p13.2,10886766,10999309,112543,-,-
BAC86_N22,19,19p13.2,10933763,11031750,97987,-,-
BAC152_A24,19,19p13.2,10958749,11054638,95889,-,-
BAC230_E05,19,19p13.2,11016664,11149399,132735,-,-
BAC57_K08,19,19p13.2,11019926,11116898,96972,-,-
BAC13_B20,19,19p13.2,11031766,11149399,117633,-,-
BAC169_C10,19,19p13.2,11032413,11151312,118899,-,-
BAC50_K12,19,19p13.2,11032419,11151588,119169,-,-
BAC197_F13,19,19p13.2,11035861,11174088,138227,-,-
BAC135_O08,19,19p13.2,11054810,11151586,96776,-,-
BAC27_M16,19,19p13.2,11135901,11228160,92259,-,-
BAC141_C08,19,19p13.2,11135901,11276798,140897,-,-
BAC218_I10,19,19p13.2,11151580,11275869,124289,-,-
BAC48_I07,19,19p13.2,11174085,11276674,102589,-,-
BAC238_N16,19,19p13.2,11271259,11346877,75618,-,-
BAC145_M13,19,19p13.2,11276789,11366039,89250,-,-
BAC184_D11,19,19p13.2,11276807,11371783,94976,-,-
BAC109_J03,19,19p13.2,11289660,11387682,98022,-,-
BAC193_N03,19,19p13.2,11296398,11423717,127319,-,-
BAC242_J22,19,19p13.2,11341455,11429833,88378,-,-
BAC249_M02,19,19p13.2,11341499,11429833,88334,-,-
BAC65_G09,19,19p13.2,11423711,11531332,107621,-,-
BAC39_D17,19,19p13.2,11531326,11627375,96049,-,-
BAC157_I24,19,19p13.2,11557425,11667786,110361,-,-
BAC110_P10,19,19p13.2,11563684,11667788,104104,-,-
BAC106_O17,19,19p13.2,11626744,11752169,125425,-,-
BAC53_P03,19,19p13.2,11673726,11769012,95286,-,-
BAC12_H12,19,19p13.2,11730852,11826986,96134,-,-
BAC46_M01,19,19p13.2,11731038,11820407,89369,-,-
BAC222_N01,19,19p13.2,11738095,11888427,150332,-,-
BAC38_K13,19,19p13.2,11747893,11856112,108219,-,-
BAC36_I05,19,19p13.2,11828364,11981580,153216,-,-
BAC218_M24,19,19p13.2,11832346,11925678,93332,-,-
BAC141_A14,19,19p13.2,11929857,12006544,76687,-,-
BAC129_M16,19,19p13.2,11958527,12088665,130138,-,-
BAC21_P07,19,19p13.2,11981719,12154783,173064,-,-
BAC10_M02,19,19p13.2,11996726,12105509,108783,-,-
BAC168_J16,19,19p13.2,12215826,12338182,122356,-,-
BAC120_N19,19,19p13.2,12338822,12469567,130745,-,-
BAC40_A09,19,19p13.13,12604052,12722475,118423,-,-
BAC162_O06,19,19p13.13,12674227,12770160,95933,-,-
BAC50_B05,19,19p13.13,12799345,12904682,105337,-,-
BAC38_H21,19,19p13.13,12848021,12979195,131174,-,-
BAC196_E07,19,19p13.13,12869000,12979218,110218,-,-
BAC170_P24,19,19p13.13,12888217,12978753,90536,-,-
BAC147_G18,19,19p13.13,12888217,13000308,112091,-,-
BAC203_M20,19,19p13.13,12888217,13010066,121849,-,-
BAC226_L19,19,19p13.13,12888218,12979216,90998,-,-
BAC160_C11,19,19p13.13,12904676,13008809,104133,-,-
BAC158_O09,19,19p13.13,13014621,13157923,143302,-,-
BAC82_K10,19,19p13.13,13033570,13140489,106919,-,-
BAC46_H10,19,19p13.13,13042907,13263279,220372,-,-
BAC78_G10,19,19p13.13,13044020,13140489,96469,-,-
BAC121_K02,19,19p13.13,13044065,13148354,104289,-,-
BAC50_N21,19,19p13.13,13055421,13172625,117204,-,-
BAC153_G17,19,19p13.13,13148465,13234823,86358,-,-
BAC143_D03,19,19p13.13,13148465,13234823,86358,-,-
BAC162_M07,19,19p13.13,13203654,13300230,96576,-,-
BAC69_N20,19,19p13.13,13221608,13333347,111739,-,-
BAC217_N07,19,19p13.13,13230550,13312080,81530,-,-
BAC117_F22,19,19p13.13,13230676,13328245,97569,-,-
BAC243_O08,19,19p13.13,13235000,13322417,87417,-,-
BAC193_B09,19,19p13.13,13268592,13368064,99472,-,-
BAC221_N22,19,19p13.13,13307541,13384863,77322,-,-
BAC177_H23,19,19p13.13,13328307,13443943,115636,-,-
BAC76_G03,19,19p13.13,13328307,13427356,99049,-,-
BAC131_D05,19,19p13.13,13333341,13405785,72444,-,-
BAC150_G20,19,19p13.13,13446140,13550740,104600,-,-
BAC149_N01,19,19p13.13,13539350,13638617,99267,-,-
BAC250_D07,19,19p13.13,13569676,13653249,83573,-,-
BAC185_G13,19,19p13.13,13569676,13650355,80679,-,-
BAC60_M02,19,19p13.13,13569676,13650355,80679,-,-
BAC210_E11,19,19p13.13,13650585,13732309,81724,-,-
BAC63_G13,19,19p13.13-19p13.12,13690832,13801822,110990,-,-
BAC90_I02,19,19p13.13,13697716,13799904,102188,-,-
BAC31_J11,19,19p13.13-19p13.12,13709723,13806407,96684,-,-
BAC166_O04,19,19p13.13-19p13.12,13771470,13882587,111117,-,-
BAC71_E11,19,19p13.12,13859599,13870736,11137,-,-
BAC86_D24,19,19p13.12,13878747,13995904,117157,-,-
BAC154_F01,19,19p13.12,13878844,13995907,117063,-,-
BAC166_H10,19,19p13.12,13882743,13995906,113163,-,-
BAC95_J04,19,19p13.12,13888396,13995906,107510,-,-
BAC31_K11,19,19p13.12,13888396,13995901,107505,-,-
BAC18_N20,19,19p13.12,14048744,14140787,92043,-,-
BAC235_M17,19,19p13.12,14091957,14206926,114969,-,-
BAC33_C02,19,19p13.12,14104663,14305406,200743,-,-
BAC134_I15,19,19p13.12,14237290,14308552,71262,-,-
BAC12_I24,19,19p13.12,14249042,14333439,84397,-,-
BAC167_M06,19,19p13.12,14298035,14392257,94222,-,-
BAC153_I17,19,19p13.12,14333689,14451376,117687,-,-
BAC240_F03,19,19p13.12,14383227,14464450,81223,-,-
BAC185_A14,19,19p13.12,14385226,14464450,79224,-,-
BAC172_L16,19,19p13.12,14401172,14510122,108950,-,-
BAC136_O15,19,19p13.12,14401176,14504156,102980,-,-
BAC97_G21,19,19p13.12,14570918,14691704,120786,-,-
BAC41_B07,19,19p13.12,14604079,14699234,95155,-,-
BAC229_N05,19,19p13.12,14615541,14728019,112478,-,-
BAC171_C01,19,19p13.12,14628541,14713883,85342,-,-
BAC229_C16,19,19p13.12,14644338,14732636,88298,-,-
BAC43_J12,19,19p13.12,14657985,14834235,176250,-,-
BAC142_I20,19,19p13.12,14693121,14770719,77598,-,-
BAC193_K24,19,19p13.12,14713876,14840978,127102,-,-
BAC230_M13,19,19p13.12,14714061,14798342,84281,-,-
BAC27_O24,19,19p13.12,14901828,15072142,170314,yes,-
BAC146_B15,19,19p13.12,14928792,15005071,76279,-,-
BAC189_B12,19,19p13.12,14928904,15005070,76166,-,-
BAC106_B12,19,19p13.12,14965713,15072129,106416,-,-
BAC248_H21,19,19p13.12,14982181,15077162,94981,-,-
BAC180_N05,19,19p13.12,14997600,15091237,93637,-,-
BAC184_E04,19,19p13.12,14998592,15081222,82630,-,-
BAC237_H05,19,19p13.12,14998593,15098388,99795,-,-
BAC127_J15,19,19p13.12,15005065,15091237,86172,-,-
BAC148_C04,19,19p13.12,15091380,15178138,86758,-,-
BAC135_J17,19,19p13.12,15160482,15232162,71680,-,-
BAC63_L12,19,19p13.12,15173186,15211410,38224,-,-
BAC182_J15,19,19p13.12,15178263,15270161,91898,-,-
BAC106_G02,19,19p13.12,15211404,15300891,89487,-,-
BAC240_I04,19,19p13.12,15211422,15366598,155176,-,-
BAC135_J06,19,19p13.12,15263783,15377732,113949,-,-
BAC117_B14,19,19p13.12,15266291,15391519,125228,-,-
BAC30_K15,19,19p13.12,15276093,15391488,115395,-,-
BAC75_P23,19,19p13.12,15377826,15455272,77446,-,-
BAC59_A11,19,19p13.12,15377970,15479919,101949,-,-
BAC67_A09,19,19p13.12,15404725,15547385,142660,-,-
BAC110_A09,19,19p13.12,15433824,15525832,92008,-,-
BAC155_N08,19,19p13.12,15463587,15553513,89926,-,-
BAC137_N22,19,19p13.12,15479968,15598415,118447,-,-
BAC143_P21,19,19p13.12,15525863,15590028,64165,-,-
BAC149_B04,19,19p13.12,15690459,15803278,112819,-,-
BAC242_K14,19,19p13.12,15723266,15802493,79227,yes,-
BAC86_E20,19,19p13.12,15723299,15811048,87749,yes,-
BAC84_E03,19,19p13.12,15769339,15882699,113360,-,-
BAC140_H01,19,19p13.12,15807519,15919919,112400,-,-
BAC200_B06,19,19p13.12,15847554,15948836,101282,-,-
BAC132_O15,19,19p13.12,15967593,16097640,130047,-,-
BAC19_P04,19,19p13.12,15970458,16056451,85993,-,-
BAC80_B13,19,19p13.12,15971016,16060294,89278,-,-
BAC226_N18,19,19p13.12-19p13.11,16097633,16210494,112861,-,-
BAC199_N23,19,19p13.11,16101756,16179448,77692,-,-
BAC123_K11,19,19p13.11,16120496,16210479,89983,-,-
BAC78_M10,19,19p13.11,16219284,16294773,75489,-,-
BAC61_L09,19,19p13.11,16219284,16326932,107648,-,-
BAC50_C11,19,19p13.11,16219305,16370429,151124,-,-
BAC107_F07,19,19p13.11,16334356,16436889,102533,-,-
BAC95_E07,19,19p13.11,16334360,16436053,101693,-,-
BAC60_A13,19,19p13.11,16366731,16465220,98489,-,-
BAC149_L10,19,19p13.11,16436097,16545219,109122,-,-
BAC179_F20,19,19p13.11,16437002,16545219,108217,-,-
BAC123_P04,19,19p13.11,16437039,16579471,142432,-,-
BAC20_L04,19,19p13.11,16447099,16565544,118445,-,-
BAC232_P18,19,19p13.11,16504907,16606004,101097,-,-
BAC39_E16,19,19p13.11,16550610,16653779,103169,-,-
BAC65_E09,19,19p13.11,16565984,16641406,75422,-,-
BAC141_L14,19,19p13.11,16649706,16745257,95551,-,-
BAC31_F20,19,19p13.11,16676434,16763401,86967,-,-
BAC88_F09,19,19p13.11,16705532,16798673,93141,-,-
BAC45_P04,19,19p13.11,16741670,16832932,91262,-,-
BAC67_E05,19,19p13.11,16791342,16883018,91676,-,-
BAC57_D08,19,19p13.11,16791342,16883018,91676,-,-
BAC66_F12,19,19p13.11,16812933,16933623,120690,-,-
BAC10_P14,19,19p13.11,16832968,16925096,92128,-,-
BAC41_F19,19,19p13.11,16852481,17050460,197979,-,-
BAC250_M22,19,19p13.11,16934752,17049725,114973,-,-
BAC81_C11,19,19p13.11,16946810,17050460,103650,-,-
BAC176_A09,19,19p13.11,17049723,17131002,81279,-,-
BAC170_M24,19,19p13.11,17050454,17153448,102994,-,-
BAC167_L05,19,19p13.11,17050454,17153176,102722,-,-
BAC225_P16,19,19p13.11,17050465,17131002,80537,-,-
BAC162_M19,19,19p13.11,17153602,17275921,122319,-,-
BAC34_D14,19,19p13.11,17220495,17334546,114051,yes,-
BAC36_M09,19,19p13.11,17282394,17407667,125273,yes,-
BAC194_F24,19,19p13.11,17400460,17493606,93146,-,-
BAC120_P20,19,19p13.11,17407660,17493606,85946,-,-
BAC112_L03,19,19p13.11,17407660,17498455,90795,-,-
BAC231_N11,19,19p13.11,17407695,17498457,90762,-,-
BAC105_G09,19,19p13.11,17433551,17567900,134349,-,-
BAC214_F15,19,19p13.11,17497376,17599794,102418,-,-
BAC205_L20,19,19p13.11,17525163,17653674,128511,-,-
BAC126_G14,19,19p13.11,17567894,17667708,99814,-,-
BAC111_C22,19,19p13.11,17575667,17667644,91977,-,-
BAC71_L07,19,19p13.11,17600486,17688438,87952,-,-
BAC183_J08,19,19p13.11,17668182,17739773,71591,-,-
BAC71_B09,19,19p13.11,17670911,17814736,143825,-,-
BAC176_J02,19,19p13.11,17691080,17784835,93755,-,-
BAC172_H02,19,19p13.11,17692282,17814740,122458,-,-
BAC231_A07,19,19p13.11,17718791,17846696,127905,-,-
BAC214_G10,19,19p13.11,17730808,17836374,105566,-,-
BAC142_C19,19,19p13.11,17730808,17807308,76500,-,-
BAC162_G15,19,19p13.11,17807330,17902581,95251,-,-
BAC131_D03,19,19p13.11,17902726,17989315,86589,-,-
BAC231_I13,19,19p13.11,17954208,18094252,140044,-,-
BAC184_F23,19,19p13.11,17989311,18074766,85455,-,-
BAC246_J06,19,19p13.11,18074760,18177578,102818,-,-
BAC41_F08,19,19p13.11,18074760,18164001,89241,-,-
BAC66_F21,19,19p13.11,18464067,18548115,84048,-,-
BAC151_O13,19,19p13.11,18519920,18616447,96527,-,-
BAC178_F17,19,19p13.11,18534876,18612675,77799,-,-
BAC80_I22,19,19p13.11,18721762,18820009,98247,-,-
BAC224_G09,19,19p13.11,18764777,18847577,82800,-,-
BAC108_E14,19,19p13.11,18844175,18930769,86594,-,-
BAC188_G10,19,19p13.11,18873668,19004835,131167,-,-
BAC242_N17,19,19p13.11,18929432,19039397,109965,-,-
BAC75_K04,19,19p13.11,18984691,19069283,84592,-,-
BAC39_K07,19,19p13.11,19016004,19104048,88044,-,-
BAC86_M04,19,19p13.11,19039543,19170334,130791,-,-
BAC200_G07,19,19p13.11,19046594,19062456,15862,-,-
BAC109_F07,19,19p13.11,19079541,19185595,106054,-,-
BAC173_B15,19,19p13.11,19139893,19329609,189716,-,-
BAC105_F05,19,19p13.11,19170326,19307500,137174,-,-
BAC234_N05,19,19p13.11,19188468,19307617,119149,-,-
BAC168_E03,19,19p13.11,19227387,19329609,102222,-,-
BAC52_G12,19,19p13.11,19287281,19395477,108196,-,-
BAC36_P18,19,19p13.11,19305374,19395273,89899,-,-
BAC169_O11,19,19p13.11,19395493,19480257,84764,-,-
BAC131_N13,19,19p13.11,19434885,19546124,111239,-,-
BAC173_B13,19,19p13.11,19434894,19546124,111230,-,-
BAC194_L07,19,19p13.11,19476479,19550351,73872,-,-
BAC210_N17,19,19p13.11,19480360,19577649,97289,-,-
BAC222_C16,19,19p13.11,19560455,19682880,122425,-,-
BAC12_L13,19,19p13.11,19563687,19719074,155387,-,-
BAC104_O22,19,19p13.11,19574827,19682879,108052,-,-
BAC48_P06,19,19p13.11,19577791,19697580,119789,-,-
BAC224_L11,19,19p13.11,19648970,19743602,94632,-,-
BAC117_D14,19,19p13.11-19p12,19701805,19807427,105622,-,-
BAC149_P03,19,19p13.11-19p12,19756746,19844370,87624,-,-
BAC195_K16,19,19p12,19864432,19973636,109204,-,-
BAC105_I08,19,19p12,19946277,20047911,101634,-,-
BAC41_P21,19,19p12,19971484,20107105,135621,-,-
BAC205_C04,19,19p12,20038226,20127507,89281,-,-
BAC199_E06,19,19p12,20051132,20130717,79585,-,-
BAC137_E09,19,19p12,20058064,20154143,96079,-,-
BAC182_L13,19,19p12,20096266,20175103,78837,-,-
BAC63_M04,19,19p12,20107034,20189607,82573,-,-
BAC100_G21,19,19p12,20111899,20200932,89033,-,-
BAC85_G03,19,19p12,20282227,20392712,110485,-,-
BAC153_E01,19,19p12,20325147,20412162,87015,-,-
BAC246_O13,19,19p12,20369273,20453188,83915,-,-
BAC184_D13,19,19p12,20369610,20453188,83578,-,-
BAC165_E05,19,19p12,20487959,20589892,101933,-,-
BAC155_M24,19,19p12,20551199,20741302,190103,-,-
BAC213_L21,19,19p12,20672398,20739533,67135,-,-
BAC181_D20,19,19p12,20680662,20780790,100128,-,-
BAC30_G10,19,19p12,20802944,20924629,121685,-,-
BAC21_J18,19,19p12,20825701,20917305,91604,-,-
BAC34_O02,19,19p12,20840905,20935761,94856,-,-
BAC118_I09,19,19p12,20964518,21054762,90244,-,-
BAC225_J07,19,19p12,20998742,21086109,87367,-,-
BAC79_I23,19,19p12,21086706,21175016,88310,-,-
BAC21_F14,19,19p12,21086708,21175018,88310,-,-
BAC118_J12,19,19p12,21101460,21185286,83826,-,-
BAC197_C22,19,19p12,21107630,21185286,77656,-,-
BAC199_I08,19,19p12,21175025,21359503,184478,-,-
BAC40_E08,19,19p12,21196996,21287260,90264,-,-
BAC149_B20,19,19p12,21224874,21318497,93623,-,-
BAC129_H06,19,19p12,21226422,21359335,132913,-,-
BAC232_A10,19,19p12,21399544,21502069,102525,-,-
BAC95_F09,19,19p12,21400519,21498394,97875,-,-
BAC121_D08,19,19p12,21438899,21600728,161829,-,-
BAC176_G18,19,19p12,21450864,21584702,133838,-,-
BAC88_N14,19,19p12,21471330,21582150,110820,-,-
BAC2_P14,19,19p12,21471330,21637772,166442,-,-
BAC109_D20,19,19p12,21680384,21782122,101738,-,-
BAC131_L12,19,19p12,21694492,21794333,99841,-,-
BAC236_H04,19,19p12,21782872,21864047,81175,-,-
BAC129_G05,19,19p12,21783208,21873974,90766,-,-
BAC81_F03,19,19p12,21971653,22064125,92472,-,-
BAC238_L19,19,19p12,22139773,22216744,76971,-,-
BAC60_H17,19,19p12,22176401,22275976,99575,-,-
BAC249_J17,19,19p12,22177456,22279853,102397,-,-
BAC109_L14,19,19p12,22186921,22288960,102039,-,-
BAC80_J12,19,19p12,22225899,22331619,105720,-,-
BAC51_P12,19,19p12,22317594,22442718,125124,-,-
BAC224_I15,19,19p12,22358411,22423452,65041,-,-
BAC97_B14,19,19p12,22366550,22473190,106640,-,-
BAC8_P09,19,19p12,22367054,22476973,109919,-,-
BAC40_D05,19,19p12,22447354,22582602,135248,-,-
BAC110_B04,19,19p12,22454495,22570571,116076,-,-
BAC147_M11,19,19p12,22460925,22574413,113488,-,-
BAC127_C04,19,19p12,22462283,22574413,112130,-,-
BAC23_G12,19,19p12,22493393,22647632,154239,-,-
BAC192_O23,19,19p12,22503873,22591801,87928,-,-
BAC249_O04,19,19p12,22544145,22647578,103433,-,-
BAC250_M19,19,19p12,22566855,22648472,81617,-,-
BAC231_M09,19,19p12,22655281,22729715,74434,-,-
BAC128_M07,19,19p12,22733587,22832181,98594,-,-
BAC250_L08,19,19p12,22742523,22832644,90121,-,-
BAC181_B12,19,19p12,22810720,22927836,117116,-,-
BAC118_F08,19,19p12,22852774,22933446,80672,-,-
BAC230_L06,19,19p12,22925518,23039474,113956,-,-
BAC230_G06,19,19p12,22938144,23050374,112230,-,-
BAC248_A09,19,19p12,22953286,23039474,86188,-,-
BAC49_F11,19,19p12,22974214,23120647,146433,-,-
BAC131_B12,19,19p12,23001122,23120815,119693,-,-
BAC108_H16,19,19p12,23039471,23132323,92852,-,-
BAC63_H20,19,19p12,23085724,23174311,88587,-,-
BAC234_G24,19,19p12,23198016,23302596,104580,-,-
BAC76_G05,19,19p12,23311429,23409037,97608,-,-
BAC50_H20,19,19p12,23335874,23438851,102977,-,-
BAC198_H19,19,19p12,23336546,23466195,129649,-,-
BAC52_D02,19,19p12,23341278,23458855,117577,-,-
BAC32_J02,19,19p12,23354314,23467860,113546,-,-
BAC67_C08,19,19p12,23354950,23458875,103925,-,-
BAC69_H22,19,19p12,23466189,23549263,83074,-,-
BAC84_D12,19,19p12,23467014,23606811,139797,-,-
BAC45_B18,19,19p12,23467272,23554262,86990,-,-
BAC128_B08,19,19p12,23628530,23712334,83804,-,-
BAC196_N09,19,19p12,23679427,23767707,88280,-,-
BAC232_H22,19,19p12,23768995,23848291,79296,-,-
BAC146_D17,19,19p12,23786547,23852648,66101,-,-
BAC235_G08,19,19p12,23793895,23892449,98554,-,-
BAC161_H05,19,19p12,23944504,24022629,78125,-,-
BAC198_N02,19,19p12,23947502,24022629,75127,-,-
BAC117_J07,19,19p12,23984088,24078072,93984,-,-
BAC176_K13,19,19q12,32889409,32973883,84474,-,-
BAC197_G18,19,19q12,32905461,33005576,100115,-,-
BAC217_B18,19,19q12,32918657,33009591,90934,-,-
BAC54_N22,19,19q12,33062070,33154105,92035,-,-
BAC149_D24,19,19q12,33186940,33321890,134950,-,-
BAC34_L09,19,19q12,33212630,33343643,131013,-,-
BAC81_M11,19,19q12,33220645,33311660,91015,-,-
BAC147_I22,19,19q12,33374865,33445001,70136,-,-
BAC230_G03,19,19q12,33437294,33523627,86333,-,-
BAC51_L04,19,19q12,33527179,33662136,134957,-,-
BAC182_G13,19,19q12,33652513,33762710,110197,-,-
BAC5_H12,19,19q12,33652517,33744641,92124,-,-
BAC196_G10,19,19q12,33684868,33782188,97320,-,-
BAC195_N10,19,19q12,33753388,33819309,65921,-,-
BAC132_C19,19,19q12,33782182,33876548,94366,-,-
BAC73_P21,19,19q12,33812856,33934517,121661,-,-
BAC188_L06,19,19q12,33834442,33885740,51298,-,-
BAC60_F06,19,19q12,33940953,34036199,95246,-,-
BAC198_G15,19,19q12,34016219,34127780,111561,-,-
BAC24_M13,19,19q12,34065281,34215237,149956,-,-
BAC167_N20,19,19q12,34070064,34173449,103385,-,-
BAC227_G23,19,19q12,34075784,34174315,98531,-,-
BAC199_O16,19,19q12,34104140,34194292,90152,-,-
BAC106_O08,19,19q12,34121007,34220964,99957,-,-
BAC240_B02,19,19q12,34159856,34255140,95284,-,-
BAC51_C06,19,19q12,34251849,34456914,205065,-,-
BAC197_A13,19,19q12,34277905,34380198,102293,-,-
BAC176_E14,19,19q12,34328745,34402139,73394,-,-
BAC145_D13,19,19q12,34383139,34466953,83814,-,-
BAC248_M20,19,19q12,34410302,34496820,86518,-,-
BAC177_N03,19,19q12,34433819,34523259,89440,-,-
BAC63_F12,19,19q12,34437185,34553894,116709,-,-
BAC188_A04,19,19q12,34437262,34534853,97591,-,-
BAC86_E09,19,19q12,34467216,34557338,90122,-,-
BAC54_I13,19,19q12,34467238,34575378,108140,-,-
BAC147_F11,19,19q12,34510188,34650121,139933,-,-
BAC75_N04,19,19q12,34532484,34768965,236481,-,-
BAC195_P18,19,19q12,34538578,34649357,110779,-,-
BAC237_J07,19,19q12,34654744,34768981,114237,-,-
BAC120_D05,19,19q12,34738983,34828262,89279,-,-
BAC61_P04,19,19q12,34792814,34932363,139549,-,-
BAC172_F13,19,19q12,34792909,34896670,103761,-,-
BAC9_P12,19,19q12,34801049,34896670,95621,-,-
BAC9_O12,19,19q12,34801049,34896670,95621,-,-
BAC108_L14,19,19q12,34801050,34896641,95591,-,-
BAC153_N13,19,19q12,34828257,34914355,86098,-,-
BAC192_O07,19,19q12,34896819,35002456,105637,-,-
BAC248_M06,19,19q12,34899293,34988850,89557,-,-
BAC30_A11,19,19q12,34932578,35018047,85469,-,-
BAC205_M03,19,19q12,34932745,35014711,81966,-,-
BAC69_E20,19,19q12,35001288,35094217,92929,-,-
BAC94_J16,19,19q12,35001290,35104294,103004,-,-
BAC185_I23,19,19q12,35002495,35124786,122291,-,-
BAC183_H21,19,19q12,35006820,35106448,99628,-,-
BAC196_M04,19,19q12,35018077,35106516,88439,-,-
BAC250_N19,19,19q12,35023359,35119174,95815,-,-
BAC23_C10,19,19q12,35104410,35196580,92170,-,-
BAC158_K02,19,19q12,35142559,35225092,82533,-,-
BAC158_L02,19,19q12,35142559,35225092,82533,-,-
BAC37_B14,19,19q12,35183426,35270522,87096,-,-
BAC60_P09,19,19q12,35200426,35283871,83445,-,-
BAC68_N04,19,19q12,35243212,35323269,80057,-,-
BAC84_J23,19,19q12,35247918,35346838,98920,-,-
BAC110_M07,19,19q12,35272695,35413563,140868,-,-
BAC165_P08,19,19q12,35338724,35427437,88713,-,-
BAC105_C14,19,19q12,35371675,35481571,109896,-,-
BAC169_B11,19,19q12,35497904,35578372,80468,-,-
BAC141_C17,19,19q12,35523850,35608925,85075,-,-
BAC153_M09,19,19q12,35616263,35714818,98555,-,-
BAC18_D17,19,19q12,35616263,35710301,94038,-,-
BAC230_L11,19,19q12,35629589,35721350,91761,-,-
BAC165_G17,19,19q12,35650925,35741504,90579,-,-
BAC166_O07,19,19q12,35679076,35817132,138056,-,-
BAC168_H18,19,19q12,35695809,35792377,96568,-,-
BAC37_I04,19,19q12,35721345,35819500,98155,-,-
BAC44_H08,19,19q12,35741581,35866727,125146,-,-
BAC109_B14,19,19q12,35817161,35901330,84169,-,-
BAC198_I23,19,19q12,35819498,35907970,88472,-,-
BAC101_O24,19,19q12,35825263,35917917,92654,-,-
BAC230_I14,19,19q12,35852425,35929606,77181,-,-
BAC161_K08,19,19q12,35886348,35967041,80693,-,-
BAC244_J06,19,19q12,35888441,35975860,87419,-,-
BAC197_O12,19,19q12,35918053,36053863,135810,-,-
BAC170_D01,19,19q12,35957444,36048488,91044,-,-
BAC237_L03,19,19q12,35987417,36069720,82303,-,-
BAC83_I23,19,19q12,36001621,36100004,98383,-,-
BAC189_F10,19,19q12,36053856,36149302,95446,-,-
BAC140_G14,19,19q12,36066446,36161323,94877,-,-
BAC108_J07,19,19q12,36069714,36159610,89896,-,-
BAC157_D24,19,19q12,36081706,36259712,178006,-,-
BAC157_C24,19,19q12,36081706,36259712,178006,-,-
BAC15_K09,19,19q12,36149523,36269786,120263,-,-
BAC26_A16,19,19q12,36149523,36269780,120257,-,-
BAC137_L05,19,19q12,36272930,36349505,76575,-,-
BAC186_P07,19,19q12,36349931,36444847,94916,-,-
BAC175_H15,19,19q12,36419581,36487869,68288,-,-
BAC233_K14,19,19q12,36444841,36543930,99089,-,-
BAC191_J04,19,19q12,36460634,36537296,76662,-,-
BAC148_B05,19,19q12,36463621,36544832,81211,-,-
BAC44_O15,19,19q12,36517231,36688856,171625,-,-
BAC119_M14,19,19q12,36538331,36654072,115741,-,-
BAC175_P01,19,19q12,36654066,36738745,84679,-,-
BAC144_L05,19,19q12,36700525,36843005,142480,-,-
BAC27_D09,19,19q12,36724291,36852077,127786,-,-
BAC227_I17,19,19q12,36733760,36852077,118317,-,-
BAC120_I03,19,19q12,36734978,36823733,88755,-,-
BAC142_N16,19,19q12,36734979,36823733,88754,-,-
BAC146_J11,19,19q12,36738874,36843010,104136,-,-
BAC116_F12,19,19q12,36793566,36885404,91838,-,-
BAC192_F04,19,19q12,36839267,36937253,97986,-,-
BAC23_C18,19,19q12,36852071,36938223,86152,-,-
BAC155_D19,19,19q12,36932285,37029671,97386,-,-
BAC102_J05,19,19q12-19q13.11,36988759,37135506,146747,-,-
BAC125_H02,19,19q13.11,37164253,37251779,87526,-,-
BAC152_G22,19,19q13.11,37221334,37303604,82270,-,-
BAC196_K05,19,19q13.11,37266781,37359931,93150,-,-
BAC196_H05,19,19q13.11,37266781,37359931,93150,-,-
BAC2_A20,19,19q13.11,37268795,37470269,201474,-,-
BAC42_K13,19,19q13.11,37313932,37422151,108219,-,-
BAC89_M02,19,19q13.11,37327967,37470867,142900,-,-
BAC77_J01,19,19q13.11,37341369,37422138,80769,-,-
BAC134_A06,19,19q13.11,37341539,37422151,80612,-,-
BAC180_J13,19,19q13.11,37360570,37471331,110761,-,-
BAC237_G04,19,19q13.11,37380003,37468177,88174,-,-
BAC200_G10,19,19q13.11,37437998,37543498,105500,-,-
BAC194_B13,19,19q13.11,37448551,37566128,117577,-,-
BAC97_H15,19,19q13.11,37468172,37578849,110677,-,-
BAC219_N19,19,19q13.11,37470276,37583131,112855,-,-
BAC149_H08,19,19q13.11,37470864,37558707,87843,-,-
BAC72_H10,19,19q13.11,37470864,37573753,102889,-,-
BAC117_H05,19,19q13.11,37480761,37566128,85367,-,-
BAC224_D17,19,19q13.11,37480765,37557666,76901,-,-
BAC115_A09,19,19q13.11,37583257,37689215,105958,-,-
BAC126_A11,19,19q13.11,37599425,37719275,119850,-,-
BAC122_M16,19,19q13.11,37599425,37718972,119547,-,-
BAC145_F18,19,19q13.11,37639759,37721863,82104,-,-
BAC92_N12,19,19q13.11,37677493,37768465,90972,-,-
BAC27_J10,19,19q13.11,37768463,37970041,201578,-,-
BAC183_P21,19,19q13.11,37768526,37863614,95088,-,-
BAC179_L13,19,19q13.11,37778466,37874399,95933,-,-
BAC178_L11,19,19q13.11,37778470,37855127,76657,-,-
BAC185_N09,19,19q13.11,37832027,37948955,116928,-,-
BAC114_E09,19,19q13.11,37832037,37951651,119614,-,-
BAC51_H03,19,19q13.11,37880854,37992734,111880,-,-
BAC175_H13,19,19q13.11,37880856,37964433,83577,-,-
BAC192_K10,19,19q13.11,37880880,37992734,111854,-,-
BAC119_D07,19,19q13.11,38024903,38170291,145388,-,-
BAC69_B05,19,19q13.11,38088317,38164697,76380,-,-
BAC58_I18,19,19q13.11,38164690,38270431,105741,-,-
BAC170_E16,19,19q13.11,38170286,38270423,100137,-,-
BAC176_K03,19,19q13.11,38189225,38270429,81204,-,-
BAC24_P16,19,19q13.11,38220246,38347029,126783,-,-
BAC156_G23,19,19q13.11,38235097,38343919,108822,-,-
BAC78_K02,19,19q13.11,38283046,38352412,69366,-,-
BAC147_O03,19,19q13.11,38288285,38368943,80658,-,-
BAC97_L23,19,19q13.11,38295315,38428995,133680,-,-
BAC230_P23,19,19q13.11,38320588,38414202,93614,-,-
BAC66_P23,19,19q13.11,38368937,38468287,99350,-,-
BAC9_B12,19,19q13.11,38497534,38587616,90082,-,-
BAC243_C08,19,19q13.11,38768114,38866931,98817,-,-
BAC79_A19,19,19q13.11,38803729,38911602,107873,-,-
BAC230_I09,19,19q13.11,38823186,38911605,88419,-,-
BAC129_N05,19,19q13.11,38911597,39019669,108072,-,-
BAC20_G09,19,19q13.11,38975362,39086340,110978,-,-
BAC178_C24,19,19q13.11,38980482,39086307,105825,-,-
BAC178_D24,19,19q13.11,38980492,39086307,105815,-,-
BAC137_I18,19,19q13.11,38981844,39071861,90017,-,-
BAC167_C13,19,19q13.11,38985963,39086340,100377,-,-
BAC160_H08,19,19q13.11,39002287,39086340,84053,-,-
BAC33_N07,19,19q13.11,39086002,39170840,84838,-,-
BAC56_M15,19,19q13.11,39086579,39170840,84261,-,-
BAC62_F03,19,19q13.11,39138457,39216956,78499,-,-
BAC125_F12,19,19q13.11,39170832,39276424,105592,-,-
BAC75_G21,19,19q13.11,39170833,39270009,99176,-,-
BAC179_E02,19,19q13.11,39170833,39246168,75335,-,-
BAC49_B02,19,19q13.11,39246684,39445362,198678,-,-
BAC167_L09,19,19q13.11,39253627,39356226,102599,-,-
BAC189_M19,19,19q13.11,39283404,39415548,132144,-,-
BAC32_M02,19,19q13.11,39283424,39404766,121342,-,-
BAC76_O23,19,19q13.11,39327855,39419247,91392,-,-
BAC32_P03,19,19q13.11,39356226,39490983,134757,-,-
BAC163_M05,19,19q13.11,39366818,39470406,103588,-,-
BAC232_L17,19,19q13.11,39591417,39609841,18424,-,-
BAC11_K16,19,19q13.11,39635482,39713565,78083,-,-
BAC179_O20,19,19q13.11,39649506,39731313,81807,-,-
BAC37_G22,19,19q13.11,39761628,39861995,100367,-,-
BAC142_B10,19,19q13.11,39765628,39862686,97058,-,-
BAC143_L09,19,19q13.11,39805677,39918792,113115,-,-
BAC234_M15,19,19q13.11,39817204,39915184,97980,-,-
BAC219_E08,19,19q13.11,39821516,39915303,93787,-,-
BAC234_A14,19,19q13.11,39918932,40015945,97013,-,-
BAC140_K23,19,19q13.11,39939710,40021707,81997,-,-
BAC219_H18,19,19q13.11,39947722,40041430,93708,-,-
BAC103_O11,19,19q13.11,40000102,40088131,88029,-,-
BAC247_F21,19,19q13.11,40040924,40131375,90451,-,-
BAC103_O17,19,19q13.11,40041440,40158765,117325,-,-
BAC235_G09,19,19q13.11,40088155,40168288,80133,-,-
BAC132_C14,19,19q13.11,40154999,40262861,107862,-,-
BAC222_E22,19,19q13.11,40155039,40268755,113716,-,-
BAC34_O18,19,19q13.11,40155849,40262857,107008,-,-
BAC156_L24,19,19q13.11,40158756,40262861,104105,-,-
BAC115_M14,19,19q13.11,40173220,40262861,89641,-,-
BAC24_H01,19,19q13.11,40196754,40297576,100822,-,-
BAC179_C07,19,19q13.11-19q13.12,40237361,40319287,81926,-,-
BAC90_H02,19,19q13.12,40345535,40468142,122607,-,-
BAC2_E20,19,19q13.12,40345695,40495495,149800,-,-
BAC78_A18,19,19q13.12,40409424,40566289,156865,yes,-
BAC111_G09,19,19q13.12,40468159,40595405,127246,yes,-
BAC77_K18,19,19q13.12,40472089,40595662,123573,yes,-
BAC42_L23,19,19q13.12,40474647,40613019,138372,yes,-
BAC189_N22,19,19q13.12,40492402,40566302,73900,yes,-
BAC180_G04,19,19q13.12,40492405,40595683,103278,yes,-
BAC131_N15,19,19q13.12,40533967,40633962,99995,yes,-
BAC10_J23,19,19q13.12,40533996,40628656,94660,yes,-
BAC25_N23,19,19q13.12,40537467,40631069,93602,yes,-
BAC56_G21,19,19q13.12,40739061,40879725,140664,-,-
BAC16_O21,19,19q13.12,40749550,40875275,125725,-,-
BAC246_K16,19,19q13.12,40759422,40875783,116361,-,-
BAC86_P18,19,19q13.12,40791524,40922054,130530,-,-
BAC250_J06,19,19q13.12,41042091,41146075,103984,-,-
BAC230_E09,19,19q13.12,41095765,41211646,115881,-,-
BAC196_D20,19,19q13.12,41127924,41211647,83723,-,-
BAC86_G08,19,19q13.12,41289947,41374320,84373,-,-
BAC120_O15,19,19q13.12,41316987,41401529,84542,-,-
BAC126_G24,19,19q13.12,41317000,41417063,100063,-,-
BAC171_P20,19,19q13.12,41327401,41386665,59264,-,-
BAC22_K16,19,19q13.12,41339705,41443771,104066,-,-
BAC19_L15,19,19q13.12,41339717,41448246,108529,-,-
BAC16_I11,19,19q13.12,41346587,41443592,97005,-,-
BAC110_C03,19,19q13.12,41493176,41583688,90512,-,-
BAC230_G11,19,19q13.12,41516252,41595357,79105,-,-
BAC97_P20,19,19q13.12,41583827,41660790,76963,-,-
BAC42_N04,19,19q13.12,41583827,41734044,150217,-,-
BAC149_H12,19,19q13.12,41611276,41753102,141826,-,-
BAC134_H09,19,19q13.12,41726344,41838499,112155,-,-
BAC42_E12,19,19q13.12,41799477,41953117,153640,-,-
BAC142_J01,19,19q13.12,41835499,41939976,104477,-,-
BAC34_L24,19,19q13.12,41939975,42070098,130123,-,-
BAC100_G11,19,19q13.12,41959989,42062644,102655,-,-
BAC58_E24,19,19q13.12,41962030,42047982,85952,-,-
BAC129_K13,19,19q13.12,42008803,42119818,111015,-,-
BAC180_E07,19,19q13.12,42090891,42196183,105292,-,-
BAC160_I01,19,19q13.12,42103381,42176669,73288,-,-
BAC221_B10,19,19q13.12,42169123,42251382,82259,-,-
BAC84_A18,19,19q13.12,42207935,42319694,111759,-,-
BAC26_A06,19,19q13.12,42223605,42324726,101121,-,-
BAC75_A13,19,19q13.12,42233834,42342478,108644,-,-
BAC222_E21,19,19q13.12,42269398,42365192,95794,-,-
BAC200_D12,19,19q13.12,42269522,42373276,103754,-,-
BAC198_B15,19,19q13.12,42320016,42370546,50530,-,-
BAC228_C21,19,19q13.12,42439506,42500200,60694,-,-
BAC162_E14,19,19q13.12,42500191,42612004,111813,-,-
BAC244_D07,19,19q13.12,42612022,42735049,123027,-,-
BAC158_G07,19,19q13.12,42758276,42852957,94681,-,-
BAC139_K18,19,19q13.12,42768037,42848861,80824,-,-
BAC196_C19,19,19q13.12,42809578,42904977,95399,-,-
BAC172_F20,19,19q13.12,42809578,42908876,99298,-,-
BAC82_L08,19,19q13.12,42884558,42990511,105953,-,-
BAC238_E01,19,19q13.12,42901792,42985218,83426,-,-
BAC85_L17,19,19q13.12,42905119,42984759,79640,-,-
BAC168_G22,19,19q13.12-19q13.13,42923174,43007553,84379,-,-
BAC70_M09,19,19q13.12-19q13.13,42923369,43007555,84186,-,-
BAC43_L15,19,19q13.12-19q13.13,42941518,43048654,107136,-,-
BAC33_P08,19,19q13.12-19q13.13,42956823,43048658,91835,-,-
BAC117_M14,19,19q13.13,43059869,43152356,92487,-,-
BAC169_I13,19,19q13.13,43082334,43215764,133430,-,-
BAC89_N08,19,19q13.13,43082335,43213510,131175,-,-
BAC252_A12,19,19q13.13,43213536,43308866,95330,-,-
BAC199_P04,19,19q13.13,43221551,43308660,87109,-,-
BAC69_H02,19,19q13.13,43224518,43321781,97263,-,-
BAC42_M20,19,19q13.13,43228573,43372851,144278,-,-
BAC97_N01,19,19q13.13,43228887,43308660,79773,-,-
BAC155_F17,19,19q13.13,43242816,43326583,83767,-,-
BAC82_I05,19,19q13.13-19q13.2,43324020,43446486,122466,-,-
BAC199_O02,19,19q13.13-19q13.2,43373417,43460354,86937,-,-
BAC91_C06,19,19q13.2,43449714,43556619,106905,-,-
BAC126_K03,19,19q13.2,43481831,43567205,85374,-,-
BAC51_K20,19,19q13.2,43523481,43684797,161316,-,-
BAC220_A14,19,19q13.2,43596245,43699108,102863,-,-
BAC124_L06,19,19q13.2,43596245,43712015,115770,-,-
BAC244_F14,19,19q13.2,43627730,43707016,79286,-,-
BAC26_B18,19,19q13.2,43633348,43827760,194412,-,-
BAC40_G15,19,19q13.2,43712478,43836355,123877,-,-
BAC167_O05,19,19q13.2,43719491,43808394,88903,-,-
BAC198_A06,19,19q13.2,43776598,43933352,156754,-,-
BAC188_D07,19,19q13.2,43838673,43949807,111134,-,-
BAC75_A16,19,19q13.2,43838726,43933344,94618,-,-
BAC196_D05,19,19q13.2,43876386,43949827,73441,-,-
BAC125_C19,19,19q13.2,44007204,44118916,111712,-,-
BAC78_D03,19,19q13.2,44026995,44158105,131110,-,-
BAC240_N23,19,19q13.2,44158358,44248642,90284,-,-
BAC236_L17,19,19q13.2,44178218,44293920,115702,-,-
BAC180_N18,19,19q13.2,44178218,44318813,140595,-,-
BAC10_D16,19,19q13.2,44207708,44234757,27049,-,-
BAC157_E08,19,19q13.2,44244756,44349149,104393,-,-
BAC10_K11,19,19q13.2,44248638,44349151,100513,-,-
BAC132_J14,19,19q13.2,44248645,44349151,100506,-,-
BAC134_F01,19,19q13.2,44329168,44431420,102252,-,-
BAC115_K02,19,19q13.2,44335048,44434306,99258,-,-
BAC97_I01,19,19q13.2,44349144,44434306,85162,-,-
BAC232_I07,19,19q13.2,44357305,44485467,128162,-,-
BAC237_O09,19,19q13.2,44395152,44476976,81824,-,-
BAC66_G10,19,19q13.2,44434556,44529656,95100,-,-
BAC33_K24,19,19q13.2,44443696,44547722,104026,-,-
BAC148_M21,19,19q13.2,44466600,44573927,107327,-,-
BAC56_G24,19,19q13.2,44466606,44547711,81105,-,-
BAC68_N18,19,19q13.2,44466624,44551397,84773,-,-
BAC168_K15,19,19q13.2,44477172,44573927,96755,-,-
BAC162_K04,19,19q13.2,44526488,44654105,127617,-,-
BAC81_M06,19,19q13.2,44581146,44714014,132868,-,-
BAC204_P12,19,19q13.2,44581400,44678563,97163,-,-
BAC101_P18,19,19q13.2,44805054,44941554,136500,-,-
BAC182_P01,19,19q13.2,44853582,44923690,70108,-,-
BAC106_E04,19,19q13.2,44855798,44958252,102454,-,-
BAC191_M05,19,19q13.2,44855972,44958252,102280,-,-
BAC167_O10,19,19q13.2,44858475,44962493,104018,-,-
BAC91_E04,19,19q13.2,44974964,45082952,107988,-,-
BAC195_L06,19,19q13.2,45024259,45143881,119622,-,-
BAC195_O06,19,19q13.2,45024265,45143875,119610,-,-
BAC36_A19,19,19q13.2,45096165,45185509,89344,-,-
BAC101_I22,19,19q13.2,45118568,45253414,134846,-,-
BAC117_G22,19,19q13.2,45140926,45288249,147323,-,-
BAC173_I21,19,19q13.2,45168227,45262268,94041,-,-
BAC200_A15,19,19q13.2,45168227,45289983,121756,-,-
BAC234_G22,19,19q13.2,45169846,45246807,76961,-,-
BAC133_D04,19,19q13.2,45199130,45293005,93875,-,-
BAC151_O01,19,19q13.2,45221794,45338263,116469,-,-
BAC73_A07,19,19q13.2,45247098,45352315,105217,-,-
BAC161_E06,19,19q13.2,45264434,45352303,87869,-,-
BAC21_K05,19,19q13.2,45289086,45387872,98786,-,-
BAC248_H13,19,19q13.2,45293073,45376799,83726,-,-
BAC101_M18,19,19q13.2,45336855,45490827,153972,-,-
BAC51_F15,19,19q13.2,45352308,45502392,150084,-,-
BAC149_G17,19,19q13.2,45388206,45490827,102621,-,-
BAC64_K04,19,19q13.2,45391137,45488456,97319,-,-
BAC55_K04,19,19q13.2,45406887,45550210,143323,-,-
BAC147_K21,19,19q13.2,45458542,45550208,91666,-,-
BAC144_F23,19,19q13.2,45458542,45549394,90852,-,-
BAC109_N16,19,19q13.2,45550202,45644361,94159,-,-
BAC204_K04,19,19q13.2,45573072,45662950,89878,-,-
BAC51_P16,19,19q13.2,45573110,45654911,81801,-,-
BAC234_P18,19,19q13.2,45594342,45682362,88020,-,-
BAC139_D09,19,19q13.2,45750410,45858854,108444,-,-
BAC152_J04,19,19q13.2,45777080,45858854,81774,-,-
BAC119_F19,19,19q13.2,45825299,45931942,106643,-,-
BAC193_L12,19,19q13.2,45862719,45948621,85902,-,-
BAC90_A12,19,19q13.2,45878591,45974489,95898,-,-
BAC232_J08,19,19q13.2,45930571,46028904,98333,-,-
BAC61_C10,19,19q13.2,45930571,46058092,127521,yes,-
BAC167_P17,19,19q13.2,45932137,46040301,108164,-,-
BAC136_N15,19,19q13.2,45943107,46058235,115128,yes,-
BAC162_J04,19,19q13.2,45952202,46028904,76702,-,-
BAC144_C16,19,19q13.2,45975406,46051217,75811,yes,-
BAC36_D17,19,19q13.2,46028896,46117786,88890,yes,-
BAC11_N07,19,19q13.2,46040906,46058092,17186,yes,-
BAC137_J21,19,19q13.2,46107559,46201381,93822,-,-
BAC80_P24,19,19q13.2,46143779,46276534,132755,-,-
BAC130_H04,19,19q13.2,46211715,46297610,85895,-,-
BAC59_K13,19,19q13.2,46277966,46372989,95023,-,-
BAC195_J02,19,19q13.2,46349624,46503041,153417,-,-
BAC101_G19,19,19q13.2,46373316,46465793,92477,-,-
BAC65_B21,19,19q13.2,46373483,46465793,92310,-,-
BAC144_E06,19,19q13.2,46373573,46465793,92220,-,-
BAC96_H18,19,19q13.2,46373573,46479871,106298,-,-
BAC137_A18,19,19q13.2,46373573,46465785,92212,-,-
BAC54_C19,19,19q13.2,46373577,46469880,96303,-,-
BAC95_P15,19,19q13.2,46380067,46480277,100210,-,-
BAC59_K24,19,19q13.2,46383399,46469561,86162,-,-
BAC57_L11,19,19q13.2,46383399,46472462,89063,-,-
BAC116_N08,19,19q13.2,46383483,46498536,115053,-,-
BAC129_A06,19,19q13.2,46478413,46572087,93674,-,-
BAC210_M15,19,19q13.2,46497293,46610905,113612,-,-
BAC109_O10,19,19q13.2,46505047,46603568,98521,-,-
BAC238_G03,19,19q13.2,46572233,46683547,111314,-,-
BAC108_M14,19,19q13.2,46628700,46771235,142535,-,-
BAC86_L21,19,19q13.2,46683545,46802889,119344,-,-
BAC90_K18,19,19q13.2,46695331,46812542,117211,-,-
BAC175_J17,19,19q13.2,46695675,46771235,75560,-,-
BAC239_L01,19,19q13.2,46695679,46781825,86146,-,-
BAC37_F18,19,19q13.2,46726683,46816015,89332,-,-
BAC75_D06,19,19q13.2,46729310,46830913,101603,-,-
BAC143_B06,19,19q13.2,46757326,46839775,82449,-,-
BAC144_I16,19,19q13.2,46865761,46959771,94010,-,-
BAC234_G03,19,19q13.2,46918854,47009091,90237,-,-
BAC25_J13,19,19q13.2,46941888,47045923,104035,-,-
BAC193_O22,19,19q13.2,46980778,47096619,115841,-,-
BAC105_F08,19,19q13.2,47014664,47095422,80758,-,-
BAC175_C17,19,19q13.2,47211131,47304580,93449,-,-
BAC53_G20,19,19q13.2,47217282,47336002,118720,-,-
BAC141_A23,19,19q13.2,47227816,47299020,71204,-,-
BAC244_C09,19,19q13.2,47304869,47404144,99275,-,-
BAC155_D20,19,19q13.2,47349115,47430270,81155,-,-
BAC242_N12,19,19q13.2,47448884,47556935,108051,-,-
BAC193_P16,19,19q13.2,47515457,47611223,95766,-,-
BAC110_P01,19,19q13.2,47526870,47634751,107881,-,-
BAC151_A20,19,19q13.2,47543493,47634751,91258,-,-
BAC116_L16,19,19q13.2,47556943,47640153,83210,-,-
BAC140_J04,19,19q13.2,47582624,47663249,80625,-,-
BAC234_E03,19,19q13.2,47612536,47710773,98237,-,-
BAC250_E09,19,19q13.2,47633481,47754472,120991,-,-
BAC66_G05,19,19q13.2,47637899,47763997,126098,-,-
BAC170_D06,19,19q13.2,47641754,47710767,69013,-,-
BAC239_L09,19,19q13.2,47647770,47764163,116393,-,-
BAC40_C17,19,19q13.2,47663248,47770331,107083,-,-
BAC75_I22,19,19q13.2,47695448,47787495,92047,-,-
BAC48_C06,19,19q13.2-19q13.31,47710790,47827029,116239,-,-
BAC231_I05,19,19q13.2-19q13.31,47754482,47837533,83051,-,-
BAC126_B17,19,19q13.2-19q13.31,47754485,47852101,97616,-,-
BAC235_M18,19,19q13.31,47826372,47913940,87568,-,-
BAC1_J18,19,19q13.31,47986787,48096055,109268,yes,-
BAC141_N13,19,19q13.31,48013537,48115219,101682,yes,-
BAC150_J02,19,19q13.31,48046977,48130781,83804,yes,-
BAC66_N10,19,19q13.31,48523933,48635180,111247,yes,-
BAC26_H09,19,19q13.31,48523937,48642721,118784,yes,-
BAC102_L18,19,19q13.31,48595172,48684448,89276,-,-
BAC151_N21,19,19q13.31,48721933,48843490,121557,-,-
BAC147_K15,19,19q13.31,48721933,48827891,105958,-,-
BAC230_L14,19,19q13.31,48732491,48837602,105111,-,-
BAC206_O04,19,19q13.31,48732654,48813454,80800,-,-
BAC153_C17,19,19q13.31,48735052,48837648,102596,-,-
BAC131_B11,19,19q13.31,48749483,48847991,98508,-,-
BAC239_N12,19,19q13.31,48749502,48847991,98489,-,-
BAC132_P05,19,19q13.31,48751473,48862062,110589,-,-
BAC113_N02,19,19q13.31,48751519,48847991,96472,-,-
BAC120_H21,19,19q13.31,48820477,48924627,104150,-,-
BAC78_D10,19,19q13.31,48847985,48958578,110593,-,-
BAC183_D06,19,19q13.31,48847985,48996158,148173,-,-
BAC43_G08,19,19q13.31,48847989,48936330,88341,-,-
BAC82_B04,19,19q13.31,48864646,49014183,149537,-,-
BAC78_M12,19,19q13.31,48918430,49025575,107145,-,-
BAC90_M04,19,19q13.31,48956621,49044471,87850,-,-
BAC175_C03,19,19q13.31,48958573,49044471,85898,-,-
BAC66_O09,19,19q13.31,49056761,49154981,98220,-,-
BAC159_G04,19,19q13.31,49101901,49184171,82270,-,-
BAC188_F19,19,19q13.31,49142321,49221192,78871,-,-
BAC158_B08,19,19q13.31,49174950,49257757,82807,-,-
BAC1_D14,19,19q13.31,49199142,49296355,97213,-,-
BAC199_C22,19,19q13.31,49224386,49346928,122542,-,-
BAC96_D03,19,19q13.31,49284318,49389783,105465,-,-
BAC115_M13,19,19q13.31,49344329,49419131,74802,-,-
BAC40_C23,19,19q13.31,49344331,49462914,118583,-,-
BAC156_K05,19,19q13.31,49445627,49546556,100929,-,-
BAC195_G17,19,19q13.31,49462908,49542203,79295,-,-
BAC56_N13,19,19q13.31,49522243,49631454,109211,-,-
BAC61_K21,19,19q13.31,49551452,49666739,115287,-,-
BAC70_F12,19,19q13.31,49585084,49678956,93872,-,-
BAC240_I23,19,19q13.31,49623722,49704271,80549,-,-
BAC169_N21,19,19q13.31,49631466,49739080,107614,-,-
BAC51_F03,19,19q13.31,49660041,49786443,126402,-,-
BAC169_M21,19,19q13.31,49687229,49797155,109926,-,-
BAC175_A05,19,19q13.31,49709363,49797235,87872,-,-
BAC198_D16,19,19q13.31,49709363,49797235,87872,-,-
BAC124_N13,19,19q13.31,49709363,49855058,145695,-,-
BAC148_N04,19,19q13.31,49709363,49786443,77080,-,-
BAC136_M23,19,19q13.31,49786433,49883247,96814,-,-
BAC240_J23,19,19q13.31,49835695,49910199,74504,-,-
BAC240_J15,19,19q13.31-19q13.32,49912792,50035879,123087,-,-
BAC151_A05,19,19q13.31-19q13.32,49924824,50030234,105410,-,-
BAC240_H15,19,19q13.31-19q13.32,49934259,50034832,100573,-,-
BAC80_M04,19,19q13.32,50124427,50239538,115111,-,-
BAC195_G09,19,19q13.32,50330628,50428313,97685,-,-
BAC231_B17,19,19q13.32,50376276,50485527,109251,-,-
BAC90_F19,19,19q13.32,50437284,50539929,102645,-,-
BAC124_J17,19,19q13.32,50461540,50579162,117622,-,-
BAC196_A12,19,19q13.32,50543540,50690274,146734,-,-
BAC195_K24,19,19q13.32,50602642,50751843,149201,-,-
BAC28_J13,19,19q13.32,50640510,50833841,193331,-,-
BAC233_C05,19,19q13.32,50661501,50753030,91529,-,-
BAC39_I20,19,19q13.32,50661503,50751846,90343,-,-
BAC175_H02,19,19q13.32,50664187,50751846,87659,-,-
BAC181_B24,19,19q13.32,50701344,50792842,91498,-,-
BAC51_A21,19,19q13.32,50763605,50893000,129395,-,-
BAC218_L03,19,19q13.32,50768202,50888846,120644,-,-
BAC51_H06,19,19q13.32,50770543,50949957,179414,-,-
BAC161_H18,19,19q13.32,50833904,50939135,105231,-,-
BAC155_D14,19,19q13.32,50833905,50965157,131252,-,-
BAC222_C08,19,19q13.32,51023148,51120148,97000,-,-
BAC152_G08,19,19q13.32,51023148,51120151,97003,-,-
BAC127_H14,19,19q13.32,51023148,51120151,97003,-,-
BAC192_D09,19,19q13.32,51120494,51236336,115842,-,-
BAC192_D13,19,19q13.32,51137022,51219260,82238,-,-
BAC30_K23,19,19q13.32,51219436,51308690,89254,-,-
BAC83_M13,19,19q13.32,51235859,51398682,162823,-,-
BAC24_L22,19,19q13.32,51262181,51365274,103093,-,-
BAC238_K14,19,19q13.32,51366250,51454812,88562,-,-
BAC29_B19,19,19q13.32,51412238,51511518,99280,-,-
BAC32_L01,19,19q13.32,51477371,51571481,94110,-,-
BAC107_M06,19,19q13.32,51536315,51661239,124924,-,-
BAC230_L20,19,19q13.32,51571619,51650918,79299,-,-
BAC103_P09,19,19q13.32,51742184,51854141,111957,-,-
BAC38_C05,19,19q13.32,51791166,51901518,110352,-,-
BAC56_D07,19,19q13.32,51797194,51910039,112845,-,-
BAC32_K09,19,19q13.32,51824302,51934475,110173,-,-
BAC88_F23,19,19q13.32,51824413,51940750,116337,-,-
BAC127_C03,19,19q13.32,51852110,51943842,91732,-,-
BAC219_E10,19,19q13.32,51854429,51944249,89820,-,-
BAC95_E03,19,19q13.32,51901525,52019291,117766,-,-
BAC36_J13,19,19q13.32,51937214,52045583,108369,-,-
BAC129_F13,19,19q13.32,51944284,52044924,100640,-,-
BAC36_D04,19,19q13.32,51944284,52045582,101298,-,-
BAC198_N12,19,19q13.32,51947930,52058745,110815,-,-
BAC72_E12,19,19q13.32,52094931,52190926,95995,-,-
BAC209_K11,19,19q13.32,52159676,52244659,84983,-,-
BAC206_G16,19,19q13.32,52162515,52276406,113891,-,-
BAC76_E22,19,19q13.32,52164544,52276406,111862,-,-
BAC159_O05,19,19q13.32,52181943,52323159,141216,-,-
BAC160_J13,19,19q13.32,52190922,52362686,171764,-,-
BAC143_O20,19,19q13.32,52216793,52297866,81073,-,-
BAC84_D13,19,19q13.32,52231401,52350104,118703,-,-
BAC100_F21,19,19q13.32,52405468,52542317,136849,-,-
BAC142_B07,19,19q13.32,52407480,52496454,88974,-,-
BAC49_N06,19,19q13.32,52407483,52544558,137075,-,-
BAC246_J08,19,19q13.32,52474055,52612574,138519,-,-
BAC176_H13,19,19q13.32,52542460,52663316,120856,-,-
BAC59_K14,19,19q13.32,52544683,52663316,118633,-,-
BAC2_I04,19,19q13.32,52612567,52742816,130249,-,-
BAC211_C23,19,19q13.32,52670886,52752357,81471,-,-
BAC38_L09,19,19q13.32,52671094,52778690,107596,-,-
BAC62_P08,19,19q13.32,52752976,52849634,96658,-,-
BAC248_J12,19,19q13.32,52795207,52896536,101329,-,-
BAC135_M24,19,19q13.32,52880377,52989763,109386,-,-
BAC149_E16,19,19q13.32,52896643,52989461,92818,-,-
BAC143_O12,19,19q13.32,52896643,52989101,92458,-,-
BAC110_O06,19,19q13.32,52957291,53073920,116629,-,-
BAC132_C15,19,19q13.32,52989183,53073915,84732,-,-
BAC36_C11,19,19q13.32,52989782,53171214,181432,-,-
BAC168_M05,19,19q13.32,52989783,53089600,99817,-,-
BAC58_O20,19,19q13.32,52995072,53073920,78848,-,-
BAC203_I18,19,19q13.32,52995289,53073920,78631,-,-
BAC214_O08,19,19q13.32,53094765,53155437,60672,-,-
BAC27_B20,19,19q13.32,53094765,53171214,76449,-,-
BAC178_D17,19,19q13.32,53094765,53169657,74892,-,-
BAC94_J21,19,19q13.32,53278259,53406867,128608,-,-
BAC78_O17,19,19q13.32,53285094,53438638,153544,-,-
BAC108_H09,19,19q13.32,53288802,53407468,118666,-,-
BAC83_D10,19,19q13.32,53296213,53407468,111255,-,-
BAC166_M12,19,19q13.32,53361049,53454509,93460,yes,-
BAC22_E07,19,19q13.32,53407131,53513083,105952,-,-
BAC143_F19,19,19q13.32,53421760,53623965,202205,yes,-
BAC46_N10,19,19q13.32,53453008,53559073,106065,-,-
BAC77_K06,19,19q13.32,53479799,53564342,84543,-,-
BAC61_A09,19,19q13.32,53479799,53611763,131964,yes,-
BAC156_E06,19,19q13.33,53801625,53923069,121444,-,-
BAC117_D09,19,19q13.33,54042934,54169497,126563,yes,-
BAC191_L05,19,19q13.33,54049303,54170666,121363,yes,-
BAC127_M21,19,19q13.33,54081497,54170666,89169,yes,-
BAC168_H24,19,19q13.33,54081497,54161699,80202,yes,-
BAC59_F02,19,19q13.33,54170659,54250053,79394,yes,-
BAC43_O02,19,19q13.33,54178723,54373554,194831,yes,-
BAC84_E12,19,19q13.33,54188289,54386957,198668,yes,-
BAC97_G03,19,19q13.33,54277161,54386930,109769,yes,-
BAC136_J21,19,19q13.33,54373846,54463036,89190,-,-
BAC34_G11,19,19q13.33,54373846,54519399,145553,-,-
BAC115_K24,19,19q13.33,54394346,54481759,87413,-,-
BAC224_O03,19,19q13.33,54410314,54514388,104074,-,-
BAC111_N05,19,19q13.33,54435424,54514384,78960,-,-
BAC49_F06,19,19q13.33,54463080,54565848,102768,yes,-
BAC226_J14,19,19q13.33,54481751,54574235,92484,yes,-
BAC233_O06,19,19q13.33,54511000,54589793,78793,yes,-
BAC211_B15,19,19q13.33,54533050,54646094,113044,yes,-
BAC77_E21,19,19q13.33,54709185,54840550,131365,yes,-
BAC68_G18,19,19q13.33,54712777,54825236,112459,-,-
BAC140_L24,19,19q13.33,54723423,54825896,102473,yes,-
BAC224_E02,19,19q13.33,54758263,54824667,66404,-,-
BAC102_O21,19,19q13.33,54758263,54912830,154567,yes,-
BAC142_G16,19,19q13.33,54839283,54928828,89545,yes,-
BAC41_L15,19,19q13.33,54979097,55067063,87966,yes,-
BAC221_P08,19,19q13.33,55026492,55106837,80345,yes,-
BAC65_C05,19,19q13.33,55122749,55245850,123101,yes,-
BAC235_A20,19,19q13.33,55146023,55241979,95956,yes,-
BAC24_I12,19,19q13.33,55378983,55407337,28354,-,-
BAC217_E07,19,19q13.33,55398036,55478638,80602,-,-
BAC236_D14,19,19q13.33,55398071,55481418,83347,-,-
BAC97_I15,19,19q13.33,55423369,55445143,21774,-,-
BAC169_A15,19,19q13.33,55512142,55669951,157809,-,-
BAC46_A04,19,19q13.33,55542148,55674651,132503,-,-
BAC148_C12,19,19q13.33,55602818,55715699,112881,-,-
BAC91_L06,19,19q13.33,55707294,55791168,83874,-,-
BAC139_O19,19,19q13.33,55707297,55809016,101719,-,-
BAC146_F15,19,19q13.33,55715798,55791168,75370,-,-
BAC46_A11,19,19q13.33,55744123,55861387,117264,-,-
BAC28_J20,19,19q13.33,55835910,55921269,85359,-,-
BAC59_L17,19,19q13.33,55933002,56044233,111231,-,-
BAC80_E08,19,19q13.33,56036379,56128866,92487,-,-
BAC122_H24,19,19q13.33,56041068,56128756,87688,-,-
BAC48_C02,19,19q13.33,56089503,56197157,107654,-,-
BAC230_I17,19,19q13.33,56089724,56194962,105238,-,-
BAC224_P13,19,19q13.33,56128859,56241374,112515,-,-
BAC107_J18,19,19q13.33,56128859,56214828,85969,-,-
BAC91_C01,19,19q13.33,56128875,56247761,118886,-,-
BAC57_B16,19,19q13.33,56194986,56327418,132432,-,-
BAC197_E19,19,19q13.33,56223321,56305047,81726,-,-
BAC96_E18,19,19q13.33,56327308,56422780,95472,-,-
BAC147_A18,19,19q13.33,56345105,56490753,145648,-,-
BAC60_L06,19,19q13.33,56371765,56488657,116892,-,-
BAC224_P14,19,19q13.33,56372239,56456914,84675,-,-
BAC89_B18,19,19q13.33,56491008,56659537,168529,-,-
BAC84_E08,19,19q13.33,56607564,56714302,106738,-,-
BAC182_J03,19,19q13.33,56607564,56723567,116003,-,-
BAC64_M09,19,19q13.33,56613150,56624430,11280,-,-
BAC23_B23,19,19q13.33,56667966,56813175,145209,-,-
BAC183_P17,19,19q13.33,56723649,56813175,89526,-,-
BAC250_M14,19,19q13.33,56733533,56813174,79641,-,-
BAC152_N02,19,19q13.33,56767915,56835235,67320,yes,-
BAC229_J19,19,19q13.33,56813170,56888749,75579,yes,-
BAC176_P17,19,19q13.33,56890757,56984963,94206,-,-
BAC186_H04,19,19q13.33,56905312,57000659,95347,-,-
BAC222_G04,19,19q13.33,56938885,57036929,98044,-,-
BAC107_A10,19,19q13.33,56939861,57055377,115516,-,-
BAC153_J10,19,19q13.33,56979660,57061419,81759,-,-
BAC51_D16,19,19q13.33,57036926,57123434,86508,-,-
BAC24_E06,19,19q13.33,57049755,57192953,143198,-,-
BAC60_M21,19,19q13.33,57131939,57225403,93464,-,-
BAC81_B24,19,19q13.33,57193106,57299566,106460,-,-
BAC238_P22,19,19q13.33,57213355,57297872,84517,-,-
BAC165_O12,19,19q13.33,57215274,57306117,90843,-,-
BAC105_H10,19,19q13.33,57216030,57303849,87819,-,-
BAC172_F03,19,19q13.33,57277203,57368180,90977,-,-
BAC242_J10,19,19q13.33,57277267,57368180,90913,-,-
BAC105_M21,19,19q13.33,57303884,57379611,75727,-,-
BAC41_K14,19,19q13.33,57328603,57484553,155950,-,-
BAC140_B16,19,19q13.33,57379627,57480755,101128,-,-
BAC250_P09,19,19q13.33,57379629,57480748,101119,-,-
BAC234_P20,19,19q13.33-19q13.41,57592798,57720308,127510,-,-
BAC199_B02,19,19q13.41,57634375,57729316,94941,-,-
BAC91_F03,19,19q13.41,57651701,57794736,143035,-,-
BAC92_G20,19,19q13.41,57720331,57843860,123529,-,-
BAC152_K20,19,19q13.41,57732013,57813712,81699,-,-
BAC229_P13,19,19q13.41,57843974,57935799,91825,-,-
BAC33_J22,19,19q13.41,57849180,57935799,86619,-,-
BAC176_L06,19,19q13.41,57874498,57994710,120212,-,-
BAC239_L08,19,19q13.41,57949392,58072829,123437,-,-
BAC157_L04,19,19q13.41,58002950,58072111,69161,-,-
BAC72_J16,19,19q13.41,58070343,58152780,82437,-,-
BAC12_M04,19,19q13.41,58071537,58197779,126242,-,-
BAC147_C12,19,19q13.41,58072976,58210854,137878,-,-
BAC129_L22,19,19q13.41,58072976,58165625,92649,-,-
BAC165_F18,19,19q13.41,58155286,58244301,89015,-,-
BAC62_C13,19,19q13.41,58209155,58335789,126634,-,-
BAC72_L02,19,19q13.41,58210852,58290888,80036,-,-
BAC112_K03,19,19q13.41,58255222,58344869,89647,-,-
BAC185_L16,19,19q13.41,58265083,58365962,100879,-,-
BAC69_P02,19,19q13.41,58336730,58433716,96986,-,-
BAC81_N10,19,19q13.41,58469307,58584830,115523,-,-
BAC37_J17,19,19q13.41,58609014,58716348,107334,-,-
BAC109_F16,19,19q13.41,58620821,58762412,141591,-,-
BAC24_F19,19,19q13.41,58868019,59007791,139772,-,-
BAC217_M20,19,19q13.41,58868202,58984041,115839,-,-
BAC44_I05,19,19q13.41,58872094,58960709,88615,-,-
BAC236_K14,19,19q13.41,58885362,58960717,75355,-,-
BAC129_O09,19,19q13.41,58885362,58960717,75355,-,-
BAC150_O21,19,19q13.41,58885362,58984041,98679,-,-
BAC59_L03,19,19q13.41,58885365,59049591,164226,-,-
BAC53_O15,19,19q13.41,58885369,59049642,164273,-,-
BAC180_O06,19,19q13.41,58885408,58986007,100599,-,-
BAC145_P14,19,19q13.41,58960712,59050708,89996,-,-
BAC52_E14,19,19q13.41,58986249,59096240,109991,-,-
BAC114_O01,19,19q13.41-19q13.42,59041314,59153968,112654,-,-
BAC78_D20,19,19q13.42,59113165,59233482,120317,-,-
BAC139_J07,19,19q13.42,59155161,59233482,78321,-,-
BAC44_H04,19,19q13.42,59255556,59359366,103810,-,-
BAC154_A20,19,19q13.42,59255556,59385605,130049,yes,-
BAC100_P09,19,19q13.42,59292709,59387354,94645,yes,-
BAC167_G08,19,19q13.42,59385606,59521904,136298,yes,-
BAC170_H17,19,19q13.42,59407361,59551312,143951,yes,-
BAC18_C20,19,19q13.42,59455900,59558242,102342,-,-
BAC237_O12,19,19q13.42,59484945,59554646,69701,yes,-
BAC26_M05,19,19q13.42,59646897,59731859,84962,-,-
BAC139_C13,19,19q13.42,59761406,59831931,70525,-,-
BAC167_J21,19,19q13.42,59862790,59952106,89316,-,-
BAC43_P05,19,19q13.42,59886294,60069305,183011,yes,-
BAC53_E05,19,19q13.42,59890818,60000952,110134,yes,-
BAC105_J03,19,19q13.42,59890839,60000948,110109,yes,-
BAC41_P09,19,19q13.42,59896954,59952106,55152,-,-
BAC140_E05,19,19q13.42,59952099,60029802,77703,yes,-
BAC105_K06,19,19q13.42,59983378,60076634,93256,-,-
BAC217_A08,19,19q13.42,60029795,60133641,103846,-,-
BAC146_C01,19,19q13.42,60047636,60124952,77316,-,-
BAC56_O23,19,19q13.42,60071235,60177950,106715,-,-
BAC80_B08,19,19q13.42,60083989,60231422,147433,-,-
BAC51_H23,19,19q13.42,60126264,60276966,150702,-,-
BAC113_L11,19,19q13.42,60129452,60213697,84245,-,-
BAC33_D10,19,19q13.42,60183807,60291985,108178,-,-
BAC195_O12,19,19q13.42,60278426,60373771,95345,-,-
BAC132_A01,19,19q13.42,60292421,60373771,81350,-,-
BAC148_F03,19,19q13.42,60299495,60402594,103099,-,-
BAC65_I15,19,19q13.42,60315009,60397768,82759,-,-
BAC12_H01,19,19q13.42,60430260,60525034,94774,-,-
BAC58_H16,19,19q13.42,60439789,60555670,115881,-,-
BAC61_M20,19,19q13.42,60544612,60629690,85078,-,-
BAC12_K15,19,19q13.42,60604764,60728726,123962,-,-
BAC11_P17,19,19q13.42,60616880,60728696,111816,-,-
BAC168_E17,19,19q13.42,60716206,60824180,107974,-,-
BAC75_O05,19,19q13.42,60716209,60807961,91752,-,-
BAC139_E06,19,19q13.42,60723179,60825857,102678,-,-
BAC101_H02,19,19q13.42,60824176,60920115,95939,-,-
BAC140_F04,19,19q13.42,60825895,60904133,78238,-,-
BAC157_L11,19,19q13.42,61043758,61124579,80821,-,-
BAC132_D10,19,19q13.42,61101405,61219321,117916,-,-
BAC112_L04,19,19q13.42,61122378,61219321,96943,-,-
BAC76_L16,19,19q13.42,61136858,61223381,86523,-,-
BAC217_M23,19,19q13.42,61140045,61220994,80949,-,-
BAC200_O10,19,19q13.42,61222441,61359849,137408,-,-
BAC42_E10,19,19q13.42,61223477,61383524,160047,-,-
BAC193_C07,19,19q13.42,61263496,61377134,113638,-,-
BAC189_G03,19,19q13.42,61269776,61377134,107358,-,-
BAC230_E14,19,19q13.42,61272095,61377134,105039,-,-
BAC145_N17,19,19q13.43,61581658,61699088,117430,-,-
BAC160_B05,19,19q13.43,61752868,61903696,150828,-,-
BAC230_O10,19,19q13.43,61757032,61858898,101866,-,-
BAC229_N09,19,19q13.43,61766644,61870712,104068,-,-
BAC67_J17,19,19q13.43,61766693,61866664,99971,-,-
BAC232_B02,19,19q13.43,61812224,61899041,86817,-,-
BAC210_J04,19,19q13.43,61870704,61969038,98334,-,-
BAC71_O07,19,19q13.43,61880381,61968808,88427,-,-
BAC65_M04,19,19q13.43,61903817,62056057,152240,-,-
BAC52_I05,19,19q13.43,62058866,62203615,144749,-,-
BAC198_O09,19,19q13.43,62103736,62189526,85790,-,-
BAC221_F10,19,19q13.43,62258327,62379213,120886,-,-
BAC150_H15,19,19q13.43,62299000,62424806,125806,-,-
BAC72_G02,19,19q13.43,62333171,62421559,88388,-,-
BAC49_D05,19,19q13.43,62338932,62443721,104789,-,-
BAC109_D14,19,19q13.43,62341880,62442135,100255,-,-
BAC178_I16,19,19q13.43,62345342,62421559,76217,-,-
BAC41_E08,19,19q13.43,62421552,62506399,84847,-,-
BAC42_G03,19,19q13.43,62442128,62615517,173389,-,-
BAC188_N13,19,19q13.43,62442128,62524646,82518,-,-
BAC100_I23,19,19q13.43,62478530,62568027,89497,-,-
BAC200_K10,19,19q13.43,62484764,62568027,83263,-,-
BAC90_D19,19,19q13.43,62521181,62617893,96712,-,-
BAC240_L22,19,19q13.43,62524639,62623009,98370,-,-
BAC158_E04,19,19q13.43,62528750,62615518,86768,-,-
BAC130_P01,19,19q13.43,62615643,62700896,85253,-,-
BAC241_D10,19,19q13.43,62618076,62737690,119614,-,-
BAC118_M01,19,19q13.43,62642497,62733468,90971,-,-
BAC49_F07,19,19q13.43,62642527,62737665,95138,-,-
BAC48_A12,19,19q13.43,62754265,62869405,115140,-,-
BAC235_N10,19,19q13.43,62782959,62860106,77147,-,-
BAC141_M10,19,19q13.43,62825271,62931552,106281,-,-
BAC109_H12,19,19q13.43,62835198,62931552,96354,-,-
BAC230_N10,19,19q13.43,62835206,62924448,89242,-,-
BAC205_H17,19,19q13.43,62882446,62972778,90332,-,-
BAC199_P09,19,19q13.43,62890273,62972753,82480,-,-
BAC51_B09,19,19q13.43,62924443,63076414,151971,-,-
BAC201_D23,19,19q13.43,62924726,63048577,123851,-,-
BAC209_B18,19,19q13.43,62953156,63040140,86984,-,-
BAC205_I01,19,19q13.43,62992785,63076189,83404,-,-
BAC241_O11,19,19q13.43,63029546,63124460,94914,-,-
BAC90_O20,19,19q13.43,63076423,63173654,97231,-,-
BAC116_D02,19,19q13.43,63081659,63184445,102786,-,-
BAC176_D06,19,19q13.43,63107766,63186251,78485,-,-
BAC202_K23,19,19q13.43,63110478,63190100,79622,-,-
BAC60_E08,19,19q13.43,63190189,63282704,92515,-,-
BAC230_L04,19,19q13.43,63190190,63286225,96035,-,-
BAC194_E18,19,19q13.43,63205131,63286225,81094,-,-
BAC104_I06,19,19q13.43,63205131,63329795,124664,-,-
BAC157_G02,19,19q13.43,63282819,63440542,157723,-,-
BAC42_A21,19,19q13.43,63308173,63420212,112039,-,-
BAC183_E01,19,19q13.43,63329851,63450018,120167,-,-
BAC65_B12,19,19q13.43,63329851,63406758,76907,-,-
BAC191_D15,19,19q13.43,63332727,63419823,87096,-,-
BAC31_A13,19,19q13.43,63372999,63517476,144477,-,-
BAC108_J12,19,19q13.43,63440536,63543177,102641,-,-
BAC90_B10,19,19q13.43,63450011,63542719,92708,-,-
BAC176_J13,19,19q13.43,63458760,63543181,84421,-,-
BAC242_F12,19,19q13.43,63509550,63633275,123725,-,-
BAC46_F12,19,19q13.43,63514615,63629584,114969,-,-
BAC37_L23,19,19q13.43,63629331,63737196,107865,-,-
BAC179_M07,20,20p13,8025,96874,88849,-,yes
BAC67_B01,20,20p13,86151,195494,109343,-,yes
BAC35_A09,20,20p13,86271,195417,109146,-,-
BAC135_B19,20,20p13,97107,187446,90339,-,-
BAC81_C17,20,20p13,168400,329358,160958,-,yes
BAC250_E24,20,20p13,192530,311334,118804,-,-
BAC235_P15,20,20p13,193140,273602,80462,-,-
BAC117_J16,20,20p13,257228,366944,109716,-,-
BAC107_B07,20,20p13,259649,363638,103989,-,-
BAC114_E07,20,20p13,289646,421622,131976,-,-
BAC187_E09,20,20p13,311332,442050,130718,-,yes
BAC236_D15,20,20p13,363632,447072,83440,-,-
BAC197_B17,20,20p13,366949,468416,101467,-,-
BAC242_D03,20,20p13,366986,451183,84197,-,-
BAC43_O04,20,20p13,393295,484239,90944,-,-
BAC144_N23,20,20p13,396891,484245,87354,-,-
BAC82_K16,20,20p13,396894,513048,116154,-,yes
BAC24_H04,20,20p13,407592,485712,78120,-,-
BAC86_O05,20,20p13,421621,513048,91427,-,-
BAC18_B12,20,20p13,496565,577427,80862,-,yes
BAC101_F06,20,20p13,513073,611281,98208,-,-
BAC31_H14,20,20p13,574054,718407,144353,-,yes
BAC199_L21,20,20p13,602524,691386,88862,-,-
BAC75_G10,20,20p13,602554,713538,110984,-,-
BAC241_L21,20,20p13,602564,705361,102797,-,-
BAC13_B04,20,20p13,705510,818280,112770,-,-
BAC156_D10,20,20p13,705510,823361,117851,-,yes
BAC132_A18,20,20p13,755465,939398,183933,-,yes
BAC130_L16,20,20p13,755469,835661,80192,-,-
BAC218_P18,20,20p13,843250,939434,96184,-,-
BAC63_A13,20,20p13,843270,965650,122380,-,-
BAC140_M15,20,20p13,857992,968921,110929,-,-
BAC50_E21,20,20p13,857992,935662,77670,-,-
BAC238_P02,20,20p13,881186,990999,109813,-,-
BAC108_C14,20,20p13,885555,990090,104535,-,-
BAC40_E05,20,20p13,903677,1013645,109968,-,yes
BAC82_M01,20,20p13,935174,973829,38655,-,-
BAC246_P15,20,20p13,953905,1091358,137453,-,yes
BAC10_O06,20,20p13,973822,1061246,87424,-,-
BAC123_K20,20,20p13,974446,1059235,84789,-,-
BAC103_N20,20,20p13,991011,1079533,88522,-,-
BAC59_E03,20,20p13,993424,1090482,97058,-,-
BAC124_P17,20,20p13,1013646,1106347,92701,-,yes
BAC76_K21,20,20p13,1146842,1219848,73006,-,yes
BAC240_A10,20,20p13,1159237,1236651,77414,-,-
BAC198_E12,20,20p13,1207044,1290428,83384,-,-
BAC52_P13,20,20p13,1216431,1347883,131452,-,yes
BAC80_D05,20,20p13,1216431,1324621,108190,-,-
BAC191_K06,20,20p13,1236725,1328657,91932,-,-
BAC25_F08,20,20p13,1236737,1320376,83639,-,-
BAC168_B22,20,20p13,1271113,1366004,94891,-,yes
BAC113_F11,20,BAC113-M13R_F11_070.ab1,1376905,1475750,98845,-,-
BAC26_N18,20,20p13,1414734,1601037,186303,yes,yes
BAC113_E14,20,20p13,1422809,1518963,96154,yes,-
BAC118_L13,20,20p13,1458390,1610314,151924,yes,yes
BAC238_B06,20,20p13,1468037,1558175,90138,yes,-
BAC229_F05,20,20p13,1476087,1565893,89806,yes,-
BAC33_H16,20,20p13,1476586,1583292,106706,yes,-
BAC230_H14,20,20p13,1476588,1607365,130777,yes,-
BAC107_B15,20,20p13,1619844,1711173,91329,-,yes
BAC228_K04,20,20p13,1619849,1701372,81523,-,-
BAC1_N22,20,20p13,1647234,1740676,93442,-,-
BAC20_B19,20,20p13,1647253,1752700,105447,-,yes
BAC11_B07,20,BAC11-T7_B07_004.ab1,1712123,1801989,89866,-,-
BAC92_K15,20,20p13,1796488,1896787,100299,-,yes
BAC36_G02,20,20p13,1907298,2062552,155254,-,yes
BAC220_D07,20,20p13,1911171,2026393,115222,-,-
BAC231_D23,20,20p13,1960458,2103543,143085,-,-
BAC15_A01,20,20p13,2027511,2146358,118847,-,-
BAC69_K23,20,20p13,2049536,2152841,103305,-,-
BAC39_C17,20,20p13,2056953,2168144,111191,-,yes
BAC151_D17,20,20p13,2097849,2186581,88732,-,-
BAC32_N18,20,20p13,2115306,2224993,109687,-,yes
BAC90_K13,20,20p13,2217437,2320749,103312,-,yes
BAC232_J06,20,20p13,2244608,2344156,99548,-,-
BAC209_J04,20,20p13,2245272,2320722,75450,-,-
BAC161_G02,20,20p13,2258899,2362630,103731,-,-
BAC63_D24,20,20p13,2270384,2347779,77395,-,-
BAC226_D09,20,20p13,2296820,2384955,88135,-,yes
BAC233_J06,20,20p13,2344149,2412611,68462,-,-
BAC106_K14,20,20p13,2362664,2449615,86951,-,yes
BAC11_L06,20,20p13,2418658,2511778,93120,-,yes
BAC63_A04,20,20p13,2463669,2567374,103705,-,-
BAC14_G01,20,20p13,2476428,2606052,129624,-,-
BAC133_O22,20,20p13,2483332,2570984,87652,-,-
BAC133_A23,20,20p13,2494971,2585451,90480,-,-
BAC89_D14,20,20p13,2494971,2631073,136102,-,yes
BAC33_D19,20,20p13,2494971,2596990,102019,-,-
BAC194_E11,20,20p13,2494971,2631073,136102,-,-
BAC132_M19,20,20p13,2522582,2614524,91942,-,-
BAC64_B18,20,20p13,2527079,2665341,138262,-,-
BAC150_C18,20,20p13,2534647,2630091,95444,-,-
BAC242_D01,20,20p13,2534919,2631122,96203,-,-
BAC46_A01,20,20p13,2537845,2658809,120964,-,-
BAC168_J14,20,20p13,2553392,2671034,117642,-,-
BAC177_L15,20,20p13,2567560,2685974,118414,-,yes
BAC125_C24,20,20p13,2640519,2816484,175965,-,yes
BAC34_L04,20,20p13,2696390,2810648,114258,-,-
BAC59_I12,20,20p13,2709297,2835011,125714,-,yes
BAC41_G20,20,20p13,2830997,2942907,111910,-,yes
BAC219_J07,20,20p13,2835005,2925583,90578,-,-
BAC4_J12,20,BAC4-M13R_J12_086.ab1,2884807,2990543,105736,-,-
BAC171_H07,20,20p13,3012330,3142424,130094,-,yes
BAC32_K06,20,20p13,3073819,3210094,136275,-,-
BAC242_A12,20,20p13,3074104,3204084,129980,-,-
BAC112_M03,20,20p13,3078830,3184274,105444,-,-
BAC33_I05,20,20p13,3142423,3234283,91860,-,yes
BAC116_J02,20,20p13,3208401,3329631,121230,-,yes
BAC78_K11,20,20p13,3250521,3329632,79111,-,yes
BAC41_D01,20,20p13,3348842,3443968,95126,-,yes
BAC70_C04,20,20p13,3424059,3538835,114776,-,yes
BAC91_I02,20,20p13,3477798,3572317,94519,-,-
BAC109_E03,20,20p13,3510612,3607783,97171,-,-
BAC6_J07,20,20p13,3538829,3645999,107170,-,yes
BAC247_H06,20,20p13,3541859,3635761,93902,-,-
BAC100_M02,20,20p13,3566255,3694529,128274,-,yes
BAC108_C08,20,20p13,3566262,3657912,91650,-,-
BAC208_F19,20,BAC208-M13R_F19_006.ab1,3667469,3769886,102417,-,-
BAC165_M22,20,20p13,3755125,3849699,94574,-,yes
BAC219_P03,20,20p13,3796170,3880101,83931,-,yes
BAC85_P14,20,BAC85-T7_P14_032.ab1,3852865,3950787,97922,-,-
BAC62_K15,20,BAC62-T7_K15_045.ab1,3937951,4080177,142226,-,-
BAC230_A23,20,20p13,3953696,4057283,103587,-,yes
BAC158_M13,20,20p13,3953708,4075131,121423,-,yes
BAC157_G13,20,20p13,3968792,4064919,96127,-,-
BAC249_L17,20,20p13,3968792,4075130,106338,-,-
BAC169_D23,20,20p13,3969975,4057303,87328,-,-
BAC57_G02,20,20p13,4057297,4149665,92368,-,yes
BAC20_G07,20,20p13,4149661,4252783,103122,-,yes
BAC127_H15,20,20p13,4198804,4288343,89539,-,yes
BAC138_N21,20,BAC138-M13R_N21_050.ab1,4301282,4409555,108273,-,-
BAC219_L14,20,20p13,4375313,4456232,80919,-,yes
BAC161_O20,20,20p13,4516857,4589802,72945,-,yes
BAC125_J18,20,20p13,4550005,4653734,103729,-,-
BAC55_B23,20,20p13,4566134,4664709,98575,-,-
BAC130_N01,20,20p13,4582117,4692850,110733,-,yes
BAC95_O08,20,20p13,4589878,4693759,103881,-,-
BAC111_E10,20,20p13,4589974,4693507,103533,-,-
BAC82_P06,20,20p13,4591079,4692850,101771,-,-
BAC176_C14,20,20p13,4598258,4677642,79384,-,-
BAC172_O16,20,20p13,4618606,4705611,87005,-,yes
REBAC194_B12,20,REBAC194-T7_B12_085.ab1,4635132,4753259,118127,-,-
BAC151_E17,20,20p13,4767310,4893478,126168,-,yes
BAC41_I21,20,20p13,4779838,4918659,138821,-,-
BAC69_D10,20,20p13,4820082,4918659,98577,-,-
BAC9_B20,20,20p13,4843231,4961583,118352,-,yes
BAC64_E03,20,BAC64-T7_E03_035.ab1,4968729,5049132,80403,-,-
BAC195_N05,20,20p13-20p12.3,4985950,5086580,100630,-,yes
BAC207_L06,20,20p13-20p12.3,4999784,5082599,82815,-,-
BAC127_K22,20,20p12.3,5032605,5123724,91119,-,-
BAC146_J15,20,20p12.3,5082798,5184300,101502,-,yes
BAC157_L15,20,20p12.3,5116728,5200407,83679,-,-
BAC106_O09,20,20p12.3,5179794,5278580,98786,-,yes
BAC61_G08,20,20p12.3,5292700,5380729,88029,-,yes
BAC64_F21,20,20p12.3,5293545,5366618,73073,-,-
BAC38_J23,20,BAC38-T7_J23_070.ab1,5326014,5453163,127149,-,-
BAC59_G17,20,20p12.3,5392971,5528691,135720,-,yes
BAC248_H09,20,20p12.3,5479230,5564879,85649,-,yes
BAC85_D15,20,BAC85-T7_D15_042.ab1,5549094,5656341,107247,-,-
BAC251_J16,20,BAC251-M13R_J16_054.ab1,5660613,5749416,88803,-,-
BAC149_H16,20,20p12.3,5672692,5749447,76755,-,yes
BAC144_D18,20,20p12.3,5680284,5790529,110245,-,-
BAC152_P03,20,20p12.3,5695138,5802416,107278,-,-
BAC36_L24,20,20p12.3,5701832,5794908,93076,-,-
BAC146_I08,20,20p12.3,5714640,5802417,87777,-,-
BAC95_M22,20,20p12.3,5731313,5864572,133259,-,yes
BAC171_B20,20,20p12.3,5827095,5924009,96914,-,yes
BAC119_F17,20,20p12.3,5871847,6002349,130502,-,yes
BAC152_B08,20,20p12.3,5877471,6002293,124822,-,-
BAC247_G23,20,20p12.3,5931640,6018230,86590,-,-
BAC34_O22,20,20p12.3,5977078,6066675,89597,-,yes
BAC248_J13,20,20p12.3,6044582,6144067,99485,-,yes
BAC65_B17,20,20p12.3,6189499,6282901,93402,-,yes
BAC135_F12,20,20p12.3,6193931,6282901,88970,-,-
BAC62_J02,20,20p12.3,6215804,6342782,126978,-,yes
BAC109_A08,20,20p12.3,6311822,6445799,133977,-,yes
BAC91_C21,20,20p12.3,6364680,6481530,116850,-,-
BAC211_L18,20,BAC211-M13R_L18_101.ab1,6396231,6491604,95373,-,-
BAC211_O18,20,20p12.3,6396232,6491429,95197,-,yes
BAC38_H20,20,BAC38-M13R_H20_028.ab1,6629688,6718628,88940,-,-
BAC198_L07,20,20p12.3,6705296,6792811,87515,-,yes
BAC202_A08,20,20p12.3,6801192,6896054,94862,-,yes
BAC22_F05,20,20p12.3,6842000,6926719,84719,-,yes
BAC243_O11,20,20p12.3,6999940,7099276,99336,-,yes
BAC147_I02,20,20p12.3,7310631,7407868,97237,-,yes
BAC232_F12,20,20p12.3,7310874,7394450,83576,-,-
BAC73_D13,20,20p12.3,7324652,7435677,111025,-,-
BAC28_P15,20,20p12.3,7352697,7441306,88609,-,yes
BAC29_L03,20,BAC29-T7_L03_046.ab1,7419665,7574053,154388,-,-
BAC248_C12,20,20p12.3,7555438,7665436,109998,-,yes
BAC170_C07,20,20p12.3,7592304,7706429,114125,-,-
BAC142_N06,20,20p12.3,7641246,7730171,88925,-,-
BAC247_E13,20,20p12.3,7651654,7745576,93922,-,yes
BAC125_M20,20,20p12.3,7809848,7907244,97396,-,yes
BAC134_D24,20,20p12.3,7829450,7907244,77794,-,-
BAC102_D09,20,20p12.3,7860425,7995213,134788,-,yes
BAC214_A12,20,20p12.3,7975702,8061683,85981,-,yes
BAC124_E07,20,20p12.3,7997136,8094813,97677,-,-
BAC115_P14,20,20p12.3,8027227,8141856,114629,-,yes
BAC160_G04,20,20p12.3,8134006,8221390,87384,-,-
BAC22_O11,20,20p12.3,8139305,8230859,91554,-,yes
BAC231_D13,20,20p12.3,8286851,8374849,87998,-,yes
BAC133_H22,20,20p12.3,8304670,8389401,84731,-,-
BAC251_A13,20,BAC251-M13R_A13_001.ab1,8311282,8384884,73602,-,-
BAC66_L07,20,20p12.3,8374844,8458685,83841,-,yes
BAC180_O16,20,20p12.3,8515245,8612106,96861,-,yes
BAC116_A07,20,20p12.3,8592320,8684335,92015,-,yes
BAC62_C20,20,BAC62-T7_C20_025.ab1,8669561,8761023,91462,-,-
BAC155_K05,20,20p12.3,8707534,8797732,90198,-,yes
BAC125_M21,20,20p12.3,8729375,8823726,94351,-,-
BAC187_P07,20,20p12.3,8768933,8850915,81982,-,yes
BAC218_C17,20,20p12.3-20p12.2,8896371,9011104,114733,-,yes
BAC235_N18,20,20p12.3-20p12.2,8937623,9062605,124982,-,yes
BAC27_A11,20,20p12.2,9018902,9121654,102752,-,yes
BAC97_B18,20,20p12.2,9064795,9215225,150430,-,yes
BAC27_B10,20,20p12.2,9064795,9192610,127815,-,-
BAC177_E07,20,20p12.2,9123613,9207647,84034,-,-
BAC191_G01,20,20p12.2,9135164,9257861,122697,-,-
BAC169_D06,20,20p12.2,9150758,9257861,107103,-,-
BAC139_L13,20,20p12.2,9171099,9257861,86762,-,-
BAC143_E21,20,20p12.2,9192678,9291270,98592,-,yes
BAC163_G19,20,BAC163-T7_G19_011.ab1,9223032,9304272,81240,-,-
BAC233_D09,20,20p12.2,9297574,9369516,71942,-,yes
BAC57_H02,20,20p12.2,9378278,9557157,178879,-,yes
BAC176_N15,20,20p12.2,9417688,9531295,113607,-,-
BAC65_B10,20,20p12.2,9458180,9590681,132501,-,yes
BAC104_A01,20,20p12.2,9564450,9674037,109587,-,yes
BAC86_O10,20,20p12.2,9639769,9650301,10532,-,-
BAC101_F14,20,BAC101-T7_F14_023.ab1,9653827,9754165,100338,-,-
BAC159_N12,20,20p12.2,9738425,9832372,93947,-,yes
BAC65_K13,20,BAC65-M13R_K13_015.ab1,9874235,10005724,131489,-,-
BAC37_D05,20,20p12.2,9887201,10005760,118559,-,yes
BAC234_N08,20,20p12.2,9929665,10020924,91259,-,-
BAC197_N14,20,20p12.2,9932698,10030302,97604,-,-
BAC114_L07,20,20p12.2,9975306,10061440,86134,-,-
BAC48_G04,20,20p12.2,9975322,10081596,106274,-,-
BAC104_C20,20,BAC104-M13R_C20_025.ab1,9996643,1009338,-8987305,-,-
BAC83_M14,20,20p12.2,10005751,10083481,77730,-,yes
BAC235_P04,20,20p12.2,10174495,10257494,82999,-,yes
BAC60_M13,20,20p12.2,10209989,10320478,110489,-,-
BAC27_D15,20,20p12.2,10223724,10314890,91166,-,-
BAC76_N12,20,20p12.2,10256766,10359116,102350,-,yes
BAC230_D10,20,20p12.2,10257499,10341906,84407,-,-
BAC37_F11,20,20p12.2,10264876,10355671,90795,-,-
BAC195_O02,20,20p12.2,10266979,10355677,88698,-,-
BAC86_I02,20,20p12.2,10266993,10407118,140125,-,-
BAC249_K23,20,20p12.2,10327157,10413812,86655,-,-
BAC71_O17,20,20p12.2,10347607,10454062,106455,-,yes
BAC191_A11,20,20p12.2,10359131,10465709,106578,-,-
BAC125_N23,20,20p12.2,10384998,10481456,96458,-,-
BAC64_C24,20,20p12.2,10407148,10502539,95391,-,yes
BAC190_N02,20,20p12.2,10407148,10487491,80343,-,-
BAC168_H22,20,20p12.2,10476137,10584904,108767,-,-
BAC116_H04,20,20p12.2,10477731,10569968,92237,-,-
BAC144_I03,20,20p12.2,10487789,10584904,97115,-,-
BAC101_L24,20,20p12.2,10494094,10617762,123668,-,yes
BAC220_J06,20,20p12.2,10502532,10584901,82369,-,-
BAC86_O12,20,20p12.2,10532761,10669012,136251,-,-
BAC247_K09,20,20p12.2,10566085,10662978,96893,-,-
BAC132_D07,20,20p12.2,10571348,10657616,86268,-,-
BAC235_M12,20,20p12.2,10571348,10649601,78253,-,-
BAC51_B06,20,20p12.2,10593538,10693442,99904,-,yes
BAC131_O20,20,20p12.2,10634056,10719870,85814,-,-
BAC246_A01,20,20p12.2,10740711,10818756,78045,-,yes
BAC126_G22,20,20p12.2,10780629,10894533,113904,-,yes
BAC41_M08,20,20p12.2,10836124,10950690,114566,-,yes
BAC130_M15,20,BAC130-M13R_M15_049.ab1,10883366,10971485,88119,-,-
BAC239_H22,20,BAC239-M13R_H22_061.ab1,10991963,11091963,100000,-,-
BAC239_K22,20,20p12.2,11012743,11091963,79220,-,yes
BAC151_C24,20,20p12.2,11025065,11116390,91325,-,-
BAC167_D01,20,20p12.2,11072677,11158301,85624,-,yes
BAC184_I05,20,20p12.2,11334787,11468925,134138,-,yes
BAC140_D16,20,20p12.2,11340449,11451769,111320,-,-
BAC36_N05,20,20p12.2,11365241,11468951,103710,-,-
BAC237_M24,20,20p12.2,11419191,11498497,79306,-,-
BAC75_I05,20,20p12.2,11451766,11546519,94753,-,yes
BAC250_L14,20,20p12.2,11514917,11595617,80700,-,yes
BAC225_L15,20,20p12.2,11556734,11650405,93671,-,yes
BAC218_D10,20,20p12.2,11628143,11705988,77845,-,-
BAC56_E12,20,20p12.2,11634657,11743418,108761,-,yes
BAC63_K24,20,20p12.2,11743412,11848160,104748,-,yes
BAC251_B12,20,BAC251-M13R_B12_082.ab1,11753278,11835982,82704,-,-
BAC169_J09,20,20p12.2-20p12.1,11889525,11963355,73830,-,yes
BAC220_L02,20,20p12.1,11931056,12014985,83929,-,yes
BAC12_J17,20,20p12.1,12004911,12098854,93943,-,yes
BAC155_P20,20,20p12.1,12088091,12173548,85457,-,yes
BAC86_F23,20,20p12.1,12127159,12229395,102236,-,yes
BAC94_O06,20,BAC94-M13R_O06_095.ab1,12217918,12322559,104641,-,-
BAC103_L16,20,20p12.1,12240895,12330337,89442,-,yes
BAC133_M18,20,20p12.1,12329098,12405907,76809,-,yes
BAC211_M12,20,20p12.1,12330580,12405449,74869,-,-
BAC248_L09,20,20p12.1,12397156,12483238,86082,-,-
BAC81_I19,20,20p12.1,12405090,12556300,151210,-,yes
BAC156_H11,20,20p12.1,12421709,12508378,86669,-,-
BAC220_F13,20,20p12.1,12424028,12514808,90780,-,-
BAC165_M10,20,20p12.1,12524717,12613032,88315,-,yes
BAC232_G09,20,BAC232-M13R_G09_043.ab1,12526387,12647679,121292,-,-
REBAC190_D20,20,REBAC190-T7_D20_026.ab1,12619314,12717654,98340,-,-
BAC238_B18,20,20p12.1,12656007,12745068,89061,-,yes
BAC53_L04,20,20p12.1,12660287,12804634,144347,-,yes
BAC236_E04,20,20p12.1,12776464,12849758,73294,-,-
BAC50_M09,20,20p12.1,12791855,12892426,100571,-,yes
BAC208_J09,20,20p12.1,12913003,12995378,82375,-,yes
BAC144_C15,20,20p12.1,12921490,13038438,116948,-,yes
BAC185_D11,20,BAC185-T7_D11_076.ab1,13007226,13099881,92655,-,-
BAC175_K05,20,20p12.1,13058551,13143166,84615,-,yes
BAC133_L08,20,20p12.1,13075987,13212669,136682,-,yes
BAC148_D10,20,20p12.1,13129485,13207573,78088,-,-
BAC118_M07,20,20p12.1,13143286,13212670,69384,-,yes
BAC27_H05,20,20p12.1,13212672,13288966,76294,-,yes
BAC203_F07,20,20p12.1,13221987,13314277,92290,-,-
BAC46_I22,20,20p12.1,13221992,13320223,98231,-,-
BAC37_H17,20,20p12.1,13253259,13361245,107986,-,yes
BAC67_H24,20,20p12.1,13291860,13398814,106954,-,yes
BAC201_J01,20,BAC201-M13R_J01_008.ab1,13437947,13520457,82510,-,-
BAC45_F23,20,BAC45-T7_F23_068.ab1,13556315,13634124,77809,-,-
BAC49_F23,20,20p12.1,13572979,13704374,131395,-,yes
BAC168_F07,20,20p12.1,13619869,13633519,13650,-,-
BAC119_O24,20,20p12.1,13634164,13769855,135691,-,yes
BAC167_H16,20,20p12.1,13769847,13912010,142163,-,yes
BAC70_J11,20,20p12.1,13798605,13880887,82282,-,-
BAC53_I23,20,20p12.1,13877597,13988692,111095,-,yes
BAC82_J21,20,20p12.1,13912191,14042403,130212,-,-
BAC108_P09,20,20p12.1,13977165,14057160,79995,-,yes
BAC83_F14,20,20p12.1,13989560,14103349,113789,-,yes
BAC21_D20,20,20p12.1,14057792,14223204,165412,-,yes
BAC139_I15,20,20p12.1,14067461,14164977,97516,-,-
BAC123_O22,20,20p12.1,14117096,14229107,112011,-,-
BAC217_B04,20,20p12.1,14133420,14266291,132871,-,-
BAC124_A14,20,20p12.1,14135325,14223213,87888,-,-
BAC245_E22,20,BAC245-M13R_E22_053.ab1,14220421,14303931,83510,-,-
BAC86_H16,20,20p12.1,14220422,14303815,83393,-,yes
BAC201_L13,20,BAC201-M13R_L13_016.ab1,14223206,14321689,98483,-,-
BAC67_D18,20,20p12.1,14223207,14310197,86990,-,-
BAC175_A10,20,20p12.1,14223207,14321720,98513,-,yes
BAC48_H22,20,BAC48-M13R_H22_064.ab1,14365842,14469725,103883,-,-
BAC174_I18,20,BAC174-M13R_I18_087.ab1,14469751,14562881,93130,-,-
BAC220_N08,20,20p12.1,14506483,14599550,93067,-,yes
BAC32_M01,20,20p12.1,14562908,14659126,96218,-,yes
BAC70_I12,20,20p12.1,14681966,14766128,84162,-,yes
BAC18_L16,20,20p12.1,14691117,14783222,92105,-,-
BAC86_O11,20,20p12.1,14726014,14879272,153258,-,yes
BAC83_F23,20,20p12.1,14793620,14880222,86602,-,-
BAC107_A13,20,20p12.1,14839435,14947576,108141,-,-
BAC119_E22,20,20p12.1,14865252,14989574,124322,-,yes
BAC85_N07,20,20p12.1,14946445,15052993,106548,-,yes
BAC157_L05,20,20p12.1,15081054,15165885,84831,-,yes
BAC114_P15,20,20p12.1,15100793,15190939,90146,-,-
BAC239_N01,20,20p12.1,15165881,15259514,93633,-,yes
BAC158_O23,20,20p12.1,15231596,15312065,80469,-,yes
BAC156_J14,20,20p12.1,15259541,15388128,128587,-,-
BAC81_M07,20,20p12.1,15275441,15402280,126839,-,yes
BAC141_J22,20,20p12.1,15375323,15472115,96792,-,yes
BAC76_B13,20,20p12.1,15542240,15645220,102980,-,yes
BAC29_M05,20,20p12.1,15597434,15710898,113464,-,-
BAC53_K23,20,20p12.1,15645214,15776454,131240,-,yes
BAC9_F08,20,20p12.1,15679948,15753113,73165,-,-
BAC180_H02,20,20p12.1,15723426,15810906,87480,-,yes
REBAC224_H24,20,REBAC224-M13R_H24_096.ab1,15753908,15831093,77185,-,-
BAC19_N15,20,20p12.1,15869973,15959241,89268,-,yes
BAC167_P14,20,20p12.1,15869984,15988918,118934,-,-
BAC57_F04,20,20p12.1,15925384,15996978,71594,-,-
BAC213_O19,20,20p12.1,15952140,16038131,85991,-,yes
BAC72_O05,20,BAC72-T7_O05_091.ab1,16043183,16155140,111957,-,-
BAC233_J21,20,20p12.1,16049706,16071604,21898,-,yes
BAC250_I05,20,20p12.1,16107679,16223653,115974,-,yes
BAC81_K08,20,20p12.1,16123101,16211760,88659,-,-
BAC233_K20,20,20p12.1,16171259,16263434,92175,-,-
BAC12_M10,20,20p12.1,16223645,16308397,84752,-,yes
BAC146_B04,20,20p12.1,16231510,16308400,76890,-,-
BAC28_J16,20,20p12.1,16257946,16381421,123475,-,-
BAC235_J09,20,20p12.1,16271369,16324187,52818,-,-
BAC26_J24,20,20p12.1,16274790,16388873,114083,-,yes
BAC110_M03,20,20p12.1,16311416,16433641,122225,-,yes
BAC247_G11,20,20p12.1,16432424,16559907,127483,-,yes
BAC144_B16,20,20p12.1,16472651,16605920,133269,-,-
BAC23_I12,20,20p12.1,16492111,16618598,126487,-,-
BAC117_P16,20,20p12.1,16536698,16653025,116327,-,yes
BAC161_G11,20,20p12.1,16578263,16669259,90996,-,-
BAC169_K13,20,20p12.1,16579621,16652253,72632,-,-
BAC158_F02,20,20p12.1,16616859,16735082,118223,-,yes
BAC58_J05,20,20p12.1,16721284,16795500,74216,-,yes
BAC136_B01,20,20p12.1,16735224,16824346,89122,-,yes
BAC14_H05,20,BAC14-T7_H05_076.ab1,16755568,16879395,123827,-,-
BAC71_B13,20,BAC71-M13R_B13_004.ab1,16929457,17054426,124969,-,-
BAC125_L19,20,20p12.1,16944819,17045804,100985,-,yes
BAC155_J20,20,20p12.1,16951414,17039275,87861,-,-
BAC132_A05,20,20p12.1,16962651,17055776,93125,-,-
BAC75_L11,20,20p12.1,16984394,17087305,102911,-,yes
BAC22_O09,20,20p12.1,17069823,17198836,129013,-,yes
BAC44_M08,20,20p12.1,17101660,17200027,98367,-,-
BAC53_C01,20,20p12.1,17107429,17221249,113820,-,-
BAC159_L06,20,20p12.1,17110468,17200129,89661,-,-
BAC161_P08,20,20p12.1,17119113,17208074,88961,-,-
BAC122_K05,20,20p12.1,17159530,17249452,89922,-,yes
REBAC181_J24,20,REBAC181-T7_J24_097.ab1,17262172,17365004,102832,-,-
BAC129_F14,20,20p12.1,17264108,17341581,77473,-,yes
BAC96_K10,20,20p12.1,17361234,17473469,112235,-,yes
BAC240_J06,20,20p12.1,17365033,17473469,108436,-,-
BAC16_A07,20,20p12.1,17407893,17499226,91333,-,-
BAC81_A09,20,20p12.1,17434096,17521952,87856,-,-
BAC88_I04,20,20p12.1,17437181,17523387,86206,-,yes
BAC178_N19,20,20p12.1,17520253,17640992,120739,-,yes
BAC148_C23,20,20p12.1,17520253,17607903,87650,-,-
BAC97_J09,20,20p12.1,17593432,17684146,90714,-,yes
BAC211_A16,20,BAC211-M13R_A16_051.ab1,17608710,17708440,99730,-,-
BAC154_K22,20,20p12.1-20p11.23,17703140,17830268,127128,-,yes
BAC96_D14,20,20p12.1-20p11.23,17753232,17880376,127144,-,yes
BAC53_F05,20,20p12.1-20p11.23,17753516,17866509,112993,-,-
BAC238_G09,20,20p11.23,17830597,17906649,76052,-,-
BAC83_A07,20,20p11.23,17830599,17933372,102773,-,yes
BAC249_F11,20,20p11.23,17899708,17999254,99546,-,-
BAC139_O07,20,20p11.23,17906865,18013638,106773,-,yes
BAC81_O21,20,20p11.23,17924699,18006521,81822,-,-
BAC125_J15,20,20p11.23,17974426,18091351,116925,-,yes
BAC118_P10,20,20p11.23,17974426,18065938,91512,-,-
BAC157_F22,20,20p11.23,17977586,18066994,89408,-,-
BAC35_N07,20,20p11.23,18039390,18171064,131674,-,yes
BAC179_M22,20,20p11.23,18122073,18215050,92977,-,-
BAC49_L07,20,20p11.23,18122074,18214982,92908,-,-
BAC86_B08,20,20p11.23,18162573,18263469,100896,-,yes
BAC228_O04,20,20p11.23,18175383,18321419,146036,-,-
BAC197_D06,20,20p11.23,18217624,18295981,78357,-,-
BAC237_G14,20,20p11.23,18217624,18325193,107569,-,yes
BAC233_J02,20,20p11.23,18242816,18317350,74534,-,-
BAC175_I16,20,20p11.23,18295991,18415185,119194,-,-
BAC36_P02,20,20p11.23,18295991,18525702,229711,-,yes
BAC219_B15,20,20p11.23,18348893,18457426,108533,-,-
BAC112_M01,20,20p11.23,18368952,18482704,113752,-,-
BAC42_P19,20,20p11.23,18368952,18517569,148617,-,-
BAC142_E03,20,20p11.23,18383050,18466893,83843,-,-
BAC57_N22,20,20p11.23,18426442,18521830,95388,-,-
BAC248_L21,20,20p11.23,18466970,18533209,66239,-,-
BAC87_K13,20,20p11.23,18466972,18582123,115151,-,-
BAC217_B20,20,20p11.23,18482748,18626777,144029,-,yes
BAC102_H03,20,20p11.23,18495860,18586335,90475,-,-
BAC180_C13,20,20p11.23,18498599,18585390,86791,-,-
BAC32_D12,20,20p11.23,18560992,18682251,121259,-,-
BAC84_K18,20,20p11.23,18562854,18683315,120461,-,-
BAC44_G02,20,20p11.23,18601219,18711527,110308,-,yes
BAC12_H10,20,20p11.23,18633614,18763022,129408,-,-
BAC35_B21,20,20p11.23,18644807,18773536,128729,-,-
BAC206_A18,20,BAC206-M13R_A18_081.ab1,18659286,18784071,124785,-,-
BAC39_J22,20,20p11.23,18659287,18773628,114341,-,yes
BAC132_N03,20,20p11.23,18818681,18941664,122983,-,yes
BAC80_N12,20,20p11.23,18847532,18946315,98783,-,-
BAC132_M11,20,20p11.23,18870350,18942973,72623,-,-
BAC20_H07,20,20p11.23,18877035,19064105,187070,-,yes
BAC86_F13,20,20p11.23,18914253,18993773,79520,-,-
BAC124_I06,20,20p11.23,18914253,19021055,106802,-,-
BAC178_A18,20,20p11.23,18914253,19021069,106816,-,-
BAC78_G05,20,20p11.23,18914253,19027508,113255,-,-
BAC248_O18,20,20p11.23,18923422,19001515,78093,-,-
BAC148_D04,20,20p11.23,18942994,19038881,95887,-,-
BAC183_E09,20,20p11.23,19001508,19092659,91151,-,yes
BAC12_L03,20,BAC12-T7_L03_048.ab1,19059555,19164999,105444,-,-
BAC63_L16,20,20p11.23,19121668,19219590,97922,-,yes
BAC78_L21,20,20p11.23,19176789,19289853,113064,-,-
BAC102_P04,20,20p11.23,19218494,19332650,114156,-,yes
BAC11_K07,20,20p11.23,19246322,19396178,149856,-,yes
BAC220_F21,20,20p11.23,19293911,19396172,102261,-,-
BAC234_J21,20,20p11.23,19361262,19451114,89852,-,yes
BAC109_M16,20,20p11.23,19401874,19491263,89389,-,yes
BAC53_L03,20,20p11.23,19478911,19565260,86349,-,yes
BAC49_H23,20,20p11.23,19491324,19602305,110981,-,-
BAC146_B02,20,20p11.23,19498119,19624604,126485,-,-
BAC51_M03,20,20p11.23,19512504,19634623,122119,-,yes
BAC248_H19,20,20p11.23,19524594,19609794,85200,-,-
BAC238_H08,20,20p11.23,19609788,19692363,82575,-,-
BAC163_O04,20,20p11.23,19609815,19701229,91414,-,-
BAC150_C06,20,20p11.23,19615099,19701452,86353,-,yes
BAC66_B21,20,20p11.23,19634757,19752840,118083,-,-
BAC42_C08,20,20p11.23,19650715,19783899,133184,-,-
BAC243_P13,20,20p11.23,19676140,19787138,110998,-,yes
BAC60_C05,20,20p11.23,19735797,19873334,137537,-,yes
BAC230_G16,20,20p11.23,19735798,19847210,111412,-,-
BAC140_D12,20,20p11.23,19765857,19873334,107477,-,-
BAC226_B08,20,20p11.23,19783894,19862315,78421,-,-
BAC246_C10,20,20p11.23,19787141,19873334,86193,-,-
BAC156_L11,20,20p11.23,19805211,19889241,84030,-,-
BAC40_I19,20,20p11.23,19811999,19893961,81962,-,-
BAC80_G08,20,20p11.23,19827115,19939449,112334,-,-
BAC116_B23,20,20p11.23,19854129,19962214,108085,-,yes
BAC248_I13,20,20p11.23,19873463,19962214,88751,-,-
BAC46_E21,20,20p11.23,19902693,19982931,80238,-,-
BAC237_L13,20,20p11.23,19921586,20032451,110865,-,-
BAC127_A15,20,20p11.23,19921586,20028222,106636,-,-
BAC67_F07,20,20p11.23,19939461,20034264,94803,-,-
BAC40_M15,20,20p11.23,19939490,20072631,133141,-,yes
BAC250_H08,20,20p11.23,19962210,20028507,66297,-,-
BAC115_F23,20,20p11.23,19973621,20095050,121429,-,yes
BAC12_O04,20,20p11.23,20003306,20087429,84123,-,-
BAC38_O04,20,20p11.23,20003309,20087501,84192,-,-
BAC148_E16,20,20p11.23,20077629,20151677,74048,-,-
BAC144_H07,20,20p11.23,20079016,20177528,98512,-,yes
BAC228_N24,20,20p11.23,20079016,20168915,89899,-,-
BAC78_H18,20,20p11.23,20131203,20250769,119566,-,yes
BAC96_C08,20,20p11.23,20166633,20250504,83871,-,-
BAC211_I18,20,BAC211-M13R_I18_088.ab1,20226087,20304453,78366,-,-
BAC219_I03,20,20p11.23,20254053,20333993,79940,-,yes
BAC148_B10,20,20p11.23,20272445,20343214,70769,-,-
BAC75_H16,20,20p11.23,20305001,20413595,108594,-,-
BAC32_P01,20,20p11.23,20330136,20413598,83462,-,yes
BAC96_L14,20,20p11.23,20339377,20413598,74221,-,-
BAC132_I23,20,20p11.23,20467794,20571814,104020,-,yes
BAC182_C09,20,20p11.23,20477694,20601135,123441,-,-
BAC37_C19,20,20p11.23,20477697,20547570,69873,-,-
BAC80_I08,20,20p11.23,20493595,20624903,131308,-,yes
BAC26_M01,20,20p11.23,20508751,20600131,91380,-,-
BAC201_F15,20,BAC201-M13R_F15_038.ab1,20625484,20712498,87014,-,-
BAC149_O07,20,20p11.23,20752573,20835036,82463,-,yes
BAC58_O04,20,20p11.23,20770047,20950293,180246,-,yes
BAC119_J10,20,20p11.23,20880700,21065181,184481,-,yes
BAC202_D06,20,20p11.23,20888469,20976151,87682,-,-
BAC150_I17,20,20p11.23,20957130,21061907,104777,-,-
REBAC194_O15,20,REBAC194-T7_O15_058.ab1,20976142,21068424,92282,-,-
BAC51_C21,20,20p11.23,21091356,21178561,87205,-,yes
BAC105_I06,20,20p11.23-20p11.22,21116758,21257401,140643,-,yes
BAC76_G24,20,20p11.23-20p11.22,21179361,21269862,90501,-,-
BAC32_M22,20,20p11.23-20p11.22,21195713,21314514,118801,-,yes
BAC41_O24,20,20p11.23-20p11.22,21195713,21290023,94310,-,-
BAC43_N24,20,20p11.22,21219225,21309727,90502,-,-
BAC60_F09,20,20p11.22,21298701,21405311,106610,-,-
BAC219_B06,20,20p11.22,21301659,21411003,109344,-,yes
BAC56_D24,20,20p11.22,21333185,21469528,136343,-,-
BAC63_I12,20,20p11.22,21365553,21470018,104465,-,yes
BAC33_J16,20,20p11.22,21365557,21469238,103681,-,-
BAC90_K01,20,20p11.22,21423570,21527931,104361,-,-
BAC28_F06,20,20p11.22,21423628,21506888,83260,-,-
BAC8_M01,20,20p11.22,21429426,21508508,79082,-,-
BAC227_M07,20,20p11.22,21469672,21552197,82525,-,yes
BAC104_O04,20,20p11.22,21507149,21611493,104344,-,yes
BAC95_G04,20,BAC95-T7_G04_059.ab1,21526455,21611459,85004,-,-
BAC143_H09,20,20p11.22,21636263,21721508,85245,-,yes
BAC184_A12,20,BAC184-M13R_A12_085.ab1,21691717,21780067,88350,-,-
BAC187_K03,20,20p11.22,21777927,21885797,107870,-,yes
BAC40_C10,20,20p11.22,21783522,21895354,111832,-,-
BAC139_B21,20,20p11.22,21836566,21920830,84264,-,yes
BAC40_B12,20,20p11.22,22056820,22177469,120649,-,yes
BAC166_I11,20,20p11.22,22156347,22252450,96103,-,yes
BAC100_A12,20,20p11.22,22181909,22271085,89176,-,yes
BAC173_B04,20,20p11.22,22253549,22269451,15902,-,-
BAC209_M08,20,20p11.22-20p11.21,22292349,22327681,35332,-,yes
BAC100_G09,20,20p11.21,22410004,22525413,115409,-,yes
BAC14_I20,20,20p11.21,22466302,22560659,94357,-,-
BAC224_I12,20,20p11.21,22502530,22611255,108725,-,yes
BAC240_B18,20,20p11.21,22531125,22602819,71694,-,-
BAC37_E07,20,20p11.21,22620884,22735898,115014,-,yes
BAC81_F09,20,20p11.21,22667061,22795739,128678,-,-
BAC119_H11,20,20p11.21,22696218,22819006,122788,-,yes
BAC90_A01,20,20p11.21,22739094,22828509,89415,-,-
BAC18_B17,20,20p11.21,22789676,22905014,115338,-,yes
BAC26_D19,20,20p11.21,22821082,22918598,97516,-,-
BAC90_H06,20,20p11.21,22821082,22963550,142468,-,yes
BAC193_E04,20,20p11.21,22828853,22959175,130322,-,-
BAC59_M08,20,20p11.21,22834296,22928402,94106,-,-
BAC120_K16,20,20p11.21,22836818,22928404,91586,-,-
BAC84_E13,20,20p11.21,22946711,23083017,136306,-,yes
BAC55_G11,20,20p11.21,22948726,23040191,91465,-,-
BAC33_K06,20,20p11.21,22959169,23030595,71426,-,-
BAC64_B08,20,20p11.21,22988505,23083016,94511,-,-
BAC139_P07,20,20p11.21,23062036,23141747,79711,-,yes
BAC85_P01,20,20p11.21,23104291,23192302,88011,-,yes
BAC104_M19,20,20p11.21,23151808,23218498,66690,-,-
BAC156_A12,20,20p11.21,23186904,23289889,102985,-,yes
BAC8_F01,20,20p11.21,23196899,23296759,99860,-,-
BAC39_L23,20,20p11.21,23205715,23305093,99378,-,-
BAC244_P02,20,20p11.21,23218494,23338004,119510,-,-
BAC48_N01,20,20p11.21,23285753,23382096,96343,-,yes
BAC100_G10,20,20p11.21,23297658,23460681,163023,-,yes
BAC158_A18,20,20p11.21,23343584,23433361,89777,-,-
BAC158_H05,20,20p11.21,23343584,23435095,91511,-,-
BAC184_C05,20,20p11.21,23350922,23437177,86255,-,-
BAC179_O01,20,BAC179-M13R_O01_015.ab1,23399928,23531042,131114,-,-
BAC176_H20,20,20p11.21,23399929,23479902,79973,-,yes
REBAC244_E21,20,REBAC244-T7_E21_035.ab1,23474764,23584048,109284,-,-
BAC186_P09,20,20p11.21,23921264,24015980,94716,-,yes
BAC100_J19,20,20p11.21,23921273,24091845,170572,-,yes
BAC120_O13,20,20p11.21,23937970,24083462,145492,-,-
BAC100_K04,20,20p11.21,23954618,24074441,119823,-,-
BAC78_F21,20,20p11.21,23959155,24058186,99031,-,-
BAC18_P01,20,20p11.21,23992889,24074430,81541,-,-
REBAC228_C05,20,REBAC228-T7_C05_075.ab1,24081210,24188397,107187,-,-
BAC239_A18,20,20p11.21,24120984,24235112,114128,-,yes
BAC23_D15,20,20p11.21,24131309,24235112,103803,-,-
BAC108_P07,20,20p11.21,24167552,24250417,82865,-,-
BAC4_H24,20,20p11.21,24200683,24382806,182123,-,yes
BAC232_O08,20,20p11.21,24221703,24362213,140510,-,-
BAC189_M04,20,20p11.21,24235106,24349059,113953,-,-
BAC33_J09,20,20p11.21,24250423,24347829,97406,-,-
BAC51_N05,20,20p11.21,24251804,24442665,190861,-,-
BAC53_L05,20,20p11.21,24251986,24395488,143502,-,-
BAC149_I20,20,20p11.21,24362641,24442128,79487,-,-
BAC55_L08,20,20p11.21,24377029,24501566,124537,-,yes
BAC168_N03,20,20p11.21,24430345,24534589,104244,-,-
BAC68_M13,20,20p11.21,24438702,24570980,132278,-,yes
BAC240_D01,20,20p11.21,24442117,24538109,95992,-,-
BAC198_A07,20,20p11.21,24530723,24608453,77730,-,-
BAC37_M13,20,20p11.21,24534588,24661098,126510,-,-
BAC88_K02,20,20p11.21,24570977,24674073,103096,-,-
BAC128_I05,20,20p11.21,24570977,24712406,141429,-,yes
BAC157_C02,20,20p11.21,24601708,24709688,107980,-,-
BAC154_J07,20,20p11.21,24633368,24735348,101980,-,yes
BAC215_E12,20,BAC215-M13R_E12_083.ab1,24712992,24807174,94182,-,-
BAC68_O01,20,20p11.21,24735376,24859330,123954,-,yes
BAC10_O10,20,20p11.21,24790408,24907376,116968,-,yes
BAC161_K24,20,BAC161-T7_K24_093.ab1,24865803,24940942,75139,-,-
BAC20_G23,20,20p11.21,24920346,25002416,82070,-,yes
BAC110_E03,20,20p11.21,24948021,25061804,113783,-,-
BAC58_F13,20,20p11.21,25002409,25091500,89091,-,yes
BAC62_C10,20,20p11.21,25002482,25124767,122285,-,-
BAC205_D01,20,20p11.21,25034665,25115116,80451,-,-
BAC193_J08,20,20p11.21,25034665,25116163,81498,-,-
BAC113_N01,20,20p11.21,25086983,25210289,123306,-,yes
BAC113_B11,20,20p11.21,25098382,25179066,80684,-,-
BAC78_N04,20,20p11.21,25101534,25192708,91174,-,-
BAC221_D07,20,20p11.21,25115148,25202356,87208,-,-
BAC56_L14,20,20p11.21,25116157,25202356,86199,-,-
BAC36_M13,20,20p11.21,25153350,25326948,173598,-,yes
BAC54_J16,20,20p11.21,25171220,25314563,143343,-,-
BAC122_O21,20,20p11.21,25179213,25289770,110557,-,-
BAC69_E11,20,20p11.21,25190472,25298772,108300,-,-
BAC189_L13,20,20p11.21,25210282,25314317,104035,-,-
BAC48_K21,20,BAC48-M13R_K21_057.ab1,25274826,25384003,109177,-,-
BAC10_B19,20,20p11.21,25358540,25480431,121891,-,yes
BAC126_N22,20,20p11.21,25455107,25581436,126329,-,yes
BAC226_M07,20,20p11.21,25455107,25536983,81876,-,-
BAC178_N14,20,20p11.21-20p11.1,25603604,25716960,113356,-,yes
BAC122_D19,20,20p11.21-20p11.1,25679941,25779575,99634,-,yes
BAC165_C09,20,20p11.1,25755459,25842805,87346,-,yes
BAC192_O06,20,20p11.1,25819417,25910335,90918,-,yes
BAC188_D20,20,BAC188-M13R_D20_027.ab1,25893538,25984667,91129,-,-
BAC150_M10,20,BAC150-T7_M10_065.ab1,26206832,26266558,59726,-,-
BAC88_F06,20,20q11.1,28034374,28144982,110608,-,yes
BAC50_I17,20,BAC50-T7_I17_072.ab1,28037513,28038394,881,-,-
BAC40_C08,20,20q11.1,28045779,28176659,130880,-,-
BAC23_M11,20,20q11.1,28045780,28161685,115905,-,-
BAC188_M06,20,20q11.1,28092338,28215059,122721,-,yes
BAC180_C14,20,BAC180-M13R_C14_027.ab1,28184435,28250971,66536,-,-
BAC32_J10,20,BAC32-T7_J10_054.ab1,28216912,28258610,41698,-,-
BAC97_F15,20,BAC97-M13R_F15_036.ab1,28251265,28351314,100049,-,-
BAC75_M05,20,20q11.21,29359238,29472558,113320,-,yes
BAC163_K18,20,20q11.21,29372210,29472556,100346,-,-
BAC247_D05,20,20q11.21,29396018,29500816,104798,-,yes
BAC30_G24,20,BAC30-T7_G24_095.ab1,29472549,29564543,91994,-,-
BAC122_M01,20,20q11.21,29549689,29639080,89391,-,yes
BAC1_C20,20,20q11.21,29565472,29588547,23075,-,-
BAC59_M05,20,20q11.21,29568303,29679324,111021,-,-
BAC181_B18,20,20q11.21,29568303,29663605,95302,-,-
BAC142_E17,20,20q11.21,29621776,29698666,76890,-,-
BAC23_P06,20,20q11.21,29639074,29765056,125982,-,yes
BAC124_N14,20,20q11.21,29663876,29765056,101180,-,-
BAC227_A22,20,20q11.21,29748921,29837299,88378,-,-
BAC135_F06,20,20q11.21,29765047,29860316,95269,-,yes
BAC195_I12,20,BAC195-M13R_I12_088.ab1,29874583,29974583,100000,-,-
BAC151_A16,20,20q11.21,29883353,29974583,91230,-,yes
BAC142_O24,20,20q11.21,29890287,29991885,101598,-,-
BAC163_M12,20,20q11.21,29920412,30011535,91123,-,-
BAC250_A06,20,20q11.21,29933148,30043007,109859,-,yes
BAC146_O07,20,20q11.21,29975156,30075619,100463,-,-
BAC189_J01,20,20q11.21,30011673,30139829,128156,-,-
BAC90_B11,20,20q11.21,30011673,30091995,80322,-,-
BAC157_B11,20,20q11.21,30040020,30140040,100020,-,yes
BAC158_M14,20,20q11.21,30092170,30211087,118917,-,yes
BAC76_P07,20,20q11.21,30100964,30132553,31589,-,-
BAC34_F18,20,20q11.21,30202381,30291426,89045,-,yes
BAC166_M21,20,20q11.21,30235608,30330880,95272,-,-
BAC169_P14,20,20q11.21,30263324,30368137,104813,-,yes
BAC42_A24,20,20q11.21,30292865,30368690,75825,-,-
BAC67_N01,20,20q11.21,30328236,30415558,87322,-,yes
BAC27_M02,20,20q11.21,30397405,30482097,84692,-,-
BAC187_P15,20,20q11.21,30411829,30525933,114104,-,yes
BAC246_K22,20,BAC246-M13R_K22_063.ab1,30437372,30520606,83234,-,-
BAC73_G15,20,20q11.21,30437422,30525933,88511,-,-
BAC210_P12,20,BAC210-M13R_P12_102.ab1,30528641,30631493,102852,-,-
BAC15_I07,20,20q11.21,30567762,30683827,116065,-,yes
BAC224_I22,20,20q11.21,30567762,30683827,116065,-,-
BAC76_A15,20,20q11.21,30574393,30674515,100122,-,-
BAC199_L18,20,20q11.21,30586426,30675362,88936,-,-
BAC249_F10,20,20q11.21,30683821,30793762,109941,-,yes
BAC67_J15,20,20q11.21,30692398,30793762,101364,-,-
BAC176_B02,20,20q11.21,30710357,30793762,83405,-,-
BAC187_C19,20,20q11.21,30713641,30793752,80111,-,-
BAC59_N07,20,20q11.21,30741532,30849990,108458,-,yes
BAC205_H07,20,20q11.21,30741832,30831612,89780,-,-
BAC53_O04,20,20q11.21,30798536,30932213,133677,-,-
BAC183_P06,20,20q11.21,30815039,30896456,81417,-,-
BAC204_A05,20,20q11.21,30815041,30904097,89056,-,-
BAC148_D08,20,20q11.21,30820570,30896456,75886,-,-
BAC89_N16,20,20q11.21,30834784,30967100,132316,-,yes
BAC168_P01,20,20q11.21,30915043,31009960,94917,-,-
BAC125_K01,20,20q11.21,30946420,31124304,177884,-,yes
BAC37_E15,20,20q11.21,30952905,31089063,136158,-,-
BAC190_I01,20,20q11.21,30974010,31056184,82174,-,-
BAC140_I09,20,20q11.21,31009953,31089061,79108,-,-
BAC232_C13,20,20q11.21,31054957,31153611,98654,-,-
BAC63_G10,20,20q11.21,31119626,31315972,196346,-,yes
BAC18_P22,20,20q11.21,31131046,31263644,132598,-,-
BAC95_B05,20,20q11.21,31150716,31298163,147447,-,-
BAC232_C03,20,20q11.21,31155149,31264199,109050,-,-
BAC152_D14,20,20q11.21,31155149,31244346,89197,-,-
BAC78_O13,20,20q11.21,31175447,31258416,82969,-,-
BAC68_F04,20,20q11.21,31204968,31298163,93195,-,-
BAC48_J02,20,20q11.21,31204977,31298101,93124,-,-
BAC55_H17,20,20q11.21,31253294,31373386,120092,-,-
BAC132_O21,20,20q11.21,31258451,31375245,116794,-,-
BAC162_P14,20,20q11.21,31285439,31366703,81264,-,-
BAC199_K02,20,20q11.21,31292308,31421002,128694,-,yes
BAC55_J23,20,20q11.21,31298157,31399577,101420,-,-
BAC84_D02,20,20q11.21,31375239,31467781,92542,-,yes
BAC191_C22,20,20q11.21,31383712,31467781,84069,-,-
BAC167_K12,20,20q11.21-20q11.22,31437126,31550500,113374,-,yes
BAC103_F19,20,BAC103-M13R_F19_006.ab1,31488142,31597699,109557,-,-
BAC93_B20,20,BAC93-M13R_B20_020.ab1,31549025,31659812,110787,-,-
BAC102_P11,20,BAC102-T7-2_P11_090.ab1,31637424,31788252,150828,-,-
BAC200_G19,20,20q11.22,31660006,31755908,95902,-,yes
BAC150_M17,20,20q11.22,31728063,31813318,85255,-,yes
BAC105_K03,20,20q11.22,31813311,31902714,89403,-,yes
BAC139_E02,20,20q11.22,31838016,31945510,107494,-,-
BAC144_J13,20,20q11.22,31840943,31942606,101663,-,-
BAC230_B03,20,20q11.22,31843805,31942606,98801,-,-
BAC191_G15,20,20q11.22,31858042,31959338,101296,-,-
BAC32_B14,20,20q11.22,31867504,31945510,78006,-,-
BAC172_P10,20,20q11.22,31880627,31996824,116197,-,yes
BAC65_L10,20,20q11.22,31898591,31986478,87887,-,-
BAC144_O24,20,20q11.22,31934705,32032988,98283,-,-
BAC135_P16,20,20q11.22,31942699,32052909,110210,-,-
BAC249_D22,20,20q11.22,31942699,32071225,128526,-,-
BAC193_I16,20,20q11.22,31946325,32032988,86663,-,-
BAC135_C07,20,20q11.22,31946325,32032871,86546,-,-
BAC84_B10,20,20q11.22,31959331,32046772,87441,-,-
BAC24_N11,20,20q11.22,31974629,32071247,96618,-,yes
BAC187_B09,20,20q11.22,32075762,32160220,84458,-,yes
BAC85_L04,20,BAC85-T7_L04_062.ab1,32078951,32160907,81956,-,-
BAC12_I13,20,20q11.22,32086952,32205902,118950,-,-
BAC228_L21,20,20q11.22,32095543,32244237,148694,-,yes
BAC75_I15,20,20q11.22,32102783,32180116,77333,-,-
BAC191_F10,20,20q11.22,32114587,32205871,91284,-,-
BAC88_G12,20,20q11.22,32131375,32222482,91107,-,-
BAC197_L04,20,BAC197-M13R_L04_062.ab1,32198962,32285571,86609,-,-
BAC96_G15,20,20q11.22,32253562,32417425,163863,-,yes
BAC97_K03,20,20q11.22,32257011,32370029,113018,-,-
BAC58_N03,20,20q11.22,32278496,32370029,91533,-,-
BAC185_F12,20,20q11.22,32278506,32370029,91523,-,-
BAC181_J15,20,20q11.22,32285609,32401612,116003,-,-
BAC100_J15,20,20q11.22,32370019,32467262,97243,-,-
BAC186_D01,20,20q11.22,32370019,32460207,90188,-,-
BAC171_B01,20,20q11.22,32378444,32458311,79867,-,-
BAC102_C17,20,20q11.22,32378453,32481673,103220,-,-
BAC161_A16,20,20q11.22,32399648,32509867,110219,-,yes
BAC219_H03,20,20q11.22,32401614,32502324,100710,-,-
BAC115_L16,20,20q11.22,32460678,32540574,79896,-,-
BAC133_I23,20,20q11.22,32481667,32568453,86786,-,yes
BAC8_L10,20,BAC8-T7_L10_073.ab1,32519834,32638059,118225,-,-
BAC135_J18,20,20q11.22,32568733,32673981,105248,-,yes
BAC224_M11,20,20q11.22,32569766,32651288,81522,-,-
BAC90_H08,20,20q11.22,32570101,32673981,103880,-,-
BAC227_F14,20,20q11.22,32580469,32673981,93512,-,-
BAC140_E03,20,20q11.22,32582187,32667404,85217,-,-
BAC92_G24,20,20q11.22,32648247,32749372,101125,-,-
BAC53_L18,20,20q11.22,32667400,32763394,95994,-,yes
BAC193_K07,20,20q11.22,32674059,32749372,75313,-,-
BAC27_H13,20,20q11.22,32674059,32787989,113930,-,yes
BAC153_C10,20,20q11.22,32678350,32777024,98674,-,-
BAC28_M04,20,BAC28-T7_M04_055.ab1,32683851,32787974,104123,-,-
BAC69_A07,20,20q11.22,32787999,32933285,145286,-,yes
BAC107_C09,20,20q11.22,32826320,32931796,105476,-,-
BAC211_N12,20,20q11.22,32833737,32911929,78192,-,-
BAC251_O15,20,20q11.22,32834277,32970416,136139,-,-
BAC224_J09,20,20q11.22,32861498,32992219,130721,-,-
BAC113_G05,20,20q11.22,32877541,33046115,168574,-,yes
BAC230_J17,20,20q11.22,32898588,32995945,97357,-,-
BAC109_O03,20,20q11.22,32907902,32992330,84428,-,-
BAC67_K03,20,20q11.22,32949659,33036844,87185,-,-
BAC74_H14,20,20q11.22,32995948,33084919,88971,-,-
BAC69_E16,20,20q11.22,33003510,33105134,101624,-,-
BAC222_J06,20,20q11.22,33021666,33135073,113407,-,yes
BAC179_H04,20,20q11.22,33135441,33246276,110835,-,yes
BAC22_D08,20,20q11.22,33146318,33246120,99802,-,-
BAC52_C06,20,20q11.22,33255431,33393481,138050,-,yes
BAC183_D09,20,BAC183-T7_D09_042.ab1,33265614,33351911,86297,-,-
BAC19_G17,20,20q11.22,33307625,33429006,121381,-,-
BAC128_A09,20,20q11.22,33371993,33471293,99300,-,-
BAC200_I09,20,20q11.22,33373425,33450499,77074,-,-
BAC84_A04,20,20q11.22,33375328,33471229,95901,-,-
BAC186_N16,20,20q11.22,33381598,33505688,124090,-,yes
BAC190_M22,20,BAC190-T7_M22_055.ab1,33471287,33583737,112450,-,-
BAC60_B21,20,20q11.22,33526195,33649168,122973,-,yes
BAC151_O18,20,20q11.22,33537663,33626019,88356,-,-
BAC114_A24,20,20q11.22,33549920,33682762,132842,-,-
BAC126_D08,20,20q11.22,33587494,33686825,99331,-,yes
REBAC242_D21,20,REBAC242-T7_D21_042.ab1,33657756,33749774,92018,-,-
BAC239_J06,20,20q11.22,33695872,33787280,91408,-,yes
BAC52_H18,20,20q11.22,33697013,33787280,90267,-,-
REBAC225_B13,20,REBAC225-T7_B13_002.ab1,33731254,33841485,110231,-,-
BAC157_K07,20,BAC157-T7_K07_014.ab1,33830947,33927034,96087,-,-
BAC95_P21,20,20q11.22-20q11.23,33841509,33945318,103809,-,yes
BAC50_P24,20,20q11.22-20q11.23,33841557,33965869,124312,-,-
BAC11_P04,20,20q11.22-20q11.23,33842213,33927066,84853,-,-
BAC204_I22,20,20q11.22-20q11.23,33843452,33918228,74776,-,-
BAC53_G05,20,20q11.22-20q11.23,33896717,33994051,97334,-,-
BAC231_K21,20,20q11.23,33909698,34020462,110764,-,-
BAC34_D16,20,20q11.23,33918344,34028404,110060,-,-
BAC51_L20,20,20q11.23,33918344,34020458,102114,-,-
BAC128_O07,20,20q11.23,33938687,34031295,92608,-,yes
BAC86_A22,20,20q11.23,33965864,34059346,93482,-,-
BAC135_C03,20,20q11.23,33996402,34081129,84727,-,yes
BAC232_H08,20,20q11.23,34034077,34165175,131098,-,yes
BAC187_H09,20,20q11.23,34059744,34142115,82371,-,-
BAC70_C01,20,20q11.23,34081132,34180371,99239,-,-
BAC66_J07,20,20q11.23,34095199,34192956,97757,-,-
BAC178_C02,20,20q11.23,34136683,34239066,102383,-,-
BAC120_M12,20,20q11.23,34148161,34294190,146029,-,yes
BAC151_H12,20,20q11.23,34155766,34282539,126773,-,-
BAC238_G02,20,20q11.23,34164926,34242440,77514,-,-
BAC184_B16,20,20q11.23,34165221,34251116,85895,-,-
BAC124_B15,20,20q11.23,34199936,34333209,133273,-,-
BAC40_O11,20,20q11.23,34231738,34333220,101482,-,-
BAC108_J11,20,20q11.23,34242444,34356005,113561,-,-
BAC128_E03,20,20q11.23,34251109,34356005,104896,-,-
BAC173_C18,20,20q11.23,34251109,34360468,109359,-,yes
BAC177_N05,20,20q11.23,34403579,34499474,95895,-,yes
BAC209_B09,20,BAC209-M13R_B09_038.ab1,34418002,34499441,81439,-,-
BAC88_P07,20,20q11.23,34462116,34613296,151180,-,yes
BAC241_O08,20,20q11.23,34540501,34633548,93047,-,-
BAC193_J02,20,20q11.23,34544861,34647282,102421,-,-
BAC27_A06,20,20q11.23,34548749,34648021,99272,-,yes
BAC37_O05,20,20q11.23,34665674,34775697,110023,-,yes
BAC26_A11,20,20q11.23,34665723,34796429,130706,-,-
BAC238_O03,20,20q11.23,34706167,34784485,78318,-,-
BAC155_D09,20,20q11.23,34728237,34814664,86427,-,-
BAC13_P24,20,20q11.23,34732784,34835143,102359,-,-
BAC1_D17,20,20q11.23,34769076,34887820,118744,-,yes
BAC39_D03,20,20q11.23,34775209,34878049,102840,-,-
BAC41_D05,20,20q11.23,34785208,34887813,102605,-,-
BAC194_H08,20,20q11.23,34785208,34878049,92841,-,-
BAC31_K17,20,20q11.23,34785208,34878045,92837,-,-
BAC28_B21,20,20q11.23,34796424,34912671,116247,-,-
BAC249_F24,20,20q11.23,34869447,34974565,105118,-,yes
BAC239_E17,20,20q11.23,34902787,34990558,87771,-,-
BAC144_P17,20,20q11.23,34936409,35036549,100140,-,-
BAC108_N06,20,20q11.23,34939375,35026824,87449,-,-
BAC96_O10,20,20q11.23,34939375,35042996,103621,-,yes
BAC24_B05,20,20q11.23,35036651,35149210,112559,-,yes
BAC141_N11,20,20q11.23,35098461,35209732,111271,-,-
BAC242_C17,20,20q11.23,35123390,35206427,83037,-,-
BAC24_C09,20,20q11.23,35149203,35314389,165186,-,yes
BAC2_C13,20,20q11.23,35173592,35280030,106438,-,-
BAC105_B13,20,20q11.23,35173625,35283942,110317,-,-
BAC82_A06,20,20q11.23,35204618,35314389,109771,-,-
BAC173_A22,20,20q11.23,35209757,35329103,119346,-,-
BAC239_K18,20,20q11.23,35220169,35313302,93133,-,-
BAC248_A14,20,20q11.23,35235070,35314390,79320,-,-
BAC157_N12,20,20q11.23,35280031,35388859,108828,-,-
BAC63_A14,20,20q11.23,35280031,35359241,79210,-,-
BAC123_D01,20,20q11.23,35280383,35358837,78454,-,-
BAC192_F15,20,20q11.23,35290678,35393586,102908,-,-
BAC152_P07,20,20q11.23,35314386,35394154,79768,-,yes
BAC75_I01,20,20q11.23,35371719,35459963,88244,-,-
BAC232_O09,20,20q11.23,35386213,35470365,84152,-,-
BAC119_P22,20,20q11.23,35386213,35539863,153650,-,yes
BAC219_D14,20,20q11.23,35394264,35496883,102619,-,-
BAC128_M16,20,BAC128-T7_M16_065.ab1,35545337,35617838,72501,-,-
BAC186_F03,20,20q11.23,35547758,35616941,69183,-,yes
BAC86_J20,20,20q11.23,35604158,35692847,88689,-,yes
BAC229_L13,20,20q11.23,35626596,35704657,78061,-,-
BAC124_J06,20,20q11.23,35626596,35706520,79924,-,-
BAC100_F05,20,20q11.23,35637480,35794959,157479,-,yes
BAC177_H07,20,20q11.23,35654076,35734702,80626,-,-
BAC78_E23,20,20q11.23,35695172,35797306,102134,-,yes
REBAC129_B05,20,REBAC129-T7_B05_066.ab1,35855622,35955622,100000,-,-
BAC195_A21,20,20q11.23,35873818,35978957,105139,-,yes
BAC186_C05,20,20q11.23,35879309,35974985,95676,-,-
BAC128_P11,20,20q11.23,35906395,36082849,176454,-,yes
BAC118_A24,20,20q11.23,35908395,35953466,45071,-,-
BAC146_K19,20,20q11.23,35979160,36077215,98055,-,-
BAC39_B18,20,20q11.23,36008247,36099381,91134,-,yes
BAC210_O20,20,BAC210-M13R_O20_041.ab1,36132553,36219444,86891,-,-
BAC239_H11,20,20q11.23,36143230,36234721,91491,-,yes
BAC121_N17,20,20q11.23,36151116,36228695,77579,-,-
BAC65_K20,20,20q11.23,36198672,36322936,124264,-,-
BAC104_E21,20,20q11.23,36198674,36306873,108199,-,-
BAC68_B14,20,20q11.23,36211520,36301463,89943,-,-
BAC58_B08,20,20q11.23,36228689,36373994,145305,-,yes
BAC140_B12,20,20q11.23,36247439,36322945,75506,-,-
BAC152_O02,20,20q11.23,36289805,36360037,70232,-,-
BAC158_G11,20,20q11.23,36463557,36547105,83548,-,yes
BAC55_D21,20,20q11.23,36463557,36565496,101939,-,-
BAC221_L16,20,20q11.23,36479407,36565497,86090,-,yes
REBAC137_L06,20,REBAC137-T7_L06_096.ab1,36602722,36682736,80014,-,-
BAC143_J16,20,20q11.23,36624498,36729731,105233,-,yes
BAC70_F03,20,20q11.23,36632346,36744456,112110,-,-
BAC160_H10,20,20q11.23,36689973,36768229,78256,-,-
BAC221_I03,20,20q11.23,36712267,36805707,93440,-,-
BAC196_P05,20,20q11.23,36719882,36805710,85828,-,-
BAC247_L10,20,20q11.23,36719885,36820703,100818,-,-
BAC149_N15,20,20q11.23,36719923,36821614,101691,-,yes
BAC175_J13,20,20q11.23,36729776,36805710,75934,-,-
BAC119_D23,20,20q11.23,36790860,36896179,105319,-,-
BAC105_G20,20,20q11.23,36815610,36917598,101988,-,yes
BAC140_D09,20,20q11.23,36823562,36948499,124937,-,-
BAC20_N13,20,20q11.23,36896252,37030943,134691,-,-
BAC92_L03,20,20q11.23,36910705,37036686,125981,-,yes
BAC108_N19,20,20q11.23-20q12,37036686,37130362,93676,-,yes
BAC68_F01,20,BAC68-T7_F01_006.ab1,37041545,37128483,86938,-,-
BAC43_F22,20,20q12,37131062,37302327,171265,-,yes
BAC30_N19,20,20q12,37199666,37301184,101518,-,-
BAC86_K02,20,20q12,37230273,37328509,98236,-,-
BAC161_E18,20,20q12,37230586,37328509,97923,-,-
BAC88_C07,20,20q12,37265238,37353329,88091,-,-
BAC92_P13,20,20q12,37268859,37391454,122595,-,-
BAC48_A02,20,20q12,37296527,37395973,99446,-,yes
BAC177_B16,20,20q12,37306001,37395973,89972,-,-
BAC51_P05,20,20q12,37426110,37514578,88468,-,yes
BAC6_P08,20,20q12,37486390,37593268,106878,-,-
BAC110_L09,20,20q12,37506689,37594567,87878,-,-
BAC133_M09,20,20q12,37507976,37609946,101970,-,yes
BAC45_P07,20,20q12,37537077,37616643,79566,-,-
BAC237_G10,20,20q12,37593262,37689823,96561,-,yes
BAC75_K02,20,20q12,37626611,37724325,97714,-,-
BAC127_A21,20,20q12,37660516,37769126,108610,-,-
BAC240_F23,20,20q12,37683584,37761285,77701,-,-
BAC233_J24,20,20q12,37689817,37788708,98891,-,yes
BAC36_K18,20,20q12,37689826,37824718,134892,-,-
BAC38_J18,20,20q12,37691421,37829707,138286,-,-
BAC133_B04,20,20q12,37693487,37766690,73203,-,-
BAC202_H08,20,20q12,37693521,37774632,81111,-,-
BAC162_A08,20,20q12,37721650,37825394,103744,-,-
BAC232_F01,20,20q12,37756732,37870149,113417,-,yes
BAC135_D22,20,20q12,37769142,37848026,78884,-,-
BAC41_E24,20,20q12,37784378,37868841,84463,-,-
BAC72_G22,20,BAC72-T7_G22_063.ab1,37915271,38005041,89770,-,-
BAC80_F05,20,20q12,38001563,38119518,117955,-,yes
BAC92_P22,20,20q12,38005068,38095713,90645,-,-
BAC205_F23,20,20q12,38076025,38156360,80335,-,yes
BAC204_J18,20,BAC204-M13R_J18_086.ab1,38115203,38195337,80134,-,-
BAC223_M19,20,20q12,38186836,38297105,110269,-,yes
BAC239_E02,20,20q12,38299231,38390139,90908,-,yes
BAC33_O18,20,20q12,38329277,38450850,121573,-,yes
BAC40_F03,20,20q12,38415210,38524634,109424,-,-
BAC79_N21,20,20q12,38419157,38536872,117715,-,yes
BAC181_O17,20,20q12,38450844,38532426,81582,-,-
BAC95_D11,20,20q12,38469693,38587655,117962,-,yes
BAC175_F13,20,20q12,38557262,38649228,91966,-,-
BAC60_I06,20,20q12,38557262,38676635,119373,-,-
BAC234_O06,20,20q12,38557278,38703531,146253,-,yes
BAC124_O12,20,20q12,38566911,38697988,131077,-,-
BAC124_H21,20,20q12,38573210,38666964,93754,-,-
BAC235_D24,20,20q12,38610246,38723627,113381,-,-
BAC190_J05,20,20q12,38611514,38716359,104845,-,-
BAC126_M14,20,20q12,38618562,38731495,112933,-,-
BAC204_D08,20,20q12,38698093,38757681,59588,-,yes
BAC97_K09,20,20q12,38712197,38789070,76873,-,-
BAC55_P15,20,20q12,38726860,38837008,110148,-,-
BAC82_B07,20,20q12,38733854,38837009,103155,-,-
BAC185_I11,20,20q12,38733855,38814414,80559,-,-
BAC116_P08,20,20q12,38757678,38837018,79340,-,yes
BAC40_N15,20,20q12,38757731,38900289,142558,-,yes
BAC11_E13,20,20q12,38860192,38955698,95506,-,yes
BAC187_L23,20,20q12,38860194,38932138,71944,-,-
BAC7_D05,20,BAC7-T7_D05_074.ab1,38919349,39047882,128533,-,-
BAC46_D12,20,20q12,39100237,39213404,113167,-,yes
BAC52_P11,20,20q12,39123855,39211648,87793,-,-
BAC233_D20,20,20q12,39123856,39212330,88474,-,-
BAC110_K17,20,20q12,39136183,39267986,131803,-,-
BAC31_F21,20,20q12,39136186,39242311,106125,-,-
BAC21_G16,20,20q12,39149118,39258841,109723,-,-
BAC36_A24,20,20q12,39157592,39263569,105977,-,-
BAC97_D16,20,20q12,39171426,39297174,125748,-,-
BAC169_I05,20,20q12,39171426,39258841,87415,-,-
BAC67_K19,20,20q12,39186964,39273709,86745,-,-
BAC227_K16,20,20q12,39212323,39303556,91233,-,yes
BAC18_D20,20,20q12,39233058,39334183,101125,-,-
BAC217_I16,20,20q12,39242320,39334189,91869,-,yes
REBAC113_B19,20,REBAC113-T7_B19_004.ab1,39255260,39355260,100000,-,-
BAC218_B14,20,20q12,39373528,39465927,92399,-,yes
BAC191_K10,20,20q12,39442108,39535777,93669,-,yes
REBAC177_A23,20,REBAC177-M13R_A23_067.ab1,39503668,39618972,115304,-,-
BAC70_D19,20,BAC70-T7_D19_012.ab1,39586158,39692991,106833,-,-
BAC176_J05,20,20q12,39625902,39710141,84239,-,yes
BAC170_N09,20,20q12,39637693,39718553,80860,-,-
BAC75_O10,20,20q12,39646935,39778789,131854,-,-
BAC66_J06,20,20q12,39649902,39791097,141195,-,-
BAC91_M07,20,20q12,39674871,39780372,105501,-,-
BAC155_H23,20,20q12,39693015,39830993,137978,-,yes
BAC236_K02,20,20q12,39718631,39852093,133462,-,-
BAC110_H10,20,20q12,39735470,39861740,126270,-,yes
BAC237_J05,20,20q12,39752812,39851850,99038,-,-
BAC37_K20,20,20q12,39760107,39851845,91738,-,-
BAC239_H21,20,20q12,39780367,39861739,81372,-,-
BAC237_N20,20,20q12,39852316,39961154,108838,-,-
BAC146_G14,20,20q12,39856027,39949384,93357,-,-
BAC160_L24,20,20q12,39859575,39967208,107633,-,yes
BAC128_H04,20,20q12,39870329,39967655,97326,-,yes
BAC44_I06,20,20q12,39870329,39961138,90809,-,-
BAC190_G12,20,BAC190-M13R_G12_091.ab1,40012132,40144587,132455,-,-
BAC192_P18,20,20q12,40019438,40112728,93290,-,yes
BAC178_G20,20,20q12,40037873,40147984,110111,-,-
BAC139_N19,20,20q12,40045183,40142988,97805,-,-
BAC246_N05,20,20q12,40112723,40203831,91108,-,yes
BAC8_E16,20,20q12,40196358,40288490,92132,-,yes
BAC52_H17,20,20q12,40226114,40340476,114362,-,yes
BAC177_F04,20,20q12,40307960,40410976,103016,-,yes
BAC177_L22,20,20q12,40308214,40410957,102743,-,-
BAC225_F10,20,20q12,40317249,40398090,80841,-,-
BAC153_J12,20,20q12,40399902,40412268,12366,-,-
BAC72_G12,20,20q12,40410975,40514844,103869,-,yes
BAC248_E04,20,20q12,40439501,40529285,89784,-,-
BAC123_A13,20,20q12,40469090,40581493,112403,-,yes
BAC129_N09,20,20q12,40514885,40604868,89983,-,-
BAC218_H04,20,20q12,40548922,40649070,100148,-,yes
BAC176_A18,20,20q12,40608700,40699492,90792,-,yes
BAC179_F02,20,20q12,40664671,40759175,94504,-,yes
BAC169_P19,20,20q12,40734927,40867076,132149,-,yes
BAC65_H18,20,20q12,40859748,40958117,98369,-,yes
BAC34_I16,20,20q12,40876915,40965671,88756,-,-
BAC148_M22,20,20q12,40908622,40987236,78614,-,-
BAC84_I06,20,20q12,40915682,41028166,112484,-,-
BAC18_I12,20,20q12-20q13.11,40952678,41113472,160794,-,yes
BAC175_J22,20,20q12,40965666,41050101,84435,-,-
BAC12_M09,20,20q12-20q13.11,41003264,41140134,136870,-,yes
BAC137_E14,20,BAC137-M13R_E14_019.ab1,41136487,41214850,78363,-,-
BAC140_N24,20,20q13.11,41140156,41253879,113723,-,yes
BAC151_P16,20,20q13.11,41182831,41279702,96871,-,yes
BAC136_K10,20,BAC136-M13R_K10_063.ab1,41279110,41366325,87215,-,-
BAC140_B06,20,20q13.11,41279696,41357627,77931,-,yes
BAC210_P07,20,BAC210-M13R_P07_026.ab1,41360806,41451321,90515,-,-
BAC50_C22,20,20q13.11,41451123,41543764,92641,-,yes
BAC218_M23,20,20q13.11,41451348,41527887,76539,-,-
BAC96_A03,20,20q13.11,41451348,41553770,102422,-,-
BAC66_M08,20,20q13.11,41455695,41565167,109472,-,-
BAC120_L24,20,20q13.11-20q13.12,41497877,41613420,115543,-,yes
BAC222_E17,20,20q13.11-20q13.12,41504565,41607763,103198,-,-
BAC42_C15,20,20q13.11-20q13.12,41565250,41665648,100398,-,-
BAC24_L04,20,20q13.11-20q13.12,41565250,41712883,147633,-,yes
BAC116_L22,20,20q13.11-20q13.12,41571670,41709191,137521,-,-
BAC100_P17,20,20q13.11-20q13.12,41585330,41708263,122933,-,-
BAC198_B08,20,20q13.12,41709349,41820291,110942,-,yes
BAC193_D05,20,20q13.12,41721428,41805872,84444,-,-
BAC170_F01,20,20q13.12,41727132,41810852,83720,-,-
BAC84_H18,20,20q13.12,41815963,41958341,142378,-,yes
BAC143_P13,20,20q13.12,41858705,41973316,114611,-,-
BAC83_M02,20,20q13.12,41891410,42024094,132684,-,-
BAC169_B21,20,20q13.12,41892697,42006038,113341,-,-
BAC88_J16,20,20q13.12,41935598,42019621,84023,-,-
BAC50_I12,20,20q13.12,41940506,42031875,91369,-,-
BAC41_I17,20,20q13.12,41947578,42047527,99949,-,yes
BAC96_C10,20,20q13.12,41969389,42057631,88242,-,-
BAC75_I24,20,20q13.12,42017641,42103675,86034,-,yes
BAC54_J13,20,BAC54-M13R_J13_018.ab1,42019831,42197630,177799,-,-
BAC221_K03,20,20q13.12,42064831,42136593,71762,-,yes
BAC134_K21,20,BAC134-M13R_K21_047.ab1,42109858,42273843,163985,-,-
BAC92_P19,20,20q13.12,42229335,42309614,80279,-,yes
BAC106_I07,20,20q13.12,42241185,42329127,87942,-,-
BAC160_L21,20,20q13.12,42260084,42366264,106180,-,-
BAC131_K03,20,20q13.12,42309608,42387002,77394,-,yes
BAC234_D24,20,20q13.12,42343034,42453727,110693,-,-
BAC81_E20,20,20q13.12,42361318,42453547,92229,-,-
BAC221_N11,20,20q13.12,42362053,42453728,91675,-,yes
BAC184_M20,20,20q13.12,42366259,42453727,87468,-,-
BAC145_H16,20,20q13.12,42366281,42453728,87447,-,-
BAC135_M14,20,20q13.12,42446677,42527730,81053,-,yes
BAC26_G17,20,20q13.12,42498376,42576815,78439,-,-
BAC46_J11,20,20q13.12,42499244,42601363,102119,-,yes
BAC243_A23,20,20q13.12,42529704,42662746,133042,-,-
BAC226_H21,20,20q13.12,42529704,42617060,87356,-,-
BAC116_F22,20,20q13.12,42529861,42687992,158131,-,yes
BAC100_F12,20,20q13.12,42580426,42684231,103805,-,-
BAC180_J21,20,20q13.12,42612691,42719048,106357,-,-
BAC132_E07,20,20q13.12,42615608,42681321,65713,-,-
BAC108_H20,20,20q13.12,42622371,42717222,94851,-,-
BAC224_M09,20,20q13.12,42622765,42699983,77218,-,-
BAC167_A19,20,20q13.12,42684364,42799486,115122,-,yes
BAC14_E05,20,20q13.12,42700016,42799928,99912,-,-
BAC171_H02,20,20q13.12,42735082,42819880,84798,-,-
BAC4_N12,20,20q13.12,42775164,42925330,150166,-,yes
BAC120_D14,20,20q13.12,42793774,42899267,105493,-,-
BAC50_J24,20,20q13.12,42799979,42923188,123209,-,-
BAC160_L09,20,20q13.12,42819899,42898974,79075,-,-
BAC36_L18,20,20q13.12,42856519,42950798,94279,-,-
BAC180_D17,20,20q13.12,42884926,42943782,58856,-,-
BAC147_O24,20,20q13.12,42899007,42976890,77883,-,yes
REBAC105_E22,20,REBAC105-T7_E22_051.ab1,42976884,43068827,91943,-,-
BAC92_O15,20,20q13.12,43013374,43107706,94332,-,yes
BAC105_J15,20,20q13.12,43021000,43146294,125294,-,-
BAC187_A11,20,20q13.12,43023970,43107491,83521,-,-
BAC70_H13,20,20q13.12,43036350,43136889,100539,-,-
BAC192_L22,20,20q13.12,43040297,43137040,96743,-,-
BAC49_P12,20,20q13.12,43078993,43175308,96315,-,-
BAC221_D23,20,20q13.12,43099822,43215029,115207,-,yes
BAC177_F03,20,20q13.12,43122270,43231342,109072,-,-
BAC118_P19,20,20q13.12,43137035,43241844,104809,-,-
BAC32_G09,20,20q13.12,43150764,43243212,92448,-,-
BAC142_J14,20,20q13.12,43159045,43241844,82799,-,-
BAC228_F11,20,20q13.12,43172376,43272555,100179,-,-
BAC58_F08,20,20q13.12,43195144,43290060,94916,-,yes
BAC247_H20,20,20q13.12,43243209,43346459,103250,-,-
BAC27_M09,20,20q13.12,43272802,43369541,96739,-,-
BAC120_J11,20,20q13.12,43287646,43375973,88327,-,yes
BAC62_N02,20,20q13.12,43353521,43421854,68333,-,-
BAC57_K02,20,20q13.12,43361078,43441154,80076,-,-
BAC222_M02,20,20q13.12,43369560,43474226,104666,-,yes
BAC211_B11,20,BAC211-M13R_B11_068.ab1,43373830,43482897,109067,-,-
BAC12_E14,20,BAC12-T7_E14_021.ab1,43474496,43653934,179438,-,-
BAC198_N07,20,20q13.12,43552396,43670929,118533,-,yes
BAC150_K12,20,20q13.12,43558754,43670026,111272,-,-
BAC171_E10,20,20q13.12,43584284,43669591,85307,-,-
BAC230_B18,20,20q13.12,43585805,43690041,104236,-,-
BAC197_L21,20,20q13.12,43587713,43670026,82313,-,-
BAC239_O07,20,20q13.12,43646363,43739303,92940,-,yes
BAC113_E09,20,20q13.12,43730869,43841263,110394,-,yes
BAC78_B01,20,20q13.12,43739298,43824506,85208,-,-
BAC168_M17,20,20q13.12,43763216,43880339,117123,-,-
BAC139_D02,20,20q13.12,43777576,43860378,82802,-,-
BAC48_E06,20,20q13.12,43823722,44029550,205828,-,yes
BAC51_A19,20,20q13.12,43824384,43948696,124312,-,-
BAC15_I11,20,20q13.12,43860668,44003216,142548,-,-
BAC155_A08,20,20q13.12,43860947,43934945,73998,-,-
BAC130_K08,20,20q13.12,43867483,43954736,87253,-,-
BAC65_L13,20,20q13.12,43875771,43966509,90738,-,-
BAC155_H13,20,20q13.12,43934938,44029711,94773,-,-
BAC50_E09,20,20q13.12,43971405,44106160,134755,-,-
BAC62_J21,20,20q13.12,43999362,44086038,86676,-,-
BAC144_J08,20,20q13.12,44021097,44106169,85072,-,yes
BAC142_O08,20,20q13.12,44029704,44127683,97979,-,-
BAC189_J05,20,20q13.12,44068770,44136181,67411,-,-
BAC180_A21,20,20q13.12,44106166,44203716,97550,yes,yes
BAC22_K14,20,20q13.12,44123070,44264771,141701,-,-
BAC134_H11,20,20q13.12,44189165,44268146,78981,-,-
BAC139_D19,20,20q13.12,44189208,44251985,62777,-,-
BAC109_D08,20,20q13.12,44196227,44284168,87941,-,yes
BAC153_J16,20,20q13.12,44198954,44276844,77890,-,-
BAC242_C18,20,20q13.12,44212912,44347181,134269,-,yes
BAC197_E20,20,20q13.12,44333379,44425295,91916,-,yes
BAC96_M13,20,20q13.12,44425289,44538815,113526,-,yes
BAC49_C12,20,BAC49-T7_C12_091.ab1,44456322,44567121,110799,-,-
BAC166_O11,20,20q13.12,44554642,44634936,80294,-,yes
BAC217_K23,20,20q13.12,44562684,44703689,141005,-,yes
BAC236_I19,20,20q13.12,44667492,44745355,77863,-,-
BAC231_F17,20,20q13.12,44683223,44759167,75944,-,yes
BAC144_K14,20,20q13.12,44711358,44815750,104392,-,yes
BAC80_O12,20,20q13.12,44784469,44872438,87969,-,yes
BAC123_P21,20,20q13.12,44865305,44981871,116566,-,yes
BAC131_C08,20,20q13.12,44929414,45010736,81322,-,yes
BAC141_B07,20,20q13.12,45011764,45114275,102511,-,yes
BAC125_O09,20,20q13.12,45048713,45131537,82824,-,-
BAC241_D17,20,20q13.12,45086487,45224414,137927,-,yes
BAC197_D19,20,20q13.12,45088115,45176372,88257,-,-
BAC221_P16,20,20q13.12,45102776,45197498,94722,-,-
BAC175_P08,20,20q13.12,45163796,45261717,97921,-,-
BAC166_O05,20,20q13.12,45176681,45263471,86790,-,-
BAC178_I01,20,20q13.12,45176683,45261717,85034,-,-
BAC182_G18,20,20q13.12,45188785,45288299,99514,-,-
BAC194_I02,20,20q13.12,45199310,45291805,92495,-,-
BAC21_K22,20,20q13.12,45205597,45332390,126793,-,yes
BAC142_J17,20,20q13.12,45278597,45399937,121340,-,-
BAC153_E02,20,20q13.12,45320400,45421351,100951,-,yes
BAC231_M07,20,20q13.12,45328445,45414086,85641,-,-
BAC169_J23,20,20q13.12,45391424,45517033,125609,-,yes
BAC227_P07,20,20q13.12,45434983,45554314,119331,-,-
BAC5_L22,20,20q13.12,45435012,45517202,82190,-,-
BAC226_B11,20,20q13.12,45447081,45570380,123299,-,yes
BAC56_A24,20,BAC56-T7_A24_084.ab1,45517215,45617694,100479,-,-
BAC52_K03,20,20q13.12,45607804,45691092,83288,-,yes
BAC222_L19,20,20q13.12,45634696,45745996,111300,-,-
BAC29_E03,20,20q13.12-20q13.13,45673256,45824514,151258,-,yes
BAC48_G03,20,20q13.12,45677822,45756765,78943,-,-
BAC60_A14,20,20q13.12-20q13.13,45723374,45837852,114478,-,-
BAC181_J21,20,20q13.12-20q13.13,45724382,45824515,100133,-,-
BAC192_B11,20,20q13.12-20q13.13,45739889,45833856,93967,-,-
BAC92_G02,20,20q13.12-20q13.13,45756814,45837864,81050,-,-
BAC248_C22,20,20q13.12-20q13.13,45761309,45864729,103420,-,-
BAC233_K05,20,20q13.12-20q13.13,45761309,45852740,91431,-,-
BAC220_H19,20,20q13.12-20q13.13,45766439,45864729,98290,-,-
BAC145_O17,20,20q13.12-20q13.13,45771584,45846541,74957,-,-
BAC219_H17,20,20q13.12-20q13.13,45771584,45891866,120282,-,-
BAC14_I08,20,20q13.13,45805945,45894517,88572,-,-
BAC134_P07,20,20q13.13,45814291,45976884,162593,-,yes
BAC26_E16,20,20q13.13,45814295,45932088,117793,-,-
BAC60_I22,20,20q13.13,45824520,45905016,80496,-,-
BAC102_O17,20,20q13.13,45824524,45908231,83707,-,-
BAC163_M20,20,20q13.13,45833931,45908224,74293,-,-
BAC124_C20,20,20q13.13,45864722,45979753,115031,-,-
BAC183_P19,20,20q13.13,45908224,45982049,73825,-,-
BAC171_D01,20,20q13.13,45908224,45983779,75555,-,-
BAC188_N10,20,20q13.13,45934948,46012514,77566,-,-
BAC34_K11,20,20q13.13,45939273,46045999,106726,-,-
BAC11_O10,20,20q13.13,45947653,46054851,107198,-,-
BAC85_A03,20,20q13.13,45969887,46071203,101316,-,yes
BAC159_C02,20,20q13.13,46064813,46191252,126439,-,yes
BAC86_G19,20,20q13.13,46082441,46206872,124431,-,-
BAC83_F08,20,20q13.13,46145445,46249131,103686,-,-
BAC33_E04,20,20q13.13,46168982,46254312,85330,-,yes
BAC241_O02,20,20q13.13,46191511,46304369,112858,-,-
BAC160_J11,20,20q13.13,46249146,46337616,88470,-,yes
BAC189_B07,20,20q13.13,46298654,46377746,79092,-,-
BAC33_L22,20,20q13.13,46303297,46377746,74449,-,-
BAC140_K04,20,20q13.13,46304407,46377880,73473,-,-
BAC114_A12,20,20q13.13,46312859,46433050,120191,-,yes
BAC161_I02,20,20q13.13,46312897,46415811,102914,-,-
BAC226_D13,20,20q13.13,46319790,46413462,93672,-,-
BAC83_C10,20,20q13.13,46363299,46472451,109152,-,-
BAC230_K10,20,20q13.13,46375626,46472442,96816,-,-
BAC80_F04,20,20q13.13,46377877,46464625,86748,-,-
BAC160_G18,20,20q13.13,46377952,46480353,102401,-,-
BAC190_B02,20,20q13.13,46412702,46520288,107586,-,yes
BAC167_P12,20,20q13.13,46450037,46542879,92842,-,-
BAC12_K18,20,20q13.13,46464644,46573915,109271,-,yes
BAC188_P09,20,20q13.13,46573910,46685624,111714,-,yes
BAC181_J04,20,20q13.13,46600570,46703971,103401,-,-
BAC220_C16,20,20q13.13,46673419,46755978,82559,-,yes
BAC168_H06,20,20q13.13,46692382,46789765,97383,-,-
BAC242_E10,20,20q13.13,46706333,46799752,93419,-,-
BAC35_F01,20,20q13.13,46706336,46817951,111615,-,yes
BAC219_A16,20,20q13.13,46718208,46801712,83504,-,-
BAC170_F08,20,20q13.13,46804976,46912015,107039,-,-
BAC36_H18,20,20q13.13,46815813,46933480,117667,-,yes
BAC124_B21,20,20q13.13,46815813,46912017,96204,-,-
BAC86_K14,20,20q13.13,46818070,46907905,89835,-,-
BAC185_I18,20,20q13.13,46818070,46932802,114732,-,-
BAC149_O10,20,20q13.13,46823271,46928828,105557,-,-
BAC22_B10,20,20q13.13,46895167,47040527,145360,-,yes
BAC127_E24,20,20q13.13,46932007,47035670,103663,-,-
BAC82_N21,20,20q13.13,46980480,47110042,129562,-,-
BAC149_L16,20,20q13.13,47031726,47120229,88503,-,yes
BAC111_O20,20,BAC111-M13R_O20_041.ab1,47040157,47152916,112759,-,-
BAC40_M03,20,20q13.13,47045607,47143433,97826,-,yes
BAC57_J11,20,20q13.13,47045607,47132436,86829,-,-
BAC154_J04,20,20q13.13,47066297,47132430,66133,-,-
BAC227_N03,20,20q13.13,47152943,47241635,88692,-,yes
BAC154_G24,20,20q13.13,47230284,47320577,90293,-,yes
BAC141_D07,20,20q13.13,47256384,47335582,79198,-,-
BAC196_B16,20,20q13.13,47256384,47322971,66587,-,-
BAC107_N07,20,20q13.13,47303514,47406880,103366,-,yes
BAC33_J21,20,20q13.13,47331610,47424579,92969,-,-
BAC176_C10,20,20q13.13,47355293,47446774,91481,-,-
BAC142_D13,20,20q13.13,47393905,47470198,76293,-,yes
BAC21_I05,20,20q13.13,47407110,47492182,85072,-,-
BAC61_A15,20,20q13.13,47424571,47517456,92885,-,-
BAC78_J19,20,20q13.13,47432053,47575992,143939,-,yes
BAC219_G20,20,20q13.13,47443663,47547140,103477,-,-
BAC240_K21,20,20q13.13,47446780,47542557,95777,-,-
BAC33_I07,20,20q13.13,47474172,47577231,103059,-,-
BAC97_A15,20,20q13.13,47512047,47625859,113812,-,-
BAC23_B21,20,20q13.13,47542835,47670381,127546,-,yes
BAC187_M07,20,20q13.13,47547133,47625859,78726,-,-
BAC13_D08,20,20q13.13,47547133,47626517,79384,-,-
BAC169_C22,20,20q13.13,47547133,47659513,112380,-,-
BAC247_E03,20,20q13.13,47547136,47631121,83985,-,-
BAC121_L22,20,20q13.13,47576033,47659565,83532,-,-
BAC68_J11,20,20q13.13,47625853,47702602,76749,-,-
BAC86_N05,20,20q13.13,47626760,47730033,103273,-,yes
BAC52_L09,20,20q13.13,47678092,47816138,138046,-,yes
BAC32_M18,20,20q13.13,47701725,47787874,86149,-,-
BAC50_P18,20,20q13.13,47743608,47754183,10575,-,-
BAC125_C10,20,20q13.13,47754185,47852173,97988,-,yes
BAC6_B09,20,20q13.13,47913654,47999153,85499,-,yes
BAC39_D14,20,20q13.13,47913716,48069075,155359,-,-
BAC67_O20,20,20q13.13,47988025,48067865,79840,-,-
BAC105_H16,20,20q13.13,47988025,48067865,79840,-,-
BAC200_O08,20,20q13.13,47988025,48090391,102366,-,yes
BAC41_L12,20,20q13.13,48038911,48133560,94649,-,-
BAC209_M18,20,20q13.13,48068094,48173518,105424,-,-
BAC48_E14,20,20q13.13,48069178,48232457,163279,-,yes
BAC206_A04,20,20q13.13,48086782,48173503,86721,-,-
BAC186_F20,20,20q13.13,48139995,48227768,87773,-,-
BAC26_F21,20,20q13.13,48150835,48270357,119522,-,-
BAC244_I11,20,20q13.13,48170454,48321330,150876,-,-
BAC84_A05,20,20q13.13,48213089,48398551,185462,-,yes
BAC238_A08,20,20q13.13,48248918,48371061,122143,-,-
BAC159_N07,20,20q13.13,48271344,48368686,97342,-,-
BAC62_O19,20,20q13.13,48297651,48374184,76533,-,-
BAC167_H11,20,20q13.13,48364799,48463484,98685,-,yes
BAC50_J21,20,20q13.13,48407924,48514023,106099,-,-
BAC218_N19,20,20q13.13,48413299,48539331,126032,-,-
BAC193_H13,20,20q13.13,48463287,48565584,102297,-,yes
BAC176_B03,20,20q13.13,48465585,48541353,75768,-,-
BAC96_H08,20,20q13.13,48537102,48674679,137577,-,yes
BAC41_E23,20,20q13.13,48571934,48674679,102745,-,-
BAC169_H22,20,20q13.13,48603474,48692289,88815,-,-
BAC35_G10,20,20q13.13,48611362,48698792,87430,-,-
BAC227_E18,20,20q13.13,48638557,48768217,129660,-,yes
BAC189_F19,20,20q13.13,48674673,48766669,91996,-,-
BAC65_C22,20,20q13.13,48749390,48831759,82369,-,-
BAC25_A14,20,20q13.13,48755630,48844541,88911,-,yes
BAC205_P18,20,20q13.13,48768649,48898919,130270,-,-
BAC100_M05,20,20q13.13,48800288,48880868,80580,-,-
BAC173_I24,20,20q13.13,48817358,48975020,157662,-,yes
BAC154_A02,20,20q13.13,48817358,48903587,86229,-,-
BAC218_E05,20,20q13.13,48881574,48970498,88924,-,-
BAC227_G02,20,20q13.13,48893556,48978288,84732,-,-
BAC224_B14,20,20q13.13,48970707,49056056,85349,-,yes
BAC141_A06,20,20q13.13,49052676,49154665,101989,-,yes
BAC86_M17,20,20q13.13,49076579,49166346,89767,-,-
BAC147_K17,20,20q13.13,49078970,49177815,98845,-,-
BAC19_N10,20,20q13.13-20q13.2,49079163,49203311,124148,-,-
BAC120_O21,20,20q13.13-20q13.2,49101287,49209659,108372,-,-
BAC123_C11,20,20q13.13-20q13.2,49115079,49209659,94580,-,-
BAC188_B24,20,20q13.13-20q13.2,49136179,49209494,73315,-,-
BAC176_F12,20,20q13.13-20q13.2,49148248,49237349,89101,-,yes
BAC130_J03,20,20q13.13-20q13.2,49169754,49292223,122469,-,-
BAC97_P04,20,20q13.13-20q13.2,49177956,49292221,114265,-,-
BAC238_N23,20,20q13.2,49200490,49293545,93055,-,yes
BAC154_K20,20,20q13.2,49242019,49326624,84605,-,yes
BAC231_O09,20,BAC231-M13R_O09_058.ab1,49259770,49341128,81358,-,-
BAC73_P12,20,BAC73-T7_P12_102.ab1,49337925,49446534,108609,-,-
BAC54_D10,20,20q13.2,49350417,49487312,136895,-,yes
BAC131_B10,20,20q13.2,49446558,49551437,104879,-,-
BAC103_M15,20,20q13.2,49446560,49549679,103119,-,-
BAC80_M19,20,20q13.2,49455449,49552437,96988,-,-
BAC29_F01,20,20q13.2,49460585,49568094,107509,-,yes
BAC24_F24,20,20q13.2,49498875,49589408,90533,-,-
BAC249_N17,20,20q13.2,49511371,49596083,84712,-,-
BAC73_J08,20,20q13.2,49552680,49720728,168048,-,yes
BAC238_C24,20,20q13.2,49562218,49649593,87375,-,-
BAC25_A04,20,20q13.2,49562292,49677790,115498,-,-
BAC35_A20,20,20q13.2,49569158,49764929,195771,-,yes
BAC66_B04,20,20q13.2,49615375,49691777,76402,-,-
BAC65_I12,20,20q13.2,49633483,49739127,105644,-,-
BAC82_P05,20,20q13.2,49633483,49726163,92680,-,-
BAC141_D18,20,20q13.2,49633843,49723319,89476,-,-
BAC26_L10,20,20q13.2,49726335,49847373,121038,-,-
BAC37_E10,20,20q13.2,49744291,49846139,101848,-,-
BAC36_F02,20,20q13.2,49744337,49847402,103065,-,yes
BAC215_F24,20,BAC215-M13R_F24_084.ab1,49828236,49923434,95198,-,-
BAC170_H14,20,20q13.2,49850458,49974768,124310,-,yes
BAC204_M22,20,20q13.2,49855255,49974475,119220,-,-
BAC54_I01,20,20q13.2,49878724,49954764,76040,-,-
BAC151_H17,20,20q13.2,49970974,50084203,113229,-,yes
BAC67_K13,20,20q13.2,49974770,50085661,110891,-,yes
BAC55_D04,20,20q13.2,49974781,50084030,109249,-,-
BAC154_A15,20,BAC154-T7_A15_035.ab1,49980738,50085657,104919,-,-
BAC78_F04,20,20q13.2,49980739,50084030,103291,-,-
BAC224_I04,20,20q13.2,50001404,50084203,82799,-,-
BAC190_M11,20,20q13.2,50002886,50084028,81142,-,-
BAC173_I03,20,20q13.2,50085807,50204563,118756,-,yes
BAC218_E14,20,20q13.2,50090353,50174984,84631,-,-
BAC161_N23,20,20q13.2,50090355,50178658,88303,-,-
BAC45_O11,20,20q13.2,50156437,50304936,148499,-,yes
BAC53_G13,20,20q13.2,50187046,50281023,93977,-,-
BAC92_K17,20,20q13.2,50214988,50324794,109806,-,-
BAC153_I20,20,20q13.2,50262126,50351181,89055,-,-
BAC236_I07,20,20q13.2,50262337,50378192,115855,-,yes
BAC90_K06,20,20q13.2,50304972,50463496,158524,-,yes
BAC30_O23,20,20q13.2,50356544,50439986,83442,-,-
BAC114_E14,20,20q13.2,50358638,50439986,81348,-,-
BAC43_L10,20,20q13.2,50395062,50487935,92873,-,-
BAC190_L18,20,20q13.2,50439992,50533141,93149,-,yes
BAC26_E14,20,20q13.2,50562516,50678636,116120,-,yes
BAC195_O05,20,20q13.2,50578976,50665840,86864,-,-
BAC162_I18,20,20q13.2,50618616,50729504,110888,-,yes
BAC133_E18,20,20q13.2,50695780,50772564,76784,-,yes
BAC114_M08,20,BAC114-M13R_M08_033.ab1,50767154,50852320,85166,-,-
BAC193_E16,20,20q13.2,50803748,50906073,102325,-,yes
BAC81_C22,20,20q13.2,50853592,51013549,159957,-,yes
BAC1_L05,20,20q13.2,50885643,50978911,93268,-,-
BAC11_O22,20,BAC11-T7_O22_073.ab1,51038165,51155554,117389,-,-
BAC166_J02,20,20q13.2,51088180,51201285,113105,-,yes
BAC66_B08,20,20q13.2,51124459,51215581,91122,-,-
BAC165_F03,20,20q13.2,51142262,51222347,80085,-,yes
BAC173_L15,20,20q13.2,51206471,51302086,95615,-,-
BAC186_I23,20,20q13.2,51212340,51309528,97188,-,yes
BAC122_D02,20,20q13.2,51269661,51371977,102316,-,yes
REBAC221_I01,20,REBAC221-T7_I01_007.ab1,51396483,51477976,81493,-,-
BAC58_P02,20,20q13.2,51411106,51502850,91744,-,yes
REBAC109_D01,20,REBAC109-T7_D01_010.ab1,51419780,51527566,107786,-,-
BAC196_G07,20,20q13.2,51419781,51502853,83072,-,yes
BAC252_B22,20,20q13.2,51526244,51634739,108495,-,yes
BAC165_E10,20,20q13.2,51549755,51648915,99160,-,yes
BAC166_K04,20,BAC166-M13R_K04_063.ab1,51560409,51644760,84351,-,-
BAC235_N23,20,BAC235-T7_N23_084.ab1,51669676,51794402,124726,-,-
BAC78_K03,20,20q13.2,51703239,51784376,81137,-,yes
BAC227_M23,20,20q13.2,51711316,51792543,81227,-,-
BAC141_B14,20,20q13.2,51731499,51826300,94801,-,-
BAC120_K22,20,20q13.2,51731499,51844776,113277,-,yes
BAC97_F14,20,20q13.2,51794466,51885631,91165,-,-
BAC40_A21,20,20q13.2,51801733,51922105,120372,-,-
BAC66_B06,20,20q13.2,51802757,51934150,131393,-,yes
BAC126_M11,20,20q13.2,51848107,51952087,103980,-,-
BAC86_N14,20,20q13.2,51871790,51988302,116512,-,yes
REBAC242_G12,20,REBAC242-T7_G12_091.ab1,51915495,51917737,2242,-,-
BAC134_N17,20,20q13.2,52011739,52107438,95699,-,yes
BAC175_F23,20,20q13.2,52059853,52150858,91005,-,-
BAC26_C24,20,20q13.2,52062667,52157176,94509,-,-
BAC90_M01,20,20q13.2,52063394,52150858,87464,-,-
BAC72_N10,20,20q13.2,52104848,52199920,95072,-,-
BAC200_N11,20,20q13.2,52107432,52212805,105373,-,yes
BAC37_H14,20,BAC37-T7_H14_030.ab1,52225199,52325199,100000,-,-
BAC123_P10,20,20q13.2,52227461,52326226,98765,-,yes
BAC114_H07,20,20q13.2,52285983,52419266,133283,-,yes
BAC51_F06,20,20q13.2,52365921,52589779,223858,-,yes
BAC149_I04,20,20q13.2,52427987,52522374,94387,-,-
BAC18_A01,20,BAC18-T7_A01_003.ab1,52583652,52677620,93968,-,-
BAC27_M15,20,20q13.2,52620373,52755393,135020,-,yes
BAC151_C16,20,20q13.2,52638180,52727760,89580,-,-
BAC67_H06,20,20q13.2,52645991,52755397,109406,-,-
BAC97_O05,20,20q13.2,52677648,52780467,102819,-,-
BAC119_H12,20,20q13.2,52727780,52830261,102481,-,yes
BAC133_K22,20,20q13.2,52839024,52940822,101798,-,yes
BAC54_B06,20,20q13.2,52850126,52958192,108066,-,-
BAC150_O04,20,20q13.2,52907187,52967062,59875,-,yes
BAC22_M15,20,20q13.2,52944036,53050583,106547,-,yes
REBAC228_B12,20,REBAC228-T7_B12_085.ab1,52988950,53067756,78806,-,-
BAC128_K01,20,20q13.2,53064053,53172187,108134,-,yes
BAC185_C16,20,20q13.2,53075934,53167832,91898,-,-
BAC195_J13,20,20q13.2,53075934,53148787,72853,-,-
BAC114_I07,20,BAC114-M13R_I07_007.ab1,53093906,53194372,100466,-,-
BAC239_K03,20,BAC239-M13R_K03_046.ab1,53186391,53275327,88936,-,-
BAC82_G07,20,20q13.2,53232499,53389282,156783,-,yes
BAC180_K06,20,20q13.2,53264063,53346562,82499,-,-
BAC68_I06,20,20q13.2,53274526,53363687,89161,-,-
BAC37_I10,20,BAC37-T7_I10_055.ab1,53400372,53500372,100000,-,-
BAC165_L17,20,20q13.2,53405973,53499023,93050,-,yes
BAC183_E24,20,20q13.2,53511059,53610620,99561,-,yes
BAC181_E19,20,20q13.2,53521479,53575552,54073,-,-
BAC40_G04,20,20q13.2,53549890,53593033,43143,-,-
BAC64_I17,20,BAC64-T7_I17_069.ab1,53556636,53642117,85481,-,-
BAC167_J05,20,20q13.2,53691578,53793988,102410,-,yes
BAC36_F21,20,20q13.2,53752137,53834677,82540,-,yes
BAC167_M08,20,20q13.2,53803027,53862786,59759,-,yes
BAC64_O23,20,BAC64-T7_O23_079.ab1,53868029,58493556,4625527,-,-
BAC43_D01,20,20q13.2,53933867,54041022,107155,-,yes
REBAC112_D21,20,REBAC112-T7_D21_044.ab1,54069637,54187800,118163,-,-
BAC177_E05,20,20q13.2,54097192,54175016,77824,-,yes
BAC1_O23,20,20q13.2,54138861,54238289,99428,-,-
BAC103_C10,20,20q13.2,54155167,54238282,83115,-,-
BAC28_J07,20,20q13.2,54167205,54282375,115170,-,yes
BAC155_A14,20,20q13.2,54176037,54286519,110482,-,-
BAC130_D13,20,20q13.2,54176038,54265649,89611,-,-
BAC230_A13,20,20q13.2,54182935,54265648,82713,-,-
BAC82_F02,20,20q13.2,54243987,54346283,102296,-,yes
REBAC231_J20,20,REBAC231-T7_J20_022.ab1,54345749,54431957,86208,-,-
BAC219_K11,20,20q13.2-20q13.31,54346409,54429455,83046,-,yes
BAC139_H21,20,20q13.2-20q13.31,54372562,54454017,81455,-,-
BAC142_L16,20,20q13.2-20q13.31,54391271,54529313,138042,-,yes
BAC87_A02,20,BAC87-M13R_A02_019.ab1,54451944,54577231,125287,-,-
BAC190_D04,20,20q13.31,54454017,54546843,92826,-,yes
BAC141_C23,20,20q13.31,54547132,54634354,87222,-,yes
BAC247_K23,20,20q13.31,54584323,54699111,114788,-,-
BAC43_M15,20,20q13.31,54601548,54699864,98316,-,yes
BAC232_D13,20,20q13.31,54641303,54760627,119324,-,yes
BAC78_G13,20,20q13.31,54641303,54753966,112663,-,-
BAC157_C16,20,20q13.31,54702507,54791794,89287,-,-
BAC146_L23,20,20q13.31,54702507,54813171,110664,-,-
BAC68_J14,20,20q13.31,54702507,54804811,102304,-,-
BAC55_G23,20,20q13.31,54702555,54842716,140161,-,yes
BAC159_M15,20,BAC159-M13R_M15_051.ab1,54844109,54930977,86868,-,-
BAC55_M08,20,20q13.31,54847001,54952458,105457,-,yes
BAC56_H19,20,20q13.31,54870693,54978063,107370,-,-
BAC104_M03,20,20q13.31,54870725,55041533,170808,-,yes
BAC201_M09,20,20q13.31,54880143,54958735,78592,-,-
BAC179_O11,20,20q13.31,54995111,55105357,110246,-,-
BAC84_I24,20,20q13.31,55023333,55118197,94864,-,yes
BAC158_M16,20,20q13.31,55053237,55118197,64960,-,-
BAC105_F04,20,20q13.31,55074483,55159929,85446,-,-
BAC25_K15,20,20q13.31,55093917,55221506,127589,-,yes
BAC162_P04,20,20q13.31,55105354,55212580,107226,-,-
BAC181_E11,20,20q13.31,55182115,55272602,90487,-,-
BAC142_G05,20,20q13.31,55199302,55321216,121914,-,yes
BAC152_H01,20,20q13.31,55212571,55297394,84823,-,-
BAC56_D20,20,20q13.31,55241650,55331019,89369,-,yes
BAC159_B13,20,BAC159-M13R_B13_006.ab1,55351841,55425498,73657,-,-
BAC168_L05,20,20q13.31,55364512,55449217,84705,-,yes
REBAC252_G18,20,REBAC252-T7_G18_094.ab1,55381241,55492949,111708,-,-
BAC78_E17,20,20q13.31,55465438,55564234,98796,-,yes
BAC63_G09,20,20q13.31,55541112,55662556,121444,-,yes
BAC130_P15,20,20q13.31,55615847,55760254,144407,-,-
BAC233_G10,20,20q13.31,55626686,55747971,121285,-,-
BAC81_I05,20,20q13.31,55638383,55769766,131383,-,-
BAC58_E10,20,20q13.31,55638404,55747958,109554,-,-
BAC33_E12,20,20q13.31,55638413,55797941,159528,-,yes
BAC222_F24,20,20q13.31,55662567,55744870,82303,-,-
BAC176_L21,20,20q13.31,55696298,55798617,102319,-,-
BAC149_G22,20,20q13.31,55760253,55886867,126614,-,yes
BAC95_J23,20,20q13.31,55760253,55865072,104819,-,-
BAC54_H02,20,20q13.31-20q13.32,55821600,55930561,108961,-,yes
BAC224_F16,20,20q13.31-20q13.32,55895523,55948006,52483,-,yes
REBAC127_G20,20,REBAC127-T7_G20_027.ab1,55901141,56015725,114584,-,-
BAC161_F13,20,20q13.32,55953451,56057540,104089,-,yes
BAC115_L05,20,20q13.32,56015865,56111761,95896,-,yes
BAC99_K06,20,BAC99-M13R_K06_095.ab1,56067539,56167627,100088,-,-
BAC144_O14,20,20q13.32,56129636,56194178,64542,-,yes
BAC46_B07,20,20q13.32,56292025,56490419,198394,-,yes
BAC53_M09,20,20q13.32,56312004,56408719,96715,-,-
BAC18_P10,20,20q13.32,56319842,56429514,109672,-,-
BAC71_J15,20,20q13.32,56408742,56518451,109709,-,-
BAC36_G13,20,20q13.32,56427045,56515399,88354,-,-
BAC205_N14,20,20q13.32,56461809,56533820,72011,-,yes
BAC234_G05,20,20q13.32,56508586,56601702,93116,-,-
BAC101_D23,20,20q13.32,56508602,56601882,93280,-,-
BAC200_O13,20,20q13.32,56510286,56615551,105265,-,yes
BAC178_J10,20,20q13.32,56602001,56615554,13553,-,-
BAC140_G24,20,20q13.32,56609659,56685559,75900,-,yes
BAC96_N19,20,20q13.32,56653918,56762459,108541,-,yes
BAC252_N13,20,20q13.32,56749370,56844917,95547,-,yes
BAC28_J06,20,20q13.32,56763816,56854945,91129,-,-
BAC161_L11,20,20q13.32,56766074,56855018,88944,-,-
BAC95_D14,20,20q13.32,56782655,56882068,99413,-,-
BAC1_F21,20,20q13.32,56782655,56995771,213116,-,yes
BAC41_E11,20,20q13.32,56785564,56882008,96444,-,-
BAC220_F08,20,20q13.32,56785565,56875572,90007,-,-
BAC128_F08,20,20q13.32,56792167,56882068,89901,-,-
BAC179_B04,20,20q13.32,56855013,56950423,95410,-,-
BAC30_I24,20,20q13.32,56855978,56941518,85540,-,-
BAC223_N01,20,20q13.32,56875575,57011802,136227,-,-
BAC24_P09,20,20q13.32,56941593,57073364,131771,-,yes
BAC182_O10,20,20q13.32,56979846,57067544,87698,-,-
BAC15_D02,20,20q13.32,57072379,57179295,106916,-,yes
BAC142_K22,20,20q13.32,57130652,57212485,81833,-,-
BAC140_H06,20,20q13.32,57130872,57208916,78044,-,-
BAC134_I23,20,20q13.32,57141382,57335600,194218,-,yes
BAC230_C17,20,20q13.32,57186237,57272315,86078,-,-
BAC135_H14,20,20q13.32,57186239,57282366,96127,-,-
BAC218_I02,20,20q13.32,57211950,57330265,118315,-,-
BAC231_H23,20,20q13.32,57253561,57336782,83221,-,-
BAC86_H13,20,20q13.32,57254229,57343167,88938,-,-
BAC176_J23,20,20q13.32,57272314,57352981,80667,-,-
BAC228_H01,20,20q13.32,57293316,57403980,110664,-,-
BAC46_L12,20,20q13.32,57323584,57412573,88989,-,-
BAC135_P24,20,20q13.32,57332394,57412934,80540,-,yes
BAC67_E21,20,20q13.32,57351293,57470555,119262,-,-
BAC132_I16,20,20q13.32,57366633,57492083,125450,-,-
BAC217_B19,20,20q13.32,57402500,57544478,141978,-,-
BAC78_C02,20,20q13.32,57412568,57508650,96082,-,-
BAC230_M03,20,20q13.32,57412929,57581006,168077,-,yes
BAC32_F06,20,20q13.32,57420705,57525094,104389,-,-
BAC171_L23,20,20q13.32,57465445,57579050,113605,-,-
BAC101_P12,20,20q13.32,57579042,57715061,136019,-,yes
BAC236_J02,20,20q13.32,57579043,57692359,113316,-,-
BAC92_C17,20,20q13.32,57591403,57703170,111767,-,-
BAC175_J14,20,20q13.32,57609865,57715061,105196,-,-
BAC115_F18,20,20q13.32,57650996,57776225,125229,-,-
BAC184_M14,20,20q13.32,57690156,57776625,86469,-,-
BAC131_I07,20,20q13.32,57699685,57800408,100723,-,yes
BAC194_L17,20,20q13.32,57785964,57866888,80924,-,yes
BAC29_A23,20,20q13.32-20q13.33,57890230,57980696,90466,-,yes
BAC206_D03,20,20q13.33,57945216,58032411,87195,-,yes
BAC63_I08,20,20q13.33,57980700,58085531,104831,-,yes
BAC140_C14,20,20q13.33,57985364,58082876,97512,-,-
BAC191_O04,20,BAC191-T7_O04_073.ab1,58105194,58181038,75844,-,-
BAC198_D21,20,20q13.33,58120897,58132161,11264,-,-
BAC133_E13,20,20q13.33,58262681,58345898,83217,-,yes
BAC26_L20,20,20q13.33,58267170,58438006,170836,-,yes
BAC78_F05,20,20q13.33,58267480,58367275,99795,-,-
BAC169_D08,20,20q13.33,58283646,58428960,145314,-,-
BAC235_E01,20,20q13.33,58283646,58348262,64616,-,-
BAC179_M08,20,20q13.33,58284793,58375749,90956,-,-
BAC102_D07,20,20q13.33,58284793,58367275,82482,-,-
BAC150_P15,20,20q13.33,58284793,58367275,82482,-,-
BAC73_G04,20,20q13.33,58298779,58409970,111191,-,-
BAC122_M05,20,20q13.33,58299452,58386968,87516,-,-
BAC70_F15,20,20q13.33,58346101,58448621,102520,-,yes
BAC5_J06,20,BAC5-T7_J06_088.ab1,58493580,58592576,98996,-,-
BAC176_N03,20,20q13.33,58494624,58591946,97322,-,yes
BAC1_F05,20,20q13.33,58516336,58651984,135648,-,yes
BAC131_N19,20,20q13.33,58598852,58710075,111223,-,-
BAC119_D08,20,20q13.33,58608419,58769617,161198,-,yes
BAC132_E01,20,20q13.33,58651987,58742850,90863,-,-
BAC244_H16,20,20q13.33,58681024,58758129,77105,-,-
BAC80_I12,20,20q13.33,58734979,58877908,142929,-,yes
BAC142_B23,20,BAC142-T7_B23_068.ab1,58796274,58912800,116526,-,-
BAC42_L06,20,20q13.33,58912833,59083556,170723,-,yes
BAC15_C05,20,20q13.33,58951559,59046575,95016,-,-
BAC148_P14,20,20q13.33,58961086,59040432,79346,-,-
BAC124_H11,20,20q13.33,58974065,59070679,96614,-,-
BAC42_C03,20,20q13.33,58985824,59088680,102856,-,-
BAC236_J20,20,20q13.33,58990249,59070679,80430,-,-
BAC70_B20,20,20q13.33,58990249,59101630,111381,-,-
BAC132_A09,20,20q13.33,59046569,59147245,100676,-,-
BAC158_L10,20,20q13.33,59046569,59136855,90286,-,-
BAC195_F14,20,20q13.33,59058830,59163304,104474,-,yes
BAC172_B07,20,20q13.33,59088678,59186648,97970,-,-
BAC63_L23,20,20q13.33,59101618,59194504,92886,-,-
BAC236_G24,20,20q13.33,59105675,59187954,82279,-,-
BAC189_J18,20,20q13.33,59125596,59203417,77821,-,-
BAC115_D16,20,20q13.33,59147604,59243178,95574,-,yes
BAC194_J07,20,20q13.33,59203411,59310318,106907,-,yes
BAC156_P03,20,BAC156-T7_P03_BAC156-T7_057.ab1,59206693,59310829,104136,-,-
BAC101_J18,20,20q13.33,59210139,59308074,97935,-,-
BAC175_H08,20,20q13.33,59215067,59299925,84858,-,-
BAC194_M18,20,20q13.33,59218545,59310303,91758,-,-
BAC75_G01,20,20q13.33,59396747,59514978,118231,-,yes
BAC13_E03,20,20q13.33,59465194,59564646,99452,-,-
BAC95_H14,20,20q13.33,59472515,59604468,131953,-,-
BAC58_D09,20,20q13.33,59490059,59625123,135064,-,yes
BAC239_J08,20,20q13.33,59492337,59564643,72306,-,-
BAC59_D10,20,20q13.33,59586362,59701273,114911,-,-
BAC32_G03,20,20q13.33,59586468,59688438,101970,-,-
BAC217_G15,20,20q13.33,59604459,59742868,138409,-,yes
BAC146_N07,20,20q13.33,59644343,59742642,98299,-,-
BAC27_O15,20,20q13.33,59688444,59775488,87044,-,-
BAC215_D14,20,20q13.33,59695399,59778287,82888,-,-
BAC60_M19,20,20q13.33,59709476,59819360,109884,-,yes
BAC90_L08,20,20q13.33,59778305,59865471,87166,-,yes
BAC80_A18,20,20q13.33,59851105,60044114,193009,-,yes
BAC200_J16,20,20q13.33,59866059,59944340,78281,-,-
BAC80_M03,20,20q13.33,59906913,60071550,164637,-,-
BAC239_A10,20,20q13.33,59948085,60052859,104774,-,-
BAC249_D10,20,20q13.33,59975550,60068269,92719,-,-
BAC240_M19,20,20q13.33,59975551,60052859,77308,-,-
BAC105_B11,20,20q13.33,60014830,60107898,93068,-,yes
BAC144_H23,20,20q13.33,60015475,60099952,84477,-,-
BAC245_O04,20,BAC245-M13R_O04_073.ab1,60021183,60121183,100000,-,-
BAC95_J20,20,20q13.33,60029001,60099952,70951,-,-
BAC186_P20,20,BAC186-T7_P20_042.ab1,60119656,60215459,95803,-,-
BAC247_M17,20,20q13.33,60143711,60258979,115268,-,yes
BAC241_D04,20,20q13.33,60232421,60305071,72650,-,-
BAC230_A08,20,20q13.33,60232436,60372640,140204,-,yes
BAC41_H17,20,20q13.33,60297806,60398094,100288,yes,-
BAC30_C05,20,20q13.33,60334240,60438859,104619,-,yes
BAC142_I19,20,20q13.33,60743422,60901143,157721,-,yes
BAC5_O23,20,20q13.33,60769415,60855342,85927,-,-
BAC197_N20,20,20q13.33,60809455,60918008,108553,-,-
BAC156_L21,20,20q13.33,60843626,60961832,118206,-,yes
BAC226_C07,20,20q13.33,60937866,61037360,99494,-,yes
BAC218_M17,20,20q13.33,60961897,61037185,75288,-,-
BAC164_L01,20,BAC164-M13R_L01_016.ab1,61037418,61114932,77514,-,-
BAC184_P03,20,20q13.33,61079087,61194617,115530,-,yes
BAC36_F14,20,20q13.33,61187897,61291885,103988,yes,yes
BAC189_O14,20,20q13.33,61234249,61322024,87775,yes,-
BAC235_L19,20,20q13.33,61243317,61367692,124375,yes,yes
BAC231_L13,20,20q13.33,61347743,61482163,134420,yes,-
BAC107_K11,20,20q13.33,61357092,61504065,146973,yes,yes
BAC170_I22,20,20q13.33,61387393,61535229,147836,yes,-
BAC196_G08,20,20q13.33,61387393,61497286,109893,yes,-
BAC236_B17,20,20q13.33,61398070,61523995,125925,-,-
BAC182_M14,20,20q13.33,61400599,61494760,94161,-,-
BAC27_L23,20,20q13.33,61497279,61638479,141200,yes,yes
BAC101_F02,20,20q13.33,61568343,61687371,119028,yes,-
BAC6_B07,20,20q13.33,61607407,61693423,86016,yes,-
BAC140_F09,20,20q13.33,61607407,61701722,94315,yes,yes
BAC192_D18,20,20q13.33,61638495,61722080,83585,yes,yes
BAC36_E22,20,20q13.33,61712650,61805126,92476,-,yes
BAC208_K01,20,BAC208-M13R_K01_015.ab1,61803466,61923822,120356,-,-
BAC91_B11,20,20q13.33,61827595,61927529,99934,yes,yes
BAC172_D09,20,20q13.33,61831173,61942516,111343,yes,-
BAC36_L10,20,20q13.33,61862056,61967338,105282,-,-
BAC36_M22,20,20q13.33,61927524,62035548,108024,-,yes
BAC244_O21,20,20q13.33,61927527,62031116,103589,-,-
BAC227_B13,20,20q13.33,61942541,62031060,88519,-,-
BAC239_C18,20,20q13.33,61942788,62031113,88325,-,-
BAC39_P17,20,20q13.33,61957311,62043405,86094,-,-
BAC38_H06,20,20q13.33,61984602,62068134,83532,-,yes
BAC90_N02,20,20q13.33,62060926,62154147,93221,-,yes
BAC143_A04,20,BAC143-M13R_A04_049.ab1,62104945,62204918,99973,-,-
BAC50_F03,20,20q13.33,62263193,62375806,112613,-,yes
BAC171_A04,20,20q13.33,62273049,62364348,91299,-,-
BAC107_K12,20,20q13.33,62273051,62364348,91297,-,-
BAC33_H12,20,20q13.33,62273056,62375822,102766,-,yes
BAC132_H16,20,BAC132-M13R_H16_060.ab1,62308370,62435917,127547,-,-
BAC85_C18,21,21p11.2,9792916,9886818,93902,-,-
BAC233_G16,21,21p11.2,9792917,9883123,90206,-,-
BAC52_M19,21,21p11.2,9792926,9886667,93741,-,-
BAC63_H13,21,21p11.2-21p11.1,9886840,10026509,139669,yes,-
BAC136_A17,21,21p11.2-21p11.1,9938424,10020852,82428,-,-
BAC199_H16,21,21p11.2-21p11.1,9972308,10064747,92439,-,-
BAC177_D13,21,21p11.1,10005724,10087370,81646,-,-
BAC172_K16,21,21p11.1,10009856,10096029,86173,-,-
BAC102_J10,21,21p11.1,10018979,10107255,88276,-,-
BAC252_C10,21,21p11.1,10043147,10149715,106568,-,-
BAC217_H08,21,21p11.1,10064927,10169718,104791,-,-
BAC53_I10,21,21p11.1,10104506,10195803,91297,-,-
BAC21_L22,21,21q11.2,13507032,13629207,122175,-,-
BAC122_G23,21,21q11.2,13594956,13785434,190478,-,-
BAC97_G12,21,21q11.2,13725531,13813182,87651,-,-
BAC170_G14,21,21q11.2,13890255,13992240,101985,-,-
BAC199_I20,21,21q11.2,13918380,14002308,83928,-,-
BAC236_I11,21,21q11.2,13931860,14023823,91963,-,-
BAC50_P15,21,21q11.2,13984617,14083341,98724,-,-
BAC235_I03,21,21q11.2,14004174,14083355,79181,-,-
BAC204_E10,21,21q11.2,14044783,14124682,79899,-,-
BAC127_J06,21,21q11.2,14159232,14239177,79945,-,-
BAC189_C13,21,21q11.2,14167085,14303419,136334,-,-
BAC97_M09,21,21q11.2,14330235,14416094,85859,-,-
BAC188_J19,21,21q11.2,14380859,14464700,83841,-,-
BAC33_D06,21,21q11.2,14461405,14625152,163747,-,-
BAC243_A10,21,21q11.2,14532045,14631484,99439,-,-
BAC244_B15,21,21q11.2,14540451,14614072,73621,-,-
BAC102_F10,21,21q11.2,14571029,14713371,142342,-,-
BAC29_L21,21,21q11.2,14659457,14765952,106495,-,-
BAC59_E23,21,21q11.2,14761443,14853341,91898,-,-
BAC190_J11,21,21q11.2,14989571,15073499,83928,-,-
BAC73_O23,21,21q11.2,14999240,15076899,77659,-,-
BAC180_I02,21,21q11.2,15073528,15140039,66511,-,-
BAC89_K18,21,21q11.2,15083641,15170981,87340,-,-
BAC64_F13,21,21q11.2,15150525,15259592,109067,-,-
BAC58_I16,21,21q11.2,15171275,15250228,78953,-,-
BAC114_O13,21,21q11.2,15180748,15253004,72256,-,-
BAC183_J17,21,21q11.2-21q21.1,15224929,15303800,78871,-,-
BAC118_L08,21,21q11.2-21q21.1,15297758,15385444,87686,-,-
BAC5_I10,21,21q21.1,15340966,15447219,106253,-,-
BAC152_J08,21,21q21.1,15340967,15447219,106252,-,-
BAC65_P05,21,21q21.1,15447297,15545757,98460,-,-
BAC223_F04,21,21q21.1,15447577,15545745,98168,-,-
BAC156_O05,21,21q21.1,15448289,15525712,77423,-,-
BAC194_O01,21,21q21.1,15464839,15548667,83828,-,-
BAC183_C10,21,21q21.1,15466895,15545756,78861,-,-
BAC158_G06,21,21q21.1,15509858,15622072,112214,-,-
BAC230_K01,21,21q21.1,15548661,15652984,104323,-,-
BAC107_B05,21,21q21.1,15573105,15712498,139393,-,-
BAC247_I22,21,21q21.1,15684469,15785012,100543,-,-
BAC36_F24,21,21q21.1,15727418,15883224,155806,-,-
BAC229_K11,21,21q21.1,15819405,15911329,91924,-,-
BAC127_M14,21,21q21.1,15878863,16003613,124750,-,-
BAC195_P23,21,21q21.1,15920080,15996003,75923,-,-
BAC67_G20,21,21q21.1,16075576,16163867,88291,-,-
BAC146_I09,21,21q21.1,16269496,16353432,83936,-,-
BAC128_E05,21,21q21.1,16484827,16629929,145102,-,-
BAC13_L10,21,21q21.1,16553126,16641599,88473,-,-
BAC30_K19,21,21q21.1,16657628,16764968,107340,-,-
BAC230_H21,21,21q21.1,16800183,16880789,80606,-,-
BAC30_J04,21,21q21.1,16901111,17045745,144634,-,-
BAC109_A07,21,21q21.1,17340726,17453830,113104,-,-
BAC162_J18,21,21q21.1,17371101,17453815,82714,-,-
BAC226_K14,21,21q21.1,17391676,17486479,94803,-,-
BAC188_N11,21,21q21.1,17402463,17507765,105302,-,-
BAC238_J03,21,21q21.1,17418685,17502720,84035,-,-
BAC208_D13,21,21q21.1,17531956,17611522,79566,-,-
BAC179_B22,21,21q21.1,17569397,17683740,114343,-,-
BAC107_M15,21,21q21.1,17572110,17659141,87031,-,-
BAC221_K17,21,21q21.1,17719601,17821750,102149,-,-
BAC193_G18,21,21q21.1,17719601,17806110,86509,-,-
BAC37_I21,21,21q21.1,17763419,17907871,144452,-,-
BAC236_D10,21,21q21.1,17805621,17934192,128571,-,-
BAC105_O18,21,21q21.1,17816225,17934192,117967,-,-
BAC83_F19,21,21q21.1,17846831,18024660,177829,-,-
BAC147_E16,21,21q21.1,17947192,18054887,107695,-,-
BAC189_F05,21,21q21.1,17947192,18024658,77466,-,-
BAC180_D11,21,21q21.1,17990162,18075447,85285,-,-
BAC31_G09,21,21q21.1,18076596,18217422,140826,-,-
BAC96_C20,21,21q21.1,18076596,18233395,156799,-,-
BAC116_H11,21,21q21.1,18137356,18233389,96033,-,-
BAC99_E05,21,21q21.1,18157303,18309880,152577,-,-
BAC91_E02,21,21q21.1,18204768,18308904,104136,-,-
BAC102_I17,21,21q21.1,18312202,18435563,123361,-,-
BAC49_N13,21,21q21.1,18374512,18504222,129710,-,-
BAC240_M07,21,21q21.1,18530589,18634646,104057,-,-
BAC243_L10,21,21q21.1,18556157,18642208,86051,-,-
BAC76_H23,21,21q21.1,18664209,18770648,106439,-,-
BAC42_L14,21,21q21.1,18689691,18826610,136919,-,-
BAC180_N06,21,21q21.1,18715120,18823763,108643,-,-
BAC46_F16,21,21q21.1,18715123,18823734,108611,-,-
BAC105_I09,21,21q21.1,18722043,18817292,95249,-,-
BAC221_D10,21,21q21.1,18945428,19029171,83743,-,-
BAC120_H22,21,21q21.1,18967957,19114476,146519,-,-
BAC54_E19,21,21q21.1,19114468,19215895,101427,-,-
BAC76_F05,21,21q21.1,19174802,19330450,155648,-,-
BAC197_K02,21,21q21.1,19231017,19316800,85783,-,-
BAC217_I14,21,21q21.1,19321105,19411607,90502,-,-
BAC110_M05,21,21q21.1,19455031,19551026,95995,-,-
BAC157_C13,21,21q21.1,19475095,19580072,104977,-,-
BAC151_P08,21,21q21.1,19533934,19630913,96979,-,-
BAC171_K03,21,21q21.1,19720247,19802572,82325,-,-
BAC66_I12,21,21q21.1,19722168,19790836,68668,-,-
BAC189_B05,21,21q21.1,19764017,19846113,82096,-,-
BAC202_E03,21,21q21.1,19798659,19891061,92402,-,-
BAC183_C22,21,21q21.1,20059757,20182993,123236,-,-
BAC125_I05,21,21q21.1,20188895,20303568,114673,-,-
BAC158_K23,21,21q21.1,20278228,20358445,80217,-,-
BAC101_D12,21,21q21.1,20406684,20512737,106053,-,-
BAC64_D19,21,21q21.1,20703069,20773739,70670,-,-
BAC80_B14,21,21q21.1,20822305,20933242,110937,-,-
BAC243_M16,21,21q21.1,20887029,20986605,99576,-,-
BAC61_F04,21,21q21.1,20960293,21097781,137488,-,-
BAC81_J06,21,21q21.1,21020607,21124651,104044,-,-
BAC7_N11,21,21q21.1,21094115,21211308,117193,-,-
BAC48_K11,21,21q21.1,21207768,21341664,133896,-,-
BAC100_C22,21,21q21.1,21216483,21314627,98144,-,-
BAC65_J20,21,21q21.1,21224466,21320207,95741,-,-
BAC181_I10,21,21q21.1,21251526,21341665,90139,-,-
BAC80_P01,21,21q21.1,21281161,21420862,139701,-,-
BAC36_I06,21,21q21.1,21536137,21632121,95984,-,-
BAC37_C10,21,21q21.1,21655545,21745565,90020,-,-
BAC149_A09,21,21q21.1,21664905,21749249,84344,-,-
BAC200_O02,21,21q21.1,21711102,21810394,99292,-,-
BAC106_G09,21,21q21.1,22010094,22107079,96985,-,-
BAC183_O17,21,21q21.1,22054335,22146838,92503,-,-
BAC221_G01,21,21q21.1,22224637,22305598,80961,-,-
BAC20_N04,21,21q21.1,22224645,22322164,97519,-,-
BAC199_F20,21,21q21.1,22242632,22322164,79532,-,-
BAC72_L18,21,21q21.1,22281886,22386711,104825,-,-
BAC65_F24,21,21q21.1,22301006,22415320,114314,-,-
BAC46_N06,21,21q21.1,22523635,22636852,113217,-,-
BAC127_A10,21,21q21.1,22613119,22730693,117574,-,-
BAC240_B22,21,21q21.1,22695540,22770784,75244,-,-
BAC38_K20,21,21q21.1,22720288,22809197,88909,-,-
BAC68_M14,21,21q21.1,22730732,22826331,95599,-,-
BAC232_N12,21,21q21.1,22814231,22896299,82068,-,-
BAC43_L21,21,21q21.1-21q21.2,22826352,22926561,100209,-,-
BAC203_J01,21,21q21.1-21q21.2,22826480,22911988,85508,-,-
BAC88_O08,21,21q21.2,22942718,23063745,121027,-,-
BAC196_J07,21,21q21.2,23063771,23135827,72056,-,-
BAC41_A03,21,21q21.2,23333727,23413016,79289,-,-
BAC33_B15,21,21q21.2,23544820,23648608,103788,-,-
BAC27_O12,21,21q21.2,23573383,23675938,102555,-,-
BAC25_B04,21,21q21.2,23692567,23819136,126569,-,-
BAC109_E08,21,21q21.2,23762909,23885897,122988,-,-
BAC100_H22,21,21q21.2,23812567,23913036,100469,-,-
BAC170_I10,21,21q21.2,23824264,23913050,88786,-,-
BAC96_L20,21,21q21.2,24013073,24110467,97394,-,-
BAC15_K05,21,21q21.2,24026111,24138811,112700,-,-
BAC173_C11,21,21q21.2,24059783,24138811,79028,-,-
BAC168_G13,21,21q21.2,24210130,24288039,77909,-,-
BAC109_A23,21,21q21.2,24274556,24353434,78878,-,-
BAC130_M05,21,21q21.2,24524457,24581774,57317,-,-
BAC154_C19,21,21q21.2,24641304,24742549,101245,-,-
BAC44_C05,21,21q21.2,24700397,24784187,83790,-,-
BAC42_M03,21,21q21.2,24721108,24841126,120018,-,-
BAC176_D17,21,21q21.2,24835539,24951857,116318,-,-
BAC75_F11,21,21q21.2,24873507,24954085,80578,-,-
BAC18_B23,21,21q21.2,24873507,24985449,111942,-,-
BAC104_J19,21,21q21.2,24880665,24951855,71190,-,-
BAC84_J13,21,21q21.2,24987728,25068041,80313,-,-
BAC184_C12,21,21q21.2,25062849,25151125,88276,-,-
BAC11_P09,21,21q21.2,25108303,25211158,102855,-,-
BAC179_B18,21,21q21.2,25119895,25220272,100377,-,-
BAC121_H20,21,21q21.2,25221983,25312454,90471,-,-
BAC1_E04,21,21q21.2,25232926,25312440,79514,-,-
BAC188_O01,21,21q21.2,25232984,25299319,66335,-,-
BAC25_L01,21,21q21.2,25274933,25385162,110229,-,-
BAC75_A11,21,21q21.2,25299326,25389271,89945,-,-
BAC248_P22,21,21q21.2,25359372,25467469,108097,-,-
BAC97_O19,21,21q21.2,25370877,25503818,132941,-,-
BAC170_E11,21,21q21.2,25517143,25610356,93213,-,-
BAC119_I21,21,21q21.2,25573558,25687243,113685,-,-
BAC56_K06,21,21q21.2,25595195,25694514,99319,-,-
BAC25_N09,21,21q21.2,25635645,25792194,156549,-,-
BAC176_F18,21,21q21.2-21q21.3,25727285,25807137,79852,-,-
BAC43_A19,21,21q21.2-21q21.3,25727290,25827221,99931,-,-
BAC57_H14,21,21q21.2-21q21.3,25764511,25882053,117542,-,-
BAC19_G11,21,21q21.2-21q21.3,25783958,25871880,87922,-,-
BAC244_F16,21,21q21.2-21q21.3,25783958,25872057,88099,-,-
BAC222_J23,21,21q21.2-21q21.3,25786684,25872045,85361,-,-
BAC184_F07,21,21q21.2-21q21.3,25792211,25872057,79846,-,-
BAC209_E24,21,21q21.3,25872064,25966282,94218,-,-
BAC86_F17,21,21q21.3,25882052,26039189,157137,-,-
BAC140_D21,21,21q21.3,25884679,25966282,81603,-,-
BAC171_I01,21,21q21.3,25889602,25978752,89150,-,-
BAC106_N07,21,21q21.3,25889603,25999102,109499,-,-
BAC50_A24,21,21q21.3,25947264,26068682,121418,-,-
BAC90_B07,21,21q21.3,25999098,26123864,124766,-,-
BAC118_O09,21,21q21.3,26008327,26131560,123233,-,-
BAC32_N12,21,21q21.3,26048889,26143982,95093,-,-
BAC65_O07,21,21q21.3,26143996,26259851,115855,-,-
BAC242_I14,21,21q21.3,26159242,26292977,133735,-,-
BAC109_O20,21,21q21.3,26193261,26292977,99716,-,-
BAC109_L22,21,21q21.3,26259339,26360250,100911,-,-
BAC242_E07,21,21q21.3,26272275,26361710,89435,-,-
BAC185_I22,21,21q21.3,26281624,26361710,80086,-,-
BAC55_E18,21,21q21.3,26302131,26479790,177659,-,-
BAC199_H13,21,21q21.3,26400902,26498839,97937,-,-
BAC8_D02,21,21q21.3,26462802,26553052,90250,-,-
BAC158_D13,21,21q21.3,26469071,26568279,99208,-,-
BAC56_L11,21,21q21.3,26497441,26612784,115343,-,-
BAC105_H09,21,21q21.3,26564135,26681748,117613,-,-
BAC108_K02,21,21q21.3,26801149,26919543,118394,-,-
BAC107_F01,21,21q21.3,26828090,26915002,86912,-,-
BAC41_G24,21,21q21.3,26955357,26967212,11855,-,-
BAC167_K05,21,21q21.3,26988444,27083390,94946,-,-
BAC147_F05,21,21q21.3,27050933,27186652,135719,yes,-
BAC165_P23,21,21q21.3,27093463,27203548,110085,yes,-
BAC249_C23,21,21q21.3,27101896,27203548,101652,yes,-
BAC195_K12,21,21q21.3,27354657,27442676,88019,-,-
BAC95_M05,21,21q21.3,27554216,27640477,86261,-,-
BAC78_E12,21,21q21.3,27559728,27673217,113489,-,-
BAC246_E03,21,21q21.3,27626707,27712896,86189,-,-
BAC119_K07,21,21q21.3,27746038,27845927,99889,-,-
BAC242_L21,21,21q21.3,27758568,27841425,82857,-,-
BAC110_A12,21,21q21.3,27870069,28013853,143784,-,-
BAC163_K09,21,21q21.3,27934952,28013853,78901,-,-
BAC252_K15,21,21q21.3,27934968,28013860,78892,-,-
BAC170_P15,21,21q21.3,27966236,28059468,93232,-,-
BAC117_B03,21,21q21.3,28025356,28132862,107506,-,-
BAC200_K21,21,21q21.3,28071015,28155807,84792,-,-
BAC69_G21,21,21q21.3,28078239,28170273,92034,-,-
BAC107_O11,21,21q21.3,28232574,28325984,93410,-,-
BAC83_K09,21,21q21.3,28386411,28461500,75089,-,-
BAC171_P10,21,21q21.3,28397925,28480023,82098,-,-
BAC211_C04,21,21q21.3,28504112,28572246,68134,-,-
BAC40_J11,21,21q21.3,28504112,28629920,125808,-,-
BAC67_L17,21,21q21.3,28549129,28651061,101932,-,-
BAC153_D16,21,21q21.3,28637144,28734194,97050,-,-
BAC143_G06,21,21q21.3,28721368,28801044,79676,-,-
BAC218_A18,21,21q21.3,28738745,28823179,84434,-,-
BAC175_L01,21,21q21.3,28783017,28876068,93051,-,-
BAC247_K08,21,21q21.3,29012868,29096925,84057,-,-
BAC34_D13,21,21q21.3,29013112,29096178,83066,-,-
BAC75_J15,21,21q21.3,29023946,29117265,93319,-,-
BAC230_G10,21,21q21.3,29162890,29251476,88586,-,-
BAC150_J15,21,21q21.3,29162890,29254549,91659,-,-
BAC162_H16,21,21q21.3,29255869,29343311,87442,-,-
BAC131_P03,21,21q21.3,29260727,29353403,92676,-,-
BAC115_I15,21,21q21.3,29279076,29363053,83977,-,-
BAC97_A17,21,21q21.3,29288222,29382419,94197,-,-
BAC36_D16,21,21q21.3,29290227,29390186,99959,-,-
BAC156_G16,21,21q21.3,29398772,29471168,72396,-,-
BAC226_A06,21,21q21.3,29706663,29781522,74859,-,-
BAC226_F22,21,21q21.3,29737148,29814617,77469,-,-
BAC230_F12,21,21q21.3,29752690,29833793,81103,-,-
BAC193_P05,21,21q21.3,29809888,29888370,78482,-,-
BAC14_B07,21,21q21.3,29839045,29930057,91012,-,-
BAC233_O22,21,21q21.3,30015529,30065562,50033,-,-
BAC117_I09,21,21q21.3,30017573,30090041,72468,-,-
BAC91_A22,21,21q21.3,30078324,30173305,94981,-,-
BAC200_A23,21,21q21.3,30135569,30259474,123905,-,-
BAC198_L05,21,21q21.3,30217479,30325669,108190,-,-
BAC66_C24,21,21q21.3,30267567,30383637,116070,-,-
BAC163_B13,21,21q21.3,30293224,30400905,107681,-,-
BAC215_L03,21,21q21.3-21q22.11,30478034,30564252,86218,-,-
BAC180_I19,21,21q22.11,30575080,30652524,77444,-,-
BAC95_D19,21,21q22.11,30646580,30743594,97014,-,-
BAC198_B20,21,21q22.11,30743661,30836604,92943,-,-
BAC208_G11,21,21q22.11,30748373,30821497,73124,-,-
BAC131_C16,21,21q22.11,30837925,30928871,90946,-,-
BAC80_L02,21,21q22.11,30978692,31094648,115956,-,-
BAC176_C16,21,21q22.11,31088725,31193897,105172,-,-
BAC166_L08,21,21q22.11,31094640,31170816,76176,-,-
BAC231_I07,21,21q22.11,31170810,31256492,85682,-,-
BAC20_I23,21,21q22.11,31212416,31331752,119336,-,-
BAC35_A08,21,21q22.11,31222050,31331740,109690,-,-
BAC8_C03,21,21q22.11,31224256,31311491,87235,-,-
BAC70_P04,21,21q22.11,31233901,31341715,107814,-,-
BAC84_O06,21,21q22.11,31352497,31450701,98204,-,-
BAC92_D08,21,21q22.11,31374134,31450701,76567,-,-
BAC119_E14,21,21q22.11,31448277,31564728,116451,-,-
BAC91_F10,21,21q22.11,31475156,31565292,90136,-,-
BAC20_P17,21,21q22.11,31487959,31576822,88863,-,-
BAC111_P02,21,21q22.11,31552618,31677373,124755,-,-
BAC151_D14,21,21q22.11,31565440,31657598,92158,-,-
BAC221_H11,21,21q22.11,31577482,31673711,96229,-,-
BAC193_A16,21,21q22.11,31587957,31673711,85754,-,-
BAC18_O20,21,21q22.11,31605786,31692148,86362,-,-
BAC184_K11,21,21q22.11,31614805,31715835,101030,-,-
BAC248_D24,21,21q22.11,31633383,31710220,76837,-,-
BAC68_A01,21,21q22.11,31678777,31780829,102052,-,-
BAC153_J03,21,21q22.11,31681405,31774408,93003,-,-
BAC220_F22,21,21q22.11,31692484,31810595,118111,-,-
BAC156_B03,21,21q22.11,31715849,31815242,99393,-,-
BAC33_B09,21,21q22.11,31718545,31829564,111019,-,-
BAC57_L21,21,21q22.11,31722494,31829561,107067,-,-
BAC169_G10,21,21q22.11,31780832,31848428,67596,-,-
BAC133_J16,21,21q22.11,31815265,31914742,99477,-,-
BAC195_F24,21,21q22.11,31829723,31914271,84548,-,-
BAC11_L10,21,21q22.11,31829736,31922945,93209,-,-
BAC104_P21,21,21q22.11,31848423,31926823,78400,-,-
BAC63_J12,21,21q22.11,31922939,32042953,120014,-,-
BAC5_K01,21,21q22.11,31949143,32053252,104109,-,-
BAC35_J01,21,21q22.11,31978338,32136701,158363,-,-
BAC50_F21,21,21q22.11,31990461,32101657,111196,-,-
BAC119_H19,21,21q22.11,32062239,32192432,130193,-,-
BAC59_H20,21,21q22.11,32113766,32247825,134059,-,-
BAC63_E06,21,21q22.11,32138256,32240118,101862,-,-
BAC190_N10,21,21q22.11,32143171,32238740,95569,-,-
BAC181_A17,21,21q22.11,32196981,32288382,91401,-,-
BAC105_A08,21,21q22.11,32253701,32365883,112182,-,-
BAC96_D18,21,21q22.11,32263768,32378032,114264,-,-
BAC238_C05,21,21q22.11,32287866,32378847,90981,-,-
BAC62_L10,21,21q22.11,32340062,32437088,97026,-,-
BAC218_I06,21,21q22.11,32378841,32463857,85016,-,-
BAC78_G12,21,21q22.11,32428292,32573505,145213,-,-
BAC160_L03,21,21q22.11,32445160,32543878,98718,-,-
BAC109_K12,21,21q22.11,32447189,32543866,96677,-,-
BAC189_M16,21,21q22.11,32473890,32557989,84099,-,-
BAC194_N16,21,21q22.11,32542657,32620143,77486,-,-
BAC77_D10,21,21q22.11,32609945,32722509,112564,-,-
BAC68_E16,21,21q22.11,32615961,32700080,84119,-,-
BAC48_K13,21,21q22.11,32622700,32757960,135260,-,-
BAC157_N05,21,21q22.11,32642841,32738232,95391,-,-
BAC208_J19,21,21q22.11,32661313,32738507,77194,-,-
BAC31_C21,21,21q22.11,32674799,32776430,101631,-,-
BAC232_B01,21,21q22.11,32677265,32791437,114172,-,-
BAC50_O05,21,21q22.11,32677296,32776434,99138,-,-
BAC66_J13,21,21q22.11,32700714,32803831,103117,-,-
BAC155_L05,21,21q22.11,32709307,32834103,124796,-,-
BAC38_G16,21,21q22.11,32717633,32842914,125281,-,-
BAC125_J24,21,21q22.11,32803825,32948939,145114,-,-
BAC22_O13,21,21q22.11,32803830,32954560,150730,-,-
BAC51_L03,21,21q22.11,32803855,32952175,148320,-,-
BAC70_N05,21,21q22.11,32824402,32909619,85217,-,-
BAC192_P03,21,21q22.11,32860848,32952210,91362,-,-
BAC114_N11,21,21q22.11,32876859,32970348,93489,-,-
BAC70_K10,21,21q22.11,32897396,32976991,79595,-,-
BAC42_A16,21,21q22.11,32953352,33089219,135867,-,-
BAC166_M06,21,21q22.11,32954553,33039216,84663,-,-
BAC221_D22,21,21q22.11,32955508,33054881,99373,-,-
BAC150_E12,21,21q22.11,33050943,33152385,101442,-,-
BAC235_D04,21,21q22.11,33066839,33152385,85546,-,-
BAC146_C24,21,21q22.11,33067680,33161744,94064,-,-
BAC160_D05,21,21q22.11,33089215,33179707,90492,-,-
BAC235_N21,21,21q22.11,33230018,33317534,87516,-,-
BAC182_E09,21,21q22.11,33262936,33321476,58540,-,-
BAC158_E09,21,21q22.11,33328712,33459128,130416,-,-
BAC167_C04,21,21q22.11,33333396,33421975,88579,-,-
BAC172_L10,21,21q22.11,33404168,33489890,85722,-,-
BAC40_E22,21,21q22.11,33405612,33489890,84278,-,-
BAC242_N08,21,21q22.11,33412633,33509772,97139,-,-
BAC252_O07,21,21q22.11,33441081,33569932,128851,-,-
BAC79_J24,21,21q22.11,33621583,33711930,90347,-,-
BAC52_L16,21,21q22.11,33622311,33729258,106947,-,-
BAC69_G05,21,21q22.11,33622329,33719980,97651,-,-
BAC33_L07,21,21q22.11,33658019,33743795,85776,-,-
BAC182_I05,21,21q22.11,33763179,33831883,68704,-,-
BAC106_J19,21,21q22.11,33763179,33852083,88904,-,-
BAC86_A15,21,21q22.11,33893000,33969575,76575,-,-
BAC87_K14,21,21q22.11,34010777,34098977,88200,-,-
BAC73_K16,21,21q22.11,34010777,34105843,95066,-,-
BAC24_N05,21,21q22.11,34085746,34195953,110207,-,-
BAC180_K20,21,21q22.11,34106438,34211631,105193,-,-
BAC199_H08,21,21q22.11,34149277,34251293,102016,-,-
BAC56_C18,21,21q22.11,34149319,34329174,179855,-,-
BAC86_C12,21,21q22.11,34159765,34288918,129153,-,-
BAC178_J20,21,21q22.11,34178715,34288944,110229,-,-
BAC197_M14,21,21q22.11,34195966,34288944,92978,-,-
BAC21_M23,21,21q22.11,34232702,34352419,119717,-,-
BAC49_F18,21,21q22.11,34288936,34394014,105078,-,-
BAC27_D19,21,21q22.11,34311265,34448365,137100,-,-
BAC90_M18,21,21q22.11,34385544,34497374,111830,-,-
BAC181_K11,21,21q22.11,34402375,34542157,139782,-,-
BAC146_B07,21,21q22.11,34440565,34530212,89647,-,-
BAC143_L07,21,21q22.11,34443307,34542157,98850,-,-
BAC160_L23,21,21q22.11,34567723,34656359,88636,-,-
BAC26_D11,21,21q22.11-21q22.12,34568465,34735762,167297,-,-
BAC82_F19,21,21q22.11-21q22.12,34573050,34749805,176755,-,-
BAC244_F10,21,21q22.11-21q22.12,34603687,34703504,99817,-,-
BAC96_F11,21,21q22.11-21q22.12,34611094,34740982,129888,-,-
BAC170_P05,21,21q22.11-21q22.12,34648361,34740954,92593,-,-
BAC151_D07,21,21q22.11-21q22.12,34651365,34749805,98440,-,-
BAC235_K21,21,21q22.11-21q22.12,34673091,34793064,119973,-,-
BAC169_G04,21,21q22.11-21q22.12,34695264,34788729,93465,-,-
BAC70_O04,21,21q22.12,34712221,34860918,148697,-,-
BAC141_N16,21,21q22.12,34714902,34793064,78162,-,-
BAC53_P20,21,21q22.12,34725632,34825796,100164,-,-
BAC65_N02,21,21q22.12,34804809,34907881,103072,-,-
BAC66_M14,21,21q22.12,34822441,34917951,95510,-,-
BAC153_M19,21,21q22.12,34835274,34921658,86384,-,-
BAC117_H13,21,21q22.12,34835274,34965290,130016,-,-
BAC137_L18,21,21q22.12,34838344,34965290,126946,-,-
BAC32_C17,21,21q22.12,34847745,34939394,91649,-,-
BAC166_I08,21,21q22.12,34870249,34961998,91749,-,-
BAC214_F06,21,21q22.12,34939444,35044434,104990,-,-
BAC53_D03,21,21q22.12,34965371,35055033,89662,-,-
BAC75_B24,21,21q22.12,34985659,35080479,94820,-,-
BAC45_D17,21,21q22.12,34989220,35096375,107155,-,-
BAC80_H23,21,21q22.12,35000846,35096466,95620,-,-
BAC208_O15,21,21q22.12,35018066,35051456,33390,-,-
BAC235_O08,21,21q22.12,35048651,35133985,85334,-,-
BAC250_A12,21,21q22.12,35059580,35145719,86139,-,-
BAC240_P01,21,21q22.12,35101293,35189368,88075,-,-
BAC100_D11,21,21q22.12,35144569,35254293,109724,-,-
BAC37_M04,21,21q22.12,35150450,35235973,85523,-,-
BAC103_G22,21,21q22.12,35162331,35254601,92270,-,-
BAC182_M09,21,21q22.12,35311504,35392399,80895,-,-
BAC194_H21,21,21q22.12,35342696,35424638,81942,-,-
BAC43_N12,21,21q22.12,35348011,35445826,97815,-,-
BAC184_O15,21,21q22.12,35358977,35466764,107787,-,-
BAC237_O02,21,21q22.12,35367524,35481970,114446,-,-
BAC96_L23,21,21q22.12,35570341,35673593,103252,-,-
BAC45_F09,21,21q22.12,35585236,35673560,88324,-,-
BAC62_E14,21,21q22.12,35595057,35711467,116410,-,-
BAC186_A07,21,21q22.12,35795336,35861631,66295,-,-
BAC25_L09,21,21q22.12,35804778,35922561,117783,-,-
BAC240_C19,21,21q22.12,35861218,35949425,88207,-,-
BAC179_K02,21,21q22.12,35990329,36076544,86215,-,-
BAC165_I10,21,21q22.12,36055546,36156526,100980,-,-
BAC104_L24,21,21q22.12,36058622,36157209,98587,-,-
BAC187_O19,21,21q22.12,36119965,36198816,78851,-,-
BAC248_C16,21,21q22.12,36127458,36261441,133983,-,-
BAC197_N06,21,21q22.12,36167556,36248286,80730,-,-
BAC88_H16,21,21q22.12,36189088,36273653,84565,-,-
BAC241_O04,21,21q22.12,36250183,36349554,99371,-,-
BAC83_F11,21,21q22.12,36250183,36340841,90658,-,-
BAC129_L19,21,21q22.12,36277781,36356978,79197,-,-
BAC137_H12,21,21q22.12,36317094,36398105,81011,-,-
BAC28_N21,21,21q22.12,36330812,36421000,90188,-,-
BAC38_F03,21,21q22.12,36347509,36420995,73486,-,-
BAC107_L18,21,21q22.12,36433570,36564057,130487,-,-
BAC13_K02,21,21q22.12,36507341,36673203,165862,-,-
BAC166_G01,21,21q22.12,36507351,36610668,103317,-,-
BAC149_P10,21,21q22.12,36572971,36668607,95636,-,-
BAC46_G19,21,21q22.12-21q22.13,36610764,36740329,129565,-,-
BAC83_K24,21,21q22.12-21q22.13,36663858,36739553,75695,-,-
BAC168_B02,21,21q22.12-21q22.13,36663859,36776496,112637,-,-
BAC152_I20,21,21q22.12-21q22.13,36674649,36764720,90071,-,-
BAC26_G22,21,21q22.13,36706961,36842691,135730,-,-
BAC39_D23,21,21q22.13,36740348,36859589,119241,-,-
BAC219_P07,21,21q22.13,36761955,36894376,132421,-,-
BAC168_O06,21,21q22.13,36763305,36846841,83536,-,-
BAC125_O04,21,21q22.13,36764733,36874044,109311,-,-
BAC29_D11,21,21q22.13,36799212,36908287,109075,-,-
BAC129_G19,21,21q22.13,36859636,36949909,90273,-,-
BAC58_D03,21,21q22.13,36868989,36983415,114426,-,-
BAC252_O05,21,21q22.13,36912043,37016389,104346,-,-
BAC154_H24,21,21q22.13,36920705,37007910,87205,-,-
BAC21_L18,21,21q22.13,37014453,37120945,106492,-,-
BAC4_J02,21,21q22.13,37069648,37093306,23658,-,-
BAC2_C08,21,21q22.13,37111861,37195125,83264,-,-
BAC41_O03,21,21q22.13,37126152,37244349,118197,-,-
BAC250_I14,21,21q22.13,37134475,37218301,83826,-,-
BAC25_B10,21,21q22.13,37148391,37239289,90898,-,-
BAC97_N22,21,21q22.13,37170288,37249610,79322,-,-
BAC28_H11,21,21q22.13,37174911,37276681,101770,-,-
BAC217_J06,21,21q22.13,37265591,37374832,109241,-,-
BAC8_G15,21,21q22.13,37271493,37360916,89423,-,-
BAC187_A08,21,21q22.13,37374844,37495563,120719,-,-
BAC169_M17,21,21q22.13,37411013,37527530,116517,-,-
BAC43_F06,21,21q22.13,37460907,37592467,131560,-,-
BAC167_E10,21,21q22.13,37462156,37564559,102403,-,-
BAC199_H05,21,21q22.13,37471451,37582144,110693,-,-
BAC210_L16,21,21q22.13,37495804,37598998,103194,-,-
BAC152_O20,21,21q22.13,37554769,37637927,83158,-,-
BAC139_B05,21,21q22.13,37564555,37644287,79732,-,-
BAC20_C11,21,21q22.13,37564563,37726927,162364,-,-
BAC146_M19,21,21q22.13,37617121,37727025,109904,-,-
BAC177_F12,21,21q22.13,37665193,37757337,92144,-,-
BAC72_M08,21,21q22.13,37668061,37757337,89276,-,-
BAC88_G04,21,21q22.13,37685714,37758000,72286,-,-
BAC46_P08,21,21q22.13,37693924,37849428,155504,-,-
BAC226_D11,21,21q22.13,37727239,37830664,103425,-,-
BAC71_B21,21,21q22.13,37781875,37893323,111448,-,-
BAC167_N12,21,21q22.13,37781875,37865215,83340,-,-
BAC33_K16,21,21q22.13,37865252,37968722,103470,-,-
BAC28_L20,21,21q22.13,37865252,37966431,101179,-,-
BAC213_C09,21,21q22.13,38110173,38209313,99140,-,-
BAC85_H03,21,21q22.13,38154736,38242711,87975,-,-
BAC20_K13,21,21q22.13,38161610,38270745,109135,-,-
BAC82_J16,21,21q22.13,38191585,38305147,113562,-,-
BAC80_J03,21,21q22.13,38356983,38463053,106070,-,-
BAC185_K04,21,21q22.13,38391342,38481705,90363,-,-
BAC167_O01,21,21q22.13,38392633,38510401,117768,-,-
BAC33_D15,21,21q22.13,38404833,38548664,143831,-,-
BAC123_H17,21,21q22.13,38430490,38518002,87512,-,-
BAC158_L13,21,21q22.13,38436826,38518002,81176,-,-
BAC193_N02,21,21q22.13-21q22.2,38518326,38616099,97773,-,-
BAC226_F17,21,21q22.13-21q22.2,38518326,38606812,88486,-,-
BAC72_B12,21,21q22.13-21q22.2,38527962,38613680,85718,-,-
BAC228_L11,21,21q22.2,38602483,38692692,90209,-,-
BAC75_H04,21,21q22.2,38609342,38692692,83350,-,-
BAC171_G24,21,21q22.2,38616453,38693128,76675,-,-
BAC141_F01,21,21q22.2,38646412,38742565,96153,-,-
BAC231_K17,21,21q22.2,38670912,38727799,56887,-,-
BAC137_K13,21,21q22.2,38826711,38904090,77379,-,-
BAC8_E17,21,21q22.2,38927686,39051376,123690,-,-
BAC217_G05,21,21q22.2,38933502,39025909,92407,-,-
BAC124_E03,21,21q22.2,38949187,39051369,102182,-,-
BAC55_I05,21,21q22.2,38961989,39054213,92224,-,-
BAC42_O16,21,21q22.2,39026043,39173084,147041,-,-
BAC115_J08,21,21q22.2,39055906,39146972,91066,-,-
BAC146_E15,21,21q22.2,39068383,39165641,97258,-,-
BAC129_H13,21,21q22.2,39228918,39327309,98391,-,-
BAC203_D06,21,21q22.2,39229066,39350635,121569,-,-
BAC223_F03,21,21q22.2,39270212,39362329,92117,-,-
BAC124_N22,21,21q22.2,39287358,39418083,130725,-,-
BAC167_I08,21,21q22.2,39304143,39416573,112430,-,-
BAC68_I03,21,21q22.2,39365234,39456964,91730,-,-
BAC131_P09,21,21q22.2,39365234,39444403,79169,-,-
BAC199_B23,21,21q22.2,39409061,39520216,111155,-,-
BAC11_C02,21,21q22.2,39409078,39526055,116977,-,-
BAC99_A04,21,21q22.2,39473292,39501983,28691,-,-
BAC50_N07,21,21q22.2,39634690,39731024,96334,-,-
BAC67_H17,21,21q22.2,39762824,39874196,111372,-,-
BAC24_I07,21,21q22.2,39785526,39896522,110996,-,-
BAC93_M15,21,21q22.2,39812510,39898859,86349,-,-
BAC85_A05,21,21q22.2,39816261,39901146,84885,-,-
BAC96_I04,21,21q22.2,39849887,39975983,126096,-,-
BAC252_C15,21,21q22.2,40016653,40167565,150912,-,-
BAC136_J11,21,21q22.2,40016670,40087921,71251,-,-
BAC162_E22,21,21q22.2,40045842,40133746,87904,-,-
BAC46_O20,21,21q22.2,40107805,40217687,109882,-,-
BAC197_A08,21,21q22.2,40131213,40222236,91023,-,-
BAC223_B09,21,21q22.2,40167556,40263863,96307,-,-
BAC43_F14,21,21q22.2,40167561,40263864,96303,-,-
BAC197_N24,21,21q22.2,40200511,40296900,96389,-,-
BAC247_A05,21,21q22.2,40212354,40296926,84572,-,-
BAC88_N19,21,21q22.2,40235062,40334183,99121,-,-
BAC57_L09,21,21q22.2,40428223,40565457,137234,-,-
BAC237_H09,21,21q22.2,40468344,40578133,109789,-,-
BAC144_E24,21,21q22.2,40534628,40628837,94209,-,-
BAC122_P18,21,21q22.2,40661323,40694298,32975,-,-
BAC185_B16,21,21q22.2,40775350,40859992,84642,-,-
BAC143_M18,21,21q22.2,40821197,40932871,111674,-,-
BAC227_D04,21,21q22.2,40832918,40958498,125580,-,-
BAC235_K05,21,21q22.2,40911396,41062539,151143,-,-
BAC72_A03,21,21q22.2,40917778,41062490,144712,-,-
BAC125_A08,21,21q22.2,40929399,41083744,154345,-,-
BAC37_M14,21,21q22.2,40965092,41062554,97462,-,-
BAC232_I14,21,21q22.2,40972427,41049972,77545,-,-
BAC161_G10,21,21q22.2,40973077,41050085,77008,-,-
BAC190_G22,21,21q22.2,41000494,41111092,110598,-,-
BAC171_C13,21,21q22.2,41090266,41172944,82678,-,-
BAC249_P10,21,21q22.2,41098730,41187910,89180,-,-
BAC170_M12,21,21q22.2,41115215,41197169,81954,-,-
BAC149_P08,21,21q22.2,41138139,41237777,99638,-,-
BAC39_F21,21,21q22.2-21q22.3,41383110,41489600,106490,-,-
BAC109_E20,21,21q22.3,41449052,41571857,122805,-,-
BAC35_B04,21,21q22.3,41521524,41600803,79279,-,-
BAC189_H08,21,21q22.3,41580063,41680772,100709,-,-
BAC199_O14,21,21q22.3,41592857,41680772,87915,-,-
BAC149_K05,21,21q22.3,41592857,41680772,87915,-,-
BAC240_J05,21,21q22.3,41592857,41680772,87915,-,-
BAC147_H19,21,21q22.3,41592857,41684802,91945,-,-
BAC233_E19,21,21q22.3,41601351,41699053,97702,-,-
BAC128_K07,21,21q22.3,41699134,41795405,96271,-,-
BAC200_M07,21,21q22.3,41711204,41799757,88553,-,-
BAC178_H13,21,21q22.3,41718832,41795597,76765,-,-
BAC149_K13,21,21q22.3,41718833,41818834,100001,-,-
BAC30_K05,21,21q22.3,41760064,41856477,96413,-,-
BAC65_D15,21,21q22.3,41779852,41874468,94616,-,-
BAC37_K03,21,21q22.3,41799760,41874489,74729,-,-
BAC37_M17,21,21q22.3,42123932,42238179,114247,-,-
BAC237_D22,21,21q22.3,42148671,42231345,82674,-,-
BAC129_E20,21,21q22.3,42179440,42273070,93630,-,-
BAC22_A01,21,21q22.3,42211087,42311598,100511,-,-
BAC109_D13,21,21q22.3,42238194,42378883,140689,-,-
BAC28_B15,21,21q22.3,42277444,42379874,102430,-,-
BAC229_F13,21,21q22.3,42277444,42363128,85684,-,-
BAC234_K03,21,21q22.3,42279843,42376518,96675,-,-
BAC21_O24,21,21q22.3,42363123,42472849,109726,-,-
BAC82_N17,21,21q22.3,42418767,42554710,135943,-,-
BAC126_M10,21,21q22.3,42518138,42622787,104649,-,-
BAC32_C18,21,21q22.3,42531752,42633608,101856,-,-
BAC39_O01,21,21q22.3,42595687,42697426,101739,-,-
BAC189_P06,21,21q22.3,42603557,42690276,86719,-,-
BAC244_H11,21,21q22.3,42613911,42697430,83519,-,-
BAC35_H11,21,21q22.3,42713848,42799368,85520,-,-
BAC46_A15,21,21q22.3,42774504,42859734,85230,-,-
BAC26_P10,21,21q22.3,42866240,42959045,92805,-,-
BAC169_B06,21,21q22.3,42878542,42988945,110403,-,-
BAC144_P12,21,21q22.3,42904752,42988945,84193,-,-
BAC190_D12,21,21q22.3,42988962,43113393,124431,-,-
BAC201_G09,21,21q22.3,43025626,43115107,89481,-,-
BAC37_D11,21,21q22.3,43064051,43151308,87257,-,-
BAC95_C22,21,21q22.3,43113386,43249094,135708,-,-
BAC34_D11,21,21q22.3,43197386,43309977,112591,-,-
BAC238_J22,21,21q22.3,43227135,43309981,82846,-,-
BAC217_J03,21,21q22.3,43231745,43309981,78236,-,-
BAC154_N05,21,21q22.3,43231745,43309976,78231,-,-
BAC147_O18,21,21q22.3,43248929,43323439,74510,-,-
BAC230_I06,21,21q22.3,43314524,43416240,101716,-,-
BAC8_N04,21,21q22.3,43395831,43485581,89750,yes,-
BAC171_F04,21,21q22.3,43398748,43486059,87311,yes,-
BAC68_B10,21,21q22.3,43660292,43781909,121617,-,-
BAC146_L21,21,21q22.3,43669881,43781865,111984,-,-
BAC10_D15,21,21q22.3,43673742,43769762,96020,-,-
BAC158_N02,21,21q22.3,43781942,43883045,101103,yes,-
BAC116_M06,21,21q22.3,43781942,43894204,112262,yes,-
BAC158_M02,21,21q22.3,43782122,43883111,100989,yes,-
BAC70_H10,21,21q22.3,43816700,43909687,92987,-,-
BAC96_C04,21,21q22.3,43846222,43955553,109331,-,-
BAC230_M01,21,21q22.3,43846227,43952202,105975,-,-
BAC244_F15,21,21q22.3,43846228,43920782,74554,-,-
BAC1_C02,21,21q22.3,43931357,44018425,87068,-,-
BAC162_H20,21,21q22.3,44016872,44110429,93557,-,-
BAC48_O18,21,21q22.3,44024694,44138366,113672,-,-
BAC167_H14,21,21q22.3,44056104,44138382,82278,-,-
BAC240_L10,21,21q22.3,44138543,44219299,80756,-,-
BAC141_O04,21,21q22.3,44138543,44231232,92689,-,-
BAC10_H12,21,21q22.3,44150510,44279728,129218,-,-
BAC78_M07,21,21q22.3,44259242,44345462,86220,-,-
BAC141_H10,21,21q22.3,44280413,44353864,73451,-,-
BAC142_G23,21,21q22.3,44328275,44443706,115431,-,-
BAC182_K09,21,21q22.3,44346184,44460422,114238,-,-
BAC54_E07,21,21q22.3,44368722,44460401,91679,-,-
BAC181_D11,21,21q22.3,44368722,44462015,93293,-,-
BAC181_A06,21,21q22.3,44368726,44462367,93641,-,-
BAC179_K20,21,21q22.3,44512776,44616533,103757,-,-
BAC234_D09,21,21q22.3,44746324,44840287,93963,-,-
BAC192_H02,21,21q22.3,44754475,44840288,85813,-,-
BAC31_M02,21,21q22.3,44754488,44869573,115085,-,-
BAC34_J09,21,21q22.3,44770446,44907399,136953,-,-
BAC120_O19,21,21q22.3,44774867,44890188,115321,-,-
BAC231_N21,21,21q22.3,44808204,44893979,85775,-,-
BAC40_K04,21,21q22.3,44808214,44908903,100689,-,-
BAC106_C14,21,21q22.3,44920652,45051598,130946,-,-
BAC95_J19,21,21q22.3,44921423,45031005,109582,-,-
BAC117_G13,21,21q22.3,44983736,45143026,159290,-,-
BAC80_E04,21,21q22.3,44984058,45093965,109907,-,-
BAC140_G11,21,21q22.3,44984058,45095551,111493,-,-
BAC21_P17,21,21q22.3,44992089,45093957,101868,-,-
BAC136_D13,21,21q22.3,44999276,45095551,96275,-,-
BAC126_D16,21,21q22.3,45017582,45093958,76376,-,-
BAC43_A04,21,21q22.3,45041635,45190586,148951,-,-
BAC118_J14,21,21q22.3,45095172,45190639,95467,-,-
BAC5_G13,21,21q22.3,45126304,45224292,97988,-,-
BAC238_A03,21,21q22.3,45208760,45277827,69067,-,-
BAC32_D08,21,21q22.3,45231491,45369489,137998,-,-
BAC240_H07,21,21q22.3,45282690,45364338,81648,-,-
BAC84_B18,21,21q22.3,45344386,45446344,101958,-,-
BAC157_I22,21,21q22.3,45360704,45447534,86830,-,-
BAC194_P18,21,21q22.3,45381219,45464137,82918,-,-
BAC134_C03,21,21q22.3,45401944,45418723,16779,-,-
BAC165_K09,21,21q22.3,45420888,45525352,104464,-,-
BAC150_K03,21,21q22.3,45464351,45579272,114921,-,-
BAC184_D23,21,21q22.3,45569815,45705109,135294,-,-
BAC242_I06,21,21q22.3,45578660,45726636,147976,-,-
BAC191_B11,21,21q22.3,45592803,45726636,133833,-,-
BAC227_P15,21,21q22.3,45766032,45856885,90853,-,-
BAC134_L21,21,21q22.3,45817700,45911073,93373,-,-
BAC207_D02,21,21q22.3,45833508,45924594,91086,-,-
BAC210_N02,21,21q22.3,45842559,45922980,80421,-,-
BAC235_I07,21,21q22.3,45997499,46084397,86898,-,-
BAC157_D10,21,21q22.3,46027965,46105810,77845,-,-
BAC151_E02,21,21q22.3,46105823,46178815,72992,-,-
BAC200_K04,21,21q22.3,46124216,46210948,86732,-,-
BAC82_N12,21,21q22.3,46132638,46210949,78311,-,-
BAC139_C14,21,21q22.3,46189044,46295854,106810,-,-
BAC25_E13,21,21q22.3,46198939,46295762,96823,-,-
BAC165_K11,21,21q22.3,46373142,46463647,90505,-,-
BAC81_A05,21,21q22.3,46445132,46567619,122487,-,-
BAC133_C03,21,21q22.3,46540211,46636256,96045,-,-
BAC156_E14,21,21q22.3,46542789,46637017,94228,-,-
BAC140_J01,21,21q22.3,46567748,46660164,92416,-,-
BAC2_G22,21,21q22.3,46636582,46841972,205390,-,-
BAC153_E17,21,21q22.3,46689006,46779928,90922,-,-
BAC11_C14,21,21q22.3,46726992,46835755,108763,-,-
BAC2_I02,21,21q22.3,46752239,46863769,111530,-,-
BAC214_A06,21,21q22.3,46752242,46862396,110154,-,-
BAC218_I03,21,21q22.3,46770754,46846300,75546,-,-
BAC118_D18,22,22q11.1,14438009,14552777,114768,-,-
BAC58_A19,22,22q11.1,14446158,14628973,182815,-,-
BAC100_D18,22,22q11.1,14446357,14550071,103714,-,-
BAC232_I16,22,22q11.1,14446357,14524152,77795,-,-
BAC171_C14,22,22q11.1,14446357,14528038,81681,-,-
BAC53_N19,22,22q11.1,14458266,14564927,106661,-,-
BAC76_P10,22,22q11.1,14461738,14573360,111622,-,-
BAC109_M02,22,22q11.1,14499426,14593764,94338,-,-
BAC147_I21,22,22q11.1,14512558,14620287,107729,-,-
BAC19_F17,22,22q11.1,14600048,14624553,24505,-,-
BAC21_C10,22,22q11.1,14802084,14913066,110982,yes,-
BAC139_G13,22,22q11.1,14913068,14998070,85002,-,-
BAC89_P12,22,22q11.1,15314423,15756574,442151,-,-
BAC179_F23,22,22q11.1,15330159,15438258,108099,-,-
BAC92_B18,22,22q11.1,15370629,15500460,129831,yes,-
BAC241_H12,22,22q11.1,15484992,15575403,90411,-,-
BAC58_H04,22,22q11.1,15516361,15695423,179062,yes,-
BAC228_B15,22,22q11.1,15545619,15627755,82136,-,-
BAC55_L03,22,22q11.1,15575400,15686841,111441,yes,-
BAC44_H07,22,22q11.1,15576873,15704236,127363,yes,-
BAC19_C05,22,22q11.1,15691172,15802933,111761,-,-
BAC180_H17,22,22q11.1,15695209,15837815,142606,-,-
BAC29_M04,22,22q11.1,15729519,15832645,103126,-,-
BAC167_O21,22,22q11.1,15738000,15844864,106864,-,-
BAC169_I04,22,22q11.1,15853136,15939595,86459,-,-
BAC173_K06,22,22q11.1,15881503,15976870,95367,-,-
BAC195_D05,22,22q11.1,15881503,15965122,83619,-,-
BAC120_E03,22,22q11.1,15885797,16019417,133620,-,-
BAC162_K19,22,22q11.1,15907943,15976870,68927,-,-
BAC237_N05,22,22q11.1,15908409,15995233,86824,-,-
BAC228_A03,22,22q11.1,15955966,16075499,119533,-,-
BAC53_L11,22,22q11.1,15966720,16096957,130237,-,-
BAC222_F01,22,22q11.1,16003779,16019417,15638,-,-
BAC193_J18,22,22q11.1,16013794,16108518,94724,-,-
BAC240_C17,22,22q11.1,16019411,16103212,83801,-,-
BAC127_G11,22,22q11.1,16027558,16159187,131629,-,-
BAC76_E24,22,22q11.1,16133548,16244888,111340,-,-
BAC167_L20,22,22q11.1,16133581,16228192,94611,-,-
BAC242_A18,22,22q11.1,16207685,16295362,87677,-,-
BAC186_A22,22,22q11.1-22q11.21,16245213,16326204,80991,-,-
BAC123_N08,22,22q11.1-22q11.21,16254361,16345796,91435,-,-
BAC124_P04,22,22q11.1-22q11.21,16267135,16369952,102817,-,-
BAC39_O22,22,22q11.1-22q11.21,16269797,16389665,119868,-,-
BAC42_J03,22,22q11.1-22q11.21,16296013,16383397,87384,-,-
BAC148_D17,22,22q11.1-22q11.21,16297688,16389669,91981,-,-
BAC108_K18,22,22q11.21,16316942,16413348,96406,-,-
BAC158_K10,22,22q11.21,16337499,16442626,105127,-,-
BAC158_H10,22,22q11.21,16337502,16442626,105124,-,-
BAC200_F18,22,22q11.21,16357749,16448297,90548,-,-
BAC86_G14,22,22q11.21,16357749,16511807,154058,yes,-
BAC217_L17,22,22q11.21,16370018,16483767,113749,-,-
BAC147_M10,22,22q11.21,16387488,16496477,108989,yes,-
BAC153_I21,22,22q11.21,16460155,16585143,124988,-,-
BAC53_H10,22,22q11.21,16460158,16541298,81140,-,-
BAC186_I17,22,22q11.21,16483761,16569760,85999,-,-
BAC133_O24,22,22q11.21,16483841,16585140,101299,-,-
BAC185_A10,22,22q11.21,16591092,16708625,117533,-,-
BAC196_C16,22,22q11.21,16604756,16685351,80595,-,-
BAC114_F12,22,22q11.21,16665687,16748010,82323,-,-
BAC174_M02,22,22q11.21,16665720,16772789,107069,-,-
BAC41_M07,22,22q11.21,16724535,16897377,172842,-,-
BAC67_K22,22,22q11.21,16724712,16845436,120724,-,-
BAC167_B18,22,22q11.21,16793539,16888626,95087,-,-
BAC168_C21,22,22q11.21,16799602,16907148,107546,-,-
BAC62_N23,22,22q11.21,16805298,16899127,93829,-,-
BAC197_M06,22,22q11.21,16814497,16888608,74111,-,-
BAC218_F18,22,22q11.21,16814505,16899155,84650,-,-
BAC103_E14,22,22q11.21,16819111,16907045,87934,-,-
BAC169_C14,22,22q11.21,16839434,16919225,79791,-,-
BAC214_I04,22,22q11.21,16897659,16975075,77416,yes,-
BAC55_I17,22,22q11.21,16905341,16994657,89316,yes,-
BAC100_I04,22,22q11.21,16969775,17070619,100844,yes,-
BAC197_F22,22,22q11.21,16969775,17053972,84197,yes,-
BAC52_P06,22,22q11.21,17041507,17389117,347610,-,-
BAC230_J04,22,22q11.21,17053967,17367595,313628,-,-
BAC120_J19,22,22q11.21,17054101,19862717,2808616,-,-
BAC128_C04,22,22q11.21,17140693,17245962,105269,yes,-
BAC143_D05,22,22q11.21,17141825,17254222,112397,-,-
BAC218_B11,22,22q11.21,17141832,17256118,114286,-,-
BAC192_K12,22,22q11.21,17148089,17229184,81095,-,-
BAC181_O15,22,22q11.21,17254216,17367603,113387,yes,-
BAC32_N17,22,22q11.21,17254220,17345950,91730,yes,-
BAC219_E14,22,22q11.21,17307265,17389183,81918,-,-
BAC157_N16,22,22q11.21,17307288,17410626,103338,-,-
BAC124_E21,22,22q11.21,17410620,17526065,115445,yes,-
BAC161_L23,22,22q11.21,17421932,17501727,79795,-,-
BAC196_A22,22,22q11.21,17446169,17542727,96558,yes,-
BAC204_B09,22,22q11.21,17446456,17541776,95320,yes,-
BAC88_I06,22,22q11.21,17526063,17647698,121635,-,-
BAC69_P21,22,22q11.21,17647712,17740090,92378,-,-
BAC185_K22,22,22q11.21,17647729,17726611,78882,-,-
BAC141_K20,22,22q11.21,17690557,17773366,82809,-,-
BAC169_K21,22,22q11.21,17690557,17773305,82748,-,-
BAC145_P12,22,22q11.21,17726605,17889246,162641,-,-
BAC224_F10,22,22q11.21,17759912,17870524,110612,-,-
BAC193_E02,22,22q11.21,17832928,17916900,83972,-,-
BAC176_N08,22,22q11.21,17894161,17957659,63498,-,-
BAC127_G04,22,22q11.21,17894165,17998249,104084,-,-
BAC165_A17,22,22q11.21,17916892,18012483,95591,-,-
BAC103_G19,22,22q11.21,17972428,18089841,117413,-,-
BAC82_N03,22,22q11.21,17987009,18120476,133467,yes,-
BAC195_M18,22,22q11.21,17998243,18089841,91598,-,-
BAC140_J13,22,22q11.21,18059640,18198191,138551,yes,-
BAC73_G13,22,22q11.21,18059663,18139208,79545,yes,-
BAC45_L11,22,22q11.21,18120563,18241970,121407,yes,-
BAC60_K03,22,22q11.21,18147202,18300577,153375,yes,-
BAC135_K16,22,22q11.21,18175339,18267854,92515,-,-
BAC154_P05,22,22q11.21,18199469,18287937,88468,-,-
BAC193_H09,22,22q11.21,18200217,18298517,98300,-,-
BAC144_B18,22,22q11.21,18200217,18304861,104644,-,-
BAC126_N11,22,22q11.21,18200217,18298518,98301,-,-
BAC135_D20,22,22q11.21,18256421,18342326,85905,yes,-
BAC101_M14,22,22q11.21,18343137,18463562,120425,yes,-
BAC179_L07,22,22q11.21,18343137,18427407,84270,yes,-
BAC198_G21,22,22q11.21,18513436,18630328,116892,-,-
BAC177_K05,22,22q11.21,18542229,18626010,83781,-,-
BAC186_B16,22,22q11.21,18542229,18625956,83727,-,-
BAC23_G16,22,22q11.21,18802821,18874787,71966,yes,-
BAC210_F18,22,22q11.21,19059592,19150941,91349,yes,-
BAC38_L05,22,22q11.21,19062541,19138838,76297,yes,-
BAC249_B23,22,22q11.21,19151033,19261733,110700,-,-
BAC32_E13,22,22q11.21,19188406,19345327,156921,-,-
BAC132_K21,22,22q11.21,19345579,19502649,157070,-,-
BAC201_I03,22,22q11.21,19347590,19458491,110901,-,-
BAC235_E11,22,22q11.21,19377782,19507920,130138,yes,-
BAC144_P14,22,22q11.21,19377782,19507920,130138,yes,-
BAC26_P01,22,22q11.21,19389772,19539950,150178,yes,-
BAC25_K01,22,22q11.21,19389827,19507920,118093,yes,-
BAC128_P06,22,22q11.21,19400781,19483118,82337,yes,-
BAC35_O12,22,22q11.21,19402927,19501413,98486,yes,-
BAC90_N16,22,22q11.21,19414073,19506499,92426,yes,-
BAC33_G05,22,22q11.21,19448576,19573752,125176,yes,-
BAC122_J17,22,22q11.21,19506805,19664136,157331,-,-
BAC130_B10,22,22q11.21,19561118,19647192,86074,-,-
BAC224_D06,22,22q11.21,19570607,19647190,76583,-,-
BAC142_L17,22,22q11.21,19670295,19808518,138223,yes,-
BAC146_P20,22,22q11.21,19684008,19808518,124510,yes,-
BAC18_C02,22,22q11.21,19684058,19783013,98955,yes,-
BAC222_A17,22,22q11.21,19684080,19783013,98933,yes,-
BAC198_E11,22,22q11.21,19722069,19820517,98448,-,-
BAC96_A12,22,22q11.21,19754060,19875793,121733,-,-
BAC51_N20,22,22q11.21,20186031,20393478,207447,-,-
BAC178_G14,22,22q11.21,20291849,20369832,77983,-,-
BAC175_B17,22,22q11.21,20291849,20393476,101627,-,-
BAC32_A14,22,22q11.21,20338052,20445031,106979,-,-
BAC194_H12,22,22q11.21,20338052,20445034,106982,-,-
BAC235_A17,22,22q11.21,20410355,20493606,83251,-,-
BAC96_E15,22,22q11.21-22q11.22,20493657,20585693,92036,-,-
BAC196_E04,22,22q11.22,20611962,20715721,103759,-,-
BAC247_B13,22,22q11.22,20623360,20713961,90601,-,-
BAC154_H02,22,22q11.22,20632910,20715721,82811,-,-
BAC108_G12,22,22q11.22,20676103,20767858,91755,-,-
BAC100_M23,22,22q11.22,20711481,20815049,103568,-,-
BAC120_H20,22,22q11.22,20715716,20815049,99333,-,-
BAC236_K22,22,22q11.22,20740799,20829885,89086,-,-
BAC170_I19,22,22q11.22,20740799,20815049,74250,-,-
BAC150_D15,22,22q11.22,20740799,20855610,114811,-,-
BAC53_C19,22,22q11.22,20747613,20835253,87640,-,-
BAC238_F18,22,22q11.22,20789227,20874121,84894,-,-
BAC154_E06,22,22q11.22,20855604,20968255,112651,yes,-
BAC77_C18,22,22q11.22,20873684,21002919,129235,-,-
BAC52_E21,22,22q11.22,20886599,21000980,114381,yes,-
BAC90_H14,22,22q11.22,20886936,20998972,112036,yes,-
BAC123_E03,22,22q11.22,20898370,21003171,104801,yes,-
BAC226_N02,22,22q11.22,20898370,21000972,102602,yes,-
BAC191_I21,22,22q11.22,20898375,20998914,100539,yes,-
BAC249_A07,22,22q11.22,20918263,20998972,80709,yes,-
BAC166_G20,22,22q11.22,20930146,21044664,114518,-,-
BAC91_D24,22,22q11.22,21003204,21103212,100008,-,-
BAC182_N11,22,22q11.22,21026275,21105301,79026,-,-
BAC150_I15,22,22q11.22,21102632,21207620,104988,-,-
BAC92_I12,22,22q11.22,21105296,21207620,102324,-,-
BAC71_L18,22,22q11.22,21148037,21220786,72749,-,-
BAC232_H01,22,22q11.22,21197043,21253842,56799,-,-
BAC125_M16,22,22q11.22,21247324,21332939,85615,yes,-
BAC190_K15,22,22q11.22,21291976,21381169,89193,yes,-
BAC146_J19,22,22q11.22,21320860,21399152,78292,-,-
BAC172_I19,22,22q11.22,21327345,21415443,88098,-,-
BAC17_E13,22,22q11.22,21332935,21444627,111692,-,-
BAC219_F19,22,22q11.22,21399148,21514671,115523,yes,-
BAC102_D24,22,22q11.22,21399151,21514673,115522,yes,-
BAC204_K06,22,22q11.22,21540332,21630683,90351,-,-
BAC235_G04,22,22q11.22,21692496,21777177,84681,-,-
BAC188_H10,22,22q11.22,21692520,21786179,93659,-,-
BAC170_F13,22,22q11.22-22q11.23,21770421,21899245,128824,-,-
BAC169_G07,22,22q11.22-22q11.23,21785657,21898492,112835,-,-
BAC92_P17,22,22q11.23,21836341,21967957,131616,-,-
BAC187_I13,22,22q11.23,21871675,21967957,96282,-,-
BAC157_I03,22,22q11.23,21961773,22111005,149232,-,-
BAC100_N23,22,22q11.23,21967951,22059686,91735,-,-
BAC61_M11,22,22q11.23,21996413,22090997,94584,-,-
BAC237_I19,22,22q11.23,22019117,22102217,83100,-,-
BAC8_H01,22,22q11.23,22211099,22331708,120609,-,-
BAC84_G07,22,22q11.23,22226164,22331708,105544,-,-
BAC123_B21,22,22q11.23,22265237,22352343,87106,-,-
BAC170_B02,22,22q11.23,22375019,22500221,125202,-,-
BAC157_N19,22,22q11.23,22435217,22552990,117773,-,-
BAC132_J01,22,22q11.23,22435849,22580649,144800,-,-
BAC144_L19,22,22q11.23,22509508,22643122,133614,yes,-
BAC193_N18,22,22q11.23,22669430,22784121,114691,yes,-
BAC171_J23,22,22q11.23,22711381,22787606,76225,yes,-
BAC221_D14,22,22q11.23,22762590,22859368,96778,-,-
BAC89_L04,22,22q11.23,22784116,22872184,88068,-,-
BAC156_O21,22,22q11.23,22785378,22859352,73974,-,-
BAC153_L10,22,22q11.23,22852009,22947445,95436,-,-
BAC233_D21,22,22q11.23,22870802,22956838,86036,-,-
BAC117_I21,22,22q11.23,22892072,22932874,40802,-,-
BAC28_L13,22,22q11.23,22928331,23040015,111684,-,-
BAC49_H20,22,22q11.23,22940568,23030593,90025,-,-
BAC67_E13,22,22q11.23,22951499,23039710,88211,-,-
BAC40_E10,22,22q11.23,22956891,23041339,84448,-,-
BAC247_C09,22,22q11.23,22956891,23065229,108338,-,-
BAC228_H17,22,22q11.23,23012424,23140672,128248,-,-
BAC154_L05,22,22q11.23,23040199,23124521,84322,-,-
BAC193_G11,22,22q11.23,23133016,23277759,144743,-,-
BAC170_F04,22,22q11.23,23140690,23221989,81299,-,-
BAC60_H22,22,22q11.23,23143219,23233660,90441,-,-
BAC158_B02,22,22q11.23,23186511,23277759,91248,-,-
BAC109_E02,22,22q11.23,23221980,23330215,108235,-,-
BAC199_J01,22,22q11.23,23240676,23355462,114786,-,-
BAC141_J23,22,22q11.23,23277755,23361937,84182,-,-
BAC80_K23,22,22q11.23,23282358,23458923,176565,-,-
BAC36_H11,22,22q11.23,23391795,23403142,11347,-,-
BAC96_M16,22,22q11.23,23431722,23575119,143397,-,-
BAC190_C04,22,22q11.23,23434620,23528222,93602,-,-
BAC240_A03,22,22q11.23,23458919,23539395,80476,-,-
BAC238_H12,22,22q11.23,23528598,23638692,110094,-,-
BAC238_G12,22,22q11.23,23528598,23638777,110179,-,-
BAC234_L03,22,22q11.23,23571447,23662751,91304,-,-
BAC65_K03,22,22q11.23,23571447,23687370,115923,-,-
BAC136_C03,22,22q11.23,23575231,23668840,93609,-,-
BAC220_K20,22,22q11.23,23671589,23776429,104840,-,-
BAC76_P14,22,22q11.23,23676503,23798592,122089,-,-
BAC231_H07,22,22q11.23,23681613,23776428,94815,-,-
BAC118_H08,22,22q11.23,23696800,23843000,146200,-,-
BAC183_F16,22,22q11.23,23769658,23835058,65400,-,-
BAC151_N20,22,22q11.23,23769678,23885639,115961,-,-
BAC62_A01,22,22q11.23,23802515,23912952,110437,-,-
BAC220_E12,22,22q11.23,23837228,23995900,158672,-,-
BAC184_B17,22,22q11.23,23847561,23938989,91428,-,-
BAC213_K17,22,22q11.23,23885645,23980189,94544,-,-
BAC193_E06,22,22q11.23,24015005,24095256,80251,-,-
BAC199_I14,22,22q11.23,24015030,24115560,100530,-,-
BAC226_C08,22,22q11.23,24037039,24125564,88525,-,-
BAC175_P10,22,22q11.23,24055573,24141562,85989,-,-
BAC12_C06,22,22q11.23,24072963,24169690,96727,-,-
BAC159_K10,22,22q11.23,24072991,24196069,123078,-,-
BAC38_J11,22,22q11.23,24100806,24189521,88715,yes,-
BAC156_L12,22,22q11.23,24151200,24244049,92849,yes,-
BAC234_P08,22,22q11.23,24151200,24248943,97743,yes,-
BAC62_L24,22,22q11.23,24151249,24266706,115457,yes,-
BAC124_K18,22,22q11.23,24169968,24266708,96740,yes,-
BAC208_P02,22,22q11.23,24196063,24286761,90698,-,-
BAC151_E16,22,22q11.23,24196064,24286909,90845,-,-
BAC150_E24,22,22q11.23-22q12.1,24212956,24302502,89546,-,-
BAC151_N05,22,22q11.23-22q12.1,24249142,24340576,91434,-,-
BAC213_P18,22,22q11.23-22q12.1,24261599,24345057,83458,-,-
BAC26_F06,22,22q11.23-22q12.1,24272820,24372467,99647,-,-
BAC228_A12,22,22q12.1,24424652,24563535,138883,-,-
BAC248_B05,22,22q12.1,24426573,24509919,83346,-,-
BAC59_M12,22,22q12.1,24457864,24560707,102843,-,-
BAC112_F05,22,22q12.1,24457875,24560694,102819,-,-
BAC146_D03,22,22q12.1,24497679,24588276,90597,-,-
BAC43_L05,22,22q12.1,24554089,24649777,95688,-,-
BAC153_I19,22,22q12.1,24588271,24689820,101549,-,-
BAC31_J04,22,22q12.1,24600727,24691725,90998,-,-
BAC32_D20,22,22q12.1,24600728,24796999,196271,-,-
BAC55_C24,22,22q12.1,24606776,24694822,88046,-,-
BAC230_G24,22,22q12.1,24662250,24753820,91570,-,-
BAC173_A12,22,22q12.1,24689915,24781671,91756,-,-
BAC179_N04,22,22q12.1,24694842,24797098,102256,-,-
BAC96_F12,22,22q12.1,24801358,24904227,102869,-,-
BAC128_D21,22,22q12.1,24844714,25000140,155426,-,-
BAC64_J23,22,22q12.1,24853126,24975434,122308,-,-
BAC121_C22,22,22q12.1,24879966,24975436,95470,-,-
BAC60_E01,22,22q12.1,24892819,24996054,103235,-,-
BAC15_G24,22,22q12.1,24918664,24996013,77349,-,-
BAC183_E21,22,22q12.1,24929453,25013814,84361,-,-
BAC128_G05,22,22q12.1,24937052,25031854,94802,-,-
BAC233_H14,22,22q12.1,24947945,25071277,123332,-,-
BAC46_F03,22,22q12.1,24947946,25032160,84214,-,-
BAC236_E18,22,22q12.1,24963182,25047496,84314,-,-
BAC197_H07,22,22q12.1,25058845,25142565,83720,-,-
BAC151_L19,22,22q12.1,25060825,25144500,83675,-,-
BAC40_G01,22,22q12.1,25071280,25208939,137659,-,-
BAC91_P16,22,22q12.1,25140952,25228505,87553,-,-
BAC62_N04,22,22q12.1,25144863,25295454,150591,-,-
BAC82_N16,22,22q12.1,25164803,25257906,93103,-,-
BAC211_F09,22,22q12.1,25190147,25257704,67557,-,-
BAC165_O09,22,22q12.1,25190643,25293527,102884,-,-
BAC66_P12,22,22q12.1,25208509,25306472,97963,-,-
BAC128_H20,22,22q12.1,25257902,25359791,101889,-,-
BAC81_F10,22,22q12.1,25293584,25415180,121596,-,-
BAC130_G02,22,22q12.1,25322186,25432939,110753,-,-
BAC224_H04,22,22q12.1,25322758,25415180,92422,-,-
BAC186_D12,22,22q12.1,25400082,25506790,106708,-,-
BAC155_M13,22,22q12.1,25400082,25495926,95844,-,-
BAC187_F13,22,22q12.1,25433023,25557571,124548,-,-
BAC75_B18,22,22q12.1,25463594,25590424,126830,-,-
BAC239_O21,22,22q12.1,25463594,25554463,90869,-,-
BAC23_C06,22,22q12.1,25526315,25624390,98075,-,-
BAC237_A10,22,22q12.1,25531067,25624388,93321,-,-
BAC68_A16,22,22q12.1,25557594,25695657,138063,-,-
BAC31_D11,22,22q12.1,25590996,25696519,105523,-,-
BAC139_B13,22,22q12.1,25617673,25727171,109498,-,-
BAC116_K05,22,22q12.1,25624383,25707645,83262,-,-
BAC32_I11,22,22q12.1,25741559,25847658,106099,-,-
BAC61_D12,22,22q12.1,25743068,25873130,130062,-,-
BAC247_P03,22,22q12.1,25788453,25873130,84677,-,-
BAC122_N03,22,22q12.1,25792867,25945225,152358,-,-
BAC226_A04,22,22q12.1,25832754,25945225,112471,-,-
BAC194_D19,22,22q12.1,25833188,25978564,145376,-,-
BAC136_O09,22,22q12.1,25862949,25945906,82957,-,-
BAC70_G02,22,22q12.1,25899729,25993419,93690,-,-
BAC141_M09,22,22q12.1,25901776,25996096,94320,-,-
BAC219_A22,22,22q12.1,25927905,26026506,98601,-,-
BAC72_N08,22,22q12.1,25954010,26041006,86996,-,-
BAC114_M20,22,22q12.1,25956952,26068837,111885,-,-
BAC71_G18,22,22q12.1,25966812,26132651,165839,-,-
BAC241_F07,22,22q12.1,26132672,26248427,115755,-,-
BAC12_F19,22,22q12.1,26165667,26293797,128130,-,-
BAC75_I19,22,22q12.1,26296290,26416743,120453,-,-
BAC233_N06,22,22q12.1,26311485,26416743,105258,-,-
BAC81_K07,22,22q12.1,26324816,26411118,86302,-,-
BAC142_H17,22,22q12.1,26332340,26411459,79119,-,-
BAC36_O12,22,22q12.1,26484629,26578313,93684,-,-
BAC36_M21,22,22q12.1,26513983,26656833,142850,-,-
BAC149_G07,22,22q12.1,26550578,26594897,44319,-,-
BAC189_J15,22,22q12.1,26583998,26724031,140033,-,-
BAC104_H23,22,22q12.1,26584016,26693469,109453,-,-
BAC59_M24,22,22q12.1,26631683,26724031,92348,-,-
BAC62_P18,22,22q12.1,26631949,26738224,106275,-,-
BAC132_A04,22,22q12.1,26644042,26724031,79989,-,-
BAC120_H17,22,22q12.1,26675460,26800462,125002,-,-
BAC97_L05,22,22q12.1,26696520,26769230,72710,-,-
BAC100_P10,22,22q12.1,26700102,26828418,128316,-,-
BAC24_L05,22,22q12.1,26704787,26860598,155811,-,-
BAC176_F23,22,22q12.1,26714291,26801075,86784,-,-
BAC161_N14,22,22q12.1,26721035,26851795,130760,-,-
BAC72_N04,22,22q12.1,26738264,26860553,122289,-,-
BAC163_F03,22,22q12.1,26769347,26860897,91550,-,-
BAC196_D17,22,22q12.1,26801219,26879996,78777,-,-
BAC84_G03,22,22q12.1,27049527,27154952,105425,-,-
BAC58_N14,22,22q12.1,27228478,27345326,116848,-,-
BAC27_L12,22,22q12.1,27253428,27373749,120321,-,-
BAC247_J10,22,22q12.1,27253569,27339581,86012,-,-
BAC176_A05,22,22q12.1,27348652,27433283,84631,-,-
BAC31_L07,22,22q12.1,27373861,27459246,85385,-,-
BAC56_L09,22,22q12.1,27378349,27524252,145903,-,-
BAC144_K06,22,22q12.1,27392926,27490838,97912,-,-
BAC75_M06,22,22q12.1,27392949,27506916,113967,-,-
BAC126_A16,22,22q12.1,27402726,27490838,88112,-,-
BAC215_E22,22,22q12.1,27471834,27588294,116460,-,-
BAC153_P04,22,22q12.1,27490829,27562220,71391,-,-
BAC95_F23,22,22q12.1,27524306,27612407,88101,-,-
BAC188_J07,22,22q12.1,27539784,27622747,82963,-,-
BAC160_K20,22,22q12.1,27562320,27668417,106097,-,-
BAC42_J07,22,22q12.1,27588582,27691097,102515,-,-
BAC95_I16,22,22q12.1,27622737,27711892,89155,-,-
BAC143_A19,22,22q12.1,27644626,27752670,108044,-,-
BAC86_J08,22,22q12.1-22q12.2,27842550,27955632,113082,-,-
BAC58_F22,22,22q12.1-22q12.2,27859306,28002599,143293,-,-
BAC39_D22,22,22q12.1-22q12.2,27874755,27999914,125159,-,-
BAC246_M15,22,22q12.1-22q12.2,27876426,27946813,70387,-,-
BAC229_K08,22,22q12.2,27946854,28025941,79087,-,-
BAC59_E15,22,22q12.2,27999909,28101908,101999,-,-
BAC235_G17,22,22q12.2,28010826,28102829,92003,-,-
BAC42_L02,22,22q12.2,28010826,28135456,124630,-,-
BAC106_B20,22,22q12.2,28072714,28163344,90630,-,-
BAC101_O07,22,22q12.2,28126295,28173701,47406,-,-
BAC191_G18,22,22q12.2,28163347,28262461,99114,-,-
BAC121_H07,22,22q12.2,28163502,28276549,113047,-,-
BAC237_K18,22,22q12.2,28191638,28272071,80433,-,-
BAC143_H03,22,22q12.2,28224949,28347605,122656,-,-
BAC108_L18,22,22q12.2,28262455,28359691,97236,-,-
BAC171_F14,22,22q12.2,28262455,28343654,81199,-,-
BAC150_B16,22,22q12.2,28279016,28383705,104689,-,-
BAC37_J03,22,22q12.2,28383741,28496470,112729,-,-
BAC51_J09,22,22q12.2,28383780,28553653,169873,-,-
BAC238_M10,22,22q12.2,28396528,28477124,80596,-,-
BAC117_O16,22,22q12.2,28407057,28496465,89408,-,-
BAC217_C05,22,22q12.2,28407057,28501815,94758,-,-
BAC193_G09,22,22q12.2,28502986,28614705,111719,-,-
BAC127_J17,22,22q12.2,28522712,28647183,124471,-,-
BAC141_P19,22,22q12.2,28554493,28633975,79482,-,-
BAC221_B12,22,22q12.2,28614215,28700430,86215,-,-
BAC247_C02,22,22q12.2,28643754,28728097,84343,-,-
BAC188_A15,22,22q12.2,28643754,28743016,99262,-,-
BAC195_F17,22,22q12.2,28688163,28780597,92434,-,-
BAC71_G16,22,22q12.2,28708972,28847566,138594,-,-
BAC67_F05,22,22q12.2,28734349,28848680,114331,-,-
BAC57_M24,22,22q12.2,28766123,28845096,78973,-,-
BAC24_P07,22,22q12.2,28766123,28844936,78813,-,-
BAC124_H17,22,22q12.2,28766123,28847641,81518,-,-
BAC127_I22,22,22q12.2,28780592,28879660,99068,-,-
BAC50_G04,22,22q12.2,28848242,29006733,158491,-,-
BAC173_M17,22,22q12.2,28848674,28928213,79539,-,-
BAC10_H04,22,22q12.2,28865964,28905470,39506,-,-
BAC80_G24,22,22q12.2,28964663,29061584,96921,-,-
BAC181_E09,22,22q12.2,28988277,29119909,131632,-,-
BAC198_F12,22,22q12.2,28988277,29085101,96824,-,-
BAC51_A01,22,22q12.2,29006740,29151352,144612,-,-
BAC246_C17,22,22q12.2,29317173,29417627,100454,-,-
BAC157_D05,22,22q12.2,29337021,29419552,82531,-,-
BAC208_K20,22,22q12.2,29337501,29417627,80126,-,-
BAC33_E01,22,22q12.2,29397451,29529598,132147,-,-
BAC160_P14,22,22q12.2,29421758,29509837,88079,-,-
BAC150_D06,22,22q12.2,29516184,29620585,104401,-,-
BAC151_H16,22,22q12.2,29529824,29620920,91096,-,-
BAC124_N16,22,22q12.2,29675718,29780017,104299,-,-
BAC68_G04,22,22q12.2,29702067,29789897,87830,-,-
BAC68_G03,22,22q12.2,29759035,29845053,86018,-,-
BAC183_O24,22,22q12.2,29772540,29845117,72577,-,-
BAC129_D04,22,22q12.2,29845450,29939385,93935,-,-
BAC140_M20,22,22q12.2,29908466,30006624,98158,-,-
BAC219_K02,22,22q12.2,30005904,30126677,120773,-,-
BAC232_L19,22,22q12.2,30006617,30095680,89063,-,-
BAC103_G23,22,22q12.2,30058971,30183606,124635,-,-
BAC235_I12,22,22q12.2,30083818,30166638,82820,-,-
BAC121_A16,22,22q12.2,30095860,30194704,98844,-,-
BAC24_F22,22,22q12.2,30126767,30244869,118102,-,-
BAC56_M12,22,22q12.2,30185755,30306108,120353,-,-
BAC89_I08,22,22q12.2,30244864,30342969,98105,-,-
BAC50_K07,22,22q12.2,30244992,30373919,128927,-,-
BAC152_D08,22,22q12.2,30266955,30380713,113758,-,-
BAC204_I03,22,22q12.2-22q12.3,30440062,30518130,78068,-,-
BAC65_F14,22,22q12.2-22q12.3,30440630,30517911,77281,-,-
BAC75_M10,22,22q12.2-22q12.3,30452963,30585065,132102,-,-
BAC140_M13,22,22q12.2-22q12.3,30480872,30591826,110954,-,-
BAC141_B02,22,22q12.2-22q12.3,30480872,30585065,104193,-,-
BAC14_I23,22,22q12.2-22q12.3,30484571,30591826,107255,-,-
BAC154_K12,22,22q12.3,30655833,30761311,105478,-,-
BAC66_O24,22,22q12.3,30655836,30746671,90835,-,-
BAC45_J11,22,22q12.3,30655989,30739949,83960,-,-
BAC140_B15,22,22q12.3,30657605,30746534,88929,-,-
BAC43_D04,22,22q12.3,30682312,30838602,156290,-,-
BAC137_K06,22,22q12.3,30684825,30784092,99267,-,-
BAC31_N08,22,22q12.3,30688847,30833862,145015,-,-
BAC139_O22,22,22q12.3,30757568,30834095,76527,-,-
BAC45_D16,22,22q12.3,30784332,30868484,84152,-,-
BAC31_D05,22,22q12.3,30817455,30920713,103258,-,-
BAC147_C09,22,22q12.3,30843814,30924971,81157,-,-
BAC183_B06,22,22q12.3,30859810,30963454,103644,-,-
BAC223_L11,22,22q12.3,30859885,30950521,90636,-,-
BAC103_C12,22,22q12.3,30868536,30984375,115839,-,-
BAC206_E14,22,22q12.3,30963737,31080953,117216,-,-
BAC176_I06,22,22q12.3,30992301,31080951,88650,-,-
BAC39_N03,22,22q12.3,31024906,31128045,103139,-,-
BAC65_L04,22,22q12.3,31156640,31250311,93671,-,-
BAC240_E19,22,22q12.3,31195647,31279328,83681,-,-
BAC200_L18,22,22q12.3,31242874,31354252,111378,-,-
BAC155_C07,22,22q12.3,31261449,31371436,109987,-,-
BAC249_J07,22,22q12.3,31331297,31412076,80779,-,-
BAC34_A24,22,22q12.3,31339460,31439029,99569,-,-
BAC247_P22,22,22q12.3,31371552,31466354,94802,-,-
BAC196_J04,22,22q12.3,31515615,31609613,93998,-,-
BAC187_K08,22,22q12.3,31516566,31610860,94294,-,-
BAC229_D09,22,22q12.3,31516566,31612107,95541,-,-
BAC250_M15,22,22q12.3,31546046,31691330,145284,-,-
BAC240_I22,22,22q12.3,31572965,31698604,125639,-,-
BAC165_D04,22,22q12.3,31596565,31717006,120441,-,-
BAC162_O14,22,22q12.3,31611000,31710142,99142,-,-
BAC152_H18,22,22q12.3,31705969,31782526,76557,-,-
BAC247_H23,22,22q12.3,31719359,31799960,80601,-,-
BAC237_H23,22,22q12.3,31757589,31833936,76347,-,-
BAC32_P21,22,22q12.3,31836586,31927757,91171,-,-
BAC66_J04,22,22q12.3,31880955,31961454,80499,-,-
BAC199_P01,22,22q12.3,31886776,31961454,74678,-,-
BAC168_M09,22,22q12.3,31962970,32053382,90412,-,-
BAC183_J16,22,22q12.3,31972028,32078385,106357,-,-
BAC71_F09,22,22q12.3,32001403,32105160,103757,-,-
BAC131_E19,22,22q12.3,32068263,32164505,96242,-,-
BAC44_C16,22,22q12.3,32090862,32105160,14298,-,-
BAC145_J21,22,22q12.3,32116244,32213075,96831,-,-
BAC203_C08,22,22q12.3,32121661,32246449,124788,-,-
BAC81_B21,22,22q12.3,32130706,32212770,82064,-,-
BAC157_I01,22,22q12.3,32162494,32246853,84359,-,-
BAC142_L01,22,22q12.3,32209372,32290951,81579,-,-
BAC90_G19,22,22q12.3,32223889,32331164,107275,-,-
BAC40_B07,22,22q12.3,32290945,32378981,88036,-,-
BAC78_K24,22,22q12.3,32307907,32397543,89636,-,-
BAC184_L18,22,22q12.3,32319523,32405098,85575,-,-
BAC234_D12,22,22q12.3,32380684,32483369,102685,-,-
BAC42_A09,22,22q12.3,32483367,32592322,108955,-,-
BAC156_I23,22,22q12.3,32489217,32592322,103105,-,-
BAC158_F20,22,22q12.3,32539342,32634533,95191,-,-
BAC195_C01,22,22q12.3,32579225,32703765,124540,-,-
BAC151_I21,22,22q12.3,32666013,32751306,85293,-,-
BAC27_F12,22,22q12.3,32670224,32800102,129878,-,-
BAC168_L18,22,22q12.3,32703760,32800102,96342,-,-
BAC144_M17,22,22q12.3,32761379,32890704,129325,-,-
BAC141_L13,22,22q12.3,32785942,32883364,97422,-,-
BAC194_G22,22,22q12.3,32785952,32883364,97412,-,-
BAC6_L09,22,22q12.3,32785988,32899508,113520,-,-
BAC68_J03,22,22q12.3,32791403,32863662,72259,-,-
BAC40_J08,22,22q12.3,32799282,32909700,110418,-,-
BAC100_D07,22,22q12.3,32799531,32910653,111122,-,-
BAC208_P15,22,22q12.3,32799531,32883151,83620,-,-
BAC35_H07,22,22q12.3,32870823,32979686,108863,-,-
BAC46_P06,22,22q12.3,32878020,33015349,137329,-,-
BAC144_I23,22,22q12.3,32892137,32979707,87570,-,-
BAC222_G01,22,22q12.3,33007571,33098841,91270,-,-
BAC8_E14,22,22q12.3,33015340,33155865,140525,-,-
BAC48_C18,22,22q12.3,33219316,33309211,89895,-,-
BAC230_O09,22,22q12.3,33288805,33379057,90252,-,-
BAC97_N24,22,22q12.3,33313397,33420150,106753,-,-
BAC190_F15,22,22q12.3,33518467,33601093,82626,-,-
BAC63_E10,22,22q12.3,33601083,33712106,111023,-,-
BAC125_N22,22,22q12.3,33604792,33712146,107354,-,-
BAC165_A22,22,22q12.3,33621760,33712144,90384,-,-
BAC34_N14,22,22q12.3,33652007,33737225,85218,-,-
BAC101_J24,22,22q12.3,33688378,33773476,85098,-,-
BAC163_C05,22,22q12.3,33712138,33793816,81678,-,-
BAC248_C06,22,22q12.3,33737221,33833379,96158,-,-
BAC42_G10,22,22q12.3,33743264,33885225,141961,-,-
BAC107_J12,22,22q12.3,33743305,33823956,80651,-,-
BAC144_G10,22,22q12.3,33823950,33913652,89702,-,-
BAC143_G08,22,22q12.3,33823958,33926528,102570,-,-
BAC44_L15,22,22q12.3,33836415,33939550,103135,-,-
BAC64_G16,22,22q12.3,33842564,33926524,83960,-,-
BAC147_C01,22,22q12.3,33844409,33926528,82119,-,-
BAC22_G21,22,22q12.3,33871685,34062917,191232,-,-
BAC18_K08,22,22q12.3,33926522,34060276,133754,-,-
BAC101_J01,22,22q12.3,33958126,34081875,123749,-,-
BAC232_E20,22,22q12.3,33958126,34046139,88013,-,-
BAC196_H15,22,22q12.3,33981564,34060283,78719,-,-
BAC237_O05,22,22q12.3,34003361,34127893,124532,yes,-
BAC29_G06,22,22q12.3,34013520,34138667,125147,yes,-
BAC171_C23,22,22q12.3,34032375,34132526,100151,yes,-
BAC161_L20,22,22q12.3,34060300,34138824,78524,yes,-
BAC94_K05,22,22q12.3,34079439,34163589,84150,yes,-
BAC151_G08,22,22q12.3,34151413,34233530,82117,-,-
BAC42_G01,22,22q12.3,34163829,34258486,94657,-,-
BAC36_B21,22,22q12.3,34216791,34348395,131604,-,-
BAC130_L21,22,22q12.3,34228813,34308807,79994,-,-
BAC75_J19,22,22q12.3,34233522,34324410,90888,-,-
BAC184_B24,22,22q12.3,34249040,34343695,94655,-,-
BAC1_D16,22,22q12.3,34324418,34416207,91789,-,-
BAC22_A04,22,22q12.3,34383075,34481618,98543,yes,-
BAC247_H19,22,22q12.3,34388365,34490577,102212,yes,-
BAC8_C09,22,22q12.3,34416205,34480676,64471,yes,-
BAC37_G19,22,22q12.3,34477351,34613197,135846,-,-
BAC19_A04,22,22q12.3,34508881,34620368,111487,-,-
BAC86_E19,22,22q12.3,34519008,34678111,159103,-,-
BAC25_I10,22,22q12.3,34553642,34691629,137987,-,-
BAC218_N04,22,22q12.3,34568988,34678226,109238,-,-
BAC185_E21,22,22q12.3,34573462,34653986,80524,-,-
BAC25_G03,22,22q12.3,34603874,34704326,100452,-,-
BAC97_M01,22,22q12.3,34630748,34722101,91353,-,-
BAC52_F11,22,22q12.3,34722131,34865369,143238,-,-
BAC24_E23,22,22q12.3,34763157,34865109,101952,-,-
BAC31_D16,22,22q12.3,34765671,34860878,95207,-,-
BAC26_E09,22,22q12.3,34886423,34970278,83855,-,-
BAC142_M17,22,22q12.3,34889142,34951924,62782,-,-
BAC70_K14,22,22q12.3,34889201,35008974,119773,-,-
BAC16_I14,22,22q12.3,34951928,34969839,17911,-,-
BAC3_F04,22,22q12.3,34976206,35089434,113228,-,-
BAC73_M23,22,22q12.3,34977178,35073792,96614,-,-
BAC146_A02,22,22q12.3,34991277,35069867,78590,-,-
BAC131_H09,22,22q12.3,35000557,35127809,127252,-,-
BAC240_E16,22,22q12.3,35036814,35158758,121944,-,-
BAC36_N11,22,22q12.3,35078357,35168759,90402,-,-
BAC249_E22,22,22q12.3,35130457,35238461,108004,-,-
BAC250_N13,22,22q12.3,35238454,35329000,90546,-,-
BAC169_C05,22,22q12.3,35238456,35329547,91091,-,-
BAC243_E18,22,22q12.3,35269669,35352332,82663,-,-
BAC94_B18,22,22q12.3,35269696,35352331,82635,-,-
BAC248_A06,22,22q12.3,35278757,35403498,124741,-,-
BAC25_B14,22,22q12.3,35307434,35403498,96064,-,-
BAC154_G21,22,22q12.3,35313787,35403502,89715,-,-
BAC150_E10,22,22q12.3,35356051,35447199,91148,-,-
BAC35_O06,22,22q12.3,35356081,35458364,102283,-,-
BAC244_M11,22,22q12.3,35458475,35571508,113033,-,-
BAC168_M19,22,22q12.3,35476088,35561486,85398,yes,-
BAC61_L12,22,22q12.3,35643515,35813971,170456,-,-
BAC104_K09,22,22q12.3,35686186,35813969,127783,-,-
BAC107_G16,22,22q12.3,35714113,35813967,99854,-,-
BAC22_J08,22,22q12.3,35718665,35879651,160986,-,-
BAC232_P17,22,22q12.3,35746665,35857152,110487,-,-
BAC163_E24,22,22q12.3-22q13.1,35797513,35907899,110386,-,-
BAC169_G13,22,22q12.3-22q13.1,35813962,35904580,90618,-,-
BAC27_E10,22,22q12.3,35813962,35887937,73975,-,-
BAC46_O11,22,22q12.3-22q13.1,35813967,35978242,164275,-,-
BAC15_I17,22,22q12.3-22q13.1,35813973,36006890,192917,-,-
BAC235_M15,22,22q12.3-22q13.1,35869147,36047185,178038,yes,-
BAC73_P11,22,22q13.1,35920336,36056491,136155,yes,-
BAC148_L24,22,22q13.1,36018991,36122228,103237,-,-
BAC161_B05,22,22q13.1,36031557,36196429,164872,-,-
BAC106_C07,22,22q13.1,36052892,36157674,104782,-,-
BAC192_P12,22,22q13.1,36052892,36171011,118119,-,-
BAC37_K11,22,22q13.1,36120244,36212750,92506,-,-
BAC128_O19,22,22q13.1,36177045,36268188,91143,-,-
BAC199_H22,22,22q13.1,36177045,36259395,82350,-,-
BAC22_G11,22,22q13.1,36268250,36384331,116081,-,-
BAC222_D19,22,22q13.1,36290280,36422048,131768,-,-
BAC28_B09,22,22q13.1,36305926,36360065,54139,-,-
BAC160_C16,22,22q13.1,36330132,36422048,91916,-,-
BAC169_N07,22,22q13.1,36368495,36454214,85719,-,-
BAC222_N03,22,22q13.1,36396518,36515348,118830,-,-
BAC147_K02,22,22q13.1,36416426,36499816,83390,-,-
BAC135_B09,22,22q13.1,36422041,36515348,93307,-,-
BAC14_G19,22,22q13.1,36443326,36579296,135970,yes,-
BAC42_L10,22,22q13.1,36454454,36587832,133378,yes,-
BAC247_F23,22,22q13.1,36542401,36659703,117302,yes,-
BAC134_I19,22,22q13.1,36542417,36637572,95155,yes,-
BAC232_I20,22,22q13.1,36587827,36682984,95157,-,-
BAC82_N10,22,22q13.1,36614059,36755323,141264,-,-
BAC166_L20,22,22q13.1,36669646,36755323,85677,-,-
BAC252_G05,22,22q13.1,36756367,36862348,105981,-,-
BAC52_C17,22,22q13.1,36787097,36868689,81592,-,-
BAC140_L12,22,22q13.1,36868680,36995138,126458,-,-
BAC69_H03,22,22q13.1,36885764,36976417,90653,-,-
BAC237_B22,22,22q13.1,36898321,36995138,96817,-,-
BAC252_M14,22,22q13.1,36898342,36976430,78088,-,-
BAC111_L11,22,22q13.1,36903011,36995085,92074,-,-
BAC145_A02,22,22q13.1,36913431,37019276,105845,-,-
BAC208_H07,22,22q13.1,36924475,37019206,94731,-,-
BAC115_K20,22,22q13.1,36934310,37026321,92011,-,-
BAC115_J05,22,22q13.1,36953210,37031345,78135,-,-
BAC162_H12,22,22q13.1,37019431,37109483,90052,-,-
BAC199_N03,22,22q13.1,37150377,37230398,80021,-,-
BAC131_D01,22,22q13.1,37177336,37273853,96517,-,-
BAC91_M03,22,22q13.1,37255801,37376691,120890,-,-
BAC154_L12,22,22q13.1,37284319,37415197,130878,-,-
BAC139_P09,22,22q13.1,37291114,37376691,85577,-,-
BAC190_O21,22,22q13.1,37331775,37423379,91604,-,-
BAC161_F18,22,22q13.1,37430350,37557723,127373,-,-
BAC80_B09,22,22q13.1,37448387,37647593,199206,-,-
BAC153_G07,22,22q13.1,37449359,37524706,75347,-,-
BAC157_O18,22,22q13.1,37478503,37559238,80735,-,-
BAC241_K15,22,22q13.1,37546046,37646696,100650,-,-
BAC200_M11,22,22q13.1,37557714,37651936,94222,-,-
BAC188_J15,22,22q13.1,37572469,37651932,79463,-,-
BAC27_B23,22,22q13.1,37603381,37731834,128453,yes,-
BAC160_I17,22,22q13.1,37605972,37697234,91262,yes,-
BAC130_P16,22,22q13.1,37646691,37752476,105785,yes,-
BAC218_K24,22,22q13.1,37651930,37733280,81350,yes,-
BAC202_M04,22,22q13.1,37678197,37772166,93969,yes,-
BAC183_I01,22,22q13.1,37720119,37807914,87795,-,-
BAC54_H04,22,22q13.1,37738221,37832258,94037,-,-
BAC33_J12,22,22q13.1,37752722,37852974,100252,-,-
BAC189_I22,22,22q13.1,37811305,37907887,96582,-,-
BAC79_J23,22,22q13.1,37832426,38017110,184684,-,-
BAC180_G12,22,22q13.1,37864274,37969161,104887,-,-
BAC154_K23,22,22q13.1,37868923,38017765,148842,-,-
BAC149_G04,22,22q13.1,37969416,38128303,158887,-,-
BAC165_G10,22,22q13.1,37974636,38069747,95111,-,-
BAC139_D07,22,22q13.1,37983035,38097969,114934,-,-
BAC141_O23,22,22q13.1,37999330,38097979,98649,-,-
BAC12_L12,22,22q13.1,38139811,38228852,89041,-,-
BAC236_H14,22,22q13.1,38207829,38278827,70998,-,-
BAC38_F09,22,22q13.1,38242360,38337642,95282,-,-
BAC149_P18,22,22q13.1,38357153,38436386,79233,-,-
BAC25_A03,22,22q13.1,38545898,38651464,105566,-,-
BAC59_A14,22,22q13.1,38545898,38646620,100722,-,-
BAC167_P07,22,22q13.1,38567948,38683107,115159,-,-
BAC161_C11,22,22q13.1,38571041,38651464,80423,-,-
BAC42_G07,22,22q13.1,38571041,38661640,90599,-,-
BAC84_H19,22,22q13.1,38577139,38710156,133017,-,-
BAC25_C02,22,22q13.1,38629027,38765441,136414,-,-
BAC143_E09,22,22q13.1,38649507,38735234,85727,-,-
BAC61_M09,22,22q13.1,38661635,38755778,94143,-,-
BAC208_A11,22,22q13.1,38710170,38811202,101032,-,-
BAC64_C18,22,22q13.1,38817061,38924153,107092,-,-
BAC23_H22,22,22q13.1,38905718,39002238,96520,-,-
BAC57_O12,22,22q13.1,38924349,39012936,88587,-,-
BAC247_L17,22,22q13.1,39016688,39111557,94869,-,-
BAC69_E19,22,22q13.1,39025730,39208194,182464,-,-
BAC50_H12,22,22q13.1,39034315,39161886,127571,-,-
BAC43_C22,22,22q13.1,39060030,39172525,112495,-,-
BAC66_M06,22,22q13.1,39087833,39203708,115875,-,-
BAC175_C10,22,22q13.1,39109628,39208010,98382,-,-
BAC192_A04,22,22q13.1,39109628,39197352,87724,-,-
BAC193_D13,22,22q13.1,39159690,39254687,94997,-,-
BAC89_M08,22,22q13.1-22q13.2,39208208,39305283,97075,-,-
BAC64_O11,22,22q13.1-22q13.2,39213585,39305283,91698,-,-
BAC73_G05,22,22q13.1-22q13.2,39252673,39353919,101246,-,-
BAC84_E17,22,22q13.1-22q13.2,39254742,39350375,95633,-,-
BAC154_M12,22,22q13.1-22q13.2,39258587,39353919,95332,-,-
BAC70_G10,22,22q13.2,39316006,39416142,100136,-,-
BAC59_J18,22,22q13.2,39359662,39447639,87977,-,-
BAC43_B14,22,22q13.2,39370132,39497945,127813,-,-
BAC217_I18,22,22q13.2,39372856,39494250,121394,-,-
BAC79_L08,22,22q13.2,39402417,39536232,133815,-,-
BAC145_D16,22,22q13.2,39444128,39588257,144129,-,-
BAC106_K07,22,22q13.2,39461628,39554841,93213,-,-
BAC13_L24,22,22q13.2,39466734,39536259,69525,-,-
BAC31_L09,22,22q13.2,39506648,39611939,105291,-,-
BAC37_K13,22,22q13.2,39506661,39685161,178500,-,-
BAC22_E03,22,22q13.2,39554846,39692721,137875,-,-
BAC209_A17,22,22q13.2,39557265,39643281,86016,-,-
BAC160_N12,22,22q13.2,39588265,39685177,96912,-,-
BAC9_B14,22,22q13.2,39692715,39806342,113627,-,-
BAC197_P09,22,22q13.2,39698458,39794500,96042,-,-
BAC140_F02,22,22q13.2,39698461,39819979,121518,-,-
BAC12_O01,22,22q13.2,39709306,39806049,96743,-,-
BAC200_I23,22,22q13.2,39712406,39806242,93836,-,-
BAC248_P03,22,22q13.2,39728849,39819979,91130,-,-
BAC143_L15,22,22q13.2,39756540,39876839,120299,-,-
BAC88_J20,22,22q13.2,39778764,39891186,112422,-,-
BAC95_M13,22,22q13.2,39806336,39915940,109604,-,-
BAC12_I08,22,22q13.2,39806336,39844569,38233,-,-
BAC119_K08,22,22q13.2,39877033,39985889,108856,-,-
BAC24_H22,22,22q13.2,39891391,40008604,117213,-,-
BAC203_M04,22,22q13.2,39919488,40000490,81002,-,-
BAC96_P17,22,22q13.2,40022315,40136015,113700,-,-
BAC162_C02,22,22q13.2,40029355,40124429,95074,-,-
BAC204_O12,22,22q13.2,40041736,40146531,104795,-,-
BAC195_C22,22,22q13.2,40041954,40136022,94068,-,-
BAC37_P22,22,22q13.2,40041954,40171303,129349,-,-
BAC218_O14,22,22q13.2,40124443,40285916,161473,-,-
BAC155_G08,22,22q13.2,40239970,40330682,90712,-,-
BAC205_M24,22,22q13.2,40286117,40366488,80371,-,-
BAC192_F05,22,22q13.2,40330797,40474168,143371,-,-
BAC53_H15,22,22q13.2,40330799,40467159,136360,-,-
BAC40_L12,22,22q13.2,40331670,40445953,114283,-,-
BAC162_D11,22,22q13.2,40337858,40416573,78715,-,-
BAC40_F13,22,22q13.2,40382963,40472012,89049,-,-
BAC160_J20,22,22q13.2,40413884,40614877,200993,-,-
BAC106_G22,22,22q13.2,40446004,40548167,102163,-,-
BAC100_I03,22,22q13.2,40472006,40570612,98606,-,-
BAC145_P13,22,22q13.2,40477145,40557499,80354,-,-
BAC241_M21,22,22q13.2,40483305,40579588,96283,-,-
BAC247_D18,22,22q13.2,40487628,40625063,137435,-,-
BAC165_M19,22,22q13.2,40557494,40689989,132495,-,-
BAC135_L24,22,22q13.2,40646223,40731930,85707,-,-
BAC149_N12,22,22q13.2,40732188,40843114,110926,-,-
BAC233_N04,22,22q13.2,40751224,40831859,80635,-,-
BAC44_M05,22,22q13.2,40809564,40889457,79893,yes,-
BAC198_F08,22,22q13.2,40873679,40980026,106347,-,-
BAC50_O02,22,22q13.2,40900023,40994818,94795,-,-
BAC137_N16,22,22q13.2,40911652,40980026,68374,-,-
BAC139_C03,22,22q13.2,40953847,41054732,100885,-,-
BAC42_D01,22,22q13.2,40953853,41059309,105456,-,-
BAC224_B13,22,22q13.2,40976854,41059309,82455,-,-
BAC239_D22,22,22q13.2,40989677,41058211,68534,-,-
BAC82_H21,22,22q13.2,41059305,41161007,101702,-,-
BAC103_O15,22,22q13.2,41071457,41161007,89550,-,-
BAC238_N21,22,22q13.2,41194966,41253199,58233,-,-
BAC122_N08,22,22q13.2,41194967,41317705,122738,yes,-
BAC126_A10,22,22q13.2,41194967,41317705,122738,yes,-
BAC189_B11,22,22q13.2,41198248,41231163,32915,-,-
BAC126_G20,22,22q13.2,41201098,41322298,121200,yes,-
BAC154_E23,22,22q13.2,41201098,41228609,27511,-,-
BAC247_H08,22,22q13.2,41311676,41382845,71169,-,-
BAC231_C11,22,22q13.2,41355768,41468163,112395,-,-
BAC175_G01,22,22q13.2,41373946,41474384,100438,-,-
BAC234_G02,22,22q13.2,41382951,41474269,91318,-,-
BAC60_B20,22,22q13.2,41394734,41530842,136108,-,-
BAC129_E16,22,22q13.2,41404250,41507061,102811,-,-
BAC238_J21,22,22q13.2,41409690,41525746,116056,-,-
BAC168_E20,22,22q13.2,41453398,41567766,114368,-,-
BAC211_M11,22,22q13.2,41617927,41728936,111009,-,-
BAC122_O04,22,22q13.2,41648704,41827983,179279,-,-
BAC233_M15,22,22q13.2,41648704,41739277,90573,-,-
BAC237_D15,22,22q13.2,41680524,41793051,112527,-,-
BAC96_J03,22,22q13.2,41695127,41789868,94741,-,-
BAC249_H19,22,22q13.2,41700870,41789868,88998,-,-
BAC66_H24,22,22q13.2,41710381,41789868,79487,-,-
BAC35_O18,22,22q13.2,41730922,41836486,105564,-,-
BAC127_I24,22,22q13.2,41810936,41996035,185099,yes,-
BAC186_A12,22,22q13.2,41820188,41907123,86935,yes,-
BAC237_E21,22,22q13.2,41910878,42037930,127052,-,-
BAC51_M21,22,22q13.2,41943878,42052803,108925,-,-
BAC103_A03,22,22q13.2,41958088,42062554,104466,-,-
BAC196_E10,22,22q13.2,42035564,42109736,74172,-,-
BAC45_D03,22,22q13.2,42043145,42127802,84657,-,-
BAC238_O04,22,22q13.2,42062547,42198665,136118,-,-
BAC176_I05,22,22q13.2,42071106,42156585,85479,-,-
BAC41_K12,22,22q13.2,42073241,42193670,120429,-,-
BAC193_G03,22,22q13.2,42103250,42193688,90438,-,-
BAC45_M03,22,22q13.2,42276194,42390168,113974,-,-
BAC153_G04,22,22q13.2,42296705,42390785,94080,-,-
BAC175_H07,22,22q13.2,42359348,42440687,81339,-,-
BAC71_C15,22,22q13.2,42387205,42521302,134097,-,-
BAC54_C07,22,22q13.2,42387210,42494312,107102,-,-
BAC18_D07,22,22q13.2,42390786,42494312,103526,-,-
BAC144_M23,22,22q13.2,42399301,42472579,73278,-,-
BAC97_K15,22,22q13.2,42440884,42529743,88859,-,-
BAC80_G09,22,22q13.2,42501096,42591312,90216,-,-
BAC84_J20,22,22q13.2-22q13.31,42529794,42616390,86596,-,-
BAC29_M18,22,22q13.31,42625106,42699925,74819,-,-
BAC109_G02,22,22q13.31,42714688,42870511,155823,-,-
BAC189_F08,22,22q13.31,42774933,42890061,115128,-,-
BAC37_C11,22,22q13.31,42774933,42882939,108006,-,-
BAC247_G09,22,22q13.31,43130385,43291005,160620,-,-
BAC69_G11,22,22q13.31,43133117,43225263,92146,-,-
BAC172_M21,22,22q13.31,43142102,43232275,90173,-,-
BAC27_I08,22,22q13.31,43235923,43410615,174692,-,-
BAC151_J18,22,22q13.31,43251046,43353724,102678,-,-
BAC66_A19,22,22q13.31,43275659,43388958,113299,-,-
BAC124_G05,22,22q13.31,43291170,43435498,144328,-,-
BAC148_J10,22,22q13.31,43326843,43410615,83772,-,-
BAC124_K09,22,22q13.31,43367412,43452436,85024,-,-
BAC134_B06,22,22q13.31,43377687,43469391,91704,-,-
BAC170_K16,22,22q13.31,43388962,43460984,72022,-,-
BAC221_K19,22,22q13.31,43440823,43534969,94146,-,-
BAC55_A15,22,22q13.31,43440855,43516728,75873,-,-
BAC227_I16,22,22q13.31,43452441,43569332,116891,-,-
BAC141_I01,22,22q13.31,43497829,43600684,102855,-,-
BAC240_L20,22,22q13.31,43613883,43709708,95825,-,-
BAC231_C07,22,22q13.31,43638578,43738345,99767,-,-
BAC162_P23,22,22q13.31,43715428,43826617,111189,-,-
BAC66_M21,22,22q13.31,43738356,43826606,88250,-,-
BAC67_D09,22,22q13.31,43956482,44110849,154367,-,-
BAC42_J14,22,22q13.31,43957827,44110321,152494,-,-
BAC172_P19,22,22q13.31,43972756,44051512,78756,-,-
BAC192_H19,22,22q13.31,43995595,44108815,113220,-,-
BAC228_P15,22,22q13.31,43995597,44071342,75745,-,-
BAC123_H22,22,22q13.31,44012192,44155081,142889,-,-
BAC249_H17,22,22q13.31,44108807,44212503,103696,-,-
BAC142_H11,22,22q13.31,44148845,44226392,77547,-,-
BAC127_O24,22,22q13.31,44158456,44245216,86760,-,-
BAC231_G11,22,22q13.31,44199787,44285193,85406,-,-
BAC40_I03,22,22q13.31,44226566,44323229,96663,-,-
BAC247_P12,22,22q13.31,44238926,44328522,89596,-,-
BAC151_L03,22,22q13.31,44243542,44327082,83540,-,-
BAC24_M11,22,22q13.31,44304046,44460491,156445,-,-
BAC175_P12,22,22q13.31,44314891,44417128,102237,-,-
BAC230_P03,22,22q13.31,44328574,44433648,105074,-,-
BAC236_P15,22,22q13.31,44352854,44467080,114226,-,-
BAC24_P14,22,22q13.31,44377878,44536681,158803,-,-
BAC40_E14,22,22q13.31,44377882,44493582,115700,-,-
BAC35_B17,22,22q13.31,44502838,44604724,101886,-,-
BAC190_J08,22,22q13.31,44521779,44629267,107488,-,-
BAC188_M20,22,22q13.31,44783257,44916327,133070,-,-
BAC150_F17,22,22q13.31,44851127,44955082,103955,-,-
BAC48_A18,22,22q13.31,44851171,44973067,121896,-,-
BAC162_B21,22,22q13.31,45016117,45104758,88641,yes,-
BAC121_P07,22,22q13.31,45051419,45218966,167547,-,-
BAC71_B20,22,22q13.31,45051419,45180838,129419,-,-
BAC78_L06,22,22q13.31,45061239,45218966,157727,-,-
BAC157_E15,22,22q13.31,45081392,45180838,99446,-,-
BAC238_K22,22,22q13.31,45081396,45213015,131619,-,-
BAC46_L01,22,22q13.31,45081461,45218966,137505,-,-
BAC226_L13,22,22q13.31,45096224,45218966,122742,-,-
BAC153_O04,22,22q13.31,45111661,45224294,112633,-,-
BAC69_L09,22,22q13.31,45112531,45213015,100484,-,-
BAC50_I03,22,22q13.31,45112531,45180836,68305,-,-
BAC38_E06,22,22q13.31,45203933,45356615,152682,-,-
BAC142_J22,22,22q13.31,45211012,45285365,74353,-,-
BAC234_L18,22,22q13.31,45273902,45384648,110746,-,-
BAC131_L06,22,22q13.31,45374580,45496633,122053,-,-
BAC243_E10,22,22q13.31,45439684,45559545,119861,-,-
BAC77_K22,22,22q13.31,45471882,45607796,135914,-,-
BAC168_L20,22,22q13.31,45490428,45618631,128203,-,-
BAC22_G15,22,22q13.31,45490428,45710056,219628,-,-
BAC147_I04,22,22q13.31,45531509,45618631,87122,-,-
BAC107_O12,22,22q13.31,45627005,45720741,93736,-,-
BAC118_C04,22,22q13.31,45627014,45716886,89872,-,-
BAC119_E10,22,22q13.31,45631026,45738369,107343,-,-
BAC178_K19,22,22q13.31,45652692,45757273,104581,-,-
BAC179_G20,22,22q13.31,45655460,45757273,101813,-,-
BAC213_C23,22,22q13.31,45660226,45769456,109230,-,-
BAC242_A05,22,22q13.31,45665737,45757273,91536,-,-
BAC180_D12,22,22q13.31,45689680,45791724,102044,-,-
BAC218_H20,22,22q13.31,45691556,45791627,100071,-,-
BAC157_G08,22,22q13.31,45717004,45840995,123991,-,-
BAC249_I15,22,22q13.31,45738423,45850588,112165,-,-
BAC27_I14,22,22q13.31,45766823,45893350,126527,-,-
BAC12_E12,22,22q13.31,45769676,45864686,95010,-,-
BAC150_O22,22,22q13.31,45870724,45982698,111974,-,-
BAC84_E16,22,22q13.31,45880503,45984105,103602,-,-
BAC154_M08,22,22q13.31,45885949,45982721,96772,-,-
BAC178_G04,22,22q13.31,45984100,46082973,98873,-,-
BAC180_F17,22,22q13.31,45984663,46090481,105818,-,-
BAC228_P09,22,22q13.31,46027069,46145641,118572,-,-
BAC162_I05,22,22q13.31,46032633,46122556,89923,-,-
BAC95_E24,22,22q13.31,46032675,46137716,105041,-,-
BAC232_L10,22,22q13.31,46033954,46131114,97160,-,-
BAC58_G14,22,22q13.31,46090475,46192147,101672,-,-
BAC82_H16,22,22q13.31,46093021,46211601,118580,-,-
BAC128_L01,22,22q13.31,46184454,46292593,108139,-,-
BAC51_G12,22,22q13.31,46203456,46346801,143345,-,-
BAC75_P09,22,22q13.31,46276668,46382241,105573,-,-
BAC200_L22,22,22q13.31,46280725,46378228,97503,-,-
BAC73_C03,22,22q13.31,46316360,46402151,85791,-,-
BAC142_L10,22,22q13.31,46319825,46340529,20704,-,-
BAC67_E16,22,22q13.31,46459697,46554399,94702,-,-
BAC140_K19,22,22q13.31,46495107,46606799,111692,-,-
BAC190_B16,22,22q13.31,46512246,46615332,103086,-,-
BAC123_F18,22,22q13.31,46556690,46647495,90805,-,-
BAC168_O03,22,22q13.31,46558922,46637969,79047,-,-
BAC49_G07,22,22q13.31,46606849,46721074,114225,-,-
BAC142_A16,22,22q13.31,46612782,46680211,67429,-,-
BAC130_J18,22,22q13.31,46654882,46728298,73416,-,-
BAC221_D15,22,22q13.31,46686130,46773265,87135,-,-
BAC234_L13,22,22q13.31,46692411,46798714,106303,-,-
BAC250_H15,22,22q13.31,46692412,46763638,71226,-,-
BAC169_G20,22,22q13.31,46709949,46802558,92609,-,-
BAC219_D13,22,22q13.31,46733679,46858955,125276,-,-
BAC127_D11,22,22q13.31,46733679,46841420,107741,-,-
BAC6_F02,22,22q13.31,46773588,46869704,96116,-,-
BAC103_N13,22,22q13.31,46809007,46923169,114162,-,-
BAC145_B03,22,22q13.31,46809009,46967309,158300,-,-
BAC29_J03,22,22q13.31,46809197,46954815,145618,-,-
BAC181_I23,22,22q13.31,46841414,46944500,103086,-,-
BAC21_A12,22,22q13.31,46851696,46962817,111121,-,-
BAC159_M08,22,22q13.31,46855573,46967309,111736,-,-
BAC173_O21,22,22q13.31,46867239,46967309,100070,-,-
BAC149_O17,22,22q13.31,46868746,46954815,86069,-,-
BAC78_L16,22,22q13.31,46868746,46954815,86069,-,-
BAC146_B09,22,22q13.31-22q13.32,46873480,47012847,139367,-,-
BAC127_L12,22,22q13.31,46873504,46962817,89313,-,-
BAC237_I14,22,22q13.31-22q13.32,46908646,47004057,95411,-,-
BAC95_F22,22,22q13.31-22q13.32,46929011,47012857,83846,-,-
BAC193_I23,22,22q13.31-22q13.32,46954809,47065739,110930,-,-
BAC169_E16,22,22q13.32,47056090,47173299,117209,-,-
BAC169_E08,22,22q13.32,47064650,47193150,128500,-,-
BAC133_B12,22,22q13.32,47065736,47122251,56515,-,-
BAC168_E19,22,22q13.32,47083331,47242242,158911,-,-
BAC140_P01,22,22q13.32,47083332,47187128,103796,-,-
BAC111_D18,22,22q13.32,47104437,47248209,143772,-,-
BAC144_C18,22,22q13.32,47111789,47218885,107096,-,-
BAC66_D19,22,22q13.32,47122543,47226536,103993,-,-
BAC209_E20,22,22q13.32,47187995,47266423,78428,-,-
BAC53_L13,22,22q13.32,47378415,47508072,129657,-,-
BAC246_L14,22,22q13.32,47388040,47493337,105297,-,-
BAC15_D04,22,22q13.32,47388040,47491239,103199,-,-
BAC217_K20,22,22q13.32,47388043,47491343,103300,-,-
BAC137_K09,22,22q13.32,47429540,47520971,91431,-,-
BAC96_E19,22,22q13.32,47453441,47562648,109207,-,-
BAC116_M03,22,22q13.32,47481531,47648351,166820,-,-
BAC132_D02,22,22q13.32,47508582,47648375,139793,-,-
BAC234_P19,22,22q13.32,47856560,47951714,95154,-,-
BAC205_P02,22,22q13.32,47886824,47970543,83719,-,-
BAC78_L13,22,22q13.32,47935656,48025961,90305,-,-
BAC115_E14,22,22q13.32,47961113,48078220,117107,-,-
BAC86_D05,22,22q13.32,47967579,48073933,106354,-,-
BAC170_I02,22,22q13.32,47980338,48078221,97883,-,-
BAC10_L20,22,22q13.32,48043927,48169945,126018,-,-
BAC184_I01,22,22q13.32,48052404,48132424,80020,-,-
BAC33_J04,22,22q13.32-22q13.33,48106136,48236585,130449,-,-
BAC55_K08,22,22q13.32-22q13.33,48121591,48236657,115066,-,-
BAC14_C13,22,22q13.32-22q13.33,48181791,48283971,102180,-,-
BAC143_D01,22,22q13.33,48215790,48314073,98283,-,-
BAC48_N07,22,22q13.33,48343910,48425913,82003,-,-
BAC211_F22,22,22q13.33,48377953,48449027,71074,-,-
BAC61_F14,22,22q13.33,48456348,48537315,80967,-,-
BAC91_D16,22,22q13.33,48461160,48529195,68035,-,-
BAC19_F01,22,22q13.33,48461327,48533525,72198,-,-
BAC192_P14,22,22q13.33,48481517,48577194,95677,-,-
BAC58_C20,22,22q13.33,48834037,48941343,107306,-,-
BAC241_N05,22,22q13.33,48863221,48945838,82617,-,-
BAC157_H05,22,22q13.33,48863221,48971923,108702,-,-
BAC41_L09,22,22q13.33,48930979,49068871,137892,-,-
BAC193_O07,22,22q13.33,49138541,49267937,129396,-,-
BAC133_C11,22,22q13.33,49276386,49383098,106712,-,-
BAC243_I02,22,22q13.33,49279081,49352038,72957,-,-
BAC248_E20,22,22q13.33,49281267,49383298,102031,-,-
BAC195_D03,X,Xp22.33,2780616,2875225,94609,-,-
BAC32_O13,X,Xp22.33,2782286,2887232,104946,-,-
BAC55_C05,X,Xp22.33,2800333,2964576,164243,-,-
BAC241_A22,X,Xp22.33,2800358,2887232,86874,-,-
BAC49_L20,X,Xp22.33,2841150,2974349,133199,-,-
BAC190_G01,X,Xp22.33,2841296,2948796,107500,-,-
BAC81_A06,X,Xp22.33,2875390,2989248,113858,-,-
BAC39_C24,X,Xp22.33,2875392,2974777,99385,-,-
BAC74_C20,X,Xp22.33,2887296,2975077,87781,-,-
BAC170_E06,X,Xp22.33,2888940,2981369,92429,-,-
BAC193_M14,X,Xp22.33,2974776,3089405,114629,-,-
BAC60_C08,X,Xp22.33,3049699,3173956,124257,-,-
BAC56_K05,X,Xp22.33,3106862,3282124,175262,-,-
BAC41_B12,X,Xp22.33,3137092,3230034,92942,-,-
BAC119_C10,X,Xp22.33,3258868,3351213,92345,-,-
BAC241_K03,X,Xp22.33,3261656,3331930,70274,-,-
BAC64_I16,X,Xp22.33,3263240,3345053,81813,-,-
BAC128_B03,X,Xp22.33,3330759,3452239,121480,-,-
BAC68_P05,X,Xp22.33,3512840,3606188,93348,-,-
BAC238_H15,X,Xp22.33,3722371,3897205,174834,-,-
BAC161_I18,X,Xp22.33,3738294,3868856,130562,-,-
BAC120_J16,X,Xp22.33,3900765,4029712,128947,-,-
BAC172_C15,X,Xp22.33,4021511,4106847,85336,-,-
BAC38_L03,X,Xp22.32,4410404,4545632,135228,-,-
BAC14_K21,X,Xp22.32,4613033,4707713,94680,-,-
BAC180_B03,X,Xp22.32,4733420,4820768,87348,-,-
BAC227_M04,X,Xp22.32,4733738,4820898,87160,-,-
BAC226_K11,X,Xp22.32,4831902,4932892,100990,-,-
BAC49_H21,X,Xp22.32,4979182,5123310,144128,-,-
BAC165_G03,X,Xp22.32,5031617,5132330,100713,-,-
BAC247_D06,X,Xp22.32,5626385,5716907,90522,-,-
BAC28_F18,X,Xp22.32-Xp22.31,5797333,6021477,224144,-,-
BAC238_B21,X,Xp22.31,6020440,6091477,71037,-,-
BAC37_K21,X,Xp22.31,6091475,6190309,98834,-,-
BAC22_G23,X,Xp22.31,6178827,6189548,10721,-,-
BAC68_H07,X,Xp22.31,6219795,6294164,74369,-,-
BAC51_I21,X,Xp22.31,6234374,6349274,114900,-,-
BAC118_P16,X,Xp22.31,6378318,6482229,103911,-,-
BAC135_P07,X,Xp22.31,6395189,6474988,79799,-,-
BAC67_P20,X,Xp22.31,6451293,6581929,130636,-,-
BAC82_G05,X,Xp22.31,6486626,6574838,88212,-,-
BAC243_C15,X,Xp22.31,6604244,6676553,72309,-,-
BAC179_I05,X,Xp22.31,6605347,6698029,92682,-,-
BAC136_D21,X,Xp22.31,6687436,6789111,101675,-,-
BAC82_D06,X,Xp22.31,6805755,6916562,110807,-,-
BAC73_H04,X,Xp22.31,6844726,6979564,134838,-,-
BAC191_E24,X,Xp22.31,7397582,7504424,106842,-,-
BAC231_F19,X,Xp22.31,7547752,7636445,88693,-,-
BAC56_K23,X,Xp22.31,7571456,7668885,97429,-,-
BAC139_A12,X,Xp22.31,7592613,7662957,70344,-,-
BAC31_E12,X,Xp22.31,7605325,7733693,128368,-,-
BAC132_F18,X,Xp22.31,7687912,7777847,89935,-,-
BAC95_L09,X,Xp22.31,7749689,7824926,75237,-,-
BAC223_N19,X,Xp22.31,7778139,7857699,79560,-,-
BAC26_J10,X,Xp22.31,7859798,7961653,101855,-,-
BAC23_N17,X,Xp22.31,7920039,8048727,128688,-,-
BAC71_K05,X,Xp22.31,7942743,8029204,86461,-,-
BAC145_B16,X,Xp22.31,8073551,8163256,89705,-,-
BAC177_O15,X,Xp22.31,8235063,8352971,117908,-,-
BAC88_A24,X,Xp22.31,8448799,8538047,89248,-,-
BAC185_C21,X,Xp22.31,8548748,8657238,108490,-,-
BAC178_N11,X,Xp22.31,8567863,8657238,89375,-,-
BAC170_I18,X,Xp22.31,8578018,8657238,79220,-,-
BAC175_B18,X,Xp22.31,8641672,8736704,95032,-,-
BAC135_L05,X,Xp22.31,8652930,8732334,79404,-,-
BAC152_G19,X,Xp22.31,8738922,8820138,81216,-,-
BAC201_I22,X,Xp22.31,8935170,9022194,87024,-,-
BAC180_P24,X,Xp22.31,9099816,9232160,132344,-,-
BAC188_L01,X,Xp22.31,9140320,9216661,76341,-,-
BAC19_D21,X,Xp22.31,9140348,9234111,93763,-,-
BAC218_C01,X,Xp22.31,9172604,9301622,129018,-,-
BAC116_N04,X,Xp22.31,9199751,9307453,107702,-,-
BAC107_H03,X,Xp22.31,9203949,9294940,90991,-,-
BAC151_O07,X,Xp22.31,9268090,9334642,66552,-,-
BAC240_F19,X,Xp22.31,9338360,9410415,72055,-,-
BAC202_E15,X,Xp22.31-Xp22.2,9415875,9538281,122406,-,-
BAC144_B19,X,Xp22.31-Xp22.2,9490621,9590801,100180,-,-
BAC252_L05,X,Xp22.2,9521834,9651038,129204,-,-
BAC246_H21,X,Xp22.2,9622375,9744322,121947,-,-
BAC224_E17,X,Xp22.2,9801473,9876797,75324,-,-
BAC161_B15,X,Xp22.2,9812171,9911237,99066,-,-
BAC59_B04,X,Xp22.2,9932157,10077430,145273,-,-
BAC218_E21,X,Xp22.2,10020957,10141420,120463,-,-
BAC143_P20,X,Xp22.2,10206273,10300807,94534,-,-
BAC211_K08,X,Xp22.2,10321751,10401154,79403,-,-
BAC71_B03,X,Xp22.2,10321755,10420672,98917,-,-
BAC165_B04,X,Xp22.2,10431838,10532595,100757,-,-
BAC119_K17,X,Xp22.2,10465908,10554799,88891,-,-
BAC146_C07,X,Xp22.2,10561056,10650233,89177,-,-
BAC181_H09,X,Xp22.2,10650228,10748199,97971,-,-
BAC42_E24,X,Xp22.2,10729247,10814240,84993,-,-
BAC144_A06,X,Xp22.2,10761740,10859319,97579,-,-
BAC121_N22,X,Xp22.2,11130577,11213899,83322,-,-
BAC127_K15,X,Xp22.2,11131550,11223648,92098,-,-
BAC166_K19,X,Xp22.2,11212243,11296743,84500,-,-
BAC247_L21,X,Xp22.2,11398656,11467895,69239,-,-
BAC221_I06,X,Xp22.2,11455287,11542963,87676,-,-
BAC31_E17,X,Xp22.2,11456924,11567730,110806,-,-
BAC228_K14,X,Xp22.2,11465756,11552410,86654,-,-
BAC208_L17,X,Xp22.2,11473781,11562117,88336,-,-
BAC100_I13,X,Xp22.2,11477696,11561403,83707,-,-
BAC151_D12,X,Xp22.2,11539559,11624254,84695,-,-
BAC182_M19,X,Xp22.2,11603278,11680407,77129,-,-
BAC51_J21,X,Xp22.2,11854586,11991407,136821,-,-
BAC128_C09,X,Xp22.2,12047249,12139867,92618,-,-
BAC31_M18,X,Xp22.2,12165736,12254264,88528,-,-
BAC70_N16,X,Xp22.2,12242131,12358309,116178,-,-
BAC81_D07,X,Xp22.2,12433910,12534700,100790,-,-
BAC156_K03,X,Xp22.2,12537503,12613593,76090,-,-
BAC192_A06,X,Xp22.2,12568795,12648017,79222,-,-
BAC194_L05,X,Xp22.2,12625258,12727034,101776,-,-
BAC62_B18,X,Xp22.2,12688144,12788691,100547,-,-
BAC172_A08,X,Xp22.2,12727026,12809268,82242,-,-
BAC162_J15,X,Xp22.2,12810691,12926795,116104,-,-
BAC165_H08,X,Xp22.2,12825382,12916148,90766,-,-
BAC72_G18,X,Xp22.2,12867807,12950045,82238,-,-
BAC159_C01,X,Xp22.2,12897487,13005701,108214,-,-
BAC40_D04,X,Xp22.2,12935160,13073689,138529,-,-
BAC4_O10,X,Xp22.2,12943699,13043472,99773,-,-
BAC172_E18,X,Xp22.2,13323680,13423449,99769,-,-
BAC41_A18,X,Xp22.2,13325047,13338150,13103,-,-
BAC161_F20,X,Xp22.2,13463120,13568622,105502,-,-
BAC90_I24,X,Xp22.2,13551690,13648150,96460,-,-
BAC154_F03,X,Xp22.2,13558214,13636774,78560,-,-
BAC19_P08,X,Xp22.2,13558258,13656434,98176,-,-
BAC236_M15,X,Xp22.2,14434119,14519125,85006,-,-
BAC95_L23,X,Xp22.2,14448738,14532586,83848,-,-
BAC243_C06,X,Xp22.2,14479985,14580762,100777,-,-
BAC52_A07,X,Xp22.2,14491072,14578067,86995,-,-
BAC134_K13,X,Xp22.2,14537559,14605907,68348,-,-
BAC33_D22,X,Xp22.2,14763104,14848131,85027,-,-
BAC107_A08,X,Xp22.2,15388920,15536134,147214,-,-
BAC39_M09,X,Xp22.2,15430095,15524913,94818,-,-
BAC72_D07,X,Xp22.2,15554475,15650339,95864,-,-
BAC122_M06,X,Xp22.2,15589598,15676315,86717,-,-
BAC247_B15,X,Xp22.2,15650527,15749136,98609,-,-
BAC244_J12,X,Xp22.2,15660569,15733973,73404,-,-
BAC149_B22,X,Xp22.2,15767807,15852461,84654,-,-
BAC184_H01,X,Xp22.2,15790147,15854969,64822,-,-
BAC184_J09,X,Xp22.2,16289998,16366616,76618,-,-
BAC80_G13,X,Xp22.2,16364681,16504483,139802,-,-
BAC5_P10,X,Xp22.2,16402861,16556928,154067,-,-
BAC151_J14,X,Xp22.2,16542262,16650035,107773,-,-
BAC31_O22,X,Xp22.2,16556927,16650037,93110,-,-
BAC5_P21,X,Xp22.2,16568986,16650908,81922,-,-
BAC65_H06,X,Xp22.2,16573760,16659173,85413,-,-
BAC136_A02,X,Xp22.2,16598432,16683326,84894,-,-
BAC233_I18,X,Xp22.2,16605327,16693149,87822,-,-
BAC69_J13,X,Xp22.2,16757217,16886818,129601,-,-
BAC230_P12,X,Xp22.2,16894589,17002591,108002,-,-
BAC155_G06,X,Xp22.2,17002699,17086548,83849,-,-
BAC132_K05,X,Xp22.13,17156536,17268598,112062,-,-
BAC16_O19,X,Xp22.13,17341581,17421745,80164,-,-
BAC8_O05,X,Xp22.13,17426925,17519925,93000,-,-
BAC29_N21,X,Xp22.13,17470117,17566248,96131,-,-
BAC150_L05,X,Xp22.13,17515213,17591706,76493,-,-
BAC135_K18,X,Xp22.13,17570011,17652061,82050,-,-
BAC15_C04,X,Xp22.13,17764939,17851569,86630,-,-
BAC125_A04,X,Xp22.13,17799943,17905044,105101,-,-
BAC107_O07,X,Xp22.13,17888369,17973776,85407,-,-
BAC61_I20,X,Xp22.13,17959685,18068562,108877,-,-
BAC192_C13,X,Xp22.13,18023761,18156446,132685,-,-
BAC8_K16,X,Xp22.13,18055232,18183734,128502,-,-
BAC16_E18,X,Xp22.13,18071972,18167265,95293,-,-
BAC180_G08,X,Xp22.13,18144389,18246366,101977,-,-
BAC108_L23,X,Xp22.13,18181669,18275228,93559,-,-
BAC110_B17,X,Xp22.13,18243318,18332469,89151,-,-
BAC76_H10,X,Xp22.13,18243949,18390108,146159,-,-
BAC235_D08,X,Xp22.13,18443636,18461784,18148,-,-
BAC66_N19,X,Xp22.13,18534400,18702970,168570,-,-
BAC43_L14,X,Xp22.13,18562907,18658361,95454,-,-
BAC10_G11,X,Xp22.13,18618154,18760965,142811,-,-
BAC2_G08,X,Xp22.13,18633858,18854495,220637,-,-
BAC129_K21,X,Xp22.13,18655005,18743223,88218,-,-
BAC228_J15,X,Xp22.13,18704643,18791370,86727,-,-
BAC51_F02,X,Xp22.13,18761035,18853103,92068,-,-
BAC187_A01,X,Xp22.13,18841828,18934060,92232,-,-
BAC193_H19,X,Xp22.13,18851886,18932340,80454,-,-
BAC81_L10,X,Xp22.13,18899778,19028684,128906,-,-
BAC55_F17,X,Xp22.13,18900769,18992793,92024,-,-
BAC160_H15,X,Xp22.13,18965902,19064911,99009,-,-
BAC230_I10,X,Xp22.13,18966939,19068141,101202,-,-
BAC222_K18,X,Xp22.13-Xp22.12,19143751,19264845,121094,-,-
BAC95_K21,X,Xp22.12,19222244,19352089,129845,-,-
BAC188_P08,X,Xp22.12,19438374,19516569,78195,-,-
BAC64_L03,X,Xp22.12,19464092,19560598,96506,-,-
BAC22_H14,X,Xp22.12,19530397,19656785,126388,-,-
BAC232_J09,X,Xp22.12,19616118,19752605,136487,-,-
BAC12_B11,X,Xp22.12,19752464,19900351,147887,-,-
BAC232_L12,X,Xp22.12,19822136,19933497,111361,-,-
BAC197_D24,X,Xp22.12,19864016,19990104,126088,-,-
BAC166_N10,X,Xp22.12,20008082,20126620,118538,-,-
BAC64_M06,X,Xp22.12,20008091,20094210,86119,-,-
BAC133_J02,X,Xp22.12,20022274,20155138,132864,-,-
BAC95_P19,X,Xp22.12,20042825,20162222,119397,-,-
BAC188_D10,X,Xp22.12,20113997,20214467,100470,-,-
BAC117_G17,X,Xp22.12,20230639,20314223,83584,-,-
BAC22_I20,X,Xp22.12,20581044,20708889,127845,-,-
BAC28_P03,X,Xp22.12,20863277,20973591,110314,-,-
BAC49_F13,X,Xp22.12,21629258,21747880,118622,-,-
BAC65_F08,X,Xp22.12-Xp22.11,21715826,21822007,106181,-,-
BAC42_L18,X,Xp22.11,21809306,21913396,104090,-,-
BAC60_G20,X,Xp22.11,21811566,21902754,91188,-,-
BAC196_O14,X,Xp22.11,21989073,22073275,84202,-,-
BAC70_H17,X,Xp22.11,22166607,22250416,83809,-,-
BAC52_O03,X,Xp22.11,22242609,22331598,88989,-,-
BAC161_C21,X,Xp22.11,22529648,22646917,117269,-,-
BAC163_N17,X,Xp22.11,22759383,22834760,75377,-,-
BAC204_O15,X,Xp22.11,22879787,22979157,99370,-,-
BAC120_N07,X,Xp22.11,23116844,23197714,80870,-,-
BAC168_J02,X,Xp22.11,23537235,23610863,73628,-,-
BAC151_N13,X,Xp22.11,23655726,23748484,92758,-,-
BAC134_H16,X,Xp22.11,23767502,23856897,89395,-,-
BAC90_C08,X,Xp22.11,23939398,24060318,120920,-,-
BAC96_B05,X,Xp22.11,24019429,24111127,91698,-,-
BAC37_H06,X,Xp22.11,24053553,24172772,119219,-,-
BAC76_H14,X,Xp22.11,24281310,24410150,128840,-,-
BAC89_J08,X,Xp22.11,24432832,24520666,87834,-,-
BAC62_H18,X,Xp22.11,24595832,24666515,70683,-,-
BAC46_K11,X,Xp22.11-Xp21.3,24879440,24975969,96529,-,-
BAC179_O16,X,Xp21.3,24920294,25029549,109255,-,-
BAC73_A06,X,Xp21.3,24975986,25069848,93862,-,-
BAC195_M08,X,Xp21.3,24979419,25061471,82052,-,-
BAC235_C01,X,Xp21.3,24995435,25126702,131267,-,-
BAC144_F15,X,Xp21.3,25507285,25603276,95991,-,-
BAC89_K13,X,Xp21.3,26318399,26386604,68205,-,-
BAC49_K02,X,Xp21.3,26332769,26453285,120516,-,-
BAC43_D05,X,Xp21.3,26966218,27087167,120949,-,-
BAC34_D19,X,Xp21.3,27505706,27690380,184674,-,-
BAC68_L01,X,Xp21.3,27684416,27774049,89633,-,-
BAC108_B14,X,Xp21.3,27716617,27837510,120893,-,-
BAC117_G09,X,Xp21.3,27935003,28047246,112243,-,-
BAC39_F22,X,Xp21.3,28079020,28181557,102537,-,-
BAC42_E13,X,Xp21.3,28766407,28942072,175665,-,-
BAC44_G06,X,Xp21.3,28817823,28928265,110442,-,-
BAC222_A01,X,Xp21.3,29114126,29210612,96486,-,-
BAC240_H08,X,Xp21.2,29490504,29574445,83941,-,-
BAC169_L23,X,Xp21.2,29490529,29582561,92032,-,-
BAC235_M06,X,Xp21.2,29507157,29599081,91924,-,-
BAC65_L14,X,Xp21.2,29622036,29749045,127009,-,-
BAC75_M16,X,Xp21.2,29629570,29718802,89232,-,-
BAC117_O24,X,Xp21.2,29920893,30058925,138032,-,-
BAC45_M10,X,Xp21.2,29920909,30021627,100718,-,-
BAC40_J23,X,Xp21.2,30142742,30252607,109865,-,-
BAC223_C04,X,Xp21.2,30166076,30255751,89675,-,-
BAC199_H10,X,Xp21.2,30372977,30461317,88340,-,-
BAC178_D19,X,Xp21.2,30398382,30486450,88068,-,-
BAC125_B24,X,Xp21.2,30521262,30608200,86938,-,-
BAC78_J02,X,Xp21.2,30522787,30643513,120726,-,-
BAC52_B11,X,Xp21.2,30634577,30754439,119862,-,-
BAC176_D24,X,Xp21.2,31127875,31230051,102176,-,-
BAC233_H23,X,Xp21.2,31377885,31489223,111338,-,-
BAC175_F03,X,Xp21.2,31399045,31489223,90178,-,-
BAC96_P06,X,Xp21.2-Xp21.1,31489396,31602012,112616,-,-
BAC100_K21,X,Xp21.1,31507945,31616801,108856,-,-
BAC57_K03,X,Xp21.1,31606579,31765366,158787,-,-
BAC129_I01,X,Xp21.1,31642173,31709030,66857,-,-
BAC63_K16,X,Xp21.1,31736630,31823359,86729,-,-
BAC142_C02,X,Xp21.1,31947660,32033402,85742,-,-
BAC142_H05,X,Xp21.1,32357927,32461644,103717,-,-
BAC118_L05,X,Xp21.1,32501033,32609841,108808,-,-
BAC123_E23,X,Xp21.1,32656276,32758216,101940,-,-
BAC63_O15,X,Xp21.1,32777044,32864051,87007,-,-
BAC30_N06,X,Xp21.1,32946584,33054790,108206,-,-
BAC133_B08,X,Xp21.1,32949814,33034896,85082,-,-
BAC92_C13,X,Xp21.1,32949814,33063190,113376,-,-
BAC147_B03,X,Xp21.1,33003700,33085041,81341,-,-
BAC211_G24,X,Xp21.1,33162946,33254979,92033,-,-
BAC63_K13,X,Xp21.1,33449165,33524922,75757,-,-
BAC64_C22,X,Xp21.1,33843838,33957993,114155,-,-
BAC149_N03,X,Xp21.1,34098757,34196469,97712,-,-
BAC85_C17,X,Xp21.1,34322748,34342403,19655,-,-
BAC118_L20,X,Xp21.1,34350582,34440878,90296,-,-
BAC36_A23,X,Xp21.1,34422877,34557557,134680,-,-
BAC105_E05,X,Xp21.1,34453504,34557354,103850,-,-
BAC132_I02,X,Xp21.1,34566546,34620268,53722,-,-
BAC252_A22,X,Xp21.1,34620357,34781393,161036,-,-
BAC191_M03,X,Xp21.1,34734511,34829489,94978,-,-
BAC31_H16,X,Xp21.1,34914044,35019156,105112,-,-
BAC153_K10,X,Xp21.1,35115251,35201442,86191,-,-
BAC228_E02,X,Xp21.1,35202335,35235086,32751,-,-
BAC73_P02,X,Xp21.1,35341675,35434392,92717,-,-
BAC188_P14,X,Xp21.1,35357749,35481569,123820,-,-
BAC61_F24,X,Xp21.1,35733076,35846995,113919,-,-
BAC186_H21,X,Xp21.1,35790599,35876257,85658,-,-
BAC50_G17,X,Xp21.1,36028284,36110584,82300,-,-
BAC239_G10,X,Xp21.1,36277977,36348031,70054,-,-
BAC79_H13,X,Xp21.1,36296767,36443604,146837,-,-
BAC172_A03,X,Xp21.1,36465114,36574794,109680,-,-
BAC237_J12,X,Xp21.1,36538118,36624513,86395,-,-
BAC117_P09,X,Xp21.1,36566813,36665661,98848,-,-
BAC185_A05,X,Xp21.1,36926759,37005064,78305,-,-
BAC41_B01,X,Xp21.1,37044622,37152784,108162,-,-
BAC36_P10,X,Xp21.1,37117412,37212597,95185,-,-
BAC240_P11,X,Xp21.1,37135003,37238243,103240,-,-
BAC46_E19,X,Xp21.1,37264309,37345078,80769,-,-
BAC148_M08,X,Xp21.1,37407588,37490254,82666,-,-
BAC46_M08,X,Xp21.1-Xp11.4,37427390,37514680,87290,-,-
BAC116_A02,X,Xp11.4,37683836,37775518,91682,-,-
BAC239_J15,X,Xp11.4,37978250,38093503,115253,-,-
BAC148_D03,X,Xp11.4,38028737,38108988,80251,-,-
BAC55_D17,X,Xp11.4,38038909,38170493,131584,-,-
BAC117_O07,X,Xp11.4,38093549,38170493,76944,-,-
BAC114_B08,X,Xp11.4,38097672,38228093,130421,-,-
BAC131_J03,X,Xp11.4,38131950,38209453,77503,-,-
BAC112_K02,X,Xp11.4,38131963,38228104,96141,-,-
BAC179_M21,X,Xp11.4,38195666,38279528,83862,-,-
BAC14_M21,X,Xp11.4,38451466,38612940,161474,-,-
BAC193_M08,X,Xp11.4,38501713,38612940,111227,-,-
BAC90_D11,X,Xp11.4,38541729,38649297,107568,-,-
BAC50_D11,X,Xp11.4,38561549,38649297,87748,-,-
BAC65_L20,X,Xp11.4,38620429,38761922,141493,-,-
BAC42_N14,X,Xp11.4,38643892,38737164,93272,-,-
BAC228_E18,X,Xp11.4,38813728,38929254,115526,-,-
BAC97_P02,X,Xp11.4,38831961,38919563,87602,-,-
BAC108_D06,X,Xp11.4,39106649,39216248,109599,-,-
BAC18_D02,X,Xp11.4,39136964,39342914,205950,-,-
BAC204_P09,X,Xp11.4,39165353,39252592,87239,-,-
BAC143_A17,X,Xp11.4,39206926,39288148,81222,-,-
BAC240_H17,X,Xp11.4,39237642,39368428,130786,-,-
BAC200_G02,X,Xp11.4,39313550,39400400,86850,-,-
BAC196_K01,X,Xp11.4,39401689,39524330,122641,-,-
BAC238_I12,X,Xp11.4,39411014,39543189,132175,-,-
BAC135_N20,X,Xp11.4,39484634,39603018,118384,-,-
BAC239_M22,X,Xp11.4,39540474,39655925,115451,-,-
BAC155_P21,X,Xp11.4,39543293,39655925,112632,-,-
BAC86_K08,X,Xp11.4,39560765,39715540,154775,-,-
BAC42_J18,X,Xp11.4,39598552,39691377,92825,-,-
BAC125_M12,X,Xp11.4,39685902,39814461,128559,-,-
BAC193_N01,X,Xp11.4,39735045,39857375,122330,-,-
BAC151_A03,X,Xp11.4,39814492,39933265,118773,-,-
BAC222_E23,X,Xp11.4,39934770,40017770,83000,-,-
BAC200_I05,X,Xp11.4,39991955,40093113,101158,-,-
BAC195_F20,X,Xp11.4,40015339,40105838,90499,-,-
BAC240_P21,X,Xp11.4,40020464,40150998,130534,-,-
BAC244_P04,X,Xp11.4,40073054,40164148,91094,-,-
BAC18_G08,X,Xp11.4,40105930,40199721,93791,-,-
BAC28_F09,X,Xp11.4,40178046,40256438,78392,-,-
BAC50_H23,X,Xp11.4,40181685,40347937,166252,-,-
BAC199_D12,X,Xp11.4,40209623,40321147,111524,-,-
BAC248_K08,X,Xp11.4,40333671,40452267,118596,-,-
BAC247_C21,X,Xp11.4,40406600,40493396,86796,-,-
BAC179_M23,X,Xp11.4,40408809,40496257,87448,-,-
BAC72_K12,X,Xp11.4,40458893,40564538,105645,-,-
BAC71_I10,X,Xp11.4,40483092,40602444,119352,-,-
BAC200_P15,X,Xp11.4,40489766,40602448,112682,-,-
BAC225_A15,X,Xp11.4,40547655,40630487,82832,-,-
BAC12_G17,X,Xp11.4,40630481,40741182,110701,-,-
BAC156_N06,X,Xp11.4,40681145,40771618,90473,-,-
BAC192_H07,X,Xp11.4,40771217,40855682,84465,-,-
BAC150_M14,X,Xp11.4,40773689,40847958,74269,-,-
BAC239_D08,X,Xp11.4,40779945,40855627,75682,-,-
BAC248_J03,X,Xp11.4,41045838,41134137,88299,-,-
BAC168_F19,X,Xp11.4,41120496,41202653,82157,-,-
BAC84_K09,X,Xp11.4,41134135,41216339,82204,-,-
BAC180_P12,X,Xp11.4,41277518,41388345,110827,-,-
BAC88_G21,X,Xp11.4,41351488,41454706,103218,-,-
BAC139_J06,X,Xp11.4,41370437,41451869,81432,-,-
BAC107_I16,X,Xp11.4,41396951,41495446,98495,-,-
BAC26_B20,X,Xp11.4,41749825,41890514,140689,-,-
BAC204_K17,X,Xp11.4,41809153,41905233,96080,-,-
BAC50_E18,X,Xp11.3,42548583,42645782,97199,-,-
BAC249_P16,X,Xp11.3,42560310,42641938,81628,-,-
BAC169_F22,X,Xp11.3,42936503,43028640,92137,-,-
BAC24_I03,X,Xp11.3,43034258,43158770,124512,-,-
BAC220_J16,X,Xp11.3,43145099,43221137,76038,-,-
BAC8_A05,X,Xp11.3,43465893,43546854,80961,-,-
BAC7_O11,X,Xp11.3,43651572,43750523,98951,-,-
BAC161_C17,X,Xp11.3,43658745,43747197,88452,-,-
BAC237_G22,X,Xp11.3,43707793,43856021,148228,-,-
BAC147_D21,X,Xp11.3,43835608,43943505,107897,-,-
BAC67_C18,X,Xp11.3,43928042,44017951,89909,-,-
BAC37_B15,X,Xp11.3,44009364,44130994,121630,-,-
BAC125_B05,X,Xp11.3,44121855,44197815,75960,-,-
BAC99_K04,X,Xp11.3,44257252,44351005,93753,-,-
BAC129_G15,X,Xp11.3,44268226,44359805,91579,-,-
BAC223_I02,X,Xp11.3,45089842,45214297,124455,-,-
BAC89_H03,X,Xp11.3,45116374,45195799,79425,-,-
BAC172_N19,X,Xp11.3,45254775,45340032,85257,-,-
BAC249_H08,X,Xp11.3,45377813,45465069,87256,-,-
BAC103_H06,X,Xp11.3,45525066,45605142,80076,-,-
BAC108_K08,X,Xp11.3,45596499,45719505,123006,-,-
BAC29_N09,X,Xp11.3,46156825,46272273,115448,-,-
BAC68_L23,X,Xp11.3,46200009,46300823,100814,-,-
BAC156_F04,X,Xp11.3,46229547,46312347,82800,-,-
BAC40_B16,X,Xp11.3,46231565,46403396,171831,-,-
BAC127_O21,X,Xp11.3,46262762,46349899,87137,-,-
BAC185_D18,X,Xp11.3,46277350,46373374,96024,-,-
BAC188_L03,X,Xp11.3,46347927,46424144,76217,-,-
BAC34_E22,X,Xp11.3,46497767,46614403,116636,-,-
BAC101_I02,X,Xp11.3,46647939,46737692,89753,-,-
BAC249_B24,X,Xp11.3,46854075,46935615,81540,-,-
BAC187_J09,X,Xp11.3,46951846,47072305,120459,-,-
BAC178_B20,X,Xp11.3-Xp11.23,47241736,47356870,115134,-,-
BAC156_E22,X,Xp11.3-Xp11.23,47241744,47327616,85872,-,-
BAC50_P12,X,Xp11.3-Xp11.23,47278620,47400194,121574,-,-
BAC162_I08,X,Xp11.3-Xp11.23,47283862,47393291,109429,-,-
BAC176_A16,X,Xp11.23,47318189,47452001,133812,-,-
BAC105_J02,X,Xp11.23,47333132,47458415,125283,-,-
BAC85_K03,X,Xp11.23,47393301,47511399,118098,-,-
BAC120_J14,X,Xp11.23,47604834,47794566,189732,-,-
BAC108_J09,X,Xp11.23,47703164,47835942,132778,-,-
BAC108_D17,X,Xp11.23,47794605,47923344,128739,-,-
BAC82_G10,X,Xp11.23,47861007,47958521,97514,-,-
BAC117_O01,X,Xp11.23,47922295,48048117,125822,-,-
BAC128_N06,X,Xp11.23,47958515,48048118,89603,-,-
BAC34_O20,X,Xp11.23,47958543,48069909,111366,-,-
BAC124_M02,X,Xp11.23,48009705,48114651,104946,-,-
BAC40_H02,X,Xp11.23,48021221,48104831,83610,-,-
BAC179_D15,X,Xp11.23,48042590,48129378,86788,-,-
BAC143_J05,X,Xp11.23,48098681,48180558,81877,-,-
BAC220_O22,X,Xp11.23,48177259,48293177,115918,-,-
BAC86_O20,X,Xp11.23,48202081,48293177,91096,-,-
BAC133_G18,X,Xp11.23,48202205,48293709,91504,-,-
BAC30_G05,X,Xp11.23,48346028,48535501,189473,-,-
BAC49_G05,X,Xp11.23,48447858,48563861,116003,-,-
BAC235_A10,X,Xp11.23,48520113,48628508,108395,-,-
BAC244_K18,X,Xp11.23,48573873,48698295,124422,-,-
BAC182_G07,X,Xp11.23,48594285,48695357,101072,-,-
BAC122_O17,X,Xp11.23,48648358,48822090,173732,-,-
BAC188_K20,X,Xp11.23,48784489,48890695,106206,-,-
BAC63_B09,X,Xp11.23,48822084,48886256,64172,-,-
BAC22_B14,X,Xp11.23,48879511,48982810,103299,-,-
BAC128_N09,X,Xp11.23,49018033,49108113,90080,yes,-
BAC195_O13,X,Xp11.23,49025089,49210177,185088,yes,-
BAC222_B14,X,Xp11.23,49098632,49288419,189787,yes,-
BAC246_P05,X,Xp11.23,49108108,49210158,102050,-,-
BAC162_H23,X,Xp11.23,49108108,49355113,247005,yes,-
BAC232_H05,X,Xp11.23,49355228,49436484,81256,-,-
BAC234_D04,X,Xp11.23,49464196,49577862,113666,-,-
BAC142_I14,X,Xp11.23,49525443,49613390,87947,-,-
BAC250_N06,X,Xp11.22,49713656,49801561,87905,-,-
BAC39_M13,X,Xp11.22,49724434,49831619,107185,-,-
BAC88_O09,X,Xp11.22,50241126,50328508,87382,-,-
BAC60_B13,X,Xp11.22,50313555,50402369,88814,-,-
BAC179_P23,X,Xp11.22,50318631,50390214,71583,-,-
BAC244_F02,X,Xp11.22,50363921,50445542,81621,-,-
BAC149_K01,X,Xp11.22,50699585,50786042,86457,-,-
BAC143_E04,X,Xp11.22,50786982,50869285,82303,-,-
BAC69_I15,X,Xp11.22,51261918,51274287,12369,-,-
BAC140_O01,X,Xp11.22,51301488,51384071,82583,-,-
BAC88_P16,X,Xp11.22,51422730,51514720,91990,-,-
BAC53_E20,X,Xp11.22,51599443,51676774,77331,-,-
BAC230_P05,X,Xp11.22,52055543,52180499,124956,-,-
BAC82_B05,X,Xp11.22,52556090,52641907,85817,-,-
BAC104_I03,X,Xp11.22,52761771,52844014,82243,-,-
BAC44_L18,X,Xp11.22,52894149,53077607,183458,yes,-
BAC80_G20,X,Xp11.22,52901234,53067945,166711,yes,-
BAC239_P05,X,Xp11.22,52925742,53029145,103403,-,-
BAC31_P15,X,Xp11.22,53189236,53308030,118794,-,-
BAC205_O22,X,Xp11.22,53262854,53351712,88858,yes,-
BAC161_M19,X,Xp11.22,53266580,53370602,104022,-,-
BAC110_E16,X,Xp11.22,53338243,53419751,81508,-,-
BAC168_F03,X,Xp11.22,53341962,53434089,92127,-,-
BAC186_H07,X,Xp11.22,53463620,53575436,111816,yes,-
BAC146_I24,X,Xp11.22,53851270,53944460,93190,-,-
BAC162_A06,X,Xp11.22,53851592,53956797,105205,-,-
BAC229_I20,X,Xp11.22,53961941,54075018,113077,-,-
BAC116_H20,X,Xp11.22,53970635,54075165,104530,-,-
BAC21_N02,X,Xp11.22,54072710,54176177,103467,-,-
BAC97_M05,X,Xp11.22,54095733,54222305,126572,-,-
BAC22_M18,X,Xp11.22,54278418,54418067,139649,-,-
BAC51_P13,X,Xp11.22,54282377,54389982,107605,-,-
BAC189_N06,X,Xp11.22,54332756,54418067,85311,-,-
BAC150_O13,X,Xp11.22,54442702,54528233,85531,-,-
BAC71_L06,X,Xp11.22,54455623,54609714,154091,yes,-
BAC97_E12,X,Xp11.22,54500259,54594498,94239,-,-
BAC37_O21,X,Xp11.22,54500259,54594413,94154,-,-
BAC42_N16,X,Xp11.22-Xp11.21,54609763,54702860,93097,-,-
BAC169_A01,X,Xp11.21,54717562,54786714,69152,-,-
BAC240_P13,X,Xp11.21,54747754,54840439,92685,-,-
BAC39_H16,X,Xp11.21,54786887,54921484,134597,yes,-
BAC228_G03,X,Xp11.21,54845907,54930754,84847,yes,-
BAC131_M08,X,Xp11.21,54934644,54969091,34447,-,-
BAC43_I13,X,Xp11.21,55060849,55193009,132160,-,-
BAC247_M15,X,Xp11.21,55068672,55143759,75087,-,-
BAC31_O17,X,Xp11.21,55153779,55245041,91262,-,-
BAC193_L09,X,Xp11.21,55494164,55594282,100118,yes,-
BAC159_K11,X,Xp11.21,55827695,55921142,93447,-,-
BAC60_L12,X,Xp11.21,55891296,55973916,82620,-,-
BAC60_K01,X,Xp11.21,55921135,56071027,149892,-,-
BAC90_G02,X,Xp11.21,56109345,56204311,94966,-,-
BAC115_H07,X,Xp11.1,56793670,56912042,118372,-,-
BAC90_L20,X,Xp11.1,57090877,57212476,121599,-,-
BAC195_A06,X,Xp11.1,57220139,57296368,76229,-,-
BAC46_G16,X,Xp11.1,57248812,57353868,105056,-,-
BAC37_B17,X,Xp11.1,57548678,57655362,106684,-,-
BAC226_M02,X,Xp11.1,57629200,57713557,84357,-,-
BAC189_M07,X,Xp11.1,57710803,57814925,104122,-,-
BAC89_E18,X,Xp11.1,57834557,57959285,124728,-,-
BAC51_B01,X,Xp11.1,58226655,58312215,85560,-,-
BAC130_F22,X,Xq11.1,62460671,62575490,114819,-,-
BAC200_C14,X,Xq11.1,62499056,62585339,86283,-,-
BAC24_I13,X,Xq11.1,62644045,62781236,137191,-,-
BAC130_K20,X,Xq11.1,62871569,62971143,99574,-,-
BAC122_I09,X,Xq11.1,63105441,63196481,91040,-,-
BAC5_P16,X,Xq11.1,63604167,63735437,131270,-,-
BAC116_G24,X,Xq11.1,64120407,64211797,91390,-,-
BAC101_M23,X,Xq11.1,64354418,64437286,82868,-,-
BAC12_C23,X,Xq11.1,64600296,64697257,96961,-,-
BAC168_F17,X,Xq11.1,64867019,64954449,87430,-,-
BAC141_P21,X,Xq12,65124812,65214507,89695,-,-
BAC119_J16,X,Xq12,65959191,66054681,95490,-,-
BAC149_P05,X,Xq12,66186909,66285888,98979,-,-
BAC33_D09,X,Xq12,66455222,66590147,134925,-,-
BAC244_F01,X,Xq12,66565728,66646519,80791,-,-
BAC59_K08,X,Xq12,66820659,66929058,108399,-,-
BAC214_J09,X,Xq12,66902041,67012284,110243,-,-
BAC244_P08,X,Xq12,67083424,67161443,78019,-,-
BAC33_A16,X,Xq12,67110494,67232333,121839,-,-
BAC5_I24,X,Xq12,67404946,67580659,175713,-,-
BAC125_P01,X,Xq13.1,67838579,67927991,89412,-,-
BAC23_O07,X,Xq13.1,67904371,68030629,126258,-,-
BAC34_G14,X,Xq13.1,68030756,68188199,157443,-,-
BAC148_F12,X,Xq13.1,68160681,68251084,90403,-,-
BAC155_N17,X,Xq13.1,68173246,68259881,86635,-,-
BAC79_C11,X,Xq13.1,68211186,68293595,82409,-,-
BAC178_B15,X,Xq13.1,68251549,68333834,82285,-,-
BAC75_E18,X,Xq13.1,68293604,68385414,91810,-,-
BAC81_I22,X,Xq13.1,68317503,68425433,107930,-,-
BAC137_G16,X,Xq13.1,68333878,68437869,103991,-,-
BAC228_F17,X,Xq13.1,68353353,68460235,106882,-,-
BAC39_H20,X,Xq13.1,68361361,68457868,96507,-,-
BAC34_L08,X,Xq13.1,68383264,68474531,91267,-,-
BAC165_G14,X,Xq13.1,68477702,68544769,67067,-,-
BAC75_D24,X,Xq13.1,68602631,68701232,98601,-,-
BAC125_E09,X,Xq13.1,69238457,69315152,76695,-,-
BAC41_C20,X,Xq13.1,69256837,69420669,163832,-,-
BAC155_P08,X,Xq13.1,69453840,69535326,81486,-,-
BAC81_G15,X,Xq13.1,69686991,69831215,144224,-,-
BAC68_F05,X,Xq13.1,69837270,69931920,94650,-,-
BAC32_N20,X,Xq13.1,69866210,69957154,90944,-,-
BAC167_E03,X,Xq13.1,69893623,69983741,90118,-,-
BAC233_N11,X,Xq13.1,70190119,70268401,78282,-,-
BAC175_G24,X,Xq13.1,70206747,70359463,152716,-,-
BAC237_N06,X,Xq13.1,70218658,70383724,165066,-,-
BAC5_M22,X,Xq13.1,70437090,70532723,95633,-,-
BAC33_M17,X,Xq13.1,70520554,70597160,76606,-,-
BAC67_J13,X,Xq13.1,70555361,70646555,91194,-,-
BAC205_H10,X,Xq13.1,70647197,70755244,108047,-,-
BAC142_N11,X,Xq13.1,70650609,70755023,104414,-,-
BAC142_O01,X,Xq13.1,70674454,70773467,99013,-,-
BAC168_O02,X,Xq13.1,70751525,70836937,85412,-,-
BAC176_O09,X,Xq13.1,70957275,71056024,98749,-,-
BAC219_E06,X,Xq13.1,70976971,71066836,89865,-,-
BAC46_P24,X,Xq13.1,71039155,71154017,114862,-,-
BAC117_P19,X,Xq13.1,71066830,71160631,93801,-,-
BAC122_P09,X,Xq13.1,71089160,71202110,112950,-,-
BAC76_A04,X,Xq13.1,71132389,71228486,96097,-,-
BAC54_C15,X,Xq13.1,71154061,71245745,91684,-,-
BAC166_K22,X,Xq13.1,71377775,71485914,108139,-,-
BAC182_P03,X,Xq13.1,71380117,71492564,112447,-,-
BAC103_N15,X,Xq13.1,71429226,71542407,113181,-,-
BAC90_F18,X,Xq13.1,71470679,71483326,12647,-,-
BAC109_B13,X,Xq13.1,71475314,71580905,105591,-,-
BAC163_E01,X,Xq13.1,71493464,71574170,80706,-,-
BAC157_A03,X,Xq13.1-Xq13.2,72149181,72241929,92748,-,-
BAC62_F24,X,Xq13.2,72286067,72369840,83773,-,-
BAC46_P09,X,Xq13.2,72344594,72438534,93940,-,-
BAC223_F12,X,Xq13.2,72468000,72536006,68006,-,-
BAC76_B14,X,Xq13.2,72476340,72574256,97916,-,-
BAC40_F11,X,Xq13.2,72908415,73029365,120950,-,-
BAC21_M16,X,Xq13.2,72914236,73020679,106443,-,-
BAC23_D08,X,Xq13.2,72970610,73077944,107334,-,-
BAC1_I20,X,Xq13.2,72989254,73175188,185934,-,-
BAC100_A23,X,Xq13.2,73138198,73259132,120934,-,-
BAC247_H05,X,Xq13.2,73159683,73183548,23865,-,-
BAC184_H08,X,Xq13.2,73167239,73267282,100043,-,-
BAC15_M09,X,Xq13.2,73354292,73501238,146946,-,-
BAC241_I07,X,Xq13.2,73354893,73429234,74341,-,-
BAC66_G11,X,Xq13.2,73395468,73502147,106679,-,-
BAC88_L11,X,Xq13.2,73416832,73514255,97423,-,-
BAC150_H11,X,Xq13.2,73462137,73532954,70817,-,-
BAC27_N15,X,Xq13.2,73466632,73556059,89427,-,-
BAC110_I17,X,Xq13.2,73586446,73722553,136107,-,-
BAC247_N12,X,Xq13.2-Xq13.3,73722569,73826268,103699,-,-
BAC162_P12,X,Xq13.2-Xq13.3,73791687,73879287,87600,-,-
BAC42_I12,X,Xq13.3,74000912,74088010,87098,-,-
BAC108_G18,X,Xq13.3,74050202,74161044,110842,-,-
BAC82_G09,X,Xq13.3,74202592,74313319,110727,-,-
BAC118_A09,X,Xq13.3,74245528,74360063,114535,-,-
BAC234_H13,X,Xq13.3,74372146,74481678,109532,-,-
BAC59_M16,X,Xq13.3,74405128,74546794,141666,-,-
BAC2_G02,X,Xq13.3,74423684,74554033,130349,-,-
BAC29_J05,X,Xq13.3,74585130,74681290,96160,-,-
BAC178_E12,X,Xq13.3,74833078,74911520,78442,-,-
BAC149_H05,X,Xq13.3,74872862,75007173,134311,-,-
BAC117_A17,X,Xq13.3,74922956,74998030,75074,-,-
BAC58_J13,X,Xq13.3,75008214,75106384,98170,-,-
BAC75_A20,X,Xq13.3,75008232,75122367,114135,-,-
BAC184_B19,X,Xq13.3,75122393,75233472,111079,-,-
BAC122_I23,X,Xq13.3,75212855,75318892,106037,-,-
BAC127_C21,X,Xq13.3,75345230,75484450,139220,-,-
BAC51_E21,X,Xq13.3,75555339,75674374,119035,-,-
BAC55_L13,X,Xq13.3,75818078,75974190,156112,-,-
BAC233_O05,X,Xq13.3-Xq21.1,75917665,76045681,128016,-,-
BAC239_F04,X,Xq21.1,76174023,76258613,84590,-,-
BAC61_D17,X,Xq21.1,76203938,76281705,77767,-,-
BAC44_I13,X,Xq21.1,76655613,76804503,148890,-,-
BAC44_L12,X,Xq21.1,76966699,77060034,93335,-,-
BAC148_D21,X,Xq21.1,76966711,77085280,118569,-,-
BAC92_G10,X,Xq21.1,77024089,77142408,118319,-,-
BAC170_L05,X,Xq21.1,77029576,77117501,87925,-,-
BAC199_F23,X,Xq21.1,77140852,77215898,75046,-,-
BAC179_M02,X,Xq21.1,77190769,77275748,84979,-,-
BAC182_D07,X,Xq21.1,77435389,77523161,87772,-,-
BAC172_B15,X,Xq21.1,77624668,77716172,91504,-,-
BAC181_F18,X,Xq21.1,77673770,77805857,132087,-,-
BAC194_I19,X,Xq21.1,77835788,77935535,99747,-,-
BAC48_D01,X,Xq21.1,77857547,77949329,91782,-,-
BAC143_G17,X,Xq21.1,78185997,78272058,86061,-,-
BAC10_H18,X,Xq21.1,78573153,78667783,94630,-,-
BAC190_D22,X,Xq21.1,78720296,78802025,81729,-,-
BAC104_G10,X,Xq21.1,78736340,78826658,90318,-,-
BAC35_B07,X,Xq21.1,78802355,78920744,118389,-,-
BAC57_P15,X,Xq21.1,78812507,78915917,103410,-,-
BAC71_C04,X,Xq21.1,78930129,79028727,98598,-,-
BAC136_M01,X,Xq21.1,79808105,79900354,92249,-,-
BAC146_I19,X,Xq21.1,79950704,80038330,87626,-,-
BAC88_M14,X,Xq21.1,80016257,80097614,81357,-,-
BAC77_E09,X,Xq21.1,80052664,80130235,77571,-,-
BAC205_P17,X,Xq21.1,80162939,80222037,59098,-,-
BAC141_P18,X,Xq21.1,80375834,80475735,99901,-,-
BAC67_D14,X,Xq21.1,80962602,81111161,148559,-,-
BAC14_K15,X,Xq21.1,81064907,81172237,107330,-,-
BAC155_J05,X,Xq21.1,81109155,81184983,75828,-,-
BAC186_P22,X,Xq21.1,81177380,81262421,85041,-,-
BAC18_B01,X,Xq21.1,81277134,81406555,129421,-,-
BAC249_F01,X,Xq21.1,81463193,81579724,116531,-,-
BAC65_L09,X,Xq21.1,81737034,81833720,96686,-,-
BAC68_N05,X,Xq21.1,81738537,81832517,93980,-,-
BAC232_L11,X,Xq21.1,81948716,82037306,88590,-,-
BAC191_F08,X,Xq21.1,82196904,82278241,81337,-,-
BAC20_K10,X,Xq21.1,82217516,82340524,123008,-,-
BAC190_E17,X,Xq21.1,82221764,82303584,81820,-,-
BAC239_C09,X,Xq21.1,82395170,82472125,76955,-,-
BAC170_M18,X,Xq21.1,82900514,82994376,93862,-,-
BAC102_G04,X,Xq21.1,83258528,83345787,87259,-,-
BAC184_N03,X,Xq21.1,83321842,83386708,64866,-,-
BAC237_F14,X,Xq21.1,83494506,83579745,85239,-,-
BAC180_D07,X,Xq21.1,83568865,83684343,115478,-,-
BAC8_B12,X,Xq21.1,83668160,83783959,115799,-,-
BAC214_L17,X,Xq21.1,83675173,83754759,79586,-,-
BAC123_M08,X,Xq21.1,83775612,83848419,72807,-,-
BAC219_G07,X,Xq21.1,84079240,84169542,90302,-,-
BAC40_J22,X,Xq21.2,84922746,85051969,129223,-,-
BAC68_P20,X,Xq21.2,85150713,85251447,100734,-,-
BAC43_K14,X,Xq21.2,85203154,85303542,100388,-,-
BAC102_A06,X,Xq21.2,85271150,85378698,107548,-,-
BAC148_L13,X,Xq21.2,85303763,85395598,91835,-,-
BAC180_L15,X,Xq21.2,85350150,85446365,96215,-,-
BAC177_M07,X,Xq21.2,85379523,85465256,85733,-,-
BAC109_M04,X,Xq21.2,85753231,85960179,206948,-,-
BAC14_J19,X,Xq21.31,86504877,86629204,124327,-,-
BAC178_D09,X,Xq21.31,86914819,86994675,79856,-,-
BAC152_J02,X,Xq21.31,86920385,87011878,91493,-,-
BAC81_A22,X,Xq21.31,87076952,87159855,82903,-,-
BAC178_C16,X,Xq21.31,87244034,87335309,91275,-,-
BAC167_C17,X,Xq21.31,87418965,87503081,84116,-,-
BAC235_I06,X,Xq21.31,87420916,87513517,92601,-,-
BAC33_K17,X,Xq21.31,87460908,87551070,90162,-,-
BAC37_A12,X,Xq21.31,87505991,87618015,112024,-,-
BAC19_N19,X,Xq21.31,87618017,87706207,88190,-,-
BAC185_C24,X,Xq21.31,87637988,87713801,75813,-,-
BAC233_B20,X,Xq21.31,87706631,87810967,104336,-,-
BAC38_H04,X,Xq21.31,88079898,88186953,107055,-,-
BAC177_H11,X,Xq21.31,88133184,88220978,87794,-,-
BAC184_N18,X,Xq21.31,88217393,88298185,80792,-,-
BAC97_C02,X,Xq21.31,88405043,88485701,80658,-,-
BAC12_P09,X,Xq21.31,88412177,88544468,132291,-,-
BAC124_C24,X,Xq21.31,88508602,88612533,103931,-,-
BAC194_D15,X,Xq21.31,88649098,88767869,118771,-,-
BAC59_I16,X,Xq21.31,88739136,88871157,132021,-,-
BAC250_M07,X,Xq21.31,88759774,88847154,87380,-,-
BAC83_P09,X,Xq21.31,88773783,88866369,92586,-,-
BAC150_H01,X,Xq21.31,89019026,89104511,85485,-,-
BAC139_J22,X,Xq21.31,89169873,89236232,66359,-,-
BAC229_I12,X,Xq21.31,89936473,90030770,94297,-,-
BAC107_H01,X,Xq21.31,90013439,90128948,115509,-,-
BAC244_C08,X,Xq21.31,90050073,90161885,111812,-,-
BAC147_A16,X,Xq21.31,90191949,90279480,87531,-,-
BAC54_O24,X,Xq21.31,90356388,90458116,101728,-,-
BAC8_H03,X,Xq21.31,90615909,90699826,83917,-,-
BAC22_B17,X,Xq21.31,90796879,90920753,123874,-,-
BAC224_G20,X,Xq21.31,91191863,91277881,86018,-,-
BAC188_K08,X,Xq21.31,91191974,91283674,91700,-,-
BAC241_N04,X,Xq21.31,91220949,91312037,91088,-,-
BAC19_F05,X,Xq21.31,91313753,91433871,120118,-,-
BAC244_P05,X,Xq21.31,91375823,91470640,94817,-,-
BAC190_E19,X,Xq21.31,91401011,91510529,109518,-,-
BAC103_E22,X,Xq21.31,91489945,91598806,108861,-,-
BAC115_L06,X,Xq21.31,91643644,91733749,90105,-,-
BAC86_D09,X,Xq21.32,92066962,92156161,89199,-,-
BAC32_A17,X,Xq21.32,92249525,92350988,101463,-,-
BAC60_M14,X,Xq21.32,92421641,92593278,171637,-,-
BAC106_P03,X,Xq21.32,92470760,92552353,81593,-,-
BAC248_H04,X,Xq21.32,92513477,92524516,11039,-,-
BAC76_H11,X,Xq21.32,92569017,92697962,128945,-,-
BAC243_A13,X,Xq21.32,92755615,92881951,126336,-,-
BAC63_E14,X,Xq21.32,92980360,93106081,125721,-,-
BAC146_B03,X,Xq21.32-Xq21.33,93462658,93554989,92331,-,-
BAC10_E04,X,Xq21.32-Xq21.33,93493252,93624558,131306,-,-
BAC158_P24,X,Xq21.33,93508410,93598931,90521,-,-
BAC197_B14,X,Xq21.33,93764289,93864464,100175,-,-
BAC182_D09,X,Xq21.33,93870477,93959235,88758,-,-
BAC161_M13,X,Xq21.33,93871333,93969500,98167,-,-
BAC32_A07,X,Xq21.33,93907614,93996500,88886,-,-
BAC231_H03,X,Xq21.33,94027809,94104232,76423,-,-
BAC230_E20,X,Xq21.33,94066390,94149376,82986,-,-
BAC178_J07,X,Xq21.33,94575033,94652293,77260,-,-
BAC33_D11,X,Xq21.33,94678627,94778993,100366,-,-
BAC210_D07,X,Xq21.33,94708939,94793186,84247,-,-
BAC191_J22,X,Xq21.33,95142962,95252261,109299,-,-
BAC34_A21,X,Xq21.33,95341675,95451183,109508,-,-
BAC67_K24,X,Xq21.33,95398227,95498198,99971,-,-
BAC184_F16,X,Xq21.33,95598315,95682562,84247,-,-
BAC220_O16,X,Xq21.33,95741268,95828448,87180,-,-
BAC90_D20,X,Xq21.33,95857323,95947716,90393,-,-
BAC6_B17,X,Xq21.33,96022346,96133479,111133,-,-
BAC226_O23,X,Xq21.33,96048330,96133502,85172,-,-
BAC136_P15,X,Xq21.33,96444318,96521434,77116,-,-
BAC90_I16,X,Xq21.33,96444318,96546882,102564,-,-
BAC228_C06,X,Xq21.33,96600262,96699543,99281,-,-
BAC217_H16,X,Xq21.33,96706702,96784045,77343,-,-
BAC90_G16,X,Xq21.33,97005661,97119486,113825,-,-
BAC29_H22,X,Xq21.33,97515670,97606129,90459,-,-
BAC34_K09,X,Xq21.33,97545270,97668289,123019,-,-
BAC240_N19,X,Xq21.33,97577933,97700084,122151,-,-
BAC230_C04,X,Xq21.33,97733044,97822976,89932,-,-
BAC144_J23,X,Xq21.33,97786211,97897061,110850,-,-
BAC82_I13,X,Xq22.1,98441533,98525154,83621,-,-
BAC80_K10,X,Xq22.1,99362517,99491133,128616,-,-
BAC195_I15,X,Xq22.1,99768872,99850090,81218,-,-
BAC137_F11,X,Xq22.1,99776808,99862064,85256,-,-
BAC122_B15,X,Xq22.1,99924804,100039808,115004,-,-
BAC246_K17,X,Xq22.1,99936944,100046316,109372,-,-
BAC198_L03,X,Xq22.1,100292814,100379303,86489,-,-
BAC73_I08,X,Xq22.1,100378287,100483968,105681,-,-
BAC57_E05,X,Xq22.1,100386244,100511014,124770,-,-
BAC238_M15,X,Xq22.1,100526955,100616247,89292,-,-
BAC116_E07,X,Xq22.1,100735333,100810259,74926,-,-
BAC190_P02,X,Xq22.1,100917827,101002229,84402,-,-
BAC153_C07,X,Xq22.1,101365822,101464520,98698,-,-
BAC134_I21,X,Xq22.1,101379776,101475097,95321,-,-
BAC167_K07,X,Xq22.1,101736402,101856338,119936,-,-
BAC148_N15,X,Xq22.1,102186807,102265960,79153,-,-
BAC154_M04,X,Xq22.1,102378230,102474334,96104,-,-
BAC142_P15,X,Xq22.1-Xq22.2,102452210,102539512,87302,-,-
BAC183_G09,X,Xq22.2,102660287,102757614,97327,-,-
BAC43_D09,X,Xq22.2,102875243,102969740,94497,-,-
BAC96_E03,X,Xq22.2,102910691,102993285,82594,-,-
BAC22_C20,X,Xq22.2,103073784,103176767,102983,-,-
BAC97_H17,X,Xq22.2,103241234,103334124,92890,-,-
BAC140_F17,X,Xq22.2,103272465,103358314,85849,-,-
BAC144_O19,X,Xq22.2,103294477,103421188,126711,-,-
BAC50_L06,X,Xq22.2,103361200,103459040,97840,-,-
BAC106_D19,X,Xq22.2,103393169,103499411,106242,-,-
BAC140_N14,X,Xq22.2,103421181,103512406,91225,-,-
BAC141_P03,X,Xq22.2-Xq22.3,103499406,103603159,103753,-,-
BAC59_F08,X,Xq22.3,103649197,103748467,99270,-,-
BAC224_A13,X,Xq22.3,103663443,103748467,85024,-,-
BAC196_I12,X,Xq22.3,103932931,104014729,81798,-,-
BAC14_A09,X,Xq22.3,105251727,105333922,82195,-,-
BAC85_L16,X,Xq22.3,105537399,105612989,75590,-,-
BAC86_A19,X,Xq22.3,105623540,105745786,122246,-,-
BAC33_F22,X,Xq22.3,105655209,105747252,92043,-,-
BAC153_I08,X,Xq22.3,106023505,106105198,81693,-,-
BAC29_F16,X,Xq22.3,106097671,106223499,125828,-,-
BAC242_E12,X,Xq22.3,106334240,106414324,80084,-,-
BAC128_J12,X,Xq22.3,106374931,106473899,98968,-,-
BAC179_E21,X,Xq22.3,106409118,106527384,118266,-,-
BAC22_K20,X,Xq22.3,106508277,106592464,84187,-,-
BAC246_K02,X,Xq22.3,106558477,106677904,119427,-,-
BAC154_M07,X,Xq22.3,106559036,106669201,110165,-,-
BAC191_F11,X,Xq22.3,106583197,106670228,87031,-,-
BAC81_A10,X,Xq22.3,106805030,106897465,92435,-,-
BAC101_I10,X,Xq22.3,106805030,106900467,95437,-,-
BAC56_M03,X,Xq22.3,106897298,106993334,96036,-,-
BAC78_D08,X,Xq22.3,107127682,107235240,107558,-,-
BAC36_B16,X,Xq22.3,107132176,107218551,86375,-,-
BAC87_O22,X,Xq22.3,107135446,107213987,78541,-,-
BAC75_K22,X,Xq22.3,107424319,107502869,78550,-,-
BAC110_L12,X,Xq22.3,107426726,107517048,90322,-,-
BAC200_I13,X,Xq22.3,107545247,107646991,101744,-,-
BAC239_B04,X,Xq22.3,107571824,107646991,75167,-,-
BAC179_N14,X,Xq22.3,108006265,108093072,86807,-,-
BAC27_H06,X,Xq22.3,108044592,108153980,109388,-,-
BAC187_C20,X,Xq22.3,108050219,108141619,91400,-,-
BAC68_A02,X,Xq22.3,108179571,108272083,92512,-,-
BAC229_I08,X,Xq22.3,108693795,108842089,148294,-,-
BAC129_I08,X,Xq22.3,108825610,108918951,93341,-,-
BAC86_L04,X,Xq22.3,108828978,108954174,125196,-,-
BAC105_I03,X,Xq22.3,108981349,109074154,92805,-,-
BAC11_N13,X,Xq22.3,109068997,109140382,71385,-,-
BAC84_C01,X,Xq22.3,109091966,109189518,97552,-,-
BAC55_G15,X,Xq22.3,109563764,109650120,86356,-,-
BAC240_C23,X,Xq22.3,109833885,109920743,86858,-,-
BAC53_D15,X,Xq22.3,109926606,110008183,81577,-,-
BAC91_J24,X,Xq22.3,110215405,110332259,116854,-,-
BAC58_E08,X,Xq22.3,110274369,110404077,129708,-,-
BAC101_J13,X,Xq23,110507012,110591809,84797,-,-
BAC182_K21,X,Xq23,110698613,110780369,81756,-,-
BAC136_O01,X,Xq23,110728514,110816047,87533,-,-
BAC123_D14,X,Xq23,110805961,110915069,109108,-,-
BAC151_J03,X,Xq23,110915064,110990275,75211,-,-
BAC35_B11,X,Xq23,111091479,111218894,127415,-,-
BAC95_M21,X,Xq23,111167656,111307411,139755,-,-
BAC195_N07,X,Xq23,111281141,111376276,95135,-,-
BAC41_C23,X,Xq23,111778527,111870639,92112,-,-
BAC217_K12,X,Xq23,112641243,112729116,87873,-,-
BAC196_B12,X,Xq23,112714493,112728123,13630,-,-
BAC69_H16,X,Xq23,112844546,112947854,103308,-,-
BAC60_J08,X,Xq23,113075964,113228101,152137,-,-
BAC247_O11,X,Xq23,113693247,113783641,90394,yes,-
BAC233_O21,X,Xq23,114195360,114292897,97537,yes,-
BAC34_D21,X,Xq23,114207936,114315905,107969,yes,-
BAC48_P10,X,Xq23,114288301,114369610,81309,-,-
BAC228_E19,X,Xq23,114343613,114412746,69133,-,-
BAC227_B06,X,Xq23,114504567,114576603,72036,-,-
BAC140_D15,X,Xq23,114729067,114830986,101919,-,-
BAC220_H10,X,Xq23,114867676,114949629,81953,-,-
BAC165_H20,X,Xq23,114867676,115001308,133632,-,-
BAC222_O22,X,Xq23,114867676,115018669,150993,-,-
BAC173_D04,X,Xq23,114867715,114985137,117422,-,-
BAC176_O13,X,Xq23,114971409,115065241,93832,-,-
BAC35_B13,X,Xq23,114973190,115064573,91383,-,-
BAC156_A16,X,Xq23,115133777,115239868,106091,-,-
BAC113_C16,X,Xq23,115184618,115296286,111668,-,-
BAC95_M07,X,Xq23,115184728,115307017,122289,-,-
BAC165_P14,X,Xq23,115390169,115450800,60631,-,-
BAC14_C07,X,Xq23,116061850,116156104,94254,-,-
BAC88_E06,X,Xq23,116238703,116361190,122487,-,-
BAC70_L11,X,Xq23,116282461,116406236,123775,-,-
BAC188_M23,X,Xq23,116287174,116394244,107070,-,-
BAC197_C16,X,Xq23,116575555,116675842,100287,-,-
BAC185_A15,X,Xq23-Xq24,116777540,116866591,89051,-,-
BAC68_K06,X,Xq24,116847895,116938012,90117,-,-
BAC15_A07,X,Xq24,117300017,117576616,276599,-,-
BAC114_B19,X,Xq24,117308151,117398104,89953,-,-
BAC148_N21,X,Xq24,117458177,117541080,82903,-,-
BAC148_N12,X,Xq24,117704883,117827548,122665,-,-
BAC172_F16,X,Xq24,117723377,117829380,106003,-,-
BAC41_H04,X,Xq24,117741852,117856414,114562,-,-
BAC84_N04,X,Xq24,117743985,117866721,122736,-,-
BAC97_M03,X,Xq24,117749203,117863172,113969,-,-
BAC199_E08,X,Xq24,117752410,117866724,114314,-,-
BAC232_P09,X,Xq24,117765404,117866397,100993,-,-
BAC46_E04,X,Xq24,117774639,117907122,132483,-,-
BAC74_M03,X,Xq24,117829580,117906650,77070,-,-
BAC71_A09,X,Xq24,117871972,117988316,116344,-,-
BAC167_K04,X,Xq24,117901867,117994928,93061,-,-
BAC75_N08,X,Xq24,118040386,118155572,115186,-,-
BAC227_J18,X,Xq24,118155688,118239238,83550,-,-
BAC21_N06,X,Xq24,118162172,118267172,105000,-,-
BAC24_G09,X,Xq24,118217825,118311642,93817,-,-
BAC125_F02,X,Xq24,118246767,118347074,100307,-,-
BAC38_M22,X,Xq24,118267182,118386737,119555,-,-
BAC179_H24,X,Xq24,118267182,118377751,110569,-,-
BAC152_O22,X,Xq24,118397902,118420698,22796,-,-
BAC238_L23,X,Xq24,118418378,118497799,79421,-,-
BAC22_L04,X,Xq24,118498009,118643323,145314,-,-
BAC144_P18,X,Xq24,118635141,118722174,87033,-,-
BAC178_B13,X,Xq24,118635141,118727651,92510,-,-
BAC82_G14,X,Xq24,118695497,118909554,214057,-,-
BAC234_L05,X,Xq24,118753845,118884990,131145,-,-
BAC21_P18,X,Xq24,118771045,118869380,98335,-,-
BAC115_N11,X,Xq24,118998370,119081639,83269,-,-
BAC118_C05,X,Xq24,119002957,119155158,152201,-,-
BAC197_A19,X,Xq24,119077411,119180676,103265,-,-
BAC248_N17,X,Xq24,119491170,119586911,95741,-,-
BAC33_J15,X,Xq24,119506057,119586920,80863,-,-
BAC88_P17,X,Xq24,119597479,119714348,116869,-,-
BAC160_A17,X,Xq24,119597607,119750334,152727,-,-
BAC218_A01,X,Xq24,119645172,119761949,116777,-,-
BAC190_B04,X,Xq24,119747610,119841914,94304,-,-
BAC78_G20,X,Xq24,119915464,120068081,152617,yes,-
BAC179_D05,X,Xq24,119920346,120029443,109097,yes,-
BAC32_I02,X,Xq24,119920347,120047069,126722,yes,-
BAC66_O22,X,Xq24,120164223,120287777,123554,-,-
BAC180_P21,X,Xq24,120423183,120528843,105660,-,-
BAC80_K02,X,Xq25,120820702,120917201,96499,-,-
BAC72_O19,X,Xq25,121039609,121174260,134651,-,-
BAC213_A14,X,Xq25,121187060,121293362,106302,-,-
BAC96_F14,X,Xq25,121229072,121333787,104715,-,-
BAC156_O11,X,Xq25,121573505,121662161,88656,-,-
BAC54_B10,X,Xq25,121640827,121751458,110631,-,-
BAC128_E11,X,Xq25,122074820,122235477,160657,-,-
BAC95_N08,X,Xq25,122074820,122175487,100667,-,-
BAC78_L09,X,Xq25,122321283,122464506,143223,-,-
BAC185_D14,X,Xq25,122372972,122489954,116982,-,-
BAC97_C11,X,Xq25,122558528,122669264,110736,-,-
BAC51_A09,X,Xq25,122669654,122792971,123317,-,-
BAC37_A17,X,Xq25,122720627,122868565,147938,-,-
BAC29_F22,X,Xq25,122720665,122812734,92069,-,-
BAC25_L19,X,Xq25,122742434,122850105,107671,-,-
BAC70_J06,X,Xq25,122812729,122891208,78479,-,-
BAC82_B13,X,Xq25,122915695,123029155,113460,-,-
BAC85_A21,X,Xq25,122922422,123009266,86844,-,-
BAC90_O22,X,Xq25,123053151,123162819,109668,-,-
BAC248_H02,X,Xq25,123193570,123307069,113499,-,-
BAC31_I20,X,Xq25,123600053,123688022,87969,-,-
BAC126_I08,X,Xq25,123730996,123845298,114302,-,-
BAC197_G13,X,Xq25,123821552,123907445,85893,-,-
BAC176_E20,X,Xq25,123889209,123965008,75799,-,-
BAC57_F20,X,Xq25,124442532,124530151,87619,-,-
BAC61_J22,X,Xq25,124929786,125050618,120832,-,-
BAC234_O19,X,Xq25,125012494,125105641,93147,-,-
BAC64_B06,X,Xq25,125328848,125422688,93840,-,-
BAC155_P22,X,Xq25,125644374,125743976,99602,-,-
BAC192_O08,X,Xq25,125917983,126001339,83356,-,-
BAC205_J13,X,Xq25,126039802,126124405,84603,-,-
BAC50_D03,X,Xq25,126131563,126264773,133210,-,-
BAC169_O15,X,Xq25,126810302,126890814,80512,-,-
BAC10_G13,X,Xq25,126810302,126926324,116022,-,-
BAC65_B02,X,Xq25,127089504,127172832,83328,-,-
BAC67_O10,X,Xq25,127750977,127840421,89444,-,-
BAC125_I22,X,Xq25,127935579,128041375,105796,-,-
BAC65_C04,X,Xq25,128013710,128117779,104069,-,-
BAC247_N09,X,Xq25,128082763,128160684,77921,-,-
BAC7_O10,X,Xq25,128117775,128247071,129296,-,-
BAC35_A12,X,Xq25,128130743,128270275,139532,-,-
BAC58_K02,X,Xq25,128247065,128426763,179698,-,-
BAC234_O22,X,Xq25,128310370,128399194,88824,-,-
BAC75_D18,X,Xq25,128540539,128657135,116596,-,-
BAC142_N21,X,Xq25,128837027,128933890,96863,-,-
BAC155_G12,X,Xq25,128847691,128933890,86199,-,-
BAC63_G23,X,Xq25,128963506,129081155,117649,-,-
BAC234_M06,X,Xq25,128976353,129067206,90853,-,-
BAC135_N09,X,Xq25,128978662,129069864,91202,-,-
BAC91_B15,X,Xq25,129339823,129446770,106947,-,-
BAC222_G13,X,Xq25,129357330,129434969,77639,-,-
BAC36_I24,X,Xq25,129451612,129555914,104302,-,-
BAC195_C06,X,Xq25-Xq26.1,129779212,129876094,96882,-,-
BAC54_O01,X,Xq26.1,130132766,130218434,85668,-,-
BAC208_P19,X,Xq26.1,130204499,130280882,76383,-,-
BAC122_K03,X,Xq26.1-Xq26.2,130241568,130385108,143540,-,-
BAC248_K18,X,Xq26.2,130336507,130423163,86656,-,-
BAC125_J05,X,Xq26.2,130423158,130572494,149336,-,-
BAC179_J15,X,Xq26.2,130688162,130790704,102542,-,-
BAC77_O16,X,Xq26.2,130696900,130812887,115987,-,-
BAC131_O21,X,Xq26.2,130745954,130812976,67022,-,-
BAC158_L08,X,Xq26.2,130745959,130823524,77565,-,-
BAC158_K08,X,Xq26.2,130745972,130823524,77552,-,-
BAC34_H13,X,Xq26.2,130898281,131014982,116701,-,-
BAC220_H23,X,Xq26.2,131310430,131394493,84063,-,-
BAC161_D12,X,Xq26.2,131625738,131724376,98638,-,-
BAC73_B07,X,Xq26.2,131631150,131750852,119702,-,-
BAC31_O21,X,Xq26.2,131639525,131744392,104867,-,-
BAC181_B15,X,Xq26.2,131650509,131737154,86645,-,-
BAC50_C06,X,Xq26.2,131651607,131743065,91458,-,-
BAC107_L13,X,Xq26.2,131882400,131988566,106166,-,-
BAC148_G20,X,Xq26.2,132105440,132237585,132145,-,-
BAC176_P10,X,Xq26.2,132113763,132221343,107580,-,-
BAC173_E10,X,Xq26.2,132129025,132238028,109003,-,-
BAC100_O23,X,Xq26.2,132282839,132365696,82857,-,-
BAC96_N03,X,Xq26.2,132347408,132466901,119493,-,-
BAC239_P17,X,Xq26.2,132351782,132434075,82293,-,-
BAC84_K10,X,Xq26.2,132407216,132495505,88289,-,-
BAC50_E02,X,Xq26.2,132421599,132523438,101839,-,-
BAC149_F02,X,Xq26.2,132504306,132596615,92309,-,-
BAC69_N21,X,Xq26.2,132661862,132798102,136240,-,-
BAC91_I05,X,Xq26.2,132808517,132894038,85521,-,-
BAC126_F23,X,Xq26.2,132855564,132932512,76948,-,-
BAC155_N09,X,Xq26.2,133100884,133189446,88562,-,-
BAC52_N11,X,Xq26.2,133105635,133235911,130276,-,-
BAC75_C09,X,Xq26.2,133170875,133278395,107520,-,-
BAC41_L18,X,Xq26.2,133332721,133488889,156168,-,-
BAC130_O02,X,Xq26.2,133349422,133445998,96576,-,-
BAC143_E08,X,Xq26.2,133353604,133466083,112479,-,-
BAC183_A22,X,Xq26.2-Xq26.3,133496105,133616008,119903,-,-
BAC165_A09,X,Xq26.3,133542189,133630401,88212,-,-
BAC86_C19,X,Xq26.3,133644266,133732003,87737,-,-
BAC36_B11,X,Xq26.3,133706863,133790302,83439,-,-
BAC21_L04,X,Xq26.3,133713378,133790564,77186,-,-
BAC227_K08,X,Xq26.3,133837241,133929953,92712,-,-
BAC154_D01,X,Xq26.3,133878387,133981906,103519,-,-
BAC19_B16,X,Xq26.3,133925111,134021955,96844,-,-
BAC73_H15,X,Xq26.3,133944803,134043785,98982,-,-
BAC238_N04,X,Xq26.3,134146813,134248456,101643,-,-
BAC243_I10,X,Xq26.3,134364569,134454882,90313,-,-
BAC58_H24,X,Xq26.3,134688720,134769876,81156,yes,-
BAC238_H13,X,Xq26.3,134691802,134735740,43938,yes,-
BAC252_P05,X,Xq26.3,134921529,135012310,90781,-,-
BAC247_B11,X,Xq26.3,135088196,135188409,100213,-,-
BAC204_M24,X,Xq26.3,135207333,135281489,74156,-,-
BAC228_P18,X,Xq26.3,135207337,135291490,84153,-,-
BAC202_O03,X,Xq26.3,135281952,135363915,81963,-,-
BAC116_I06,X,Xq26.3,135521220,135649047,127827,-,-
BAC15_C03,X,Xq26.3,135521247,135636885,115638,-,-
BAC240_E13,X,Xq26.3,135558569,135633239,74670,-,-
BAC35_A16,X,Xq26.3,135607057,135720863,113806,-,-
BAC22_A02,X,Xq26.3,135690269,135813412,123143,-,-
BAC52_D17,X,Xq26.3,135690269,135832289,142020,-,-
BAC122_G10,X,Xq26.3,135757498,135838838,81340,-,-
BAC61_A21,X,Xq26.3,136227127,136358357,131230,-,-
BAC121_B07,X,Xq26.3,136271531,136366152,94621,-,-
BAC50_M03,X,Xq26.3,136358440,136455763,97323,-,-
BAC75_B06,X,Xq26.3,136372003,136482752,110749,-,-
BAC170_L14,X,Xq26.3,136382256,136491142,108886,-,-
BAC52_K10,X,Xq26.3,136460176,136623419,163243,-,-
BAC160_J17,X,Xq26.3,136472508,136573897,101389,-,-
BAC56_O09,X,Xq26.3,136547807,136668800,120993,-,-
BAC65_O22,X,Xq26.3,136569698,136660681,90983,-,-
BAC232_P07,X,Xq26.3,136894701,136984578,89877,-,-
BAC227_D21,X,Xq26.3,137024112,137097509,73397,-,-
BAC137_I16,X,Xq26.3,137135950,137153345,17395,-,-
BAC248_B07,X,Xq26.3,137592680,137679094,86414,-,-
BAC129_J22,X,Xq27.1,137812879,137906322,93443,-,-
BAC41_J10,X,Xq27.1,137846128,137987871,141743,-,-
BAC78_B07,X,Xq27.1,138135443,138256766,121323,-,-
BAC205_K06,X,Xq27.1,138151751,138231507,79756,-,-
BAC226_B09,X,Xq27.1,138547374,138644257,96883,-,-
BAC224_J03,X,Xq27.1,138778136,138875463,97327,-,-
BAC235_I23,X,Xq27.1,138825673,138906140,80467,-,-
BAC105_O19,X,Xq27.1,138859612,138981380,121768,-,-
BAC162_N20,X,Xq27.1,138859612,138981448,121836,-,-
BAC151_E05,X,Xq27.1,138898596,138990049,91453,-,-
BAC140_K17,X,Xq27.1,138987986,139082234,94248,-,-
BAC18_M08,X,Xq27.1,138987986,139131753,143767,-,-
BAC89_A05,X,Xq27.1,139029378,139115867,86489,-,-
BAC34_L03,X,Xq27.1,139187758,139327095,139337,-,-
BAC35_J19,X,Xq27.1,139196555,139332114,135559,-,-
BAC106_D17,X,Xq27.1,139367331,139511504,144173,-,-
BAC114_D23,X,Xq27.1,139506916,139619822,112906,-,-
BAC230_M10,X,Xq27.1,139853605,139939034,85429,-,-
BAC167_P05,X,Xq27.1,139885942,139939035,53093,-,-
BAC60_D09,X,Xq27.1,139967296,140085389,118093,-,-
BAC83_B22,X,Xq27.1,139967296,140068760,101464,-,-
BAC233_N08,X,Xq27.2,140141212,140223733,82521,-,-
BAC144_B17,X,Xq27.2,140226806,140328281,101475,-,-
BAC77_O23,X,Xq27.2,140328329,140431066,102737,-,-
BAC42_K17,X,Xq27.2,140854473,140970857,116384,-,-
BAC20_A16,X,Xq27.2,140916390,141007685,91295,-,-
BAC177_B13,X,Xq27.2,141088355,141188783,100428,-,-
BAC69_M15,X,Xq27.2,141093963,141200483,106520,-,-
BAC162_B10,X,Xq27.2,141489490,141600695,111205,-,-
BAC106_C02,X,Xq27.2,141502616,141592669,90053,-,-
BAC43_A10,X,Xq27.2-Xq27.3,141886806,141975865,89059,-,-
BAC197_G20,X,Xq27.3,142239908,142312794,72886,-,-
BAC73_M06,X,Xq27.3,142930987,143019508,88521,-,-
BAC136_C12,X,Xq27.3,143455932,143524410,68478,-,-
BAC61_I07,X,Xq27.3,143464857,143560342,95485,-,-
BAC252_I02,X,Xq27.3,143743638,143897617,153979,-,-
BAC195_O22,X,Xq27.3,143897609,143985544,87935,-,-
BAC167_F23,X,Xq27.3,144036394,144135894,99500,-,-
BAC166_J20,X,Xq27.3,144051517,144136724,85207,-,-
BAC199_E10,X,Xq27.3,144582601,144604833,22232,-,-
BAC144_D02,X,Xq27.3,144894211,144975034,80823,-,-
BAC42_G22,X,Xq27.3,144911504,145046142,134638,-,-
BAC22_J09,X,Xq27.3,145180934,145294636,113702,-,-
BAC65_M13,X,Xq27.3,145494080,145585601,91521,-,-
BAC237_E16,X,Xq27.3,145498541,145578506,79965,-,-
BAC91_G24,X,Xq27.3,146063144,146162890,99746,-,-
BAC175_M01,X,Xq27.3,146191236,146275903,84667,-,-
BAC237_H01,X,Xq27.3,146220103,146298699,78596,-,-
BAC219_K03,X,Xq27.3,146437829,146560580,122751,-,-
BAC141_G01,X,Xq27.3,146577609,146668493,90884,-,-
BAC118_D14,X,Xq27.3,146671361,146808961,137600,-,-
BAC226_H04,X,Xq27.3,146671361,146795101,123740,-,-
BAC125_F24,X,Xq27.3,146689255,146806339,117084,-,-
BAC236_A21,X,Xq27.3,146762295,146843403,81108,-,-
BAC57_E17,X,Xq28,147117945,147211433,93488,-,-
BAC61_J12,X,Xq28,147576852,147667442,90590,-,-
BAC109_C06,X,Xq28,147645924,147764509,118585,-,-
BAC23_D04,X,Xq28,147699345,147781232,81887,-,-
BAC239_I03,X,Xq28,147750477,147826838,76361,-,-
BAC130_N14,X,Xq28,147762923,147877010,114087,-,-
BAC191_K02,X,Xq28,148113216,148193715,80499,-,-
BAC110_E14,X,Xq28,148402530,148534033,131503,-,-
BAC70_O03,X,Xq28,148402658,148513821,111163,-,-
BAC58_H01,X,Xq28,148922150,149111774,189624,-,-
BAC192_J06,X,Xq28,149099654,149186467,86813,-,-
BAC41_M16,X,Xq28,149148826,149278195,129369,-,-
BAC119_C15,X,Xq28,149354893,149476738,121845,-,-
BAC244_J02,X,Xq28,149412587,149519504,106917,-,-
BAC140_N06,X,Xq28,149423054,149522865,99811,-,-
BAC117_L09,X,Xq28,149533972,149618487,84515,-,-
BAC190_M05,X,Xq28,149689098,149766308,77210,-,-
BAC55_F19,X,Xq28,149842615,149935382,92767,-,-
BAC246_C05,X,Xq28,150308815,150425250,116435,-,-
BAC104_O20,X,Xq28,150434595,150517200,82605,-,-
BAC139_D06,X,Xq28,150511334,150617374,106040,-,-
BAC150_P11,X,Xq28,150528233,150653540,125307,-,-
BAC32_I19,X,Xq28,150671336,150687627,16291,-,-
BAC160_C04,X,Xq28,150787205,150892750,105545,-,-
BAC171_E04,X,Xq28,150876470,150963393,86923,-,-
BAC107_M14,X,Xq28,151024337,151150103,125766,-,-
BAC130_P05,X,Xq28,151205325,151282622,77297,-,-
BAC91_I04,X,Xq28,151227582,151318191,90609,-,-
BAC73_M20,X,Xq28,151287138,151368497,81359,-,-
BAC140_C17,X,Xq28,151291663,151397228,105565,-,-
BAC76_H21,X,Xq28,151342153,151427222,85069,-,-
BAC139_P13,X,Xq28,151624167,151721538,97371,-,-
BAC43_D10,X,Xq28,151919721,152061155,141434,-,-
BAC201_C13,X,Xq28,152329086,152402262,73176,yes,-
BAC27_B24,X,Xq28,152468870,152614120,145250,yes,-
BAC58_L15,X,Xq28,152503527,152599092,95565,yes,-
BAC123_P03,X,Xq28,152633105,152762279,129174,yes,-
BAC197_L13,X,Xq28,152651035,152765270,114235,yes,-
BAC197_F15,X,Xq28,152805970,152907710,101740,yes,-
BAC234_C04,X,Xq28,152808081,152883992,75911,yes,-
BAC115_I10,X,Xq28,153041191,153145565,104374,yes,-
BAC18_P16,X,Xq28,153041370,153126798,85428,yes,-
BAC170_P07,X,Xq28,153043834,153126798,82964,yes,-
BAC184_L19,X,Xq28,153091677,153250284,158607,yes,-
BAC113_F18,X,Xq28,153132513,153237835,105322,yes,-
BAC171_F11,X,Xq28,153330074,153459189,129115,yes,-
BAC43_A21,X,Xq28,153424880,153559571,134691,-,-
BAC32_F17,X,Xq28,153459413,153559571,100158,yes,-
BAC154_L24,X,Xq28,153666347,153762892,96545,-,-
BAC169_G11,X,Xq28,153700318,153790613,90295,yes,-
BAC76_M12,X,Xq28,153729057,153833913,104856,yes,-
BAC67_B19,X,Xq28,153762939,153851864,88925,yes,-
BAC90_L23,X,Xq28,153812977,153900034,87057,-,-
BAC184_N24,X,Xq28,153875524,153958784,83260,-,-
BAC67_L20,X,Xq28,153968128,154093597,125469,-,-
BAC122_E13,X,Xq28,154091653,154197560,105907,yes,-
BAC192_B23,Y,Yp11.32,319715,426650,106935,-,-
BAC61_I02,Y,Yp11.32,326898,426455,99557,-,-
BAC233_C01,Y,Yp11.32,514323,675238,160915,-,-
BAC139_K17,Y,Yp11.32,601939,714256,112317,-,-
BAC57_D04,Y,Yp11.32,668831,759518,90687,-,-
BAC46_I15,Y,Yp11.32,687415,783162,95747,-,-
BAC118_H09,Y,Yp11.32,759846,881946,122100,-,-
BAC140_H24,Y,Yp11.32,797416,881657,84241,-,-
BAC186_F02,Y,Yp11.32,915571,1174330,258759,-,-
BAC176_M14,Y,Yp11.32,1152492,1289291,136799,-,-
BAC132_K20,Y,Yp11.32,1327906,1435664,107758,-,-
BAC97_B01,Y,Yp11.32,1573975,1674334,100359,-,-
BAC177_F06,Y,Yp11.32-Yp11.31,1653607,1762499,108892,-,-
BAC131_O23,Y,Yp11.31,1722357,1824217,101860,-,-
BAC140_P23,Y,Yp11.31,1759682,1861690,102008,-,-
BAC27_A01,Y,Yp11.31,1830352,1963701,133349,-,-
BAC10_H14,Y,Yp11.31,1853393,1956126,102733,-,-
BAC84_M18,Y,Yp11.31,1866198,1965863,99665,-,-
BAC242_M03,Y,Yp11.31,1889093,1977956,88863,-,-
BAC46_M21,Y,Yp11.31,2146049,2168332,22283,-,-
BAC90_G11,Y,Yp11.31,2164274,2261154,96880,-,-
BAC149_K06,Y,Yp11.31,2164275,2247583,83308,-,-
BAC188_F17,Y,Yp11.31,2174317,2276329,102012,-,-
BAC147_M08,Y,Yp11.31,2213590,2312726,99136,-,-
BAC86_B13,Y,Yp11.31,2213920,2375207,161287,-,-
BAC68_G09,Y,Yp11.31,2276364,2360524,84160,-,-
BAC189_D22,Y,Yp11.31,2483264,2624252,140988,-,-
BAC82_E05,Y,Yp11.31,2485580,2624252,138672,-,-
BAC241_N10,Y,Yp11.31,2500328,2614945,114617,-,-
BAC96_G05,Y,Yp11.31,2507900,2624252,116352,-,-
BAC17_A13,Y,Yp11.31,2520517,2608057,87540,-,-
BAC248_N11,Y,Yp11.31,2520517,2610676,90159,-,-
BAC219_C18,Y,Yp11.31,2542321,2626906,84585,-,-
BAC43_L01,Y,Yp11.31,2624337,2735973,111636,-,-
BAC122_D24,Y,Yp11.31,2627230,2675526,48296,-,-
BAC84_G04,Y,Yp11.31,2721712,2844127,122415,-,-
BAC122_O09,Y,Yp11.31,2797987,2879492,81505,-,-
BAC58_A06,Y,Yp11.31,3052876,3164830,111954,-,-
BAC220_N24,Y,Yp11.31,3210421,3248519,38098,-,-
BAC180_C24,Y,Yp11.31-Yp11.2,3215324,3315569,100245,-,-
BAC97_C08,Y,Yp11.31,3216301,3299297,82996,-,-
BAC50_P04,Y,Yp11.31-Yp11.2,3248661,3340036,91375,-,-
BAC11_K06,Y,Yp11.2,3436602,3549612,113010,-,-
BAC132_G18,Y,Yp11.2,3636454,3719982,83528,-,-
BAC74_L10,Y,Yp11.2,4008707,4117876,109169,-,-
BAC230_F04,Y,Yp11.2,4836846,4959701,122855,-,-
BAC56_M19,Y,Yp11.2,5086368,5238048,151680,-,-
BAC91_G21,Y,Yp11.2,5202819,5288864,86045,-,-
BAC65_A04,Y,Yp11.2,5248202,5341624,93422,-,-
BAC196_E09,Y,Yp11.2,5527045,5614744,87699,-,-
BAC76_G04,Y,Yp11.2,6139724,6279464,139740,-,-
BAC115_O17,Y,Yp11.2,6226126,6311581,85455,-,-
BAC10_I08,Y,Yp11.2,6258864,6378082,119218,-,-
BAC90_L17,Y,Yp11.2,6262690,6428829,166139,-,-
BAC244_N13,Y,Yp11.2,6330385,6441274,110889,-,-
BAC229_H04,Y,Yp11.2,6702710,6782097,79387,-,-
BAC250_M23,Y,Yp11.2,6799252,6875799,76547,-,-
BAC239_G09,Y,Yp11.2,6825007,6912069,87062,-,-
BAC86_F07,Y,Yp11.2,6939094,7047723,108629,-,-
BAC16_E22,Y,Yp11.2,6970476,7070958,100482,-,-
BAC69_F16,Y,Yp11.2,7115532,7193663,78131,-,-
BAC165_N23,Y,Yp11.2,7122813,7200625,77812,-,-
BAC158_N08,Y,Yp11.2,7193674,7255227,61553,-,-
BAC188_H04,Y,Yp11.2,7427331,7507409,80078,-,-
BAC64_K11,Y,Yp11.2,7610823,7709981,99158,-,-
BAC242_N10,Y,Yp11.2,7794349,7905628,111279,-,-
BAC24_K23,Y,Yp11.2,8029316,8132309,102993,-,-
BAC187_O08,Y,Yp11.2,8066619,8148504,81885,-,-
BAC133_C13,Y,Yp11.2,8188209,8279051,90842,-,-
BAC247_K21,Y,Yp11.2,8467826,8538287,70461,-,-
BAC116_E08,Y,Yp11.2,8575932,8736322,160390,-,-
BAC205_L13,Y,Yp11.2,8607008,8706082,99074,-,-
BAC227_N09,Y,Yp11.2,8891169,8974955,83786,-,-
BAC18_N08,Y,Yp11.2,9104809,9236217,131408,-,-
BAC52_L18,Y,Yp11.2,9226545,9270530,43985,-,-
BAC132_J19,Y,Yp11.2,9242221,9929731,687510,-,-
BAC169_H10,Y,Yp11.2,9246932,9921585,674653,-,-
BAC204_L20,Y,Yp11.2,9250264,9270427,20163,-,-
BAC97_K10,Y,Yp11.2,9290900,9921585,630685,-,-
BAC67_E19,Y,Yp11.2,9929747,10048670,118923,-,-
BAC234_G14,Y,Yp11.2,10382492,10460693,78201,-,-
BAC101_D24,Y,Yp11.2,10543310,10639659,96349,-,-
BAC26_I16,Y,Yp11.2,10544343,10639660,95317,-,-
BAC90_B02,Y,Yq11.1,11660468,11795754,135286,-,-
BAC165_F09,Y,Yq11.1,11665833,11759047,93214,-,-
BAC175_E13,Y,Yq11.1,11671038,11791657,120619,-,-
BAC151_J05,Y,Yq11.1,11791652,11864302,72650,-,-
BAC221_H19,Y,Yq11.1,11796068,11879755,83687,-,-
BAC30_B08,Y,Yq11.1,11820789,11864299,43510,-,-
BAC249_L23,Y,Yq11.1,11850066,11987629,137563,-,-
BAC248_F22,Y,Yq11.1,11879748,11975244,95496,-,-
BAC194_I21,Y,Yq11.1,11890230,11975246,85016,-,-
BAC37_D15,Y,Yq11.1-Yq11.21,12466760,12554327,87567,-,-
BAC233_N21,Y,Yq11.21,12815323,12897408,82085,-,-
BAC46_G23,Y,Yq11.21,12855502,12937883,82381,-,-
BAC130_H18,Y,Yq11.21,12934928,13034478,99550,-,-
BAC38_F05,Y,Yq11.21,12956766,13034478,77712,-,-
BAC240_B03,Y,Yq11.21,12958811,13036413,77602,-,-
BAC53_D22,Y,Yq11.21,13133328,13234260,100932,-,-
BAC26_N23,Y,Yq11.21,13145135,13250796,105661,-,-
BAC32_I14,Y,Yq11.21,13191997,13321190,129193,-,-
BAC240_J19,Y,Yq11.21,13227005,13316247,89242,-,-
BAC5_N18,Y,Yq11.21,13227034,13331670,104636,-,-
BAC64_N03,Y,Yq11.21,13247829,13375273,127444,-,-
BAC29_G04,Y,Yq11.21,13250834,13358763,107929,-,-
BAC127_H21,Y,Yq11.21,13495385,13609582,114197,-,-
BAC181_I22,Y,Yq11.21,13705265,13826673,121408,-,-
BAC154_P20,Y,Yq11.21,13709958,13814490,104532,-,-
BAC239_D18,Y,Yq11.21,13748144,13828667,80523,-,-
BAC192_M14,Y,Yq11.21,13970303,14064396,94093,-,-
BAC48_D16,Y,Yq11.21,14010602,14098109,87507,-,-
BAC101_I21,Y,Yq11.21,14086977,14174195,87218,-,-
BAC228_J07,Y,Yq11.221,14372269,14465429,93160,-,-
BAC148_O21,Y,Yq11.221,14534336,14635567,101231,-,-
BAC85_C21,Y,Yq11.221,15126224,15239228,113004,-,-
BAC58_H14,Y,Yq11.221,15537728,15619590,81862,-,-
BAC134_A02,Y,Yq11.221,15736345,15939943,203598,-,-
BAC12_B23,Y,Yq11.221,15768996,15877419,108423,-,-
BAC78_I15,Y,Yq11.221,15895089,15985877,90788,-,-
BAC185_E19,Y,Yq11.221,15924658,16031175,106517,-,-
BAC140_H17,Y,Yq11.221,16177603,16271634,94031,-,-
BAC23_I15,Y,Yq11.221,16572671,16694511,121840,-,-
BAC67_D10,Y,Yq11.221,16584238,16692589,108351,-,-
BAC70_H11,Y,Yq11.221,16597922,16684987,87065,-,-
BAC227_M19,Y,Yq11.221,16720375,16811747,91372,-,-
BAC243_O19,Y,Yq11.221,16725879,16792740,66861,-,-
BAC43_E12,Y,Yq11.221,16750215,16886274,136059,-,-
BAC65_J16,Y,Yq11.221,17261230,17382688,121458,-,-
BAC36_J10,Y,Yq11.221,17296472,17385220,88748,-,-
BAC40_L21,Y,Yq11.221,17382684,17497709,115025,-,-
BAC195_K18,Y,Yq11.221,17404830,17497902,93072,-,-
BAC180_K16,Y,Yq11.221,17415806,17520345,104539,-,-
BAC83_H05,Y,Yq11.221,17440614,17533054,92440,-,-
BAC196_H16,Y,Yq11.221,17653198,17731754,78556,-,-
BAC102_F03,Y,Yq11.221,17655546,17754959,99413,-,-
BAC78_F12,Y,Yq11.221,18211540,18289229,77689,-,-
BAC49_J09,Y,Yq11.221,18262823,18378120,115297,-,-
BAC237_B04,Y,Yq11.221,18313729,18386392,72663,-,-
BAC141_M01,Y,Yq11.222,19070668,19146902,76234,-,-
BAC20_H11,Y,Yq11.222,19176499,19259437,82938,-,-
BAC31_L01,Y,Yq11.222,19643980,19738325,94345,-,-
BAC240_H05,Y,Yq11.222,20119719,20208748,89029,-,-
BAC148_D15,Y,Yq11.222,20249672,20376557,126885,-,-
BAC235_G11,Y,Yq11.222,20440063,20538857,98794,-,-
BAC108_F10,Y,Yq11.222,21033400,21107425,74025,-,-
BAC90_N08,Y,Yq11.222,21082318,21185706,103388,-,-
BAC46_N23,Y,Yq11.222,21101381,21191464,90083,-,-
BAC80_J09,Y,Yq11.222,21103264,21237288,134024,-,-
BAC221_D16,Y,Yq11.222-Yq11.223,21237282,21327502,90220,-,-
BAC37_G04,Y,Yq11.223,21821927,21904810,82883,-,-
BAC147_N13,Y,Yq11.223,21902593,22051106,148513,-,-
BAC166_C12,Y,Yq11.223,21904807,22001501,96694,-,-
BAC218_L09,Y,Yq11.223,22051101,22080977,29876,yes,-
BAC71_F05,Y,Yq11.223,22059548,22076227,16679,yes,-
BAC132_A12,Y,Yq11.223,22077536,22125586,48050,yes,-
BAC109_J12,Y,Yq11.223,22129028,22222951,93923,yes,-
BAC37_P09,Y,Yq11.223,22131027,22276555,145528,yes,-
BAC239_M03,Y,Yq11.223,22159461,22238975,79514,-,-
BAC5_O07,Y,Yq11.223,22366432,22387249,20817,-,-
BAC170_J12,Y,Yq11.223,22592161,24285128,1692967,-,-
BAC145_L08,Y,Yq11.223,22629196,22735098,105902,yes,-
BAC205_A21,Y,Yq11.223,23232499,23317755,85256,-,-
BAC105_F12,Y,Yq11.223,23239375,23405142,165767,-,-
BAC244_F04,Y,Yq11.223,23308931,23421495,112564,yes,-
BAC166_M22,Y,Yq11.223,23386514,23476686,90172,yes,-
BAC41_I24,Y,Yq11.223,23464529,23603803,139274,-,-
BAC151_O11,Y,Yq11.223,23482965,23569326,86361,yes,-
BAC141_I24,Y,Yq11.223,23506629,23581870,75241,-,-
BAC31_F01,Y,Yq11.223,23585187,23684191,99004,-,-
BAC22_E21,Y,Yq11.223,24143342,24309906,166564,-,-
BAC224_D20,Y,Yq11.223,24640545,24723413,82868,-,-
BAC168_J09,Y,Yq11.223,24746713,24858395,111682,-,-
BAC176_J22,Y,Yq11.223,24797518,24919219,121701,-,-
BAC175_P03,Y,Yq11.223,24801890,24888223,86333,-,-
BAC27_K04,Y,Yq11.223,24808291,24906093,97802,-,-
BAC19_E10,Y,Yq11.23,26946257,27049488,103231,-,-
BAC236_H15,Y,Yq11.23,27011004,27117567,106563,-,-
BAC247_I09,Y,Yq11.23,27013223,27097249,84026,-,-
BAC65_G13,Y,Yq12,57427195,57438920,11725,-,-
BAC154_P04,Y,Yq12,57598670,57689986,91316,-,-
